Timestamp,Account No,Balance,Amount,tag
00:16,555393405.0,-1020.37295,-35.34,9
01:31,270374623.0,10213.10070011245,-3.12,2
02:22,678851253.0,5075.757461229566,-1.45,8
02:31,198946608.0,6395.087862622103,-34.43,9
02:46,518474507.0,13600.298014706974,-27.21,9
02:47,259015404.0,4808.844542587488,-36.94,9
02:54,131388684.0,20634.014535486025,-22.06,7
02:59,749378808.0,5574.617739056726,-43.17,5
03:02,196289502.0,14306.24353142484,-6.99,9
03:11,500043411.0,12982.024188770534,-2.08,8
03:11,647936800.0,1854.1785820921796,-13.24,2
03:16,364396689.0,-518.29325,-33.37,9
03:18,259015404.0,4773.404779829732,-35.44,5
03:33,196289502.0,14244.246288178989,-62.0,2
03:35,310740977.0,255.69176250617295,-4.47,7
03:35,541639148.0,5452.465969144514,-9.78,2
03:36,466649401.0,400.06906572319673,-10.78,7
03:41,633345190.0,7434.626860045669,-38.39,9
03:44,187541224.0,7049.216567386137,-35.25,9
03:47,736340277.0,7835.05669629449,-8.99,9
03:49,851181128.0,4884.645268445495,-37.64,9
03:52,454356905.0,2701.1682469826214,-4.35,2
03:53,252760664.0,6207.485869063067,-34.55,7
04:03,899742927.0,12970.643689488492,-13.1,8
04:04,987656636.0,6190.172715491885,-51.96,2
04:05,887853850.0,10755.619758638317,-34.44,9
04:05,534325901.0,6723.705713837709,-7.25,7
04:10,324224854.0,4282.953073677454,-66.22,5
04:12,822135975.0,12181.948367839304,-21.55,8
04:19,730002588.0,12856.748009970002,-1.08,8
04:20,305778936.0,11678.93630059625,-27.97,8
04:24,873701090.0,2197.266092105655,-4.71,4
04:24,890830949.0,1257.0303499999982,-31.13,9
04:31,779236304.0,837.4552588016564,-28.93,9
04:31,510101371.0,12636.644645166294,-26.74,9
04:33,873693307.0,8629.66482227601,-8.11,7
04:35,256002321.0,8400.44977873745,-15.24,9
04:36,489964679.0,22325.61881578203,-30.65,9
04:37,213112754.0,7002.818779638467,-32.69,5
04:38,683319988.0,7770.409736529099,-4.56,7
04:43,549414742.0,7920.225470715652,-33.02,9
04:45,496395938.0,12132.313743661369,-11.44,2
04:49,766941757.0,9712.912730818342,-32.87,9
04:50,134461671.0,8078.564903705955,-5.45,7
04:57,851649498.0,10121.505389332016,-19.36,7
04:59,675806859.0,6645.819069108416,-4.32,7
05:02,613729471.0,7680.553874741501,-8.17,7
05:03,905860285.0,15651.802927619552,-10.46,5
05:06,383833857.0,21517.0917973419,-1.92,5
05:12,408057540.0,7560.025666524455,-10.56,2
05:18,482513594.0,7916.208836137348,-29.96,2
05:19,930277104.0,10226.874959751272,-12.99,9
05:21,169006407.0,11661.271987396804,-60.29,2
05:21,489964679.0,22303.33464575707,-22.28,2
05:22,699139822.0,2700.415374156768,-42.68,8
05:22,417850087.0,15703.395549585535,-62.92,7
05:22,518474507.0,13583.5710981332,-16.73,2
05:26,709608057.0,3803.442658103844,-48.3,9
05:28,435984758.0,5466.031489466257,-48.98,7
05:29,779236304.0,827.6109411124914,-9.84,8
05:30,237493332.0,13179.637900219685,-2.74,2
05:35,462962606.0,443.1315499999989,-23.73,9
05:38,950234174.0,1840.8006253226845,-0.75,5
05:41,519644021.0,2733.7008362723873,-21.76,7
05:46,858989281.0,25436.508940835018,-20.17,2
05:47,532478725.0,5427.705496276786,-64.88,7
05:50,414805878.0,14077.37815339777,-46.13,9
05:57,994214354.0,9288.467756680682,-24.18,9
05:59,480557476.0,10825.0422988288,-22.31,2
05:59,522188082.0,7681.674557057058,-39.72,2
06:02,198946608.0,6385.781574079849,-9.31,7
06:02,930277104.0,10222.653992354595,-4.22,5
06:05,216285378.0,21604.764315006803,-30.14,9
06:07,419550103.0,17251.881494840323,-21.17,7
06:14,586315521.0,11264.054848075635,-20.15,2
06:14,364357875.0,6688.437856591364,-28.31,5
06:15,366550080.0,23440.90315983644,-3.75,8
06:16,785749304.0,8410.004633327868,-9.54,8
06:17,887853850.0,10712.809036000855,-42.81,2
06:20,767447966.0,5025.347005512111,-2.0,7
06:21,124102251.0,4601.514005646173,-48.86,8
06:22,668329719.0,9210.752948469992,-15.3,7
06:23,832564361.0,14747.540160494436,-18.9,2
06:26,678330503.0,4410.206509059181,-11.81,7
06:28,146909202.0,5560.203478738555,-17.5,7
06:31,108481285.0,8444.389160311857,-9.44,4
06:31,284905540.0,7549.781818960158,-31.16,5
06:33,264550521.0,9206.282736207868,-19.51,7
06:34,806358207.0,11368.90863791859,-2.13,7
06:35,973086490.0,9656.093098649788,-18.68,9
06:42,254853117.0,3083.969913131277,-30.24,2
06:43,909669130.0,14.19788473676666,-31.33,9
06:45,506618547.0,17474.932033903428,-12.1,7
06:45,853907490.0,7428.878588230183,-44.23,7
06:47,639409800.0,31240.922167742432,-55.79,8
06:51,145387690.0,5569.948700012476,-24.2,9
06:54,802697323.0,19457.51772640083,-35.12,9
06:54,215426302.0,1007.8564040256916,-12.94,9
06:55,108563213.0,21286.970110026006,-4.38,7
06:55,450896297.0,12892.120007020629,-36.73,8
06:58,795847804.0,20585.746949912915,-18.25,9
06:59,705848712.0,23569.445636515306,-21.89,9
07:00,624500124.0,3673.5346359048463,-41.46,7
07:00,656812046.0,1452.8130996691657,-38.55,2
07:03,151968462.0,8770.73212245732,-20.06,7
07:06,235881534.0,12223.406333144583,-33.2,7
07:07,985188462.0,1250.6536887112247,-39.87,9
07:09,819515373.0,2728.83073606379,-22.89,9
07:09,547010927.0,22057.23655597104,-35.53,9
07:11,815385232.0,9311.960007109568,-19.26,2
07:11,473820682.0,11097.833239871688,-19.63,5
07:15,287480331.0,11755.94585015516,-7.51,4
07:17,994214354.0,9287.785310078832,-0.68,2
07:18,687135796.0,25158.056195301557,-40.83,2
07:18,769311479.0,7044.196653822238,-35.22,2
07:20,176922958.0,2428.56371364187,-11.02,2
07:21,407574996.0,3780.339385020175,-17.99,7
07:23,290818242.0,6706.25630971507,-50.44,7
07:24,128033695.0,3205.9634960550525,-34.38,7
07:25,383625050.0,6132.542014722928,-3.48,2
07:28,657139925.0,12302.209673012898,-66.45,2
07:28,651756497.0,13252.685320651284,-36.22,7
07:35,308505160.0,12315.12064560916,-70.42,7
07:35,322221939.0,3988.48014309072,-12.21,2
07:40,547010927.0,22033.520883810867,-23.72,4
07:40,960208650.0,15485.822117340073,-8.13,2
07:41,585625048.0,1208.2176190586329,-11.95,7
07:43,195895574.0,7009.328813814608,-19.56,2
07:46,795847804.0,20570.72209639791,-15.02,2
07:47,370521542.0,23518.412176794463,-70.74,2
07:52,949032480.0,5552.372418130638,-25.74,9
07:58,256002321.0,8345.681389348616,-54.77,7
08:04,441274121.0,11842.010474427612,-47.29,5
08:05,550169791.0,18947.46543545428,-65.54,5
08:05,897714622.0,8747.592813616946,-35.0,2
08:06,409971170.0,2286.229957985303,-7.49,5
08:06,527842638.0,1592.1741426329838,-7.1,9
08:07,623156843.0,5562.486387921985,-6.96,2
08:09,558119802.0,29474.681827482073,-47.63,7
08:14,601627384.0,4964.589259332462,-2.08,4
08:15,245690309.0,8633.446800196214,-2.36,5
08:19,494404688.0,-2290.7857653362075,-17.85,5
08:20,704517789.0,16545.612469418575,-11.84,7
08:22,534097839.0,-4089.226049999998,-7.12,5
08:23,738958551.0,8238.210654330787,-86.44,5
08:23,762859681.0,-556.6499000000011,-14.07,5
08:23,949032480.0,5544.242681561402,-8.13,4
08:25,604288474.0,3263.0687876408892,-16.95,9
08:26,854513972.0,581.9554999999996,-63.4,5
08:26,143061865.0,6838.5389552287115,-31.05,5
08:28,417850087.0,15661.857549585537,-41.54,5
08:28,699313649.0,-2038.015899141906,-24.64,5
08:32,822250278.0,6600.377814633884,-23.29,7
08:33,202320275.0,-533.7919000000003,-121.99,5
08:33,183186021.0,-1119.725049999999,-24.59,5
08:35,366550080.0,23369.76915983644,-71.13,5
08:35,779816907.0,-2626.0810829229126,-23.45,5
08:35,511179916.0,7644.057980828385,-17.34,5
08:36,471897866.0,8282.738553163601,-3.54,2
08:36,749371623.0,-2386.221653517343,-26.8,5
08:37,703537476.0,1719.314249999999,-43.64,5
08:37,321372947.0,-278.51305078909934,-53.71,5
08:38,195895574.0,6977.849813814608,-31.48,5
08:38,647472692.0,22331.964593057968,-128.37,5
08:39,478986718.0,-889.4363000000003,-78.76,5
08:39,329840194.0,1261.3551701431477,-70.45,5
08:39,824916823.0,8686.161259967621,-118.12,5
08:40,180719578.0,-3854.367749999996,-36.41,5
08:41,426466211.0,-2945.37575,-50.23,5
08:45,535744551.0,1431.4726159956267,-36.49,5
08:47,124377686.0,-2433.8448999999987,-50.64,5
08:49,954263768.0,-117.73910000000018,-54.62,5
08:50,612304466.0,-1920.9432500000005,-35.43,5
08:50,245198540.0,-589.5086011982206,-28.23,5
08:50,851649498.0,10028.671389332016,-92.83,5
08:52,651756497.0,13154.111320651284,-98.57,5
08:52,698955014.0,1243.8607049409122,-50.45,5
08:54,609939116.0,6690.131783669524,-22.74,8
08:56,203466392.0,5376.364716454687,-0.92,5
08:56,152488934.0,1158.0008573137306,-122.97,5
08:57,361201224.0,6589.454232067893,-162.5,5
08:59,992204045.0,11104.051929220128,-60.24,7
09:00,718058208.0,2047.6581165591265,-95.72,5
09:02,116169597.0,-85.17405000000045,-232.47,5
09:03,705848712.0,23554.594890313616,-14.85,2
09:07,444371478.0,500.95494999999886,-136.9,5
09:07,613729471.0,7672.953874741501,-7.6,9
09:09,660789920.0,-2229.1883473823727,-39.28,5
09:12,187111705.0,7437.231085896912,-6.34,2
09:13,854513972.0,571.9654999999996,-9.99,7
09:13,520239952.0,-30.51162665476291,-12.99,2
09:16,823208989.0,2025.0881960134816,-100.39,2
09:17,551196328.0,4248.683700000005,-41.99,2
09:17,706250160.0,10772.619621120515,-0.49,2
09:18,471897866.0,8198.346553163601,-84.39,5
09:18,454356905.0,2664.6080869826214,-36.56,4
09:20,203466392.0,5341.364716454687,-35.0,2
09:21,741903302.0,2671.5006479884787,-6.8,9
09:21,355602925.0,1261.3854455558708,-84.87,5
09:22,647936800.0,1771.9485820921795,-82.23,2
09:22,663479159.0,1183.8913418277086,-16.98,7
09:23,169006407.0,11645.271987396804,-16.0,1
09:23,264208990.0,906.3511999999992,-121.99,2
09:24,698955014.0,1188.8707049409122,-54.99,2
09:24,570410059.0,1676.0857967763095,-59.5,2
09:24,399538448.0,7182.442520655865,-7.8,9
09:24,324224854.0,4276.893073677454,-6.06,2
09:26,660874296.0,1726.8574499608465,-39.95,7
09:26,596171893.0,238.2317448255111,-6.99,7
09:26,853907490.0,7411.406588230183,-17.47,5
09:26,277562576.0,1095.8336757914603,-27.48,4
09:26,414805878.0,13892.808153397771,-184.57,2
09:26,348460748.0,-6.063550000000845,-139.61,5
09:26,412823730.0,395.0593758504898,-42.03,2
09:26,147474476.0,4896.872727031108,-6.99,7
09:28,833499132.0,2282.228,-31.95,7
09:29,183888402.0,17192.91145948729,-233.06,7
09:30,670427480.0,2278.6686000000013,-109.98,2
09:30,834581602.0,780.9715499999995,-1.99,4
09:30,752362502.0,9065.572655041988,-30.01,7
09:32,895331556.0,-14.500100000000582,-36.98,4
09:32,383625050.0,6079.722814722928,-52.82,4
09:32,188263947.0,842.8797500000003,-39.98,2
09:33,603721739.0,1539.0768994831842,-62.98,2
09:35,282837512.0,13567.022721206176,-49.9,5
09:35,903663593.0,1062.3424618155489,-54.0,2
09:35,851181128.0,4836.719528445496,-47.93,4
09:37,492215823.0,1402.6925738154423,-5.09,7
09:37,973388795.0,975.0676761636216,-10.0,2
09:38,500843551.0,945.3661499999998,-5.99,2
09:38,685959099.0,2563.563866099241,-21.0,4
09:39,448279144.0,1187.7093499999996,-13.98,1
09:39,197865285.0,502.4073117312205,-50.98,2
09:40,585625048.0,1170.2376190586328,-37.98,2
09:41,200080192.0,10015.007759881555,-102.23,5
09:41,427909748.0,2242.0532000000117,-5.99,2
09:41,282102606.0,857.3128124228265,-46.98,2
09:42,859603181.0,4226.47823240119,-42.67,5
09:43,887156614.0,283.6167789592264,-48.49,2
09:44,131388684.0,20605.424535486025,-28.59,2
09:44,819515373.0,2697.88073606379,-30.95,1
09:45,108481285.0,8425.409160311858,-18.98,2
09:45,500043411.0,12950.330948770534,-31.69,4
09:46,999752672.0,621.4296435333345,-79.0,2
09:47,450896297.0,12863.81165702063,-28.31,4
09:47,668175891.0,874.6227951930412,-63.98,5
09:47,860360312.0,374.2011588826804,-59.98,2
09:48,903663593.0,1012.0924618155487,-50.25,2
09:48,390747457.0,903.1842999999984,-22.98,2
09:48,641376155.0,-76.19148789854898,-180.6,2
09:48,361955473.0,482.2104452440845,-149.0,2
09:49,494789005.0,3242.7344304553444,-45.02,5
09:50,203466392.0,5205.564716454687,-135.8,2
09:52,492215823.0,1292.4407738154428,-110.25,4
09:52,108563213.0,21269.980110026005,-16.99,7
09:54,414454079.0,1639.5918500000016,-2.53,4
09:54,535744551.0,1416.4926159956267,-14.98,7
09:56,117273481.0,8499.285049737542,-28.96,7
09:57,448279144.0,1165.7093499999996,-22.0,2
09:57,648644594.0,787.6093999999991,-81.5,2
09:58,587202562.0,842.8669994170687,-8.98,4
09:58,552980092.0,191.54371911933745,-63.98,2
10:00,570410059.0,1616.5957967763095,-59.49,2
10:01,857455726.0,219.37098587568437,-89.5,2
10:03,624500124.0,3642.9417359048466,-30.59,4
10:03,769319491.0,-418.6555000000004,-59.33,5
10:04,500843551.0,889.3761499999998,-55.99,2
10:04,887156614.0,214.6167789592264,-69.0,2
10:05,183888402.0,17113.13945948729,-79.77,4
10:06,742223719.0,837.4940573048028,-96.88,5
10:06,473820682.0,11012.321239871686,-85.51,5
10:07,549414742.0,7886.476478739154,-33.75,7
10:07,227104649.0,2020.2470643161776,-100.09,2
10:08,660561861.0,1332.1010688409165,-113.59,5
10:08,149684419.0,1107.0622999999985,-134.49,2
10:09,603721739.0,1454.0968994831842,-84.98,2
10:09,414454079.0,1629.4718500000015,-10.12,2
10:09,910730524.0,7657.827883872252,-42.57,5
10:10,559995067.0,4918.487546822651,-118.29,2
10:11,835736339.0,2914.756740583976,-117.59,2
10:11,846550094.0,3154.4367141437215,-23.48,4
10:12,203466392.0,5017.264716454687,-188.3,2
10:12,350921975.0,405.9884710738743,-50.0,2
10:14,626989363.0,1094.5104633173755,-12.99,2
10:15,822135975.0,12175.918367839304,-6.03,4
10:15,641376155.0,-144.07748789854898,-67.89,2
10:16,349614277.0,1796.7905999999996,-64.99,2
10:17,361955473.0,277.71044524408444,-204.5,2
10:18,183888402.0,16989.253459487292,-123.89,4
10:18,992204045.0,11015.981929220128,-88.07,2
10:18,497772347.0,1072.3191499999984,-297.43,5
10:19,461990622.0,9151.26079942604,-49.02,2
10:19,624500124.0,3614.241735904847,-28.7,5
10:19,512989907.0,-2112.5194039753665,-19.18,5
10:21,912705941.0,16998.019437148807,-10.16,2
10:21,783650950.0,-539.4886434110116,-151.19,2
10:21,624563756.0,-84.80917121644367,-69.98,2
10:22,500843551.0,843.4061499999998,-45.97,2
10:22,867679563.0,2.1585537017158316,-85.72,5
10:22,742223719.0,792.5040573048028,-44.99,2
10:22,661295096.0,3071.286623370718,-1.5,4
10:23,284161641.0,174.41231104057567,-35.0,2
10:23,303843160.0,535.9705000000017,-44.99,2
10:23,366477356.0,890.28685,-60.0,2
10:24,184430449.0,2660.615271363016,-15.98,1
10:25,147474476.0,4696.000727031108,-200.87,2
10:25,698076160.0,5828.0145431085775,-69.98,4
10:26,986267641.0,5766.998151367868,-59.98,4
10:26,719586818.0,17511.304205639724,-22.4,7
10:27,873693307.0,8586.17482227601,-43.49,2
10:27,641376155.0,-184.66348789854896,-40.59,2
10:27,846550094.0,3091.4667141437217,-62.97,2
10:28,854513972.0,491.98549999999955,-79.98,2
10:29,390747457.0,885.2142999999983,-17.97,7
10:30,760753808.0,-539.6987500000004,-86.32,5
10:32,683078800.0,1688.0128191981998,-24.97,7
10:33,835736339.0,2753.112740583976,-161.64,2
10:34,709151315.0,297.5332183741599,-6.99,1
10:34,913801979.0,637.3626299144939,-118.68,5
10:35,183888402.0,16906.653459487294,-82.6,4
10:36,858989281.0,25429.268940835012,-7.24,7
10:37,570410059.0,1515.1057967763095,-101.49,2
10:38,680773155.0,453.6815833310918,-59.99,2
10:39,297823329.0,825.5926999999992,-99.99,2
10:39,736340277.0,7816.601425649918,-18.46,5
10:40,559995067.0,4787.615546822651,-130.87,2
10:41,583558311.0,452.4007847513319,-123.77,5
10:41,720742759.0,1350.681530883008,-27.99,2
10:41,626989363.0,1059.5104633173755,-35.0,2
10:42,986267641.0,5639.008151367868,-127.99,2
10:42,366477356.0,766.78685,-123.5,2
10:43,147474476.0,4504.928727031108,-191.07,2
10:44,303843160.0,508.02050000000173,-27.95,1
10:44,639409800.0,31175.68216774243,-65.24,2
10:45,641376155.0,-256.04948789854893,-71.39,2
10:46,264208990.0,889.3711999999991,-16.98,4
10:46,886837068.0,279.1930999999995,-69.99,2
10:47,709151315.0,116.26121837415994,-181.27,2
10:47,711045550.0,842.6963500000029,-28.0,2
10:47,203466392.0,4905.964716454687,-111.3,2
10:48,652048867.0,-56.933900000000975,-53.83,5
10:48,274818272.0,452.5853785671315,-81.5,4
10:49,623156843.0,5474.506387921985,-87.98,2
10:49,390747457.0,878.2242999999983,-6.99,4
10:49,487051121.0,1895.80418640972,-132.0,2
10:50,241459011.0,944.8151132723472,-33.96,1
10:50,348325817.0,10308.132721015552,-3.19,4
10:53,284161641.0,-22.287688959424315,-196.7,2
10:54,492215823.0,1124.4687738154428,-167.97,7
10:54,559995067.0,4632.2575468226505,-155.36,2
10:55,329840194.0,1241.3051701431475,-20.05,7
10:56,214339619.0,300.91408704013725,-64.99,2
10:57,604288474.0,3205.6957563144665,-57.37,7
10:58,776431321.0,3090.393761988023,-11.98,1
11:01,795847804.0,20527.392096397907,-43.33,1
11:02,835736339.0,2683.112740583976,-70.0,2
11:03,124125096.0,532.2329943878024,-18.0,4
11:03,237684254.0,5700.919667672027,-43.45,7
11:04,940569402.0,6593.361382758944,-0.2,5
11:04,350921975.0,366.0384710738743,-39.95,4
11:04,183888402.0,16777.867459487294,-128.79,7
11:05,834581602.0,699.4358999999995,-81.54,5
11:05,196289502.0,14227.496288178989,-16.75,4
11:07,390747457.0,840.2442999999982,-37.98,2
11:07,570410059.0,1501.6157967763097,-13.49,2
11:10,795847804.0,20515.282096397907,-12.11,4
11:11,380228542.0,-403.2811081844345,-47.99,2
11:11,471897866.0,8109.9865531636015,-88.36,7
11:12,274818272.0,415.60537856713154,-36.98,7
11:14,633345190.0,7424.403947550342,-10.22,7
11:14,903663593.0,869.2174618155489,-142.88,2
11:16,284161641.0,-71.28768895942432,-49.0,2
11:16,310620484.0,874.2267381437229,-46.25,2
11:16,130154096.0,1259.6070252012682,-16.98,7
11:17,366477356.0,696.78685,-70.0,2
11:18,559995067.0,4396.357546822651,-235.9,2
11:20,203466392.0,4847.164716454687,-58.8,2
11:20,764450279.0,19178.67000074624,-121.99,2
11:20,310375875.0,4061.8944517633913,-21.57,4
11:21,709151315.0,-42.62478162584006,-158.89,2
11:21,806358207.0,11274.01383791859,-94.89,4
11:22,427909748.0,2184.143200000012,-57.91,7
11:22,200080192.0,9905.835759881556,-109.17,7
11:22,874431242.0,8619.893845489185,-10.08,2
11:23,183888402.0,16640.681459487292,-137.19,7
11:25,973086490.0,9647.823767695783,-8.27,7
11:25,331450202.0,8159.309814342787,-53.5,7
11:28,835736339.0,2632.726740583976,-50.39,2
11:29,857455726.0,0.3709858756843687,-219.0,2
11:29,610645022.0,434.70463735508184,-70.98,2
11:30,824916823.0,8680.081259967621,-6.08,7
11:31,886837068.0,267.2130999999995,-11.98,4
11:31,631111289.0,-855.5765000000007,-33.65,5
11:31,492215823.0,1029.2827738154429,-95.19,4
11:34,166019891.0,7632.94805996834,-37.88,5
11:34,329840194.0,1097.7651701431478,-143.54,2
11:35,366477356.0,634.28685,-62.5,2
11:36,570410059.0,1387.6157967763097,-114.0,2
11:37,812692024.0,4444.662663331379,-14.99,4
11:37,475277431.0,2905.1841369436193,-11.0,4
11:38,487051121.0,1831.30418640972,-64.5,2
11:38,534204159.0,6802.310250796248,-0.89,7
11:40,427909748.0,2182.153200000012,-1.99,4
11:41,203466392.0,4702.264716454687,-144.9,2
11:44,124125096.0,504.2329943878024,-28.0,2
11:44,492850697.0,118.76807666586336,-20.01,2
11:45,833899961.0,2158.759766953437,-39.88,5
11:46,844835978.0,9767.727999400176,-25.96,7
11:47,310740977.0,205.70176250617297,-49.99,2
11:48,496395938.0,12047.13774366137,-85.18,5
11:48,709151315.0,-213.39678162584,-170.77,2
11:49,277562576.0,1093.1485507952725,-2.69,7
11:51,610645022.0,276.2346373550819,-158.47,2
11:51,147474476.0,4301.956727031108,-202.97,2
11:51,448279144.0,1132.7293499999996,-32.98,2
11:52,200080192.0,9822.549759881556,-83.29,7
11:53,887156614.0,160.1267789592264,-54.49,2
11:54,284161641.0,-147.58768895942433,-76.3,2
11:54,131388684.0,20473.824535486023,-131.6,2
11:54,183888402.0,16509.13745948729,-131.54,4
11:57,390747457.0,799.2542999999982,-40.99,2
11:58,196289502.0,14168.798838178987,-58.7,4
11:58,487051121.0,1791.30418640972,-40.0,2
12:00,184430449.0,2571.738021363016,-88.88,5
12:01,656812046.0,1427.7430996691658,-25.07,2
12:03,227104649.0,1988.2670643161775,-31.98,7
12:03,350921975.0,176.0384710738743,-190.0,2
12:03,683319988.0,7744.189736529099,-26.22,9
12:03,690523499.0,1063.6126999999997,-7.5,7
12:05,709151315.0,-323.96878162584005,-110.57,2
12:05,897592348.0,13570.514778836248,-23.67,2
12:06,822135975.0,12133.548367839305,-42.37,7
12:07,454129843.0,1677.4000487975245,-44.0,2
12:07,492215823.0,966.9967738154428,-62.29,4
12:07,836110591.0,7315.862401234272,-27.93,9
12:08,361955473.0,104.71044524408444,-173.0,2
12:09,940569402.0,6579.261382758944,-14.1,9
12:10,200080192.0,9581.091759881556,-241.46,4
12:10,487051121.0,1701.30418640972,-90.0,2
12:11,690941877.0,-11.875038482508105,-30.59,9
12:11,149684419.0,983.5722999999984,-123.49,2
12:11,274818272.0,402.11537856713153,-13.49,4
12:11,824916823.0,8652.941259967622,-27.14,9
12:12,224524792.0,-2023.2506824308489,-28.45,9
12:15,350921975.0,18.03847107387429,-158.0,2
12:16,624500124.0,3603.261735904847,-10.98,9
12:17,203466392.0,4667.264716454687,-35.0,2
12:17,491392945.0,4221.213500000006,-27.99,2
12:18,329840194.0,997.3751701431478,-100.39,2
12:20,235881534.0,12204.416333144583,-18.99,7
12:21,887156614.0,45.16677895922639,-114.96,2
12:23,610645022.0,207.23463735508187,-69.0,2
12:23,350921975.0,-36.46152892612571,-54.5,2
12:27,466649401.0,345.0890657231967,-54.98,2
12:27,221868392.0,5472.282216719475,-30.43,9
12:28,630691258.0,485.7865448748414,-42.98,2
12:29,149684419.0,915.5822999999984,-67.99,2
12:31,200080192.0,9451.647759881556,-129.44,4
12:31,366477356.0,561.78685,-72.5,2
12:31,131388684.0,20390.524535486027,-83.3,2
12:32,858560423.0,10871.221258762564,-61.7,5
12:32,200080192.0,9407.225641979949,-44.42,7
12:33,532478725.0,5386.205496276786,-41.5,9
12:34,487051121.0,1611.80418640972,-89.5,2
12:36,241459011.0,938.8251132723472,-5.99,4
12:36,361955473.0,-34.28955475591556,-139.0,2
12:37,766941757.0,9705.266470818342,-7.65,4
12:37,943329213.0,2487.951986921184,-11.15,7
12:40,534204159.0,6800.298250796248,-2.01,4
12:42,492215823.0,827.6967738154428,-139.3,7
12:43,630691258.0,420.8165448748414,-64.97,4
12:43,559995067.0,4240.985546822651,-155.37,2
12:43,887156614.0,-21.313221040773612,-66.48,2
12:47,843174694.0,-4303.860999999998,-45.78,5
12:47,350921975.0,-100.96152892612572,-64.5,2
12:47,487051121.0,1447.30418640972,-164.5,2
12:48,274818272.0,331.6253785671315,-70.49,7
12:49,948069469.0,-573.997400000001,-65.25,5
12:51,252701364.0,-3284.328672677917,-43.66,5
12:53,183888402.0,16381.765459487293,-127.37,4
12:54,405416860.0,1818.5416620628148,-26.97,7
12:54,857455726.0,-84.12901412431563,-84.5,2
12:54,282837512.0,13492.738598561276,-74.28,5
12:54,131388684.0,20313.524535486027,-77.0,2
12:57,149684419.0,750.1022999999984,-165.48,2
12:57,329840194.0,960.0966501431478,-37.28,4
12:58,311467864.0,443.3601999999992,-97.81,5
12:58,421881811.0,6079.384470439388,-8.08,4
13:00,601627384.0,4930.249259332461,-34.34,9
13:00,487051121.0,1397.30418640972,-50.0,2
13:02,941285623.0,547.8623990667703,-45.49,2
13:03,718058208.0,2046.4984340236535,-1.16,7
13:03,203466392.0,4545.464716454687,-121.8,2
13:05,345582855.0,-535.0447471794508,-31.24,5
13:06,886837068.0,204.9780999999995,-62.23,2
13:07,366477356.0,424.78685,-137.0,2
13:08,657139925.0,12285.969673012898,-16.24,9
13:09,799453072.0,322.222149999999,-28.95,1
13:11,598586358.0,-3031.694949999997,-13.5,5
13:11,183888402.0,16333.479459487293,-48.29,7
13:11,744968736.0,-1341.2041265694238,-48.73,5
13:12,585625048.0,1164.8376190586328,-5.4,9
13:12,766941757.0,9556.766470818342,-148.5,2
13:13,857455726.0,-227.62901412431563,-143.5,2
13:13,331450202.0,8128.989814342787,-30.32,1
13:14,812692024.0,4439.662663331379,-5.0,9
13:14,277562576.0,1087.0485507952724,-6.1,9
13:15,350921975.0,-297.9615289261257,-197.0,2
13:16,165691047.0,-289.4421000000009,-66.17,5
13:18,587202562.0,822.8769994170686,-19.99,2
13:18,534325901.0,6714.910193837709,-8.8,4
13:21,887156614.0,-85.31322104077361,-64.0,2
13:22,274818272.0,292.1253785671315,-39.5,2
13:23,149684419.0,696.1222999999984,-53.98,2
13:24,603721739.0,1404.1168994831842,-49.98,2
13:24,366477356.0,315.78684999999996,-109.0,2
13:27,682194230.0,-1993.5533500000008,-40.38,5
13:27,903663593.0,788.5924618155489,-80.62,2
13:27,886837068.0,148.7280999999995,-56.25,2
13:28,122884111.0,-2713.12608307297,-23.84,5
13:30,284161641.0,-200.08768895942433,-52.5,2
13:30,941285623.0,478.5623990667703,-69.3,2
13:32,131388684.0,20303.324535486023,-10.2,2
13:32,138609932.0,4455.803003294584,-44.0,4
13:34,559995067.0,4075.7995468226504,-165.19,2
13:35,492215823.0,627.5247738154428,-200.17,7
13:36,203466392.0,4433.464716454687,-112.0,2
13:36,680773155.0,435.32758333109183,-18.35,5
13:36,893134725.0,2309.564762973209,-30.96,7
13:38,859603181.0,4201.51823240119,-24.96,1
13:39,421881811.0,6042.413307941315,-36.97,7
13:41,799453072.0,270.24214999999896,-51.98,4
13:42,903663593.0,755.2174618155489,-33.38,2
13:43,350921975.0,-475.4615289261257,-177.5,2
13:43,668329719.0,9127.270948469994,-83.48,5
13:43,783650950.0,-822.2746434110115,-282.79,2
13:50,203466392.0,4266.8647164546865,-166.6,2
13:50,284161641.0,-266.5876889594243,-66.5,2
13:51,147474476.0,4206.112727031108,-95.84,2
13:51,274818272.0,267.1253785671315,-25.0,2
13:51,887156614.0,-185.7832210407736,-100.47,2
13:55,358846516.0,770.0876225272181,-84.98,2
13:57,191161970.0,-3150.5799999999967,-92.32,5
13:58,131388684.0,20250.432535486027,-52.89,5
13:58,610645022.0,134.76463735508187,-72.47,2
14:02,366477356.0,196.78684999999996,-119.0,2
14:03,641376155.0,-351.9354878985489,-95.89,2
14:04,941285623.0,436.5763990667703,-41.99,2
14:04,655450953.0,-2539.81737845553,-28.91,5
14:05,627622066.0,2511.2082521442267,-61.98,2
14:06,703588001.0,473.5861999999995,-96.1,5
14:08,492215823.0,351.05277381544283,-276.47,4
14:11,559995067.0,3880.5415468226506,-195.26,2
14:12,570410059.0,1345.1157967763097,-42.5,2
14:13,264550521.0,9156.134736207869,-50.15,5
14:14,859264768.0,312.3942337819385,-9.99,1
14:14,836110591.0,7282.852401234272,-33.01,2
14:15,857455726.0,-311.12901412431563,-83.5,2
14:16,229205098.0,7523.983847596573,-27.5,2
14:16,641376155.0,-442.9074878985489,-90.97,2
14:17,284161641.0,-412.8876889594243,-146.3,2
14:17,887156614.0,-295.7832210407736,-110.0,2
14:18,487051121.0,1279.80418640972,-117.5,2
14:18,147474476.0,4123.512727031108,-82.6,2
14:18,350921975.0,-549.9615289261258,-74.5,2
14:23,903953091.0,3579.237276253707,-36.84,9
14:24,941285623.0,340.7043990667703,-95.87,2
14:27,361955473.0,-216.28955475591556,-182.0,2
14:27,574548998.0,583.0297999999992,-67.57,5
14:30,131388684.0,20084.532535486025,-165.9,2
14:31,610645022.0,1.2646373550818737,-133.5,2
14:36,366477356.0,152.28684999999996,-44.5,2
14:36,203466392.0,4197.564716454686,-69.3,2
14:44,610645022.0,-53.735362644918126,-55.0,2
14:46,131388684.0,20021.532535486025,-63.0,2
14:47,641376155.0,-488.37948789854886,-45.47,2
14:47,500051919.0,335.3596966505905,-25.0,2
14:48,570410059.0,1326.1257967763097,-18.99,2
14:49,487051121.0,1010.80418640972,-269.0,2
14:51,941285623.0,262.33239906677034,-78.37,2
14:52,912705941.0,16981.029437148805,-16.99,7
14:53,361955473.0,-415.2895547559155,-136.5,2
14:53,203466392.0,4148.564716454686,-49.0,2
14:54,610645022.0,-183.70536264491813,-129.97,2
14:56,887156614.0,-445.7632210407736,-149.98,2
15:02,504055745.0,-92.66263865823308,-88.5,2
15:12,857455726.0,-381.1290141243156,-70.0,2
15:13,941285623.0,190.94639906677037,-71.39,2
15:15,570410059.0,1227.1257967763097,-99.0,2
15:17,504055745.0,-202.16263865823308,-109.5,2
15:17,581655972.0,38567.995172446696,-33.23,7
15:18,641376155.0,-681.5794878985489,-193.2,2
15:18,131388684.0,19819.232535486022,-202.3,2
15:20,487051121.0,896.3041864097199,-114.5,2
15:25,610645022.0,-267.1553626449181,-83.45,2
15:26,586041848.0,855.9036999999992,-13.98,7
15:26,203466392.0,3998.0647164546863,-150.5,2
15:31,941285623.0,125.87439906677037,-65.07,2
15:37,857455726.0,-531.1290141243156,-150.0,2
15:37,504055745.0,-261.16263865823305,-59.0,2
15:41,785749304.0,8394.764633327868,-15.24,9
15:46,610645022.0,-431.6453626449181,-164.49,2
15:47,131388684.0,19770.232535486022,-49.0,2
15:48,570410059.0,1157.6257967763097,-69.5,2
15:48,487051121.0,796.8041864097199,-99.5,2
15:51,203466392.0,3900.0647164546863,-98.0,2
15:56,349614277.0,1791.8005999999996,-4.99,1
15:59,610645022.0,-478.63536264491813,-46.99,2
16:02,361955473.0,-629.7895547559156,-214.5,2
16:02,519935524.0,1351.725189737519,-33.17,9
16:02,504055745.0,-338.66263865823305,-77.5,2
16:08,857455726.0,-729.6290141243156,-198.5,2
16:08,903663593.0,678.3424618155489,-76.88,2
16:09,558119802.0,29456.05182748207,-18.63,9
16:12,494977194.0,2001.6239705975768,-56.92,1
16:16,361955473.0,-694.2895547559156,-64.5,2
16:18,241459011.0,883.8351132723471,-54.99,6
16:19,203466392.0,3753.764716454686,-146.3,2
16:22,886837068.0,126.7280999999995,-22.0,2
16:28,504055745.0,-358.16263865823305,-19.5,2
16:29,467207141.0,1744.5048670482638,-41.98,2
16:29,887156614.0,-588.2532210407736,-142.49,2
16:29,198946608.0,6358.761574079848,-27.02,1
16:32,361955473.0,-793.7895547559156,-99.5,2
16:34,521611005.0,-75.47538585104657,-1.99,4
16:38,487051121.0,726.8041864097199,-70.0,2
16:39,151278285.0,-73.42325000000041,-149.98,2
16:41,200080192.0,9249.067641979947,-158.16,2
16:42,709151315.0,-434.5687816258401,-110.6,2
16:49,203466392.0,3620.764716454686,-133.0,2
16:52,892354433.0,-93.20896063433877,-84.14,5
16:54,361955473.0,-927.7895547559156,-134.0,2
17:03,610450243.0,-1229.3496,-22.46,5
17:05,887156614.0,-815.2432210407736,-226.99,2
17:07,474951915.0,-2357.4510952340124,-14.69,5
17:07,200080192.0,9137.067641979947,-112.0,2
17:08,684988568.0,-58.53387342720144,-45.97,2
17:11,487051121.0,674.8041864097199,-52.0,2
17:19,203466392.0,3571.764716454686,-49.0,2
17:22,844206657.0,9.011455146569816,-117.41,5
17:25,964702094.0,1646.4602816629351,-99.01,5
17:27,466649401.0,197.10906572319672,-147.98,2
17:33,610645022.0,-590.1153626449182,-111.48,2
17:34,887156614.0,-874.2332210407736,-58.99,2
17:34,504055745.0,-443.16263865823305,-85.0,2
17:35,169689461.0,1402.9660999999992,-12.99,2
17:36,684988568.0,-68.51387342720145,-9.98,4
17:37,487051121.0,478.30418640971993,-196.5,2
17:38,809499628.0,15285.46725362714,-4.47,8
17:41,203466392.0,3379.264716454686,-192.5,2
17:42,151278285.0,-116.87435000000042,-43.45,5
17:43,521611005.0,-127.46538585104656,-51.99,2
17:45,487051121.0,453.80418640971993,-24.5,2
17:54,699997811.0,1215.8398000000034,-21.97,7
17:55,331450202.0,7992.389814342787,-136.6,2
17:55,169689461.0,1389.9760999999992,-12.99,2
17:58,857455726.0,-799.6290141243156,-70.0,2
17:58,510101371.0,12627.194645166292,-9.45,4
17:59,941285623.0,18.802399066770363,-107.07,2
18:03,626989363.0,990.5433133173756,-68.97,5
18:06,203466392.0,3274.264716454686,-105.0,2
18:07,414805878.0,13873.918623387784,-18.89,7
18:07,610645022.0,-672.5753626449182,-82.46,2
18:10,709151315.0,-601.1687816258401,-166.6,2
18:11,504055745.0,-552.662638658233,-109.5,2
18:12,857455726.0,-824.1290141243156,-24.5,2
18:22,280268430.0,4731.219936626336,-105.97,7
18:24,535744551.0,1394.512615995627,-21.98,7
18:24,809499628.0,15263.21725362714,-22.25,9
18:24,195895574.0,6963.869813814608,-13.98,9
18:26,941285623.0,-112.08360093322965,-130.89,2
18:28,516051449.0,2178.4755090142908,-10.34,7
18:29,203466392.0,3232.964716454686,-41.3,2
18:43,158766229.0,-555.9548858934699,-69.96,5
18:44,610645022.0,-820.0553626449182,-147.48,2
18:47,203466392.0,3107.6647164546857,-125.3,2
19:02,604288474.0,3183.8697563144665,-21.83,5
19:04,534583529.0,1076.4016880547654,-122.53,5
19:09,998390769.0,405.7937509405242,-103.53,5
19:22,203466392.0,2917.2647164546856,-190.4,2
19:25,308897841.0,1221.1210999999994,-11.69,5
19:38,871866387.0,-719.7360000000007,-89.44,5
19:43,673025413.0,2594.286557376699,-48.03,5
19:47,203466392.0,2840.9647164546855,-76.3,2
19:48,128033695.0,3178.7334960550525,-27.23,9
19:56,679662108.0,14034.403845474091,-19.13,7
19:57,170637730.0,3217.2768483312866,-36.02,7
19:57,768271776.0,-397.24674676657935,-123.15,5
19:58,780463728.0,3036.68682094224,-43.05,5
20:07,842682241.0,7256.6831026179325,-2.79,8
20:12,618514666.0,18472.060192376583,-75.38,5
20:15,399144202.0,3099.833191415591,-23.23,9
20:16,596328017.0,-2314.1303499999995,-92.65,5
20:24,752362502.0,9026.951139067898,-38.62,5
20:37,472213568.0,-277.1389442060532,-95.06,5
20:42,886921642.0,3771.4771981013414,-30.51,5
20:45,180616589.0,1738.473648033954,-53.72,5
20:46,399144202.0,3094.869937746454,-4.96,7
21:06,703478110.0,4174.49770300111,-0.47,4
21:09,373163757.0,10413.32914689022,-2.61,8
22:41,886921642.0,3725.750626231201,-45.73,7
00:14,887853850.0,10649.15929663789,-63.65,5
00:17,413557825.0,514.2096999999997,-29.54,9
00:19,409971170.0,2278.0355698088256,-8.19,2
00:20,970298834.0,3080.230781742705,-8.99,7
00:20,802697323.0,19413.437726400833,-44.08,9
00:28,858989281.0,25413.518940835012,-15.75,9
00:30,853907490.0,7352.858403942769,-58.55,5
00:30,940569402.0,6563.261382758944,-16.0,9
00:35,776431321.0,3074.0001615151914,-16.39,8
00:36,435984758.0,5453.252934747652,-12.78,5
00:41,835736339.0,2595.286740583976,-37.44,9
00:41,196289502.0,14146.908838178988,-21.89,9
00:43,851181128.0,4816.779528445496,-19.94,9
00:43,473820682.0,10994.421239871686,-17.9,9
00:45,895750759.0,-674.2650880756659,-32.59,9
00:46,887853850.0,10628.38929663789,-20.77,9
00:53,601627384.0,4882.032501092407,-48.22,4
00:58,806358207.0,11224.640746102365,-49.37,7
01:02,471897866.0,8023.124138439335,-86.86,5
01:17,940569402.0,6526.434353920747,-36.83,5
01:17,169006407.0,11627.781490268586,-17.49,8
01:17,324224854.0,4271.290104276728,-5.6,2
01:22,570323670.0,3570.511065882394,-6.5,5
01:24,795847804.0,20492.538294861806,-22.74,5
01:25,858989281.0,25409.116515837977,-4.4,5
01:27,166019891.0,7563.752738011595,-69.2,2
01:30,704517789.0,16535.703648649567,-9.91,2
01:32,905860285.0,15614.950532610814,-36.85,5
01:36,647936800.0,1753.1607005240014,-18.79,5
01:40,496395938.0,12019.863772789296,-27.27,2
01:41,633345190.0,7395.303947550342,-29.1,9
01:44,473820682.0,10974.875834731694,-19.55,2
01:47,450896297.0,12833.795312743956,-30.02,7
01:47,506618547.0,17474.26735807957,-0.66,7
01:48,824916823.0,8624.461259967622,-28.48,9
01:50,656812046.0,1406.62442546166,-21.12,2
01:50,992204045.0,11004.259898372891,-11.72,2
01:54,264550521.0,9135.906565649751,-20.23,7
01:55,836110591.0,7258.232401234272,-24.62,9
02:01,651756497.0,13120.23433432826,-33.88,8
02:06,667367404.0,8403.323032936118,-80.91,2
02:12,987656636.0,6151.574943311298,-38.6,2
02:28,624500124.0,3599.2219159576935,-4.04,2
02:29,873693307.0,8580.006769958418,-6.17,2
02:36,836110591.0,7172.046862455696,-86.19,7
02:39,270374623.0,10190.56656789414,-22.53,7
02:39,200080192.0,9092.370454581853,-44.7,5
02:41,679662108.0,14019.502828283825,-14.9,7
02:46,518474507.0,13545.181098133202,-38.39,9
02:48,987163717.0,6100.679430000005,-33.59,9
02:49,256002321.0,8333.431389348616,-12.25,9
02:51,315546581.0,24900.04068148147,-6.18,2
02:55,408057540.0,7519.459967773259,-40.57,5
02:57,541639148.0,5452.450644606023,-0.02,2
02:58,815385232.0,9306.66144263652,-5.3,2
03:06,719586818.0,17454.651290663543,-56.65,7
03:09,901037631.0,1508.2333230964066,-33.24,9
03:11,416060965.0,902.9672320979583,-34.61,7
03:13,179173981.0,6749.055846031878,-39.19,9
03:17,822135975.0,12067.333831389971,-66.21,7
03:22,824916823.0,8559.249752957083,-65.21,8
03:22,414805878.0,13834.828623387782,-39.09,9
03:26,679911053.0,2391.8891138540894,-12.21,5
03:26,766941757.0,9523.266470818342,-33.5,9
03:34,818552503.0,1103.070899999999,-36.3,9
03:35,482513594.0,7898.23719264045,-17.97,5
03:41,290818242.0,6704.9658172269055,-1.29,2
03:43,308505160.0,12313.67970260076,-1.44,7
03:45,705848712.0,23547.604890313614,-6.99,9
03:46,108481285.0,8420.106369908264,-5.3,5
03:46,558119802.0,29451.43453993554,-4.62,2
03:48,779236304.0,800.4609411124915,-27.15,9
03:49,706250160.0,10740.833574080048,-31.79,5
03:53,534325901.0,6681.2928252489755,-33.62,7
03:55,785749304.0,8394.554867025408,-0.21,8
03:56,675806859.0,6588.6446412796295,-57.17,2
04:01,912705941.0,16945.942539638338,-35.09,7
04:03,195895574.0,6903.692942405098,-60.18,5
04:08,809499628.0,15244.81725362714,-18.4,9
04:08,179173981.0,6697.915709099978,-51.14,5
04:11,403383649.0,2227.3335643427586,-11.81,7
04:14,203466392.0,2784.930308667775,-56.03,4
04:16,930277104.0,10217.06621491459,-5.59,7
04:22,709608057.0,3777.722658103845,-25.72,9
04:24,949032480.0,5515.812681561401,-28.43,9
04:33,914806976.0,1441.503250185486,-32.17,9
04:34,237493332.0,13177.871830701532,-1.77,4
04:37,832564361.0,14681.53261331968,-66.01,7
04:41,520447032.0,8636.369137620328,-77.52,2
04:43,987229118.0,4027.583335083233,-33.66,7
04:46,950234174.0,1807.4017309036683,-33.4,2
04:52,433917275.0,8163.181792309509,-76.34,5
04:59,683319988.0,7718.249736529099,-25.94,9
05:01,489964679.0,22269.14464575707,-34.19,9
05:16,305778936.0,11650.11425371428,-28.82,2
05:17,128033695.0,3166.19356752867,-12.54,4
05:18,531186970.0,1113.1645562436197,-26.17,2
05:20,547010927.0,22014.290883810867,-19.23,9
05:21,229205098.0,7511.329631240554,-12.65,4
05:22,216285378.0,21567.064315006803,-37.7,9
05:24,131388684.0,19753.565831709035,-16.67,5
05:25,151968462.0,8765.184127724011,-5.55,2
05:26,749378808.0,5545.017739056726,-29.6,9
05:26,985188462.0,1215.7736887112246,-34.88,9
05:29,532478725.0,5352.655496276786,-33.55,9
05:32,572384506.0,9899.888542218509,-22.94,9
05:32,235881534.0,12183.62603758467,-20.79,2
05:36,779236304.0,782.9843789230691,-17.48,2
05:38,399144202.0,3092.7561387570813,-2.11,7
05:39,221868392.0,5438.954441105563,-33.33,7
05:41,738958551.0,8233.69850437821,-4.51,5
05:48,417850087.0,15655.98839210559,-5.87,2
05:48,687135796.0,25139.556195301557,-18.5,9
05:49,613729471.0,7667.798859604858,-5.16,7
05:51,383833857.0,21510.24856470593,-6.84,7
05:54,550169791.0,18936.18631797791,-11.28,2
05:56,287480331.0,11743.974690378813,-11.97,7
05:59,365608668.0,925.3931138595588,-32.11,7
05:59,237493332.0,13164.921830701533,-12.95,9
06:06,364357875.0,6676.6749431520975,-11.76,7
06:10,108931112.0,13069.273237426309,-38.69,9
06:13,984783496.0,13116.227650598934,-10.44,9
06:13,587225252.0,10045.777643080097,-30.17,2
06:16,752362502.0,9000.63232561248,-26.32,7
06:23,949032480.0,5459.343455396371,-56.47,2
06:26,170637730.0,3200.0461583442143,-17.23,5
06:31,500043411.0,12932.578356991611,-17.75,2
06:31,383625050.0,6074.094604753526,-5.63,7
06:32,809499628.0,15180.297374164458,-64.52,7
06:41,187541224.0,7010.536567386137,-38.68,9
06:43,259015404.0,4733.474779829732,-39.93,9
06:43,108563213.0,21220.447241051377,-49.53,8
06:47,441274121.0,11838.971703103673,-3.04,5
07:01,973086490.0,9577.13626452311,-70.69,2
07:03,196289502.0,14146.718330099342,-0.19,5
07:04,366550080.0,23364.896251047685,-4.87,2
07:05,897714622.0,8740.496927581256,-7.1,8
07:11,146909202.0,5555.43856868748,-4.76,7
07:12,310375875.0,4006.271127497458,-55.62,5
07:14,454356905.0,2609.003750718528,-55.6,4
07:16,480557476.0,10776.043478888569,-49.0,7
07:16,183888402.0,16297.69945948729,-35.78,9
07:17,145387690.0,5569.635716370131,-0.31,7
07:17,586315521.0,11247.381564012958,-16.67,5
07:18,749378808.0,5537.435994941023,-7.58,7
07:18,822250278.0,6594.316549161313,-6.06,2
07:21,678851253.0,5022.342542331417,-53.41,7
07:23,581655972.0,38558.78018293896,-9.21,2
07:29,885259672.0,4207.625547084042,-15.35,2
07:33,549414742.0,7851.236478739154,-35.24,9
07:37,699139822.0,2686.764718631163,-13.65,2
07:42,994214354.0,9252.485310078831,-35.3,9
07:44,245690309.0,8609.245240413913,-24.2,5
07:50,730002588.0,12835.71557750351,-21.03,2
07:52,718058208.0,1992.76321344832,-53.74,7
07:54,532478725.0,5341.593903005429,-11.06,8
07:57,842682241.0,7240.534702095534,-16.15,7
08:03,834383043.0,5417.584043977827,-24.13,7
08:03,859603181.0,4180.92762589357,-20.59,8
08:14,213112754.0,6992.5747050469345,-10.24,2
08:24,256002321.0,8316.464085223986,-16.97,2
08:28,494789005.0,3231.3276726899007,-11.41,8
08:28,604288474.0,3166.164285014553,-17.71,8
08:35,874431242.0,8572.58963066729,-47.3,5
08:42,851181128.0,4749.743612806573,-67.04,2
08:43,113747882.0,11011.636657708112,-7.26,7
08:44,522188082.0,7677.608923062567,-4.07,7
08:47,370521542.0,23500.12286688521,-18.29,7
08:56,187541224.0,6991.269424640879,-19.27,2
09:10,519644021.0,2654.3457761710483,-79.36,2
09:12,540159353.0,10083.923049549116,-12.23,2
09:13,303843160.0,498.0305000000017,-9.99,4
09:14,116169597.0,-125.14405000000043,-39.97,4
09:15,596171893.0,228.2417448255111,-9.99,7
09:17,280098744.0,1430.4083778716656,-9.99,4
09:20,912705941.0,16944.44103963834,-1.5,4
09:20,715068825.0,689.8944999999999,-104.98,6
09:20,549414742.0,7756.764478739155,-94.47,4
09:21,853907490.0,7342.718403942768,-10.14,6
09:21,553734946.0,912.743999999999,-74.97,4
09:27,442079728.0,628.9751192193139,-28.96,7
09:29,660874296.0,1690.3774499608464,-36.48,4
09:30,408057540.0,7483.159967773258,-36.3,6
09:31,518474507.0,13542.296655939666,-2.88,2
09:33,698076160.0,5826.725110309371,-1.29,7
09:37,856957948.0,8619.186512498258,-54.11,7
09:39,652048867.0,-66.92390000000097,-9.99,1
09:39,454356905.0,2558.210630718528,-50.79,4
09:40,815993333.0,942.5127423074427,-19.09,2
09:42,834383043.0,5335.614043977826,-81.97,4
09:42,648644594.0,637.6193999999991,-149.99,6
09:43,200080192.0,9068.300454581851,-24.07,1
09:44,559995067.0,3878.584377687884,-1.96,8
09:48,492215823.0,345.96277381544286,-5.09,1
09:48,986774156.0,1174.9349316257678,-19.97,7
09:48,575652395.0,1910.369615254497,-85.97,4
09:49,535744551.0,1384.522615995627,-9.99,4
09:49,223207876.0,1172.4341,-159.6,2
09:49,668329719.0,9018.112948469994,-109.16,2
09:50,987163717.0,6078.279430000005,-22.4,6
09:50,405416860.0,1735.0516620628148,-83.49,2
09:51,549414742.0,7660.192478739155,-96.57,7
09:56,736340277.0,7810.4814256499185,-6.12,7
09:57,287480331.0,11727.734690378811,-16.24,7
09:58,604334058.0,326.37259999999947,-61.48,4
09:59,403383649.0,2220.3335643427586,-7.0,1
09:59,705848712.0,23527.48736126467,-20.12,5
10:00,903663593.0,656.3724618155488,-21.97,7
10:02,386729293.0,26652.090371223698,-107.98,6
10:03,424397946.0,4499.7677836054,-111.3,2
10:04,822718326.0,9761.600479462708,-19.98,7
10:05,534204159.0,6788.334934467067,-11.96,8
10:06,198051483.0,21.420489591143237,-91.5,2
10:08,639409800.0,31157.54992774243,-18.13,4
10:08,583579399.0,1290.4303499999992,-9.99,7
10:11,227104649.0,1964.7435643161775,-23.52,4
10:11,736340277.0,7809.684499265831,-0.8,8
10:12,282837512.0,13428.548598561274,-64.19,2
10:16,223207876.0,856.0341,-316.4,2
10:16,506618547.0,17453.12735807957,-21.14,7
10:17,683319988.0,7669.06899856047,-49.18,5
10:17,585596026.0,587.3317250035306,-95.99,2
10:19,907987693.0,-2208.5844999999995,-8.45,5
10:20,889916166.0,-57.90379858677328,-43.03,5
10:22,101531259.0,-43.02830000000034,-65.38,5
10:23,737547541.0,464.4565995677742,-59.99,2
10:23,672913754.0,10413.398772146513,-223.29,2
10:24,679911053.0,2375.3991138540896,-16.49,4
10:24,633345190.0,7352.226947550342,-43.08,4
10:25,199016328.0,7086.893992810781,-240.1,2
10:26,667367404.0,8390.153032936118,-13.17,2
10:26,994214354.0,9250.902190078834,-1.58,4
10:27,166019891.0,7561.740738011596,-2.01,4
10:29,187111705.0,7351.201085896912,-86.03,5
10:29,254853117.0,3072.979913131277,-10.99,7
10:29,925659248.0,-608.5569392295712,-65.02,5
10:30,435984758.0,5434.734434747652,-18.52,4
10:31,771125520.0,510.73664999999943,-19.55,5
10:32,549414742.0,7555.192478739155,-105.0,2
10:33,574548998.0,576.0397999999992,-6.99,4
10:34,893134725.0,2249.594762973209,-59.97,4
10:35,441142605.0,2638.142250000003,-103.4,5
10:36,461029994.0,7614.791404323135,-100.9,5
10:36,822135975.0,11981.483831389973,-85.85,2
10:36,890567652.0,-21.428000320399384,-63.7,5
10:36,170637730.0,3137.4547583442145,-62.59,4
10:37,229205098.0,7445.725631240553,-65.6,5
10:37,519644021.0,2567.005776171048,-87.34,2
10:37,627622066.0,2501.218252144227,-9.99,2
10:37,198051483.0,-19.829510408856763,-41.25,2
10:37,179173981.0,6644.845709099978,-53.07,2
10:38,667367404.0,8364.803032936117,-25.35,2
10:39,684284526.0,-2757.5188667457583,-27.55,5
10:39,477216513.0,-870.6414499999994,-64.58,5
10:40,314980178.0,2896.3338500000045,-12.99,2
10:40,199016328.0,6787.293992810781,-299.6,2
10:41,442070890.0,758.2894624443711,-223.0,7
10:42,727417797.0,5192.793500000007,-31.99,2
10:42,703478110.0,4149.527703001109,-24.97,7
10:42,352899149.0,303.8496999999989,-56.92,7
10:42,402438092.0,1388.515599999999,-131.98,2
10:43,475277431.0,2759.5841369436193,-145.6,2
10:43,609939116.0,6687.636245063754,-2.5,4
10:43,424397946.0,4412.9677836054,-86.8,2
10:44,895331556.0,-122.0001000000006,-107.5,2
10:44,291580432.0,221.18150000000037,-66.48,2
10:45,298000165.0,23461.418091924683,-168.0,2
10:46,223207876.0,793.7341,-62.3,2
10:46,215404070.0,552.1695891798497,-35.0,2
10:47,492215823.0,220.53277381544285,-125.43,2
10:47,421881811.0,5964.559826774825,-77.85,8
10:48,986774156.0,1016.9549316257678,-157.98,2
10:48,423208402.0,2243.478800000002,-12.99,2
10:48,893134725.0,2139.614762973209,-109.98,2
10:50,949032480.0,5427.883455396371,-31.46,2
10:50,975345315.0,30956.514799999964,-124.99,2
10:50,388862238.0,844.3703021097062,-14.95,4
10:51,235881534.0,11994.62603758467,-189.0,2
10:51,796709231.0,-66.18147210370235,-61.0,2
10:52,583579399.0,1145.4403499999992,-144.99,2
10:52,419550103.0,17191.254494840323,-60.63,5
10:53,939972497.0,908.238058600011,-65.97,5
10:53,241459011.0,857.9134132723472,-25.92,5
10:53,851181128.0,4688.503612806573,-61.24,2
10:53,223207876.0,661.4341000000001,-132.3,2
10:53,668175891.0,829.6427951930411,-44.98,2
10:54,672913754.0,10311.898772146513,-101.5,2
10:55,286484726.0,642.168093719129,-147.87,5
10:55,198051483.0,-135.70451040885678,-115.88,2
10:56,856957948.0,8611.206512498258,-7.98,4
10:56,785210466.0,2726.4123016744497,-91.41,5
10:57,433917275.0,8146.821792309509,-16.36,4
10:58,291580432.0,168.71150000000037,-52.47,2
10:59,572384506.0,9884.108662218508,-15.78,4
11:01,690958123.0,17651.909651702554,-13.0,2
11:01,799861885.0,842.792849999999,-28.0,2
11:03,215311171.0,6333.567016312963,-40.99,2
11:04,691012931.0,-1604.8747500000009,-101.7,5
11:04,895331556.0,-182.0001000000006,-60.0,2
11:04,653640811.0,15393.323533309438,-6.0,1
11:05,549414742.0,7337.506478739155,-217.69,2
11:05,730002588.0,12807.61557750351,-28.1,7
11:05,583579399.0,1017.4603499999992,-127.98,2
11:05,198051483.0,-218.2045104088568,-82.5,2
11:07,783650950.0,-901.3816434110116,-79.11,5
11:07,475277431.0,2545.3841369436195,-214.2,2
11:08,478412511.0,638.0360201974607,-19.99,2
11:09,668329719.0,8991.898211233947,-26.21,5
11:09,823208989.0,1970.320196013481,-54.77,5
11:10,624563756.0,-209.7891712164437,-124.98,2
11:11,215426302.0,969.9304040256916,-37.93,5
11:11,541639148.0,5417.890644606023,-34.56,1
11:11,235663459.0,-95.19057018798485,-26.45,5
11:14,987656636.0,6119.424943311298,-32.15,2
11:14,834581602.0,649.4458999999995,-49.99,2
11:14,779376323.0,3176.346715820126,-39.0,4
11:15,730002588.0,12775.324927503509,-32.29,4
11:15,873693307.0,8501.858769958419,-78.15,5
11:15,518474507.0,13495.656655939669,-46.64,2
11:16,291580432.0,15.73150000000038,-152.98,2
11:16,520239952.0,-78.48162665476292,-47.97,2
11:16,424397946.0,4262.4677836054,-150.5,2
11:17,971010829.0,677.7146776164759,-19.97,7
11:20,492850697.0,68.73807666586335,-50.03,2
11:20,461990622.0,9039.89779942604,-111.36,5
11:20,835736339.0,2580.7822505839763,-14.5,4
11:20,417850087.0,15603.01839210559,-52.97,2
11:21,298000165.0,23256.318091924684,-205.1,2
11:22,223207876.0,564.1341000000001,-97.3,2
11:22,987229118.0,3944.593335083234,-82.99,2
11:24,867987292.0,4367.979076510484,-50.04,2
11:24,672913754.0,10167.712772146511,-144.19,2
11:25,583579399.0,968.8820999999992,-48.58,5
11:25,700138124.0,5487.667300000004,-30.06,5
11:26,322221939.0,3864.72714309072,-123.75,5
11:27,322221939.0,3830.3318889760167,-34.4,7
11:29,987656636.0,6078.274943311299,-41.15,1
11:29,235881534.0,11918.326037584671,-76.3,2
11:30,531186970.0,961.5235562436196,-151.64,5
11:31,859264768.0,260.4142337819385,-51.98,2
11:31,668329719.0,8921.212211233948,-70.69,2
11:33,194745206.0,681.2423720912432,-73.2,2
11:35,259015404.0,4668.79585336408,-64.68,2
11:35,556631012.0,95.60507308567836,-145.93,5
11:36,510101371.0,12601.924645166291,-25.27,4
11:36,424397946.0,3970.5677836054,-291.9,2
11:37,331450202.0,7978.93774684037,-13.45,2
11:38,815993333.0,921.5547423074428,-20.96,5
11:39,198051483.0,-340.4545104088568,-122.25,2
11:39,587202562.0,666.9069994170686,-155.97,2
11:39,853907490.0,7316.398403942769,-26.32,5
11:41,570269025.0,2566.462903575495,-10.06,2
11:41,678330503.0,4306.928509059181,-103.28,5
11:43,223207876.0,362.5341000000001,-201.6,2
11:44,874431242.0,8527.880630667289,-44.71,5
11:44,449871732.0,8992.72876379418,-49.99,4
11:44,291580432.0,-89.24849999999962,-104.98,2
11:45,973086490.0,9504.56026452311,-72.58,5
11:46,842682241.0,7127.8487020955345,-112.69,5
11:46,324046160.0,-685.3633332130709,-109.39,5
11:47,255814263.0,4187.211537992111,-37.94,7
11:47,169006407.0,11544.731490268588,-83.05,2
11:48,969697937.0,-4228.555265670551,-55.92,5
11:48,897592348.0,13435.524778836249,-134.99,2
11:48,699139822.0,2655.684718631163,-31.08,2
11:51,187541224.0,6980.059424640879,-11.21,7
11:52,905860285.0,15582.232532610811,-32.72,5
11:53,298000165.0,23021.118091924684,-235.2,2
11:54,668329719.0,8844.226211233947,-76.99,2
11:54,199016328.0,6612.993992810781,-174.3,2
11:54,169006407.0,11524.721490268586,-20.01,2
11:55,587202562.0,551.9269994170686,-114.98,2
11:55,424397946.0,3684.2677836054,-286.3,2
11:58,242218612.0,-922.5261999999992,-44.04,5
11:58,555804115.0,-1540.8585475587026,-42.31,5
11:59,920830317.0,36.30817063748157,-183.86,5
11:59,583579399.0,904.3820999999992,-64.5,2
12:00,885259672.0,4165.573537084042,-42.05,4
12:01,344219145.0,9248.291096228226,-191.07,2
12:03,910730524.0,7616.797883872252,-41.03,2
12:03,766941757.0,9489.806470818345,-33.46,2
12:04,454356905.0,2531.810630718528,-26.4,9
12:04,500043411.0,12886.328356991611,-46.25,6
12:04,235881534.0,11745.426037584672,-172.9,2
12:05,291580432.0,-153.74849999999964,-64.5,2
12:05,280990953.0,250.04284999999865,-42.43,9
12:06,866941383.0,2068.000600000005,-114.98,2
12:07,845648250.0,317.93554999999947,-79.92,5
12:08,585596026.0,518.3317250035306,-69.0,2
12:09,973086490.0,9491.32026452311,-13.24,9
12:09,776431321.0,3064.0101615151916,-9.99,4
12:09,895331556.0,-213.9901000000006,-31.99,2
12:09,412823730.0,217.2873758504898,-177.77,2
12:10,540159353.0,10060.943049549118,-22.98,2
12:13,298000165.0,22769.818091924684,-251.3,2
12:14,149684419.0,652.0322999999984,-44.09,9
12:15,994214354.0,9197.43432011954,-53.47,8
12:16,449387287.0,781.3816938351015,-24.97,7
12:16,424397946.0,3404.9677836053997,-279.3,2
12:16,769311479.0,7029.700261663995,-14.5,7
12:18,331450202.0,7856.43774684037,-122.5,2
12:19,624563756.0,-284.7791712164437,-74.99,2
12:20,815993333.0,871.5147423074429,-50.04,2
12:20,223207876.0,240.73410000000007,-121.8,2
12:22,541639148.0,5379.573124606023,-38.32,4
12:23,475277431.0,2350.0841369436193,-195.3,2
12:24,414454079.0,1566.6218500000018,-62.85,2
12:24,407574996.0,3777.867821999376,-2.47,8
12:24,992204045.0,10938.361898372894,-65.9,5
12:25,781554833.0,2584.211313609717,-4.34,2
12:27,199016328.0,6424.69399281078,-188.3,2
12:27,990461108.0,994.048918620611,-94.0,7
12:27,668329719.0,8616.054211233946,-228.17,2
12:30,370757362.0,1139.9510283132383,-105.98,2
12:32,583579399.0,891.3920999999991,-12.99,2
12:32,331450202.0,7779.43774684037,-77.0,2
12:34,704517789.0,16509.543648649567,-26.16,2
12:36,896821055.0,138.82507368523534,-107.77,5
12:36,534204159.0,6735.014934467067,-53.32,2
12:37,344522228.0,-2645.5594882083924,-8.1,5
12:38,358846516.0,709.107622527218,-60.98,2
12:40,291580432.0,-186.73849999999965,-32.99,2
12:41,531186970.0,913.5335562436196,-47.99,2
12:43,252419513.0,-1669.615785813416,-29.14,9
12:43,364357875.0,6582.027943152098,-94.65,5
12:44,895331556.0,-447.9901000000006,-234.0,2
12:44,986267641.0,5584.018151367868,-54.99,2
12:45,766692943.0,-1790.0167500000005,-18.73,5
12:46,199016328.0,6259.493992810781,-165.2,2
12:51,713910252.0,-295.69407427145836,-137.3,5
12:52,225210798.0,794.947773759209,-84.67,2
12:53,679911053.0,2339.7411138540897,-35.66,5
12:54,331450202.0,7675.13774684037,-104.3,2
12:54,455831435.0,-1432.3505048014945,-74.57,5
12:56,217540156.0,-3078.0598199999954,-44.88,5
12:56,971129830.0,-1333.5606499999997,-25.56,5
12:57,678330503.0,4272.705842606186,-34.22,7
12:58,990461108.0,872.048918620611,-122.0,4
12:58,475277431.0,2004.2841369436192,-345.8,2
12:59,450896297.0,12809.815312743956,-23.98,9
13:01,414454079.0,1564.0918500000018,-2.53,4
13:01,480557476.0,10770.343478888568,-5.7,9
13:02,879091637.0,808.4345237379769,-50.85,2
13:02,672913754.0,9928.326772146513,-239.39,2
13:02,736310094.0,-687.0573240274259,-59.68,5
13:04,858560423.0,10831.241258762566,-39.98,4
13:05,585625048.0,1159.0376190586328,-5.8,9
13:06,259015404.0,4663.145853364081,-5.65,9
13:08,317161035.0,-3223.380099999997,-88.56,5
13:08,734161378.0,-2478.512669434213,-35.89,5
13:08,482513594.0,7834.48119264045,-63.76,5
13:08,198051483.0,-433.8295104088568,-93.38,2
13:08,709151315.0,-760.5587816258401,-159.39,5
13:09,812692024.0,4433.562663331379,-6.1,9
13:09,767447966.0,4897.81400551211,-127.53,5
13:12,291580432.0,-236.73849999999965,-50.0,2
13:13,419084831.0,-120.26527552610312,-168.3,5
13:13,225210798.0,650.775773759209,-144.17,2
13:15,857754342.0,2502.2732728586616,-90.48,2
13:15,322221939.0,3824.531888976017,-5.8,9
13:15,344219145.0,9081.705096228226,-166.59,2
13:15,199016328.0,6169.89399281078,-89.6,2
13:16,785210466.0,2685.5373016744497,-40.88,2
13:18,223207876.0,104.23410000000008,-136.5,2
13:19,337771621.0,-2466.69765,-94.06,5
13:21,424397946.0,3244.6677836053996,-160.3,2
13:23,187111705.0,7346.101085896912,-5.1,9
13:24,630468201.0,-610.1323338897016,-102.46,5
13:24,668329719.0,8532.796211233946,-83.26,2
13:25,340321732.0,2134.024150000003,-5.05,9
13:26,448004226.0,2568.488728545749,-50.92,1
13:26,990461108.0,778.048918620611,-94.0,4
13:27,628470485.0,1157.355029900123,-29.94,4
13:28,475277431.0,1672.4841369436194,-331.8,2
13:29,796709231.0,-178.63962210370232,-112.46,5
13:29,824218857.0,-3148.871160845429,-67.29,5
13:29,355733816.0,4177.6881174981545,-16.98,7
13:32,331450202.0,7619.83774684037,-55.3,2
13:33,448004226.0,2568.0983119306047,-0.39,5
13:38,213930646.0,-1226.5368634725633,-142.68,5
13:40,672913754.0,9737.954772146511,-190.37,2
13:40,455052690.0,-539.7382600513724,-166.4,5
13:41,460463595.0,-992.2479454185788,-32.88,9
13:41,785210466.0,2603.4123016744497,-82.12,2
13:42,192202372.0,1018.8602912643372,-159.59,2
13:44,198051483.0,-515.9545104088568,-82.12,2
13:44,344219145.0,8936.819096228226,-144.89,2
13:45,703588001.0,281.0861999999995,-192.5,2
13:47,683078800.0,1679.9231420384876,-8.09,5
13:47,475277431.0,1520.5841369436191,-151.9,2
13:48,390747457.0,744.7542999999982,-54.5,2
13:50,315078351.0,6239.85181530948,-38.19,4
13:50,424397946.0,2978.6677836053996,-266.0,2
13:52,857754342.0,2398.7932728586616,-103.48,2
13:52,496395938.0,11996.873772789297,-22.99,7
13:52,548907062.0,-1119.9324612317112,-34.87,5
13:54,291580432.0,-361.2084999999996,-124.47,2
13:54,192202372.0,835.4602912643373,-183.4,2
13:56,198051483.0,-629.5795104088568,-113.62,2
13:56,668329719.0,8400.510211233946,-132.29,2
13:56,799453072.0,260.25214999999895,-9.99,2
13:58,137822385.0,3371.078463295927,-125.97,2
13:58,254853117.0,2990.919913131277,-82.06,2
14:00,475277431.0,1374.9841369436194,-145.6,2
14:03,979135922.0,896.4308005904502,-38.02,2
14:03,315546581.0,24587.84068148147,-312.2,2
14:05,117308635.0,1313.7934569870868,-81.44,5
14:05,940569402.0,6446.0943539207465,-80.34,2
14:07,390747457.0,591.7542999999982,-153.0,2
14:08,331450202.0,7557.537746840369,-62.3,2
14:08,672913754.0,9615.496772146513,-122.46,2
14:09,630691258.0,335.8165448748414,-85.0,2
14:11,402438092.0,1301.535599999999,-86.98,2
14:11,990461108.0,658.548918620611,-119.5,4
14:13,500051919.0,330.36969665059047,-4.99,7
14:14,785210466.0,2481.5373016744497,-121.88,2
14:15,391688371.0,724.8753195685231,-88.37,5
14:15,331450202.0,7473.537746840369,-84.0,2
14:16,895331556.0,-502.4901000000006,-54.5,2
14:17,703588001.0,156.5861999999995,-124.5,2
14:17,796709231.0,-365.62962210370233,-186.99,2
14:23,668329719.0,8336.810211233946,-63.7,2
14:26,291580432.0,-447.1884999999997,-85.98,2
14:26,552980092.0,171.54371911933745,-20.0,4
14:26,198051483.0,-682.0795104088568,-52.5,2
14:27,767447966.0,4837.704005512111,-60.11,2
14:29,990461108.0,643.5689186206109,-14.98,1
14:30,331450202.0,7333.537746840369,-140.0,2
14:33,639409800.0,31137.207823971385,-20.34,7
14:35,491392945.0,4201.627500000006,-19.59,5
14:36,315546581.0,24427.54068148147,-160.3,2
14:37,412823730.0,26.929375850489834,-190.36,2
14:37,672913754.0,9491.624772146512,-123.87,2
14:37,796709231.0,-518.1196221037023,-152.49,2
14:38,585596026.0,395.35172500353053,-122.98,2
14:41,352291960.0,2212.3377033035736,-131.98,2
14:43,344219145.0,8831.819096228226,-105.0,2
14:44,703588001.0,-37.41380000000049,-194.0,2
14:48,688712152.0,6019.23399695747,-17.4,2
14:48,425964226.0,3588.115650000002,-15.98,1
14:51,137822385.0,3339.0884632959273,-31.99,2
14:51,583579399.0,811.4120999999991,-79.98,2
14:52,895331556.0,-696.9901000000007,-194.5,2
14:53,338022396.0,522.5858893757387,-32.06,5
14:53,489964679.0,22239.86444575707,-29.28,4
14:54,331450202.0,7110.937746840369,-222.6,2
14:55,657528784.0,138.46790000000064,-100.23,5
14:56,255814263.0,4095.561237992111,-91.65,5
14:57,785210466.0,2440.6623016744497,-40.88,7
14:58,358846516.0,670.1676225272181,-38.94,7
14:59,668329719.0,8107.910211233946,-228.9,2
15:00,910730524.0,7568.556068687196,-48.24,2
15:03,489964679.0,22171.06721529377,-68.8,2
15:04,223207876.0,-186.26589999999993,-290.5,2
15:05,175452235.0,2595.1342500000005,-13.03,2
15:05,166019891.0,7536.590738011596,-25.15,2
15:05,913801979.0,627.3726299144939,-9.99,1
15:05,601627384.0,4868.832501092407,-13.2,1
15:07,412823730.0,-47.045224149510176,-73.97,5
15:07,297823329.0,803.6226999999992,-21.97,1
15:08,990461108.0,424.568918620611,-219.0,7
15:09,785210466.0,2354.4123016744497,-86.25,4
15:11,151968462.0,8674.12812772401,-91.06,5
15:11,199016328.0,5999.79399281078,-170.1,2
15:11,198051483.0,-712.0795104088568,-30.0,2
15:11,857754342.0,2311.803272858662,-86.99,2
15:11,585596026.0,326.8617250035305,-68.49,2
15:12,390747457.0,427.75429999999824,-164.0,2
15:17,126929801.0,1250.8899190559712,-35.85,5
15:20,867987292.0,4352.253726220297,-15.73,8
15:21,990461108.0,323.06891862061093,-101.5,7
15:22,651756497.0,13064.13433432826,-56.1,4
15:23,703588001.0,-234.4138000000005,-197.0,2
15:25,344219145.0,8762.547096228225,-69.27,2
15:26,585596026.0,242.39172500353052,-84.47,2
15:27,821971408.0,2193.947229235632,-10.21,5
15:28,587202562.0,436.1571494170686,-115.77,5
15:30,331450202.0,6916.337746840369,-194.6,2
15:33,412823730.0,-183.48922414951016,-136.44,2
15:35,176922958.0,2420.9855686218484,-7.58,7
15:36,475277431.0,1235.6841369436197,-139.3,2
15:38,442070890.0,638.2894624443711,-120.0,7
15:38,198051483.0,-818.9545104088568,-106.88,2
15:40,196289502.0,14109.228330099342,-37.49,1
15:41,990461108.0,219.56891862061093,-103.5,4
15:42,660561861.0,1317.3078361603002,-14.79,7
15:42,657139925.0,12239.224575153725,-46.75,2
15:45,240643705.0,262.6208118080258,-1.99,4
15:46,199016328.0,5821.99399281078,-177.8,2
15:47,857754342.0,2139.3132728586615,-172.49,2
15:47,390747457.0,235.25429999999824,-192.5,2
15:51,370757362.0,1103.8672134689168,-36.08,7
15:51,331450202.0,6867.337746840369,-49.0,2
15:52,412823730.0,-278.67522414951014,-95.19,2
15:53,585596026.0,95.40172500353052,-146.99,2
15:54,703588001.0,-284.4138000000005,-50.0,2
15:54,873701090.0,2127.80440457567,-69.46,7
15:55,344219145.0,8722.675096228226,-39.87,2
15:56,475277431.0,1004.6841369436196,-231.0,2
16:04,441142605.0,2605.162250000003,-32.98,2
16:05,517934629.0,1571.9576787084266,-35.0,2
16:12,331450202.0,6648.937746840369,-218.4,2
16:15,703588001.0,-373.9138000000005,-89.5,2
16:17,344219145.0,8628.203096228226,-94.47,2
16:18,585596026.0,40.41172500353052,-54.99,2
16:19,668329719.0,7834.924211233946,-272.99,2
16:19,399144202.0,3073.5161387570815,-19.24,9
16:21,444428189.0,1483.7121000000027,-9.99,7
16:25,796709231.0,-550.1096221037023,-31.99,2
16:27,696333897.0,804.0052999999991,-12.99,2
16:29,198946608.0,6314.671574079848,-44.09,2
16:29,475277431.0,934.6841369436196,-70.0,2
16:30,291580432.0,-537.6684999999997,-90.48,2
16:30,143003091.0,19792.62719920389,-14.99,4
16:42,424397946.0,2759.5677836053997,-219.1,2
16:42,399538448.0,7172.452520655866,-9.99,2
16:43,788740658.0,3814.0089957997743,-140.0,2
16:46,796709231.0,-649.0996221037024,-98.99,2
16:47,886921642.0,3577.406626231201,-148.34,4
16:48,198051483.0,-950.5795104088568,-131.62,2
16:49,475117511.0,8103.85562803596,-19.97,4
16:55,788740658.0,3782.5089957997743,-31.5,2
16:55,475277431.0,704.3841369436195,-230.3,2
17:01,291580432.0,-594.6384999999997,-56.97,2
17:01,198051483.0,-1084.0795104088568,-133.5,2
17:05,184430449.0,2569.1531261940477,-2.58,8
17:06,424397946.0,2504.7677836053995,-254.8,2
17:07,233981231.0,1978.3854947815137,-71.97,4
17:09,198946608.0,6135.513574079848,-179.16,2
17:13,785210466.0,2261.0373016744497,-93.38,7
17:13,475277431.0,477.5841369436196,-226.8,2
17:15,198051483.0,-1225.0795104088568,-141.0,2
17:23,291580432.0,-647.1284999999997,-52.49,2
17:26,424397946.0,2242.9677836053993,-261.8,2
17:26,475277431.0,275.98413694361955,-201.6,2
17:26,462962606.0,436.1415499999989,-6.99,7
17:28,137913631.0,1640.1939999999995,-28.94,9
17:29,678851253.0,4997.272542331417,-25.07,6
17:29,788740658.0,3578.1089957997747,-204.4,2
17:31,618514666.0,18468.570192376585,-3.49,4
17:33,120634201.0,4804.503500000003,-29.98,7
17:38,596171893.0,196.2917448255111,-31.95,7
17:41,198946608.0,6057.869574079848,-77.64,2
17:45,668329719.0,7771.224211233946,-63.7,2
17:51,654329190.0,84.78980094851936,-9.98,1
17:52,198946608.0,5801.697574079848,-256.17,2
17:52,785210466.0,2195.7873016744497,-65.25,7
17:52,198051483.0,-1290.3295104088568,-65.25,2
17:55,788740658.0,3411.5089957997748,-166.6,2
17:56,788740658.0,3393.5807283636273,-17.93,7
17:57,199016328.0,5683.393992810779,-138.6,2
17:58,668329719.0,7645.924211233946,-125.3,2
17:59,291580432.0,-703.1084999999997,-55.98,2
18:10,785210466.0,2060.0373016744497,-135.75,4
18:11,749371623.0,-2416.1516535173428,-29.93,9
18:16,844206657.0,-21.21854485343019,-30.23,9
18:18,865748375.0,5667.460990018397,-73.82,2
18:24,252760664.0,6167.753877729342,-39.73,5
18:32,873693307.0,8488.668769958418,-13.19,9
18:34,199016328.0,5390.793992810779,-292.6,2
18:34,678851253.0,4975.872542331417,-21.4,9
18:59,503575533.0,7444.630100000015,-21.0,9
19:01,593191200.0,1442.8602999999991,-23.7,9
19:11,270374623.0,10177.06656789414,-13.5,9
19:16,670102069.0,4341.400285802156,-23.1,7
19:18,854895960.0,2754.8499900124675,-26.07,2
19:39,547010927.0,21996.774351596872,-17.52,8
19:54,984783496.0,13107.851727290004,-8.38,7
20:04,145387690.0,5544.385716370131,-25.25,9
20:06,687135796.0,25099.002994841176,-40.55,4
21:06,386729293.0,26628.910471548388,-23.18,7
00:10,315546581.0,24406.351753303377,-21.19,2
00:12,912705941.0,16927.960158389204,-16.48,7
00:17,822135975.0,11974.649476762495,-6.83,5
00:21,985188462.0,1191.3436887112246,-24.43,9
00:22,851649498.0,10003.525081819056,-25.15,8
00:28,776431321.0,3061.8934321482625,-2.12,2
00:28,417850087.0,15553.69931307834,-49.32,2
00:28,795847804.0,20489.681051896576,-2.86,8
00:32,851181128.0,4683.370775946715,-5.13,2
00:33,108481285.0,8418.561172803875,-1.55,7
00:34,858989281.0,25389.616515837977,-19.5,9
00:36,264550521.0,9117.818542054689,-18.09,2
00:41,802697323.0,19383.49772640083,-29.94,9
00:46,131388684.0,19734.165831709033,-19.4,9
00:47,586315521.0,11244.01712145661,-3.36,8
00:49,633345190.0,7349.244571254432,-2.98,7
00:50,701070224.0,1004.57875,-42.73,9
00:51,237684254.0,5649.54344002802,-51.38,5
00:55,604288474.0,3163.351271688738,-2.81,2
00:59,519644021.0,2551.420106945066,-15.59,5
01:00,785749304.0,8371.063313884042,-23.49,2
01:00,200080192.0,9056.988221868118,-11.31,2
01:02,815385232.0,9303.08446175893,-3.58,4
01:03,124102251.0,4578.220972171053,-23.29,5
01:19,836110591.0,7138.876862455696,-33.17,9
01:20,146909202.0,5493.312249237312,-62.13,7
01:21,471897866.0,7953.369822256732,-69.75,2
01:23,897714622.0,8716.653666790235,-23.84,8
01:29,699139822.0,2639.5534402688677,-16.13,7
01:31,858989281.0,25364.920233700603,-24.7,2
01:32,166019891.0,7517.862279496288,-18.73,7
01:32,421881811.0,5926.048119707651,-23.2,8
01:39,534325901.0,6655.416493482389,-25.88,7
01:47,949032480.0,5413.133455396371,-14.75,9
01:51,315546581.0,24374.211753303374,-32.14,9
01:54,282837512.0,13403.646017714553,-24.9,2
01:56,534325901.0,6648.026493482389,-7.39,9
01:57,137822385.0,3317.615641350627,-21.47,8
02:05,903953091.0,3534.490762369467,-44.75,5
02:08,823208989.0,1962.4110877960816,-7.91,5
02:15,237493332.0,13151.124062510327,-13.8,5
02:16,897592348.0,13398.698288819,-36.83,2
02:21,179173981.0,6626.55783021024,-18.29,7
02:25,383625050.0,6041.080685192169,-33.01,7
02:27,541639148.0,5366.60642659772,-12.97,2
02:35,718058208.0,1973.311398201102,-19.45,5
02:35,887853850.0,10613.817093260954,-14.57,2
02:36,824916823.0,8535.580310791474,-23.67,7
02:37,809499628.0,15159.99737416446,-20.3,9
02:41,853907490.0,7299.154211259147,-17.24,2
02:55,587225252.0,10010.727643080098,-35.05,9
02:59,651756497.0,13036.079919621456,-28.05,2
03:00,245690309.0,8594.426456958352,-14.82,2
03:01,994214354.0,9166.71432011954,-30.72,9
03:04,518474507.0,13465.066655939669,-30.59,9
03:21,187541224.0,6945.129424640879,-34.93,9
03:22,704517789.0,16476.67138687742,-32.87,5
03:22,414805878.0,13797.878623387782,-36.95,9
03:24,532478725.0,5314.053903005429,-27.54,9
03:25,489964679.0,22139.577215293764,-31.49,9
03:26,656812046.0,1370.097401066393,-36.53,4
03:26,809499628.0,15157.060267330067,-2.94,2
03:27,480557476.0,10762.818348982157,-7.53,7
03:30,229205098.0,7442.4015621625085,-3.32,5
03:39,706250160.0,10725.792674915778,-15.04,8
03:40,259015404.0,4630.815853364081,-32.33,9
03:40,940569402.0,6435.394353920747,-10.7,9
03:44,581655972.0,38524.24425069062,-34.54,7
03:44,221868392.0,5431.9987441696,-6.96,5
03:47,950234174.0,1799.611835918232,-7.79,7
03:52,108563213.0,21171.698757530357,-48.75,5
03:54,203466392.0,2752.552383202132,-32.38,4
03:55,532478725.0,5293.179005616531,-20.87,2
03:59,709608057.0,3750.142658103845,-27.58,9
04:00,874431242.0,8510.496271235608,-17.38,7
04:06,749378808.0,5509.895994941023,-27.54,9
04:10,461029994.0,7596.583082343871,-18.21,7
04:13,705848712.0,23510.28736126467,-17.2,9
04:15,213112754.0,6976.033587896154,-16.54,2
04:20,282837512.0,13362.296017714552,-41.35,9
04:29,984783496.0,13086.558258028695,-21.29,5
04:32,518474507.0,13434.143638754327,-30.92,7
04:40,715068825.0,651.4144999999999,-38.48,9
04:44,749378808.0,5502.419841278549,-7.48,2
04:48,256002321.0,8299.224085223987,-17.24,9
04:52,987656636.0,6046.386241281722,-31.89,7
04:52,506618547.0,17449.778343438804,-3.35,7
04:54,195895574.0,6884.322942405098,-19.37,9
04:55,287480331.0,11712.823911578358,-14.91,7
04:55,370521542.0,23496.95659127748,-3.17,7
04:56,844835978.0,9761.140185927248,-6.59,2
04:56,550169791.0,18931.852706382113,-4.33,7
05:05,128033695.0,3158.466590839714,-7.73,2
05:10,383833857.0,21500.85065290134,-9.4,8
05:17,832564361.0,14679.787238918376,-1.75,8
05:18,324224854.0,4235.312734265012,-35.98,5
05:22,256002321.0,8295.777078625224,-3.45,8
05:31,609939116.0,6655.692949109907,-31.94,5
05:34,885259672.0,4162.592793929653,-2.98,5
05:34,216285378.0,21530.3843150068,-36.68,9
05:40,730002588.0,12743.584382812858,-31.74,5
05:41,668329719.0,7630.167065112598,-15.76,8
05:42,973086490.0,9431.96821364938,-59.35,2
05:42,331450202.0,6571.964772742175,-76.97,2
05:42,414805878.0,13785.889129917072,-11.99,7
05:43,549414742.0,7311.016478739155,-26.49,9
05:45,687135796.0,25078.253786454447,-20.75,2
05:55,145387690.0,5506.545716370131,-37.84,9
05:55,298007503.0,765.6181036256334,-34.28,9
05:55,308505160.0,12304.289291273768,-9.39,5
05:57,183888402.0,16271.17945948729,-26.52,9
05:57,610645022.0,-836.2853626449182,-16.23,9
05:59,473820682.0,10962.113101717348,-12.76,4
06:00,310375875.0,3987.243211926721,-19.03,7
06:05,601627384.0,4841.425902290464,-27.41,5
06:14,779946617.0,15422.928599630812,-2.3,5
06:14,472995101.0,1995.11747388833,-45.01,4
06:15,859603181.0,4176.475160539102,-4.45,4
06:16,305778936.0,11605.424366082229,-44.69,2
06:16,399144202.0,3039.6761387570814,-33.84,9
06:17,176922958.0,2395.987492074559,-25.0,4
06:21,779236304.0,760.1943789230692,-22.79,9
06:22,758160963.0,7953.232510488333,-4.25,8
06:29,678330503.0,4260.502427436917,-12.2,7
06:30,657139925.0,12204.329315675146,-34.9,4
06:33,679662108.0,14009.377982792104,-10.12,7
06:34,450896297.0,12784.213101547064,-25.6,5
06:36,547010927.0,21973.544351596873,-23.23,9
06:36,613729471.0,7642.178859604858,-25.62,9
06:37,905860285.0,15517.953391148125,-64.28,5
06:45,930277104.0,10208.718499547462,-8.35,8
06:47,433917275.0,8122.679782192516,-24.14,2
06:48,183888402.0,16266.79166649585,-4.39,7
06:55,986267641.0,5576.945058496277,-7.07,7
06:57,806358207.0,11224.491482970248,-0.15,7
06:59,683319988.0,7652.197009548508,-16.87,8
07:08,836110591.0,7113.37576968391,-25.5,5
07:09,670102069.0,4297.832299949605,-43.57,7
07:18,151968462.0,8645.240808992921,-28.89,5
07:19,259015404.0,4588.693839473454,-42.12,8
07:21,828532554.0,1089.6325095129466,-7.6,2
07:22,776108637.0,1434.7079023859055,-6.5,9
07:25,873693307.0,8465.24613965866,-23.42,8
07:27,348325817.0,10278.876041617286,-29.26,5
07:29,170637730.0,3122.4038654664237,-15.05,2
07:30,496395938.0,11934.79365511756,-62.08,8
07:34,613729471.0,7600.891259899814,-41.29,2
07:35,554792076.0,24555.987378602968,-11.41,2
07:41,196289502.0,14067.694971002593,-41.53,8
07:52,779236304.0,741.290347028171,-18.9,8
07:53,678851253.0,4895.064317454071,-80.81,5
07:54,380228542.0,-409.0811081844345,-5.8,9
07:58,511179916.0,7620.428519416359,-23.63,2
07:59,534204159.0,6734.348798363677,-0.67,2
08:02,441274121.0,11833.263890268106,-5.71,2
08:02,766941757.0,9451.426470818344,-38.38,9
08:03,829914501.0,2643.635806570974,-5.8,9
08:11,336557504.0,1594.1500891085354,-6.5,9
08:13,618514666.0,18459.94644726166,-8.62,7
08:14,564214408.0,-56.77301527427378,-15.28,5
08:21,885259672.0,4156.942793929654,-5.65,9
08:22,383833857.0,21473.57865290134,-27.27,5
08:22,833499132.0,2249.7294500000003,-32.5,5
08:24,121113546.0,178.1061560698697,-75.75,5
08:26,613729471.0,7534.783259899814,-66.11,5
08:27,712474734.0,-1824.131831236004,-45.57,5
08:28,822250278.0,6583.3264438513415,-10.99,7
08:28,130154096.0,1170.9492252012683,-88.66,5
08:28,290818242.0,6704.051545451397,-0.91,2
08:29,624563756.0,-324.2136712164437,-39.43,5
08:29,270374623.0,10175.551909540534,-1.51,7
08:30,969804197.0,-1746.7412500000005,-24.72,5
08:31,553734946.0,863.746799999999,-49.0,5
08:32,218795010.0,21.77614999999965,-101.55,5
08:32,106601471.0,9608.063719531245,-12.0,5
08:34,915666111.0,-3680.779574772038,-36.18,5
08:34,680773155.0,424.3151833310918,-11.01,5
08:34,169006407.0,11516.099044183924,-8.62,2
08:35,752362502.0,8984.005786430853,-16.63,7
08:36,339791565.0,-2936.2511999999974,-13.04,5
08:36,430910686.0,1482.3574000000003,-121.81,5
08:36,949032480.0,5407.204794856695,-5.93,8
08:37,518746136.0,-1081.5747282369168,-18.57,5
08:38,173317688.0,-2058.2412348842854,-53.72,5
08:39,802697323.0,19363.744547115075,-19.75,8
08:39,266777719.0,223.0014337802397,-40.81,5
08:41,786141370.0,-579.1625000000008,-86.36,5
08:41,212560376.0,-356.9118742208978,-139.31,5
08:45,175452235.0,2550.8452500000003,-44.29,5
08:45,147341222.0,-1259.8142253207957,-91.47,5
08:46,806358207.0,11079.339482970248,-145.15,5
08:47,141521177.0,6471.237900000011,-100.58,5
08:47,558119802.0,29445.880927139395,-5.55,5
08:47,876890798.0,3677.532570699929,-20.93,5
08:49,246753533.0,721.0030999999988,-41.18,5
08:52,711140907.0,971.0430999999994,-25.9,5
08:52,132400709.0,559.7174851539398,-143.1,5
08:52,520447032.0,8615.992048171267,-20.38,7
08:52,762859681.0,-598.4024000000011,-41.75,5
08:53,345514953.0,1451.454999999999,-109.01,5
08:55,644751433.0,-1097.4645584655382,-51.03,5
08:56,145387690.0,5500.595286579155,-5.95,2
08:56,494404688.0,-2334.1882653362077,-43.4,5
08:57,331450202.0,6555.878772742175,-16.09,5
08:57,364396689.0,-573.06125,-54.77,5
08:59,407574996.0,3768.153446042517,-9.71,2
08:59,738958551.0,8232.066289295915,-1.63,7
09:00,695607232.0,-146.93950538943997,-46.58,5
09:01,131388684.0,19726.565831709035,-7.6,9
09:02,441274121.0,11827.613890268109,-5.65,9
09:02,506618547.0,17441.878343438802,-7.9,9
09:03,618138606.0,1444.646410892108,-7.9,9
09:03,169006407.0,11509.799044183925,-6.3,9
09:03,835736339.0,2544.935250583976,-35.85,5
09:03,549414742.0,7309.616192440245,-1.4,7
09:04,540159353.0,10048.35704954912,-12.59,5
09:05,551755686.0,7154.695067377236,-124.05,5
09:05,722358036.0,74.23114062708257,-168.98,5
09:06,261894284.0,-2541.893799999998,-19.18,5
09:08,643610517.0,-2741.913690729657,-42.02,5
09:09,540159353.0,10043.657049549118,-4.7,9
09:09,322221939.0,3821.386614951774,-3.15,2
09:09,941285623.0,-251.58660093322965,-139.5,5
09:09,556992209.0,10683.69701000001,-41.97,5
09:11,558875206.0,2595.069300000001,-5.25,9
09:12,370521542.0,23382.954591277477,-114.0,5
09:12,162370388.0,-2136.8629,-30.64,5
09:13,690958123.0,17647.609651702554,-4.3,9
09:13,943829984.0,399.93540911345735,-102.18,5
09:14,195895574.0,6870.930984811481,-13.39,8
09:15,280098744.0,1420.4183778716656,-9.99,4
09:16,570410059.0,987.5919467763096,-170.03,5
09:18,344522228.0,-2654.7769882083926,-9.22,5
09:18,519644021.0,2541.400106945066,-10.02,7
09:21,117273481.0,8493.635049737542,-5.65,9
09:22,621181115.0,-297.89924957077113,-63.08,5
09:23,214339619.0,295.21408704013726,-5.7,9
09:23,392270893.0,11010.774237519106,-68.42,5
09:24,895331556.0,-710.0241000000007,-13.03,5
09:24,667367404.0,8359.003032936118,-5.8,9
09:25,899742927.0,12946.424188642855,-24.22,8
09:28,494789005.0,3177.6488108911317,-53.68,5
09:28,534204159.0,6700.318798363677,-34.03,4
09:29,960208650.0,15385.732117340072,-100.09,2
09:31,383833857.0,21455.248652901337,-18.33,1
09:33,258201793.0,-422.8148000000005,-35.97,2
09:35,741903302.0,2546.9128979884786,-124.59,5
09:36,819515373.0,2556.1359860637904,-141.74,5
09:36,256002321.0,8174.201078625224,-121.58,5
09:36,521611005.0,-240.45538585104657,-112.99,2
09:36,913801979.0,607.3826299144939,-19.99,2
09:37,304455868.0,1611.97715971583,-50.09,2
09:37,187111705.0,7071.701085896912,-274.4,2
09:38,246753533.0,671.0130999999988,-49.99,4
09:39,977899503.0,177.49489358085245,-138.6,4
09:44,215426302.0,785.8584040256916,-184.07,2
09:44,743630833.0,540.0357632847013,-31.49,4
09:44,909676212.0,1673.767617470368,-49.91,5
09:44,834383043.0,5291.542043977826,-44.07,2
09:45,555393405.0,-1054.2281,-33.86,5
09:45,105375973.0,518.5356528189403,-104.29,7
09:46,179173981.0,6570.41783021024,-56.14,2
09:46,583558311.0,432.4107847513319,-19.99,2
09:47,221356538.0,286.0017999999996,-26.95,7
09:47,613729471.0,7494.663259899814,-40.12,7
09:49,965038148.0,-1075.722514367672,-48.16,5
09:52,901432314.0,4148.368042272981,-2.8,7
09:52,722358036.0,13.741140627082563,-60.49,2
09:55,524425303.0,-187.33370000000107,-59.36,5
09:55,741903302.0,2491.9828979884787,-54.93,7
09:55,340321732.0,1889.477050000003,-244.55,5
09:57,675806859.0,6442.75764127963,-145.89,5
09:58,272538745.0,14584.629900000022,-184.8,2
09:58,310740977.0,18.115762506172928,-187.59,2
09:59,977899503.0,-60.50510641914752,-238.0,7
09:59,757115616.0,1665.8500000000026,-22.96,7
10:00,461029994.0,7524.613082343871,-71.97,4
10:01,187111705.0,6960.401085896912,-111.3,2
10:03,916270283.0,1594.8162499999987,-37.99,2
10:03,287480331.0,11708.123911578356,-4.7,9
10:03,738958551.0,8201.956289295915,-30.11,2
10:04,821971408.0,2173.6612292356317,-20.29,5
10:04,815993333.0,849.5247423074429,-21.99,1
10:06,105375973.0,394.6496528189403,-123.89,7
10:06,215426302.0,579.4004040256916,-206.46,2
10:09,711045550.0,772.7163500000029,-69.98,2
10:10,508518911.0,282.05675027901054,-7.49,4
10:11,414454079.0,1558.511850000002,-5.58,4
10:13,898104045.0,-1367.9221000000018,-191.12,5
10:14,310740977.0,-83.32823749382706,-101.44,2
10:15,402438092.0,1217.093899999999,-84.44,5
10:16,788740658.0,3389.8956314782067,-3.69,2
10:16,866941383.0,2039.0306000000048,-28.97,4
10:17,760704118.0,1741.0643127174887,-68.45,5
10:21,684988568.0,-98.51387342720145,-30.0,2
10:23,977899503.0,-339.1051064191475,-278.6,4
10:23,399144202.0,2985.8361387570812,-53.84,7
10:25,282837512.0,13354.696017714552,-7.6,9
10:26,737547541.0,438.4765995677742,-25.98,2
10:26,980500334.0,-150.38693389290435,-117.74,2
10:26,461029994.0,7341.24108234387,-183.37,2
10:27,480198977.0,11375.85936614741,-125.05,5
10:30,215426302.0,558.4284040256916,-20.97,2
10:30,979135922.0,714.4308005904502,-182.0,2
10:30,105375973.0,172.76365281894036,-221.89,7
10:32,187111705.0,6831.601085896912,-128.8,2
10:33,652048867.0,-227.40390000000096,-160.48,2
10:35,675806859.0,6414.075139153092,-28.68,7
10:35,272538745.0,14493.629900000022,-91.0,2
10:38,684988568.0,-143.50387342720143,-44.99,2
10:38,994947671.0,1466.5857000000003,-57.56,5
10:38,480198977.0,11345.87936614741,-29.98,4
10:38,308897841.0,1158.2386999999994,-62.88,5
10:42,672994751.0,-55.80869241586261,-31.99,2
10:44,977899503.0,-516.9051064191475,-177.8,7
10:47,799861885.0,707.8510499999991,-134.94,5
10:49,553734946.0,835.746799999999,-28.0,2
10:50,475277431.0,264.99413694361954,-10.99,4
10:51,264550521.0,9083.798542054688,-34.02,7
10:51,215426302.0,468.1284040256916,-90.3,2
10:51,494789005.0,3170.133810891132,-7.51,4
10:53,527842638.0,1559.2965426329838,-32.88,5
10:56,461029994.0,7237.65508234387,-103.59,2
10:59,272538745.0,14367.629900000022,-126.0,2
11:00,652048867.0,-410.403900000001,-183.0,2
11:01,980500334.0,-235.11443389290432,-84.73,2
11:02,979135922.0,484.13080059045024,-230.3,2
11:04,215426302.0,365.97040402569166,-102.16,2
11:08,120634201.0,4792.553500000004,-11.95,4
11:08,760704118.0,1678.7643127174888,-62.3,2
11:09,779620857.0,98.54330361482415,-75.93,5
11:10,722358036.0,-116.73885937291745,-130.48,2
11:11,160166876.0,1623.263690586244,-59.98,2
11:12,684988568.0,-150.49387342720144,-6.99,2
11:15,366550080.0,23345.703442969017,-19.19,4
11:16,264550521.0,8998.638542054687,-85.16,2
11:16,933491926.0,2768.0963,-21.97,7
11:18,670102069.0,4277.5622999496045,-20.27,7
11:19,980500334.0,-292.11443389290434,-57.0,2
11:20,108931112.0,13046.787697426307,-22.49,4
11:22,298000165.0,22739.828091924683,-29.99,4
11:22,760704118.0,1581.4783127174887,-97.29,2
11:23,272538745.0,14304.629900000022,-63.0,2
11:24,979135922.0,257.3308005904503,-226.8,2
11:25,904154012.0,1032.5974581204323,-149.98,2
11:26,215426302.0,286.18440402569166,-79.79,2
11:29,960208650.0,15362.68739942802,-23.04,2
11:29,647472692.0,22330.407053057967,-1.56,4
11:30,105375973.0,129.37765281894036,-43.39,2
11:30,660561861.0,1252.3378361603002,-64.97,4
11:33,776431321.0,3039.9234321482627,-21.97,1
11:35,272538745.0,14159.02990000002,-145.6,2
11:36,979135922.0,118.0308005904503,-139.3,2
11:37,980500334.0,-402.7244338929043,-110.61,2
11:37,252760664.0,6118.834376403149,-48.92,7
11:39,672994751.0,-72.77869241586261,-16.97,1
11:39,828532554.0,1073.6525095129466,-15.98,2
11:40,781554833.0,2511.231313609717,-72.98,2
11:41,722358036.0,-184.1988593729174,-67.46,2
11:41,984783496.0,13084.491718028698,-2.07,4
11:44,272538745.0,14012.729900000022,-146.3,2
11:44,519935524.0,1318.012689737519,-33.71,5
11:44,760704118.0,1546.4783127174887,-35.0,2
11:49,684988568.0,-279.49387342720144,-129.0,2
11:52,461029994.0,7091.36908234387,-146.29,2
11:53,980500334.0,-482.9594338929044,-80.23,2
11:53,719742742.0,416.43749222203655,-25.19,1
11:56,272538745.0,13863.629900000022,-149.1,2
11:58,215426302.0,136.41240402569167,-149.77,2
11:59,979135922.0,-77.26919940954969,-195.3,2
12:00,130522384.0,-399.81381562086057,-121.5,2
12:01,993663752.0,321.6402424103966,-28.85,9
12:03,105375973.0,3.391652818940372,-125.99,2
12:04,409370545.0,358.05427554552017,-17.04,7
12:05,556992209.0,10678.707010000013,-4.99,7
12:09,461029994.0,7020.68308234387,-70.69,2
12:11,684988568.0,-312.47387342720145,-32.98,2
12:13,187111705.0,6735.001085896912,-96.6,2
12:17,760704118.0,1535.9923127174886,-10.49,2
12:17,979135922.0,-196.26919940954969,-119.0,2
12:23,272538745.0,13688.629900000022,-175.0,2
12:26,980500334.0,-514.8269338929043,-31.87,2
12:28,448004226.0,2556.0983119306047,-12.0,9
12:32,187111705.0,6470.401085896911,-264.6,2
12:32,130522384.0,-474.31381562086057,-74.5,2
12:36,977899503.0,-729.0051064191475,-212.1,2
12:38,461029994.0,6779.1970823438705,-241.49,2
12:41,106601471.0,9527.675719531244,-80.39,5
12:41,684988568.0,-354.4538734272015,-41.98,2
12:42,355940285.0,2317.4384281896837,-30.99,9
12:46,760704118.0,1460.4063127174886,-75.59,2
12:48,310620484.0,837.6567381437228,-36.57,9
12:55,899692478.0,-1349.936743524007,-90.85,5
12:55,895331556.0,-719.9725000000007,-9.95,5
12:56,980500334.0,-579.6794338929043,-64.85,2
12:58,422955974.0,-236.70276500095,-124.59,5
12:59,170233640.0,-978.1945100501028,-13.95,5
12:59,461029994.0,6528.61108234387,-250.59,2
13:01,977899503.0,-827.0051064191475,-98.0,2
13:03,215426302.0,2.726404025691693,-133.69,2
13:08,407574996.0,3740.0834460425167,-28.07,1
13:16,364357875.0,6574.063487222942,-7.96,5
13:16,553734946.0,815.756799999999,-19.99,2
13:18,901432314.0,4093.530042272981,-54.84,5
13:20,127809299.0,1311.9869428980364,-131.25,2
13:20,215426302.0,-77.04559597430831,-79.77,2
13:22,399144202.0,2946.2504855617062,-39.59,5
13:22,849096144.0,2040.4907896445743,-6.35,9
13:23,300095518.0,528.9358283414176,-42.49,5
13:24,910730524.0,7564.256068687196,-4.3,9
13:25,688712152.0,6013.33399695747,-5.9,9
13:25,490868147.0,-156.43522087869857,-42.61,5
13:27,469561218.0,90.33174999999916,-62.42,5
13:28,993039226.0,-3766.036999999996,-40.6,5
13:31,192202372.0,818.9702912643373,-16.49,4
13:36,980500334.0,-667.7819338929042,-88.1,2
13:37,980500334.0,-696.9219338929042,-29.14,9
13:40,979135922.0,-367.7691994095497,-171.5,2
13:49,977899503.0,-927.6791064191476,-100.67,5
13:49,105375973.0,-85.46634718105962,-88.86,7
13:51,127809299.0,1148.8619428980364,-163.12,2
13:53,136770968.0,43.338599999999715,-38.97,2
13:55,211493028.0,648.9199999999994,-39.49,9
13:58,598793068.0,576.8092499999984,-216.26,5
14:00,130522384.0,-587.8038156208605,-113.49,2
14:00,414454079.0,1555.971850000002,-2.54,4
14:01,979135922.0,-566.5691994095497,-198.8,2
14:08,105375973.0,-215.6523471810596,-130.19,4
14:13,527842638.0,1524.2965426329838,-35.0,2
14:18,652048867.0,-508.38390000000095,-97.98,2
14:19,105375973.0,-347.2523471810596,-131.6,4
14:23,461029994.0,6352.96708234387,-175.64,2
14:23,310740977.0,-164.50023749382706,-81.17,2
14:27,479456865.0,1157.2439814894049,-8.99,4
14:29,979135922.0,-667.3691994095497,-100.8,2
14:31,130522384.0,-702.2838156208605,-114.48,2
14:31,176922958.0,2388.897492074559,-7.09,1
14:32,442079728.0,594.5851192193139,-34.39,9
14:33,180616589.0,1736.4836480339538,-1.99,4
14:40,980500334.0,-774.5394338929042,-77.62,2
14:41,105375973.0,-616.0383471810596,-268.79,7
14:42,538003940.0,1912.540000000008,-3.98,4
14:43,979135922.0,-820.6691994095496,-153.3,2
14:51,127809299.0,1064.4869428980364,-84.38,2
14:52,980500334.0,-826.2894338929042,-51.75,2
14:57,979135922.0,-1013.1691994095496,-192.5,2
15:00,310740977.0,-369.586237493827,-205.09,2
15:00,461029994.0,6126.19508234387,-226.77,2
15:00,130522384.0,-772.2338156208605,-69.95,2
15:02,105375973.0,-669.9243471810596,-53.89,7
15:02,127809299.0,950.4869428980364,-114.0,2
15:03,980500334.0,-915.156933892904,-88.87,2
15:05,857997794.0,1301.2906651508872,-5.99,4
15:06,873701090.0,2117.75434457567,-10.05,4
15:08,136770968.0,-11.04510000000029,-54.38,5
15:08,823208989.0,1960.4010877960816,-2.01,4
15:13,575652395.0,1810.399615254497,-99.97,4
15:19,834383043.0,5229.970043977826,-61.57,2
15:19,706361191.0,266.60629849407815,-45.05,5
15:21,105375973.0,-756.7243471810596,-86.8,4
15:29,130522384.0,-807.7238156208605,-35.49,2
15:32,637649383.0,893.0174499999985,-48.02,5
15:37,834383043.0,5032.598043977826,-197.37,2
15:39,444428189.0,1469.732100000003,-13.98,7
15:41,979135922.0,-1156.6691994095495,-143.5,2
15:46,587225252.0,9976.752786803669,-33.97,2
16:00,980500334.0,-1011.8994338929042,-96.74,2
16:07,272538745.0,13567.52990000002,-121.1,2
16:08,187111705.0,6324.801085896911,-145.6,2
16:10,516051449.0,2155.525509014291,-22.95,9
16:17,522188082.0,7674.7057039131505,-2.9,5
16:30,980500334.0,-1124.7744338929042,-112.88,2
16:30,977899503.0,-1115.9791064191477,-188.3,4
16:32,829914501.0,2372.063806570974,-271.57,7
16:33,310375875.0,3933.735211926721,-53.51,5
16:34,105375973.0,-906.4963471810596,-149.77,7
16:36,272538745.0,13448.52990000002,-119.0,2
16:42,441142605.0,2597.182250000003,-7.98,4
16:42,409971170.0,2236.4812848378,-41.55,2
16:43,979135922.0,-1288.9691994095494,-132.3,2
16:44,914806976.0,1359.523250185486,-81.98,2
16:45,605116158.0,2502.9168999999997,-1.99,4
16:47,829914501.0,2140.377806570974,-231.69,7
16:54,272538745.0,13309.92990000002,-138.6,2
16:59,105375973.0,-1021.2963471810594,-114.8,7
16:59,310740977.0,-494.84423749382705,-125.26,2
17:03,256045540.0,-3031.8188999999993,-14.17,5
17:04,345582855.0,-598.7118471794508,-63.67,5
17:05,979135922.0,-1390.4691994095494,-101.5,2
17:05,633345190.0,7310.114571254432,-39.13,9
17:07,957821152.0,-1129.9931035715497,-54.84,5
17:08,131388684.0,19719.43995159509,-7.13,7
17:09,807714284.0,825.2242607360001,-57.7,5
17:10,482513594.0,7820.828317298655,-13.65,7
17:12,227104649.0,1889.6735643161776,-75.07,2
17:12,435984758.0,5370.522750483716,-64.21,5
17:12,310740977.0,-539.630237493827,-44.79,2
17:16,940569402.0,6421.0602505417155,-14.33,7
17:20,684988568.0,-389.4438734272015,-34.99,2
17:24,340295966.0,-1650.5844500000003,-41.38,5
17:25,349614277.0,1756.8505999999995,-34.95,7
17:26,887853850.0,10597.307093260952,-16.51,7
17:26,272538745.0,13114.629900000022,-195.3,2
17:29,698955014.0,1167.3807049409122,-21.49,4
17:30,736340277.0,7784.16449926583,-25.52,1
17:30,604334058.0,199.23789999999943,-127.13,5
17:30,971010829.0,543.7346776164759,-133.98,2
17:30,975345315.0,30944.534799999965,-11.98,4
17:31,581655972.0,38500.27425069062,-23.97,7
17:31,500843551.0,805.4361499999998,-37.97,4
17:34,834581602.0,596.9658999999995,-52.48,2
17:34,859603181.0,4127.146160539102,-49.33,5
17:35,358846516.0,640.1876225272181,-29.98,2
17:35,979135922.0,-1539.5691994095494,-149.1,2
17:36,285220959.0,11196.40181149677,-40.99,2
17:37,868377987.0,3265.156369515681,-141.75,2
17:40,696333897.0,741.0752999999992,-62.93,4
17:41,245690309.0,8579.230826958352,-15.2,4
17:42,433917275.0,8102.189782192516,-20.49,2
17:43,834581602.0,498.48589999999945,-98.48,2
17:43,140893085.0,4816.176306365462,-101.99,2
17:43,314980178.0,2761.9898500000045,-134.34,2
17:43,475117511.0,8065.381484997325,-38.47,8
17:44,380228542.0,-568.9604081844345,-159.88,5
17:45,310740977.0,-766.4022374938271,-226.77,2
17:46,298000165.0,22734.628688130364,-5.2,5
17:46,581655972.0,38469.250250690624,-31.02,5
17:46,383625050.0,5984.650685192169,-56.43,2
17:46,500043411.0,12812.870356991612,-73.46,5
17:47,980500334.0,-1223.384433892904,-98.61,2
17:47,836110591.0,7053.475769683911,-59.9,2
17:47,752362502.0,8907.005786430853,-77.0,2
17:49,647936800.0,1734.4689744861162,-18.69,2
17:49,187541224.0,6877.964493051784,-67.16,7
17:49,829914501.0,2050.091806570974,-90.29,2
17:49,832564361.0,14603.487238918377,-76.3,2
17:50,361201224.0,6579.454232067893,-10.0,7
17:51,684988568.0,-459.9238734272015,-70.48,2
17:52,951817450.0,8836.006883968386,-104.64,5
17:53,996042490.0,5252.322046170784,-67.98,2
17:57,105375973.0,-1264.868347181059,-243.57,7
17:58,245690309.0,8566.644826958352,-12.59,5
17:59,858989281.0,25347.330233700603,-17.59,7
17:59,886837068.0,4.7380999999995055,-121.99,2
17:59,187111705.0,6258.301085896911,-66.5,2
18:01,425964226.0,3429.215650000002,-158.9,2
18:01,214339619.0,280.22408704013725,-14.99,9
18:01,868377987.0,3123.406369515681,-141.75,2
18:02,834581602.0,418.49589999999944,-79.99,2
18:02,705848712.0,23487.871315073426,-22.42,5
18:04,980500334.0,-1360.634433892904,-137.25,2
18:05,672913754.0,9337.379772146513,-154.25,5
18:09,383833857.0,21435.608652901337,-19.64,9
18:10,105375973.0,-1521.0403471810594,-256.17,4
18:12,500043411.0,12805.51917407889,-7.35,2
18:13,752362502.0,8844.705786430854,-62.3,2
18:17,691012931.0,-1628.8647500000009,-23.99,9
18:19,903953091.0,3524.010762369467,-10.48,7
18:19,829914501.0,2001.8058065709736,-48.29,2
18:20,314980178.0,2664.0318500000044,-97.96,2
18:23,878989510.0,4897.714077321594,-97.06,5
18:27,653640811.0,15359.645831496504,-33.68,4
18:28,684988568.0,-569.9238734272014,-110.0,2
18:33,187111705.0,6231.891261524493,-26.41,8
18:38,520239952.0,-218.2912266547629,-139.81,5
18:39,844835978.0,9697.734185927247,-63.41,5
18:43,699139822.0,2603.413440268868,-36.14,9
18:44,196289502.0,14034.13697100259,-33.56,5
18:44,752362502.0,8718.705786430854,-126.0,2
18:44,711140907.0,933.4130999999994,-37.63,9
18:44,893134725.0,2107.082962973209,-32.53,5
18:48,684988568.0,-644.4238734272014,-74.5,2
18:51,130154096.0,1138.9792252012685,-31.97,7
18:55,489964679.0,22089.539376053257,-50.04,7
18:56,987163717.0,6058.621850000005,-19.66,7
18:58,510101371.0,12560.994645166293,-40.93,9
18:59,628470485.0,834.1860299001231,-323.17,5
19:01,720221651.0,-2151.7138665984353,-45.12,5
19:07,684988568.0,-651.9138734272015,-7.49,2
19:07,155867488.0,539.8916999999985,-24.99,9
19:08,221868392.0,5406.6487441696,-25.35,9
19:08,631744379.0,-1957.3287594910676,-26.0,5
19:11,639409800.0,31086.68491463148,-50.52,2
19:18,752362502.0,8558.405786430854,-160.3,2
19:19,426474982.0,-3339.01225,-40.91,5
19:25,535744551.0,1301.1715159956266,-83.35,5
19:27,316793091.0,805.8128600549512,-97.24,5
19:43,286484726.0,628.6767764574821,-13.49,5
19:49,403765849.0,-2164.807999999999,-31.18,5
19:59,191992682.0,-2238.581460292064,-119.39,5
20:01,752362502.0,8531.505786430855,-26.9,9
20:11,642924505.0,148.80967018352626,-125.35,5
20:13,659415300.0,2687.845913472887,-99.07,5
20:16,936813994.0,2.277610832788355,-87.84,5
20:19,558875206.0,2576.729300000001,-18.34,9
20:20,170637730.0,3091.7718654664236,-30.63,5
20:22,550169791.0,18857.54070638211,-74.31,5
20:25,605711527.0,-72.75548616741654,-130.09,5
20:31,143061865.0,6771.800955228711,-66.74,5
20:41,887853850.0,10571.827093260954,-25.48,9
20:44,435984758.0,5278.220750483716,-92.3,5
20:45,224112146.0,112.43949999999889,-48.46,5
20:46,659415300.0,2685.8216708942273,-2.02,2
20:48,624500124.0,3592.2610172442273,-6.96,7
20:50,285873880.0,10305.283998000295,-7.17,8
21:06,779946617.0,15385.038599630812,-37.89,9
00:11,973086490.0,9389.50313372679,-42.47,2
00:12,399144202.0,2914.3604855617064,-31.89,9
00:36,480557476.0,10729.556248757037,-33.26,2
00:40,613729471.0,7489.575380106313,-5.09,5
01:09,340321732.0,1858.247050000003,-31.23,9
01:14,305778936.0,11601.481586692682,-3.94,8
01:48,779236304.0,716.920347028171,-24.37,9
01:56,899742927.0,12927.685191334698,-18.74,2
02:01,738958551.0,8169.9719891891555,-31.98,5
02:16,407574996.0,3725.1135365016366,-14.97,7
02:32,256002321.0,8162.251078625224,-11.95,9
02:48,683319988.0,7631.847009548507,-20.35,9
02:51,473820682.0,10956.39524540188,-5.72,5
02:58,213112754.0,6960.557382542125,-15.48,7
03:09,661295096.0,3068.126204411934,-3.16,7
03:17,256002321.0,8161.326497099428,-0.92,7
03:23,668329719.0,7628.446505700112,-1.72,5
03:24,749378808.0,5472.329841278549,-30.09,9
03:35,216285378.0,21500.6143150068,-29.77,9
03:45,151968462.0,8613.331118567901,-31.91,8
03:46,887853850.0,10542.727093260954,-29.1,9
03:47,290818242.0,6701.295767185192,-2.76,7
03:49,647936800.0,1708.9789744861162,-25.49,9
03:51,558119802.0,29445.143797244946,-0.74,8
03:51,795847804.0,20458.871886572702,-30.81,7
03:53,383625050.0,5917.301029023968,-67.35,8
03:58,709608057.0,3711.4626581038447,-38.68,9
04:02,534325901.0,6638.4100284922415,-9.62,7
04:10,550169791.0,18832.711771590824,-24.83,7
04:10,889916166.0,-97.43379858677328,-39.53,9
04:13,324224854.0,4230.743496427378,-4.57,7
04:15,699139822.0,2595.399033983222,-8.01,5
04:19,930277104.0,10205.986500424478,-2.73,5
04:22,108481285.0,8395.541774592974,-23.02,7
04:23,287480331.0,11675.783911578355,-32.34,9
04:23,134461671.0,8073.468886481766,-5.1,7
04:24,832564361.0,14598.326292580305,-5.16,7
04:27,492215823.0,189.9927738154429,-30.54,9
04:28,450896297.0,12763.723101547064,-20.49,9
04:29,809499628.0,15139.120267330069,-17.94,9
04:34,779236304.0,708.3181377561614,-8.6,8
04:34,836110591.0,7027.525769683911,-25.95,9
04:37,822250278.0,6559.56838553998,-23.76,7
04:39,519644021.0,2519.804709009888,-21.6,8
04:46,683319988.0,7629.991527914034,-1.86,2
04:50,719586818.0,17443.644586596303,-11.01,2
04:52,873693307.0,8464.32211503442,-0.92,2
04:56,853907490.0,7288.174211259147,-10.98,9
04:58,187541224.0,6843.334493051784,-34.63,9
04:59,705848712.0,23467.66037231989,-20.21,2
04:59,851649498.0,9974.459198580253,-29.07,4
05:01,985188462.0,1156.0536887112246,-35.29,9
05:02,609939116.0,6655.413746065692,-0.28,8
05:07,131388684.0,19717.04834610523,-2.39,4
05:08,108563213.0,21163.40458028753,-8.29,2
05:10,145387690.0,5488.110451982595,-12.48,5
05:14,176922958.0,2381.0641270209567,-7.83,2
05:16,145387690.0,5467.880451982595,-20.23,9
05:24,940569402.0,6346.243125894287,-74.82,2
05:25,304455868.0,1588.0771597158298,-23.9,9
05:26,489964679.0,22054.18937605326,-35.35,9
05:30,704517789.0,16463.261698008184,-13.41,2
05:31,252760664.0,6112.308619070762,-6.53,7
05:32,730002588.0,12736.003404821917,-7.58,8
05:36,823208989.0,1924.8689857577472,-35.53,4
05:38,785749304.0,8347.414534724505,-23.65,7
05:38,322221939.0,3796.985939528175,-24.4,7
05:39,853907490.0,7272.97205481024,-15.2,2
05:39,308505160.0,12257.286909225377,-16.16,5
05:39,633345190.0,7284.634571254433,-25.48,9
05:41,706250160.0,10721.777025933923,-4.02,2
05:41,287480331.0,11669.816317227504,-5.97,2
05:43,824916823.0,8497.950310791475,-37.63,9
05:46,858989281.0,25324.440233700603,-22.89,9
05:47,482513594.0,7816.109872673821,-4.72,8
05:47,687135796.0,25025.62961189781,-52.62,4
05:47,203466392.0,2740.996776694452,-11.56,5
05:53,749378808.0,5411.125179211091,-61.2,4
05:55,146909202.0,5484.261334461312,-9.05,2
05:55,383833857.0,21408.02051105539,-27.59,2
05:56,865748375.0,5630.954008177663,-36.51,2
06:00,624500124.0,3588.996550228721,-3.26,2
06:02,994214354.0,9142.244320119542,-24.47,9
06:02,779946617.0,15323.263412270357,-61.78,2
06:03,245690309.0,8559.58581216028,-7.06,4
06:06,678851253.0,4861.924860967909,-33.14,2
06:06,806358207.0,11069.506659875038,-9.83,2
06:06,679662108.0,14000.285425392109,-9.09,7
06:18,984783496.0,13061.157510011612,-23.33,2
06:25,549414742.0,7285.726192440245,-23.89,9
06:27,259015404.0,4564.853839473454,-23.84,9
06:27,656812046.0,1320.4717625054527,-49.63,8
06:27,187111705.0,6207.88132899356,-24.01,2
06:28,822135975.0,11969.393398405016,-5.26,2
06:29,518474507.0,13392.963638754329,-41.18,9
06:30,905860285.0,15510.351209604089,-7.6,5
06:42,454356905.0,2524.134020372752,-7.68,7
06:45,950234174.0,1787.1371944170226,-12.47,5
06:47,647936800.0,1705.904513355562,-3.07,7
06:51,873701090.0,2116.8256937516444,-0.93,5
06:51,391688371.0,690.045319568523,-34.83,9
06:54,421881811.0,5922.081070918133,-3.97,7
06:54,994214354.0,9137.002885430064,-5.24,5
06:56,943329213.0,2484.467643070922,-3.48,4
06:56,603721739.0,1384.176899483184,-19.94,9
07:02,506618547.0,17425.469817103636,-16.41,8
07:03,113747882.0,10974.146657708112,-37.49,9
07:06,169006407.0,11493.455248151602,-16.34,7
07:08,399144202.0,2894.376923700129,-19.98,2
07:08,769311479.0,6951.314927308647,-27.17,7
07:10,237493332.0,13141.134062510328,-9.99,9
07:12,417850087.0,15551.430351446335,-2.27,4
07:18,849096144.0,2022.5507896445745,-17.94,9
07:20,366550080.0,23275.36010423656,-70.34,5
07:28,433917275.0,8098.920689669851,-3.27,2
07:29,651756497.0,13016.187195618408,-19.89,2
07:29,667367404.0,8319.408073976323,-39.59,2
07:34,547010927.0,21959.195403699032,-14.35,2
07:35,414805878.0,13749.659129917072,-36.23,9
07:36,657139925.0,12172.951626658867,-31.38,4
07:39,450896297.0,12705.802244202445,-57.92,2
07:40,802697323.0,19337.314547115075,-26.43,9
07:44,639409800.0,31016.409913808377,-70.28,2
07:44,549414742.0,7277.4160963383265,-8.31,2
07:49,170637730.0,3059.98584457764,-31.79,7
07:56,897714622.0,8670.572980724057,-46.08,2
07:58,285220959.0,11185.408800441935,-10.99,2
08:07,500043411.0,12801.222851843007,-4.3,7
08:11,435984758.0,5250.308534939704,-27.91,4
08:12,336557504.0,1588.0500891085355,-6.1,9
08:14,241459011.0,850.1134132723472,-7.8,9
08:15,270374623.0,10137.8354388656,-37.72,7
08:16,824916823.0,8496.280254082869,-1.67,7
08:16,331450202.0,6522.152772742175,-33.73,5
08:17,189335192.0,-785.9288017578602,-48.4,5
08:17,358846516.0,634.0876225272181,-6.1,9
08:18,885259672.0,4151.442793929654,-5.5,9
08:19,604288474.0,3140.572628272224,-22.78,5
08:20,475117511.0,8018.425484997325,-46.96,5
08:22,395284483.0,2017.59592440364,-5.1,9
08:24,183888402.0,16234.79166649585,-32.0,9
08:25,673025413.0,2567.028557376699,-27.26,5
08:27,903663593.0,621.6993618155489,-34.67,5
08:28,200080192.0,9053.339791915269,-3.65,5
08:30,138609932.0,4341.416003294585,-114.39,5
08:31,534325901.0,6580.912028492242,-57.5,5
08:31,585625048.0,1100.6786190586329,-58.36,5
08:31,333054026.0,-1009.13010597681,-19.18,5
08:32,291128777.0,-2542.0589405263695,-13.77,5
08:32,576188756.0,-2777.5739999999996,-33.13,5
08:32,237493332.0,13127.56126280536,-13.57,5
08:33,936917570.0,-2462.1299999999987,-31.09,5
08:33,719742742.0,372.77849222203656,-43.66,5
08:33,511179916.0,7502.954519416359,-117.47,5
08:34,147508204.0,-304.6602822181134,-36.65,5
08:38,598586358.0,-3053.107449999997,-21.41,5
08:38,961077907.0,-12.125749999999869,-63.34,5
08:39,680773155.0,380.0660833310918,-44.25,5
08:39,675806859.0,6412.413644266597,-1.66,7
08:39,142791593.0,-384.4680500000005,-85.55,5
08:40,809499628.0,15136.853431822983,-2.27,7
08:40,932820758.0,-2243.584066775555,-50.2,5
08:41,967989787.0,-294.7793173592728,-156.87,5
08:41,220183538.0,877.7872999999996,-48.64,5
08:42,780463728.0,2926.88202094224,-109.8,5
08:44,370521542.0,23375.504034358193,-7.45,2
08:44,718058208.0,1968.4075460313295,-4.9,8
08:46,235310449.0,826.9531848303087,-146.24,5
08:47,541639148.0,5358.30110079153,-8.31,2
08:48,820686957.0,-613.1965163111959,-86.28,5
08:50,815385232.0,9282.927795815542,-20.16,2
08:51,949032480.0,5361.5822079549025,-45.62,5
08:51,992204045.0,10923.369106774036,-14.99,7
08:53,511179916.0,7475.91400063617,-27.04,7
08:53,639409800.0,30969.579913808375,-46.83,5
08:53,215426302.0,-119.56359597430831,-42.52,5
08:54,398429109.0,1930.424950000001,-47.8,5
08:56,943329213.0,2312.204643070922,-172.26,5
08:56,822135975.0,11877.091398405017,-92.3,5
08:57,916270283.0,1546.3482499999986,-48.47,5
09:02,392790315.0,-3974.011394372066,-55.07,5
09:02,117273481.0,8486.335049737543,-7.3,9
09:06,417850087.0,15546.130351446338,-5.3,9
09:10,506618547.0,17419.819817103635,-5.65,9
09:10,657139925.0,12091.527626658866,-81.42,5
09:13,586315521.0,11238.51712145661,-5.5,9
09:14,627917561.0,3030.800050000003,-6.0,9
09:14,290818242.0,6695.995767185192,-5.3,9
09:16,603375739.0,2240.684063023267,-70.0,2
09:16,215404070.0,504.1795891798497,-47.99,2
09:16,683319988.0,7624.641527914034,-5.35,9
09:17,348325817.0,10235.243081617287,-43.63,4
09:17,550832673.0,2645.497359978149,-5.99,4
09:18,169006407.0,11487.655248151605,-5.8,9
09:20,519644021.0,2487.684709009888,-32.12,2
09:21,851649498.0,9967.359198580252,-7.1,9
09:21,475277431.0,250.0241369436195,-14.97,4
09:22,214339619.0,273.8740870401372,-6.35,9
09:24,540159353.0,10037.957049549115,-5.7,9
09:26,666952234.0,259.666648124487,-199.98,2
09:27,930277104.0,10173.616500424478,-32.37,2
09:28,522188082.0,7635.2076247770465,-39.5,7
09:29,690958123.0,17641.909651702554,-5.7,9
09:29,625658193.0,-1431.681080243783,-265.82,5
09:30,497772347.0,1012.3291499999984,-59.99,2
09:31,679943657.0,3921.2444500000097,-30.14,2
09:33,176922958.0,2348.594127020957,-32.47,2
09:33,348325817.0,10224.958701525791,-10.28,8
09:34,779946617.0,15293.233412270356,-30.03,4
09:36,819515373.0,2554.6359860637904,-1.5,4
09:37,348525881.0,281.4816245949363,-94.97,2
09:37,943329213.0,2290.144643070922,-22.06,7
09:38,430910686.0,1280.3574000000003,-202.0,2
09:39,797184978.0,418.23593657301944,-310.8,2
09:40,979892433.0,-1412.265300000001,-43.74,5
09:42,886921642.0,3568.306626231201,-9.1,5
09:47,950234174.0,1754.9571944170225,-32.18,2
09:49,603375739.0,2095.8260630232667,-144.86,2
09:53,348325817.0,10158.918701525792,-66.04,2
09:53,252760664.0,6077.278619070762,-35.03,2
09:55,741903302.0,2486.5028979884787,-5.48,4
09:56,264550521.0,8946.947279939195,-51.69,7
09:58,668175891.0,790.6927951930411,-38.95,1
09:59,149684419.0,643.7322999999984,-8.3,9
09:59,818552503.0,949.580899999999,-153.49,2
10:04,903953091.0,3518.660762369467,-5.35,9
10:05,797184978.0,337.73593657301944,-80.5,2
10:08,449387287.0,671.4016938351015,-109.98,2
10:12,709608057.0,3691.233429120529,-20.23,7
10:15,603375739.0,1897.7540630232663,-198.07,2
10:17,475117511.0,7986.435484997325,-31.99,6
10:19,818552503.0,917.590899999999,-31.99,2
10:19,873701090.0,2055.799693751645,-61.03,5
10:21,925037906.0,1348.1018000000015,-137.97,2
10:21,449387287.0,464.2016938351015,-207.2,2
10:24,137822385.0,3312.915641350627,-4.7,9
10:24,246753533.0,666.3130999999987,-4.7,9
10:29,655368335.0,4704.402680263816,-67.11,4
10:30,430910686.0,1155.8574000000003,-124.5,2
10:32,797184978.0,239.73593657301944,-98.0,2
10:34,250895529.0,1955.1214324692871,-33.95,1
10:35,662610817.0,-1146.765681324928,-284.53,5
10:36,228136274.0,782.3509499999991,-30.0,4
10:37,648644594.0,479.11939999999913,-158.5,2
10:38,595800644.0,-975.3528500000002,-102.84,5
10:41,603375739.0,1688.4820630232666,-209.27,2
10:44,901432314.0,4057.440042272981,-36.09,1
10:49,430910686.0,805.3574000000003,-350.5,2
10:50,252760664.0,6037.000619070762,-40.28,5
10:51,613427466.0,5820.812905655875,-24.31,2
10:53,910730524.0,7461.902068687195,-102.35,5
10:56,414454079.0,1545.8418500000018,-10.13,4
10:58,280098744.0,1368.3803778716656,-52.04,5
10:59,818552503.0,749.100899999999,-168.49,2
11:01,534204159.0,6598.818798363677,-101.5,2
11:09,797184978.0,-3.8640634269805503,-243.6,2
11:11,603375739.0,1583.4960630232667,-104.99,2
11:14,430910686.0,662.3574000000003,-143.0,2
11:15,449387287.0,392.2116938351014,-71.99,2
11:17,586041848.0,820.9136999999992,-34.99,2
11:19,648644594.0,334.61939999999913,-144.5,2
11:20,818552503.0,692.110899999999,-56.99,2
11:21,520447032.0,8566.744363316075,-49.25,2
11:26,904154012.0,997.6474581204324,-34.95,7
11:31,793781222.0,2265.7688789474028,-41.97,4
11:40,364357875.0,6489.440051065036,-84.62,8
11:42,430910686.0,536.3574000000003,-126.0,2
11:46,596171893.0,128.31174482551108,-67.98,2
11:50,250895529.0,1910.1314324692871,-44.99,2
11:51,240643705.0,137.64081180802577,-124.98,2
11:52,143606916.0,237.19260402918977,-147.63,5
12:00,613427466.0,5778.842905655874,-41.97,4
12:04,743630833.0,430.0557632847013,-109.98,2
12:06,797184978.0,-136.86406342698055,-133.0,2
12:08,449387287.0,199.02569383510144,-193.19,2
12:09,538003940.0,1902.550000000008,-9.99,7
12:09,401293808.0,33.748549999999284,-30.85,9
12:11,973086490.0,9373.56313372679,-15.94,9
12:14,797184978.0,-328.66406342698053,-191.8,2
12:16,151916463.0,1659.6045555991686,-30.44,9
12:16,603375739.0,1465.1960630232668,-118.3,2
12:17,596171893.0,75.3317448255111,-52.98,2
12:19,648644594.0,236.11939999999913,-98.5,2
12:21,987656636.0,6038.108012710491,-8.28,2
12:21,818552503.0,542.630899999999,-149.48,2
12:28,430910686.0,347.3574000000003,-189.0,2
12:35,913801979.0,603.3926299144939,-3.99,4
12:36,909676212.0,1567.797617470368,-105.97,6
12:37,499244466.0,-130.659381283422,-35.47,5
12:40,430910686.0,245.35740000000033,-102.0,2
12:43,670102069.0,4275.929707563177,-1.63,4
12:46,648644594.0,96.61939999999912,-139.5,2
12:51,797184978.0,-516.2640634269806,-187.6,2
12:52,603375739.0,1276.9380630232667,-188.26,2
12:54,818552503.0,477.15089999999896,-65.48,2
12:55,127809299.0,700.2270928980364,-69.88,5
12:58,684988568.0,-692.3724734272015,-40.46,5
12:59,891513205.0,684.9752796590692,-50.41,5
13:01,391559884.0,178.36684999999946,-171.23,5
13:04,346874167.0,308.2110499999992,-55.38,5
13:04,910730524.0,7456.802068687195,-5.1,9
13:05,405416860.0,1732.005753863785,-3.05,4
13:05,564214408.0,-70.45871527427379,-13.69,5
13:06,874506295.0,-1573.221756245572,-21.81,5
13:08,856461967.0,-210.70864647050752,-50.11,5
13:09,120634201.0,4772.553500000004,-20.0,9
13:09,696758548.0,-3008.4853963201376,-19.34,5
13:12,403383649.0,2209.343564342759,-10.99,1
13:13,903468956.0,-163.89450000000053,-42.28,5
13:23,726913482.0,-834.760848526476,-67.35,5
13:25,688712152.0,6006.18399695747,-7.15,9
13:27,818552503.0,401.65089999999896,-75.5,2
13:38,603375739.0,1160.7800630232668,-116.16,2
13:40,535744551.0,1289.1715159956266,-12.0,4
13:45,556992209.0,10643.019226083052,-35.69,8
13:46,603375739.0,994.9080630232668,-165.87,2
13:55,766941757.0,9427.996470818343,-23.43,9
13:57,818552503.0,348.66089999999895,-52.99,2
13:57,575652395.0,1572.847615254497,-237.55,5
13:59,596171893.0,24.3417448255111,-50.99,2
14:03,700138124.0,5413.397300000003,-74.27,5
14:06,152616936.0,1283.8880078630648,-62.98,6
14:06,479366718.0,1616.4800976323995,-83.98,2
14:22,425730826.0,97.95940938871968,-42.7,5
14:24,256002321.0,8122.276497099428,-39.05,1
14:36,797184978.0,-714.3640634269806,-198.1,2
14:38,613427466.0,5756.872905655874,-21.97,2
14:42,596171893.0,-20.1582551744889,-44.5,2
14:45,480198977.0,11295.88936614741,-49.99,2
14:46,479456865.0,1135.2639814894048,-21.98,4
14:47,648644594.0,-114.88060000000088,-211.5,2
14:50,822250278.0,6517.90137553998,-41.67,4
14:57,834383043.0,5000.608043977826,-31.99,2
14:57,403383649.0,2161.526564342759,-47.82,5
14:59,797184978.0,-850.1640634269805,-135.8,2
15:08,588565416.0,6830.810836855609,-10.98,1
15:16,298000165.0,22614.662688130364,-119.97,5
15:18,444428189.0,1287.7621000000026,-181.97,2
15:24,648644594.0,-280.38060000000087,-165.5,2
15:30,128033695.0,3119.546590839714,-38.92,4
15:32,857997794.0,1292.3106651508872,-8.98,4
15:39,807098817.0,247.5462499999992,-123.43,5
15:41,449387287.0,141.63969383510147,-57.39,2
15:42,552980092.0,46.698719119337454,-124.84,5
15:47,797184978.0,-985.9640634269804,-135.8,2
15:50,648644594.0,-483.88060000000087,-203.5,2
15:51,409971170.0,2219.1312848378,-17.35,7
15:54,116598243.0,2380.49932775601,-238.0,2
15:55,550832673.0,2635.349048823173,-10.15,4
15:59,596171893.0,-116.1282551744889,-95.97,2
15:59,158414827.0,-1458.3986000000016,-40.66,5
16:04,818552503.0,250.16089999999895,-98.5,2
16:07,648644594.0,-636.8806000000009,-153.0,2
16:10,829914501.0,1906.1508065709736,-95.65,5
16:12,449387287.0,59.039693835101474,-82.6,2
16:12,603375739.0,775.8220630232669,-219.09,2
16:22,527842638.0,1498.3165426329838,-25.98,4
16:24,818552503.0,159.18089999999893,-90.98,2
16:24,116598243.0,2208.99932775601,-171.5,2
16:29,603375739.0,609.2220630232669,-166.6,2
16:29,807714284.0,784.2342607360001,-40.99,2
16:31,916270283.0,1423.3782499999986,-122.97,2
16:33,198051483.0,-1426.6079604088568,-136.28,5
16:34,797184978.0,-1207.8640634269805,-221.9,2
16:35,598793068.0,521.8392499999984,-54.97,4
16:39,818552503.0,-32.29910000000109,-191.48,2
16:46,448279144.0,995.2293499999996,-137.5,7
16:57,985188462.0,1150.9836887112249,-5.07,7
16:57,603375739.0,445.4780630232669,-163.74,2
16:58,297823329.0,656.0724999999992,-147.55,5
16:58,492850697.0,66.74608666586334,-1.99,4
16:59,146909202.0,5443.941334461312,-40.32,4
17:03,449387287.0,29.681693835101477,-29.36,2
17:09,124102251.0,4548.2309721710535,-29.99,2
17:14,448279144.0,848.7293499999996,-146.5,4
17:16,874431242.0,8510.247173947788,-0.25,5
17:17,558119802.0,29420.65379724494,-24.49,9
17:18,492215823.0,137.98297381544296,-52.01,4
17:18,603375739.0,220.10606302326693,-225.37,2
17:19,678330503.0,4250.127279096742,-10.38,7
17:20,449387287.0,-126.40430616489851,-156.09,2
17:21,860360312.0,235.76810888268037,-138.43,5
17:21,108481285.0,8345.551774592974,-49.99,2
17:25,277562576.0,1080.0585507952724,-6.99,4
17:26,871200314.0,621.6733577708047,-142.97,6
17:26,116169597.0,882.9459499999996,-61.91,7
17:27,491392945.0,4181.657500000006,-19.97,7
17:28,324224854.0,4196.343496427378,-34.4,2
17:28,603375739.0,31.120063023266937,-188.99,2
17:28,690523499.0,1059.6226999999997,-3.99,4
17:29,423208402.0,2187.5088000000023,-55.97,4
17:30,954263768.0,-135.70910000000018,-17.97,9
17:30,574548998.0,570.0497999999992,-5.99,1
17:30,129018172.0,8154.258887752609,-31.59,8
17:32,587225252.0,9961.367563397793,-15.39,5
17:33,510101371.0,12525.774645166292,-35.22,9
17:33,138609932.0,4329.476003294585,-11.94,4
17:33,500043411.0,12729.292851843007,-71.93,2
17:34,822718326.0,9661.610479462708,-99.99,2
17:36,361201224.0,6551.424232067893,-28.03,2
17:36,152488934.0,1106.0208573137306,-51.98,2
17:36,322720763.0,6719.557408430771,-12.99,7
17:37,147474476.0,4107.532727031108,-15.98,7
17:37,152488934.0,1069.7408573137309,-36.28,9
17:38,587202562.0,331.6571494170686,-104.5,2
17:40,999752672.0,591.4796435333344,-29.95,7
17:40,585596026.0,-31.55827499646948,-71.97,2
17:42,449387287.0,-219.49030616489853,-93.09,2
17:45,471897866.0,7943.309822256731,-10.06,2
17:47,919185264.0,3920.9752557370466,-6.99,7
17:50,331048953.0,-77.18763202150637,-25.79,5
17:51,818552503.0,-136.7891000000011,-104.49,2
17:52,651756497.0,12962.037195618408,-54.15,2
17:55,596463612.0,-2521.8776047251395,-53.66,5
17:56,970298834.0,3075.7015711298745,-4.53,5
17:56,871200314.0,605.6933577708047,-15.98,7
17:59,441274121.0,11770.332820877898,-57.28,5
17:59,603375739.0,-126.35193697673309,-157.47,2
18:00,651756497.0,12941.987195618409,-20.05,2
18:01,532478725.0,5266.549005616531,-26.63,9
18:01,491392945.0,4140.539500000005,-41.12,5
18:01,690523499.0,953.5285999999996,-106.09,5
18:02,587202562.0,190.15714941706855,-141.5,2
18:03,558119802.0,29403.22379724494,-17.43,5
18:03,912705941.0,16925.902129120426,-2.06,5
18:04,709632525.0,-1570.2773500000008,-65.41,5
18:08,627723633.0,-1295.327228003763,-94.86,5
18:11,656812046.0,1229.8567625054527,-90.61,5
18:11,648644594.0,-771.8806000000009,-135.0,2
18:12,687135796.0,25015.07961189781,-10.55,9
18:12,797184978.0,-1471.7640634269806,-263.9,2
18:12,117273481.0,8485.18836017816,-1.15,5
18:14,558875206.0,2434.026950000001,-142.7,5
18:16,331450202.0,6476.2878464755,-45.86,5
18:21,639420537.0,-1539.08895,-25.62,5
18:21,310375875.0,3892.595056034981,-41.14,2
18:22,585596026.0,-92.52547499646948,-60.97,5
18:23,742223719.0,729.5340573048028,-62.97,7
18:25,858989281.0,25322.766060504444,-1.67,2
18:27,670427480.0,2237.791050000001,-40.88,5
18:28,285428103.0,8573.781950465585,-47.0,5
18:30,494156462.0,-744.1052864817603,-109.19,5
18:39,303843160.0,464.06050000000175,-33.97,7
18:39,252964502.0,-664.5328224913006,-31.24,9
18:43,706301742.0,-2600.6031499999985,-17.54,5
18:44,752362502.0,8524.957359659773,-6.55,7
18:48,679911053.0,2339.5137492557005,-0.23,7
18:49,909669130.0,306.2278847367666,-7.97,4
18:50,188263947.0,755.0000000000002,-87.88,5
18:51,365608668.0,743.9678138595589,-181.43,5
18:51,487051121.0,447.8597899891073,-5.94,2
18:55,122884111.0,-1105.8360830729698,-22.71,5
18:55,298000165.0,22610.00365181298,-4.66,2
18:56,581618317.0,-4480.436701873206,-48.53,5
18:56,308505160.0,12226.248909225376,-31.04,5
18:57,480557476.0,10642.014248757036,-87.54,5
19:03,392270893.0,11007.225879014177,-3.55,2
19:03,817294757.0,-2593.1408,-50.68,5
19:05,128033695.0,3109.85775728187,-9.69,8
19:07,108563213.0,21022.83058028753,-140.57,5
19:08,532478725.0,5226.668285843646,-39.88,2
19:12,593191200.0,1273.404999999999,-169.46,5
19:12,605116158.0,2469.5339,-33.38,5
19:13,195895574.0,6854.1708989604185,-16.76,2
19:13,679662108.0,13898.960425392108,-101.32,5
19:17,982286721.0,-3100.488024017731,-25.16,5
19:20,586315521.0,11202.359259879868,-36.16,7
19:21,496395938.0,11932.219103717867,-2.57,2
19:22,503575533.0,7360.9451000000145,-83.69,5
19:23,851181128.0,4630.409827385525,-52.96,5
19:23,241459011.0,812.4877132723472,-37.63,5
19:23,949032480.0,5346.202207954902,-15.38,9
19:25,940569402.0,6328.343125894287,-17.9,9
19:29,548907062.0,-1222.9343112317113,-103.0,5
19:32,452974357.0,-2509.6014499999965,-36.25,5
19:35,500051919.0,234.29049665059048,-96.08,5
19:36,245690309.0,8546.64581216028,-12.94,9
19:37,670102069.0,4242.139707563177,-33.79,9
19:39,235881534.0,11697.894642934029,-47.53,7
19:40,885259672.0,4150.28979674196,-1.15,5
19:42,124125096.0,446.0986943878024,-58.13,5
19:43,901432314.0,4027.80060046412,-29.64,5
19:43,897592348.0,13359.142990524597,-39.56,7
19:43,514362267.0,277.67916910706043,-36.89,5
19:50,383833857.0,21389.980511055393,-18.04,9
19:55,705848712.0,23454.020372319887,-13.64,9
19:55,581655972.0,38443.68941907882,-25.56,2
20:00,736340277.0,7763.206499265831,-20.96,5
20:03,609939116.0,6511.437746065692,-143.98,5
20:19,933745726.0,-1881.6189435706765,-32.28,5
20:20,822718326.0,9632.084479462708,-29.53,5
20:25,663479159.0,1011.4035418277084,-140.53,5
20:34,203466392.0,2669.414776694452,-71.58,5
20:36,779816907.0,-2673.1285829229128,-47.05,5
20:36,887853850.0,10463.381323227966,-79.35,2
20:38,624500124.0,3554.346550228721,-34.65,5
20:40,897592348.0,13212.058990524596,-147.08,5
20:40,221868392.0,5180.2301505133855,-36.42,5
20:41,419550103.0,17175.560027554267,-15.69,7
20:42,279149837.0,1159.393049999999,-133.83,5
20:43,282837512.0,13348.506118428995,-6.19,4
20:49,504055745.0,-606.1153386582331,-53.45,5
20:51,865748375.0,5564.930008177663,-66.02,5
20:52,836110591.0,7027.488451961565,-0.04,5
20:52,373875019.0,14142.26254532261,-53.07,5
21:10,547010927.0,21931.095403699033,-28.1,9
21:48,672913754.0,9331.183776019545,-6.2,2
02:28,712474734.0,-1852.061831236004,-27.93,9
02:34,549414742.0,7249.866096338326,-27.55,9
02:37,779236304.0,672.8681377561613,-35.45,9
02:46,824916823.0,8459.290254082869,-36.99,9
02:55,858989281.0,25304.27606050444,-18.49,9
02:59,541639148.0,5328.46110079153,-29.84,9
03:00,809499628.0,15124.473431822984,-12.38,9
03:03,581655972.0,38441.646526143,-2.04,2
03:06,549414742.0,7238.175890373061,-11.69,2
03:07,851181128.0,4590.519827385525,-39.89,9
03:07,853907490.0,7220.887202357822,-52.08,2
03:10,550169791.0,18812.114930670385,-20.6,8
03:11,421881811.0,5864.100111578864,-57.98,7
03:12,534204159.0,6563.55390084135,-35.26,7
03:25,738958551.0,8150.249782823948,-19.72,5
03:26,532478725.0,5193.538285843646,-33.13,9
03:26,887853850.0,10427.33799224708,-36.04,5
03:31,824916823.0,8451.916955203102,-7.37,2
03:33,489964679.0,22030.59937605326,-23.59,9
03:44,601627384.0,4807.135902290464,-34.29,9
03:45,687135796.0,25007.68961189781,-7.39,9
03:46,588565416.0,6771.486594039148,-59.32,2
03:49,779236304.0,651.7504845815778,-21.12,2
04:04,489964679.0,21993.00134900186,-37.6,2
04:04,417850087.0,15466.93190986316,-79.2,7
04:05,871200314.0,597.3288242426385,-8.36,7
04:16,613729471.0,7465.297674677599,-24.28,7
04:24,851649498.0,9953.433262841903,-13.93,2
04:30,687135796.0,24975.30607383208,-32.38,8
04:39,179173981.0,6544.823704940252,-25.59,7
04:43,858989281.0,25298.297197071963,-5.98,2
04:44,176922958.0,2329.245976494643,-19.35,4
04:47,647936800.0,1659.3233480715692,-46.58,2
04:53,836110591.0,6994.388451961565,-33.1,9
04:53,264550521.0,8885.450299112226,-61.5,7
04:56,985188462.0,1111.9836887112249,-39.0,9
05:01,940569402.0,6282.761343321443,-45.58,5
05:04,471897866.0,7926.519233275947,-16.79,5
05:04,256002321.0,8107.376497099428,-14.9,9
05:05,510101371.0,12521.295096426842,-4.48,8
05:06,930277104.0,10140.920958210718,-32.7,4
05:15,788740658.0,3379.5264083507504,-10.37,2
05:18,912705941.0,16903.29615996727,-22.61,5
05:19,897714622.0,8650.913322073382,-19.66,2
05:25,678851253.0,4851.508999329028,-10.42,5
05:29,259015404.0,4530.763839473454,-34.09,9
05:31,506618547.0,17419.16041722624,-0.66,5
05:31,758160963.0,7902.738410108615,-50.49,7
05:32,237493332.0,13089.401261919698,-38.16,2
05:33,520447032.0,8553.815485955496,-12.93,7
05:36,572384506.0,9878.404562587246,-5.7,2
05:36,166019891.0,7470.182814996685,-47.68,4
05:36,108812033.0,726.9992499999986,-30.84,9
05:39,769311479.0,6899.979078124123,-51.34,5
05:43,108931112.0,13017.467697426307,-29.32,9
05:43,766941757.0,9395.906470818343,-32.09,9
05:46,364357875.0,6460.955136823453,-28.48,5
05:47,886921642.0,3540.93308637997,-27.37,2
05:47,679662108.0,13866.93601825792,-32.02,5
05:51,200080192.0,9023.539805647895,-29.8,2
05:52,822250278.0,6517.420409813389,-0.48,2
05:56,414805878.0,13716.579129917072,-33.08,9
05:56,874431242.0,8482.171687540398,-28.08,7
05:56,383833857.0,21354.858991865753,-35.12,5
05:57,324224854.0,4142.079302501217,-54.26,8
06:05,145387690.0,5439.940451982596,-27.94,9
06:06,547010927.0,21903.95540369903,-27.14,9
06:09,522188082.0,7619.208097134509,-16.0,5
06:09,310620484.0,802.5067381437228,-35.15,9
06:11,151968462.0,8586.538426534122,-26.79,2
06:12,833899961.0,2154.893322838991,-3.87,2
06:12,699139822.0,2589.8422131688485,-5.56,7
06:19,668329719.0,7593.980831654049,-34.47,2
06:19,667367404.0,8254.956194564147,-64.45,2
06:19,310375875.0,3860.6450560349817,-31.95,9
06:23,350921975.0,-570.4615289261258,-20.5,9
06:24,146909202.0,5418.654698766799,-25.29,4
06:27,779946617.0,15279.42485215413,-13.81,4
06:27,678330503.0,4209.059352273205,-41.07,2
06:29,809499628.0,15118.073391851034,-6.4,8
06:32,237684254.0,5643.905296763993,-5.64,5
06:33,169006407.0,11458.373087667927,-29.28,4
06:38,376271050.0,1268.1202468611796,-12.63,2
06:38,656812046.0,1191.7496084590969,-38.11,2
06:39,197865285.0,477.9173117312205,-24.49,9
06:42,290818242.0,6689.016840460682,-6.98,7
06:42,587202562.0,173.1771494170686,-16.98,9
06:45,802697323.0,19304.234547115073,-33.08,9
06:46,705848712.0,23430.830372319888,-23.19,9
06:48,718058208.0,1935.7385955042912,-32.67,7
06:49,749378808.0,5350.254702795218,-60.87,7
06:49,899742927.0,12917.490395598405,-10.19,2
06:51,910730524.0,7454.806550025075,-2.0,5
06:52,322221939.0,3771.1659650936567,-25.82,2
06:56,683319988.0,7589.311527914034,-35.33,9
07:01,195895574.0,6843.470640320358,-10.7,5
07:01,534325901.0,6546.1599517804825,-34.75,4
07:03,859603181.0,4089.6467724959457,-37.5,5
07:03,651756497.0,12912.851475792144,-29.14,7
07:04,229205098.0,7430.332112259128,-12.07,7
07:05,308505160.0,12214.522429067809,-11.73,7
07:06,815385232.0,9267.222171860963,-15.71,7
07:07,480557476.0,10614.71662266938,-27.3,7
07:07,704517789.0,16457.487872370955,-5.77,5
07:08,823208989.0,1890.8560969093048,-34.01,2
07:09,518474507.0,13354.023638754328,-38.94,9
07:09,310375875.0,3830.1297435500337,-30.52,2
07:11,776108637.0,1428.5579023859054,-6.15,9
07:11,196289502.0,14023.756971002593,-10.38,9
07:14,500043411.0,12698.578059977996,-30.71,2
07:16,901432314.0,4003.909716771267,-23.89,7
07:16,145387690.0,5412.505932292725,-27.43,7
07:20,705848712.0,23423.817337109147,-7.01,5
07:29,108563213.0,20997.00084054268,-25.83,5
07:30,713641917.0,1005.2854404874208,-49.49,5
07:31,657139925.0,12038.624305719622,-52.9,5
07:33,414805878.0,13712.047184154988,-4.53,5
07:36,259015404.0,4526.7753916438405,-3.99,4
07:42,752362502.0,8521.392753087406,-3.56,4
07:42,441274121.0,11724.1637448385,-46.17,8
07:42,609939116.0,6491.001225001539,-20.44,7
07:42,541639148.0,5325.5574782995645,-2.9,5
07:43,675806859.0,6409.005827692205,-3.41,5
07:46,547010927.0,21865.304307229413,-38.65,5
07:48,950234174.0,1721.5575231204236,-33.4,7
07:49,183888402.0,16195.05166649585,-39.74,9
07:51,987656636.0,6034.176548764761,-3.93,5
07:55,305778936.0,11532.292677677458,-69.19,2
07:57,331450202.0,6456.131528064803,-20.16,4
08:04,604288474.0,3120.4830977067986,-20.09,7
08:08,395284483.0,2011.54592440364,-6.05,9
08:09,187541224.0,6795.804493051784,-47.53,9
08:09,336557504.0,1583.0500891085355,-5.0,9
08:13,785749304.0,8329.818668201164,-17.6,7
08:14,241459011.0,806.7877132723471,-5.7,9
08:15,216285378.0,21463.7743150068,-36.84,9
08:16,146909202.0,5410.854698766799,-7.8,9
08:17,221868392.0,5173.219246366183,-7.01,8
08:22,519935524.0,-6.687310262481059,-4.7,9
08:23,358846516.0,328.98762252721804,-5.1,9
08:25,989506909.0,-2231.1448707594377,-16.56,5
08:26,885259672.0,4143.389796741961,-6.9,9
08:28,331684336.0,-1383.7715199513216,-59.59,5
08:29,407574996.0,3724.3421588091583,-0.77,5
08:32,245690309.0,8488.46181216028,-58.18,5
08:32,795847804.0,20417.311216193513,-41.56,4
08:34,737537711.0,-1663.4294663984642,-31.34,5
08:35,270374623.0,10113.66089873798,-24.17,5
08:36,387957305.0,-2444.2161059800796,-18.05,5
08:37,143061865.0,6746.384546013348,-25.42,2
08:37,215832575.0,-1549.1344637442194,-13.49,5
08:37,494156986.0,-226.73775432766496,-30.28,5
08:39,473820682.0,10951.308954283655,-5.09,8
08:41,518746136.0,-1127.7372282369167,-46.16,5
08:43,639409800.0,30921.362802415035,-48.22,5
08:43,801500539.0,-2843.9011999999993,-69.7,5
08:44,143003091.0,19784.82661166886,-7.8,7
08:44,785749304.0,8274.588668201164,-55.23,5
08:45,407323346.0,-2361.7279325553127,-56.36,5
08:45,554792076.0,24447.683378602967,-108.3,5
08:46,475277431.0,64.99313694361956,-185.03,5
08:49,706250160.0,10651.32679668095,-70.45,2
08:50,659008214.0,-2972.715102290424,-31.17,5
08:53,124102251.0,4545.728241189251,-2.5,2
08:55,441274121.0,11702.4777448385,-21.69,5
08:55,170637730.0,3009.1007565819614,-50.89,2
08:56,221356538.0,199.8177999999996,-86.18,5
08:58,250957494.0,488.6532999999989,-117.01,5
08:59,572136270.0,-222.6365506664223,-105.52,5
09:00,581655972.0,38348.224526143,-93.42,5
09:02,979122276.0,-234.6820377056713,-120.85,5
09:02,197865285.0,470.4173117312205,-7.5,9
09:03,169006407.0,11453.673087667928,-4.7,9
09:03,930277104.0,10070.885958210718,-70.03,5
09:04,310171581.0,-1929.81870434092,-16.11,5
09:07,441274121.0,11695.5777448385,-6.9,9
09:07,999752672.0,586.2296435333344,-5.25,9
09:08,741903302.0,2480.802897988479,-5.7,9
09:08,586315521.0,11196.759259879867,-5.6,9
09:09,540159353.0,9997.665049549118,-40.29,5
09:11,522188082.0,7524.372097134509,-94.84,5
09:13,973086490.0,9352.209942276297,-21.35,2
09:14,259015404.0,4487.30539164384,-39.47,7
09:14,873701090.0,2043.699563629198,-12.1,5
09:19,690958123.0,17636.159651702554,-5.75,9
09:20,506618547.0,17410.860417226242,-8.3,9
09:20,117273481.0,8479.18836017816,-6.0,9
09:20,854895960.0,2686.8699900124675,-67.98,2
09:22,618138606.0,1439.246410892108,-5.4,9
09:23,417850087.0,15460.48190986316,-6.45,9
09:23,158766229.0,-582.4285358934699,-26.47,5
09:24,370521542.0,23343.69785848037,-31.81,2
09:24,162162212.0,-141.62705667269114,-66.99,2
09:27,683078800.0,1674.2231420384876,-5.7,9
09:27,773633520.0,373.0085609385115,-113.06,5
09:28,552980092.0,31.698719119337454,-15.0,4
09:30,279149837.0,1138.423049999999,-20.97,1
09:32,943829984.0,384.9654091134573,-14.97,4
09:33,541639148.0,5319.341578299564,-6.22,4
09:34,508518911.0,254.05675027901057,-28.0,2
09:36,812692024.0,4385.864663331378,-47.7,5
09:38,879091637.0,725.8345237379768,-82.6,2
09:38,950234174.0,1595.8175231204236,-125.74,2
09:40,849096144.0,1983.7637896445744,-38.79,5
09:40,792845450.0,1085.922150000001,-52.99,4
09:40,441142605.0,2595.1922500000032,-1.99,4
09:41,553734946.0,597.256799999999,-218.5,2
09:50,338022396.0,442.0676893757387,-80.52,5
09:50,727417797.0,5185.803500000007,-6.99,4
09:51,673025413.0,2522.088557376699,-44.94,1
09:51,170637730.0,2947.0018065819613,-62.1,4
09:52,909669130.0,253.18788473676665,-53.04,2
09:53,461029994.0,6089.22508234387,-36.97,4
09:53,604288474.0,3110.9770977067988,-9.51,5
09:56,654329190.0,77.79980094851936,-6.99,1
09:56,766941757.0,9331.026470818344,-64.88,1
10:02,386277162.0,402.3899999999997,-20.97,7
10:06,890830949.0,1167.5503499999982,-89.48,2
10:07,879091637.0,415.0345237379769,-310.8,2
10:17,554792076.0,24433.066413097094,-14.62,2
10:17,534204159.0,6492.6006808413495,-70.95,4
10:17,909676212.0,1541.3176174703678,-26.48,4
10:17,414454079.0,1536.7118500000015,-9.13,4
10:19,246753533.0,660.9130999999987,-5.4,9
10:20,668175891.0,784.7027951930411,-5.99,4
10:20,890830949.0,1152.570349999998,-14.98,2
10:22,287480331.0,11664.416317227506,-5.4,9
10:26,865748375.0,5371.758008177663,-193.17,2
10:27,996042490.0,5180.352046170784,-71.97,2
10:31,310620484.0,795.4767381437229,-7.03,7
10:31,194745206.0,546.1843720912432,-135.06,2
10:32,598793068.0,510.8392499999984,-11.0,4
10:37,197779140.0,44.12229999999964,-75.33,5
10:44,865748375.0,5254.158008177663,-117.6,2
10:55,355733816.0,4165.708117498155,-11.98,7
10:55,779236304.0,603.1504845815778,-48.6,2
11:01,879091637.0,38.43452373797692,-376.6,2
11:02,661295096.0,3046.126204411934,-22.0,2
11:03,660561861.0,1189.4078361603,-62.93,4
11:05,155867488.0,538.3916999999985,-1.5,4
11:05,970298834.0,3045.6515711298744,-30.05,2
11:14,572384506.0,9867.888062587246,-10.52,4
11:16,821971408.0,2126.2432292356316,-47.42,5
11:20,660561861.0,1106.8078361603002,-82.6,2
11:28,821971408.0,2098.293229235632,-27.95,7
11:33,879091637.0,-142.8654762620231,-181.3,2
11:36,572384506.0,9784.182062587246,-83.71,5
11:37,779376323.0,3086.846715820126,-89.5,2
11:40,596171893.0,-135.09825517448888,-18.97,7
11:41,586041848.0,780.9336999999991,-39.98,4
11:50,660561861.0,915.7078361603002,-191.1,2
11:52,985188462.0,1088.270248711225,-23.71,4
12:02,779376323.0,2828.846715820126,-258.0,2
12:02,519644021.0,2463.9018865656185,-23.78,7
12:07,879091637.0,-240.8654762620231,-98.0,2
12:13,703537476.0,1665.324249999999,-53.99,2
12:16,572384506.0,9764.162062587246,-20.02,9
12:17,687135796.0,24955.70607383208,-19.6,1
12:21,822250278.0,6511.171889813389,-6.25,4
12:21,711045550.0,657.5313500000029,-115.18,5
12:21,879091637.0,-350.76547626202307,-109.9,2
12:27,132400709.0,536.4374851539399,-23.28,9
12:27,456246119.0,18270.240305289575,-25.0,2
12:36,769319491.0,-496.1455000000004,-77.49,2
12:37,179173981.0,6522.403704940252,-22.42,7
12:42,879091637.0,-452.265476262023,-101.5,2
12:42,639549973.0,6934.309110265778,-84.29,5
12:46,490868147.0,-297.26122087869857,-140.83,5
12:55,709142813.0,887.2589999999994,-59.41,5
12:59,538003940.0,1891.570000000008,-10.98,7
13:02,570323670.0,3537.4780658823943,-33.03,4
13:05,407574996.0,3716.8421588091583,-7.5,9
13:05,340321732.0,1852.747050000003,-5.5,9
13:06,688712152.0,6001.83399695747,-4.35,9
13:08,849096144.0,1977.7637896445744,-6.0,9
13:11,769319491.0,-569.6155000000005,-73.47,2
13:11,855129444.0,-146.619045437372,-112.44,5
13:12,621652856.0,1867.0519696105396,-5.65,9
13:15,175452235.0,2522.7652500000004,-28.08,2
13:18,687135796.0,24945.39607383208,-10.31,4
13:20,585625048.0,1093.878619058633,-6.8,9
13:21,322221939.0,3766.1659650936567,-5.0,9
13:21,168414279.0,210.43228427492133,-14.99,4
13:26,706361191.0,222.71629849407816,-43.89,5
13:30,660561861.0,772.2078361603002,-143.5,2
13:44,797184978.0,-1527.7637134269803,-56.0,5
13:46,779946617.0,15229.374852154133,-50.05,2
13:51,339791565.0,-2968.8386999999975,-32.59,5
13:58,660561861.0,723.2078361603002,-49.0,2
14:00,890830949.0,1060.080349999998,-92.49,2
14:11,879091637.0,-653.8654762620231,-201.6,2
14:11,117308635.0,1291.1250896342312,-22.67,7
14:17,660561861.0,577.6078361603002,-145.6,2
14:21,993663752.0,218.15959241039656,-103.48,5
14:28,970298834.0,3029.4615711298743,-16.19,9
14:29,660561861.0,476.80783616030016,-100.8,2
14:34,890830949.0,1015.080349999998,-45.0,2
15:00,660561861.0,238.80783616030016,-238.0,2
15:10,514362267.0,262.6891691070604,-14.99,4
15:19,867987292.0,4347.616806142828,-4.64,2
15:28,660561861.0,124.0078361603002,-114.8,2
15:29,492058070.0,1106.013468740471,-9.99,2
15:44,492850697.0,13.726086665863342,-53.02,2
15:46,890830949.0,1006.090349999998,-8.99,2
15:53,492058070.0,1051.660968740471,-54.35,2
15:58,409971170.0,2207.260004061213,-11.87,5
16:01,890830949.0,890.6103499999981,-115.48,2
16:02,660561861.0,-43.99216383969981,-168.0,2
16:10,587225252.0,9952.217842971872,-9.15,8
16:17,492058070.0,1015.683468740471,-35.98,2
16:20,660561861.0,-140.59216383969982,-96.6,2
16:23,370757362.0,1068.9172134689168,-34.95,7
16:25,183186021.0,-1127.420049999999,-7.7,5
16:26,376271050.0,1156.6602468611795,-111.46,2
16:28,890830949.0,824.1203499999981,-66.49,2
16:28,785210466.0,2028.0673016744497,-31.97,4
16:31,280098744.0,1360.4003778716656,-7.98,4
16:31,227104649.0,1856.7335643161775,-32.94,9
16:32,641764023.0,-1265.3913037720042,-46.06,5
16:34,376271050.0,1092.1602468611795,-64.5,2
16:35,321372947.0,-330.7155507890993,-52.2,5
16:39,709608057.0,3660.882409120529,-30.35,4
16:40,478412511.0,633.0460201974607,-4.99,7
16:41,194745206.0,395.0263720912432,-151.16,2
16:43,890830949.0,792.1303499999981,-31.99,2
16:46,527842638.0,1481.3465426329838,-16.97,7
16:47,679911053.0,2326.713897548611,-12.8,8
16:48,456221621.0,941.7431673026282,-91.2,5
16:50,128033695.0,3086.4831266203923,-23.37,7
16:52,492058070.0,947.823468740471,-67.86,7
16:52,660561861.0,-251.19216383969984,-110.6,2
16:56,108481285.0,8321.461871413141,-24.09,5
16:58,376271050.0,944.1802468611796,-147.98,2
16:59,516051449.0,2145.535509014291,-9.99,4
17:03,413557825.0,472.25969999999967,-41.95,1
17:08,633345190.0,7261.424571254432,-23.21,9
17:12,949032480.0,5319.357425997707,-26.84,8
17:13,194745206.0,304.72637209124315,-90.3,2
17:15,683319988.0,7525.314338074536,-64.0,2
17:16,687135796.0,24922.66607383208,-22.73,2
17:18,949032480.0,5290.617425997707,-28.74,9
17:18,376271050.0,826.7202468611795,-117.46,2
17:19,409971170.0,2141.9710040612126,-65.29,5
17:24,951817450.0,8799.026883968387,-36.98,7
17:25,532478725.0,5182.337598137728,-11.2,2
17:25,699997811.0,1154.2541500000034,-61.59,5
17:25,500043411.0,12672.928059977998,-25.65,4
17:26,752362502.0,8498.382753087406,-23.01,7
17:26,854513972.0,465.0154999999995,-26.97,7
17:28,525524239.0,112.19235021119364,-138.38,2
17:29,871200314.0,577.3388242426385,-19.99,2
17:30,890830949.0,762.1503499999981,-29.98,2
17:31,235881534.0,11559.774642934026,-138.12,2
17:31,141521177.0,6349.247900000011,-121.99,2
17:32,876890798.0,3639.542570699929,-37.99,2
17:32,879091637.0,-820.4654762620231,-166.6,2
17:33,822135975.0,11872.041398405016,-5.05,4
17:33,668692488.0,1850.1119831225756,-34.98,4
17:33,221868392.0,5137.699246366183,-35.52,7
17:33,466649401.0,173.10906572319672,-24.0,7
17:35,166019891.0,7410.892814996685,-59.29,5
17:35,169006407.0,11429.693087667927,-23.98,1
17:36,871200314.0,451.3688242426384,-125.97,2
17:39,131388684.0,19657.016066105232,-60.03,4
17:40,373163757.0,10368.942620573578,-44.39,2
17:41,899742927.0,12872.500395598405,-44.99,2
17:41,525524239.0,6.067350211193627,-106.12,2
17:42,106601471.0,9165.775719531244,-146.3,2
17:43,851181128.0,4558.436994113557,-32.08,2
17:43,736340277.0,7729.774499265831,-33.43,5
17:44,117273481.0,8339.21636017816,-139.97,2
17:44,667367404.0,8253.413394564148,-1.54,4
17:44,709608057.0,3624.202409120529,-36.68,9
17:44,462962606.0,376.1415499999989,-60.0,2
17:45,874431242.0,8472.031687540399,-10.14,2
17:45,975345315.0,30932.084799999964,-12.45,9
17:47,990461108.0,196.64636862061093,-22.92,5
17:48,492058070.0,858.573468740471,-89.25,7
17:48,550832673.0,2562.359048823173,-72.99,2
17:48,383625050.0,5913.775579479299,-3.53,2
17:49,583579399.0,759.4024499999991,-52.01,5
17:49,361201224.0,6510.434232067893,-40.99,7
17:50,833899961.0,2115.953322838991,-38.94,7
17:50,769311479.0,6871.899078124123,-28.08,2
17:51,147474476.0,4079.532727031108,-28.0,2
17:52,421881811.0,5686.125111578864,-177.97,5
17:52,940569402.0,6269.3713433214425,-13.39,9
17:52,876890798.0,3616.572570699929,-22.97,1
17:53,237493332.0,13024.6612619197,-64.74,2
17:53,766812921.0,-8.533200000000717,-9.99,2
17:55,887853850.0,10401.447992247082,-25.89,9
17:55,986267641.0,5521.955058496277,-54.99,2
17:55,303843160.0,337.0588000000017,-127.0,5
17:56,510101371.0,12499.215096426842,-22.08,4
17:57,198946608.0,5771.651933563536,-30.05,2
17:57,525524239.0,-46.43264978880637,-52.5,2
18:00,214339619.0,187.90408704013723,-85.97,4
18:00,653640811.0,15062.173831496504,-297.47,2
18:00,131388684.0,19655.42372848987,-1.59,8
18:02,117273481.0,8212.516360178159,-126.7,2
18:02,466649401.0,117.28896572319672,-55.82,5
18:02,282102606.0,833.1728124228265,-24.14,9
18:04,335698481.0,-1979.4754966949404,-51.46,5
18:05,890830949.0,645.6503499999981,-116.5,2
18:08,879091637.0,-925.4654762620232,-105.0,2
18:10,668692488.0,1681.5344831225757,-168.58,5
18:11,492058070.0,742.345968740471,-116.23,4
18:14,435984758.0,5241.9560207378645,-8.35,2
18:17,188263947.0,716.5200000000002,-38.48,9
18:17,836110591.0,6986.459656220106,-7.93,2
18:19,194745206.0,181.54037209124317,-123.19,2
18:19,106601471.0,8984.475719531245,-181.3,2
18:20,891716230.0,309.56929807062056,-34.98,7
18:20,992204045.0,10857.263066774036,-66.11,7
18:20,413557825.0,209.31869999999964,-262.94,5
18:21,237493332.0,12996.5492619197,-28.11,5
18:21,901432314.0,3956.211716771268,-47.7,5
18:22,558119802.0,29380.08379724494,-23.14,9
18:22,628470485.0,822.2060299001231,-11.98,7
18:22,196289502.0,14007.536971002592,-16.22,7
18:25,117273481.0,8202.730360178159,-9.79,2
18:26,194745206.0,156.59037209124318,-24.95,9
18:27,987163717.0,6019.011850000005,-39.61,9
18:28,525524239.0,-193.80764978880637,-147.38,2
18:28,601627384.0,4759.3595559399755,-47.78,8
18:32,252760664.0,6025.529934790151,-11.47,5
18:33,203466392.0,2637.4298762355247,-31.98,2
18:34,656812046.0,1165.5596084590968,-26.19,9
18:35,315546581.0,24363.615395117173,-10.6,2
18:42,844835978.0,9672.754185927248,-24.98,7
18:42,522188082.0,7515.354097134509,-9.02,7
18:42,874431242.0,8435.9991875404,-36.03,7
18:44,213112754.0,6921.640373259813,-38.92,7
18:45,120634201.0,4681.777500000004,-90.78,5
18:45,984783496.0,13033.29849670496,-27.86,7
18:48,117273481.0,8194.344360178158,-8.39,2
18:54,865748375.0,5216.556586855434,-37.6,2
18:55,229502829.0,-2950.932424186248,-64.4,5
18:56,703478110.0,4073.9907030011095,-75.54,5
18:57,874431242.0,8403.5991875404,-32.4,9
18:58,837876918.0,-2053.057791465422,-30.17,5
18:59,399144202.0,2813.280676956703,-81.1,2
19:03,954263768.0,-164.67650000000015,-28.97,5
19:05,399144202.0,2786.5006769567026,-26.78,9
19:05,788740658.0,3355.5964083507506,-23.93,9
19:06,905860285.0,15500.54222601228,-9.81,2
19:07,296972867.0,-602.4873000000007,-61.92,5
19:07,633345190.0,7222.604904894489,-38.82,2
19:08,832564361.0,14547.562292580304,-50.76,5
19:08,844835978.0,9633.68704310472,-39.07,7
19:13,226703987.0,2484.433949999999,-131.33,5
19:14,971010829.0,538.5412564442454,-5.19,2
19:14,117273481.0,8115.972360178158,-78.37,2
19:15,496395938.0,11899.972350689322,-32.25,5
19:19,984783496.0,12947.45049670496,-85.85,5
19:24,623156843.0,5219.839387921985,-254.67,5
19:25,744968736.0,-1416.8013265694235,-75.6,5
19:29,698076160.0,5792.064882081277,-34.66,5
19:33,683078800.0,1590.1338920384876,-84.09,5
19:38,196289502.0,13989.321850042315,-18.22,5
19:42,124102251.0,4441.414241189251,-104.31,5
19:42,564744955.0,-54.25044141115801,-73.47,5
19:44,558119802.0,29362.436187508007,-17.65,8
19:45,245690309.0,8472.45056449536,-16.01,7
19:55,106601471.0,8970.213130229793,-14.26,2
19:57,994214354.0,9103.672885430064,-33.33,9
20:00,625281433.0,-714.2764073707567,-152.56,5
20:00,586315521.0,11184.015413785048,-12.74,2
20:03,719586818.0,17410.8109647708,-32.83,2
20:05,887156614.0,-975.6590210407736,-101.43,5
20:23,113747882.0,10968.55502197071,-5.59,5
20:24,355602925.0,1260.8525938274147,-0.53,2
20:28,806358207.0,11058.329220393647,-11.18,2
20:34,709608057.0,3596.1975087217374,-28.0,5
20:46,986267641.0,5503.076058496277,-18.88,5
21:09,454356905.0,2499.7340203727517,-24.4,9
23:34,366550080.0,23268.48012313301,-6.88,5
01:09,370521542.0,23342.81377749013,-0.88,7
01:35,421881811.0,5674.867652588681,-11.26,2
01:42,687135796.0,24913.888473046376,-8.78,7
02:02,547010927.0,21843.246463914336,-22.06,2
02:14,987656636.0,6001.167650982556,-33.01,2
02:16,779946617.0,15227.066262258812,-2.31,5
02:23,809499628.0,15102.223391851034,-15.85,9
02:26,709608057.0,3560.9675087217374,-35.23,9
02:28,749378808.0,5296.274702795218,-29.15,9
02:33,518474507.0,13324.633638754329,-29.39,9
02:34,558119802.0,29344.196187508005,-18.24,9
02:46,549414742.0,7101.8376503730615,-29.65,9
02:47,339791565.0,-3218.8386999999975,-250.0,4
02:48,252760664.0,6013.7405415123785,-11.79,5
02:52,873693307.0,8423.332797746176,-29.2,2
02:54,506618547.0,17407.102482893308,-3.76,2
02:59,749378808.0,5289.70226907768,-6.57,4
03:03,183888402.0,16149.82166649585,-45.23,9
03:11,196289502.0,13977.121850042317,-12.2,9
03:15,433917275.0,8070.99068966985,-27.93,9
03:16,836110591.0,6947.419656220106,-39.04,9
03:17,575652395.0,1511.5706378938153,-61.28,2
03:23,489964679.0,21957.721349001866,-35.28,9
03:26,348325817.0,10117.499912184094,-41.42,7
03:32,500043411.0,12672.117099396406,-0.81,7
03:34,532478725.0,5147.697598137727,-34.64,9
03:38,259015404.0,4458.29539164384,-29.01,9
03:44,449387287.0,-245.44030616489852,-25.95,9
03:47,836110591.0,6881.146492952599,-66.27,7
03:49,994214354.0,9073.092885430066,-30.58,9
03:54,948558249.0,8466.122015959809,-34.39,9
03:55,583558311.0,413.4607847513319,-18.95,9
03:56,802697323.0,19270.33454711507,-33.9,9
04:08,324224854.0,4099.520738741951,-42.56,5
04:09,192202372.0,786.8844030290111,-32.09,2
04:09,785749304.0,8254.162557224694,-20.43,2
04:14,290818242.0,6631.065491851657,-57.95,5
04:20,994214354.0,9009.471030034896,-63.62,7
04:22,108931112.0,12973.227697426308,-44.24,9
04:24,613729471.0,7437.981468984452,-27.32,7
04:24,656812046.0,1160.981678276318,-4.58,5
04:25,287480331.0,11650.951449282227,-13.46,5
04:29,259015404.0,4421.9540234872875,-36.34,2
04:34,701070224.0,967.69875,-36.88,9
04:38,482513594.0,7791.591596156619,-5.33,8
04:38,518474507.0,13284.247682713483,-40.39,8
04:40,752362502.0,8468.592235950317,-29.79,7
04:42,256002321.0,8086.346497099428,-21.03,9
04:45,675806859.0,6403.7233170618065,-5.28,2
04:48,812692024.0,4363.939178787427,-21.93,2
04:49,550169791.0,18799.811071039636,-12.3,2
04:52,873701090.0,2003.0316158380324,-40.67,7
04:53,678851253.0,4817.875579655491,-33.63,7
04:55,679662108.0,13860.006439997716,-6.93,2
04:59,229205098.0,7390.229791249352,-40.1,7
05:02,145387690.0,5380.555932292726,-31.95,9
05:07,851649498.0,9908.687310927142,-44.75,2
05:07,473820682.0,10929.90431733745,-21.4,7
05:13,256002321.0,8061.172563158605,-25.17,5
05:18,887853850.0,10368.457992247082,-32.99,9
05:18,399144202.0,2755.6106769567027,-30.89,9
05:23,409971170.0,2134.3928231083064,-7.58,8
05:25,667367404.0,8214.048471791762,-39.36,7
05:29,417850087.0,15446.210234003403,-14.27,7
05:37,169006407.0,11366.606874610672,-63.09,7
05:38,719586818.0,17376.706401695006,-34.1,7
05:39,187541224.0,6769.2244930517845,-26.58,9
05:47,572384506.0,9737.122062587245,-27.04,9
05:47,593378953.0,1066.472700000005,-34.59,9
05:54,187111705.0,6183.019552361278,-24.86,2
05:56,143003091.0,19729.065177996312,-55.76,7
05:57,822250278.0,6506.081811675504,-5.09,8
05:58,151968462.0,8572.27481865438,-14.26,8
06:01,651756497.0,12904.841776637171,-8.01,5
06:02,853907490.0,7178.111529152902,-42.78,2
06:04,383833857.0,21344.720758106665,-10.14,7
06:04,960208650.0,15318.686347414276,-44.0,7
06:04,520447032.0,8529.131558515794,-24.68,7
06:07,822135975.0,11867.018306522668,-5.02,2
06:07,366550080.0,23265.251375983007,-3.23,2
06:09,705848712.0,23414.327337109145,-9.49,9
06:13,532478725.0,5143.054567767802,-4.64,2
06:17,973086490.0,9331.56671389856,-20.64,2
06:19,315546581.0,24349.23985955784,-14.38,5
06:20,940569402.0,6259.659038222656,-9.71,5
06:21,170637730.0,2924.5320618863875,-22.47,4
06:22,878989510.0,4879.014077321594,-18.7,9
06:26,237684254.0,5594.77971555769,-49.13,5
06:26,572384506.0,9733.76125191391,-3.36,2
06:27,832564361.0,14492.667608346608,-54.89,2
06:34,245690309.0,8441.968423363134,-30.48,7
06:35,858989281.0,25278.857197071964,-19.44,9
06:35,305778936.0,11503.362677677458,-28.93,9
06:36,450896297.0,12657.052244202445,-23.32,9
06:37,221868392.0,5134.967966950337,-2.73,2
06:38,795847804.0,20374.822173689947,-42.49,7
06:46,893134725.0,2091.152962973209,-15.93,9
06:47,108563213.0,20989.305085229713,-7.7,7
06:53,108481285.0,8283.451059163413,-38.01,5
06:55,718058208.0,1908.940479983734,-26.8,5
07:02,581655972.0,38273.84461876961,-74.38,5
07:03,706250160.0,10650.210303670125,-1.12,2
07:05,383625050.0,5911.016349530559,-2.76,5
07:06,305778936.0,11502.172277939922,-1.19,7
07:08,668329719.0,7590.363093065307,-3.62,5
07:09,930277104.0,10015.696270135464,-55.19,7
07:09,496395938.0,11898.45174064919,-1.52,2
07:09,364357875.0,6452.084563748256,-8.87,7
07:11,823208989.0,1883.6201509951832,-7.24,7
07:11,609939116.0,6483.965837330283,-7.04,7
07:12,237493332.0,12995.274439983034,-1.27,7
07:12,203466392.0,2635.8383186688434,-1.59,7
07:13,216285378.0,21433.154315006803,-30.62,9
07:18,195895574.0,6790.454279735554,-53.02,4
07:20,815385232.0,9257.88473049336,-9.34,7
07:21,705848712.0,23394.270489180715,-20.06,2
07:21,766941757.0,9291.696470818344,-39.33,9
07:27,769311479.0,6855.1555796283155,-16.74,8
07:28,806358207.0,10999.14485521716,-59.18,5
07:31,824916823.0,8428.336955203102,-23.58,9
07:32,559995067.0,3843.6676694246503,-34.92,5
07:34,414805878.0,13677.817184154988,-34.23,9
07:37,124102251.0,4416.045302716834,-25.37,7
07:37,264550521.0,8871.752644712087,-13.7,4
07:37,699139822.0,2588.5978362449855,-1.24,7
07:41,534325901.0,6537.228318645331,-8.93,2
07:44,985188462.0,1055.6802487112247,-32.59,9
07:50,905860285.0,15460.15136870952,-40.39,2
07:52,776108637.0,1421.4579023859055,-7.1,9
08:00,308505160.0,12202.678488058586,-11.84,5
08:02,454129843.0,1671.9000487975245,-5.5,9
08:02,738958551.0,8114.426742675923,-35.82,8
08:03,395284483.0,2005.84592440364,-5.7,9
08:10,399538448.0,7167.052520655866,-5.4,9
08:11,519935524.0,-12.48731026248106,-5.8,9
08:15,519644021.0,2397.354211393105,-66.55,7
08:16,892354433.0,-100.05896063433876,-6.85,9
08:17,683319988.0,7503.855542985939,-21.46,7
08:17,270374623.0,10079.79762755427,-33.86,8
08:18,992204045.0,10855.715687035672,-1.55,2
08:18,874431242.0,8371.810420930502,-31.79,2
08:19,639409800.0,30915.33783438769,-6.02,5
08:21,446720287.0,-676.4249591815944,-40.86,5
08:24,766941757.0,9269.889242893987,-21.81,2
08:25,423208402.0,2083.0107000000025,-104.5,5
08:25,885259672.0,4136.5897967419605,-6.8,9
08:26,165098840.0,-760.7781263623731,-31.85,5
08:26,176922958.0,2286.3808479104705,-42.87,2
08:27,558119802.0,29342.48090148131,-1.72,8
08:27,556992209.0,10616.307226083052,-26.71,5
08:27,197865285.0,450.5072117312205,-19.91,5
08:28,246753533.0,596.5809999999988,-64.33,5
08:29,137913631.0,1600.7328999999995,-39.46,5
08:29,467207141.0,1737.0048670482638,-7.5,9
08:36,145387690.0,5374.735167102794,-5.82,5
08:36,842682241.0,7103.54344979698,-24.31,5
08:36,564214408.0,-97.0321152742738,-26.57,5
08:37,541639148.0,5312.505841365429,-6.84,8
08:38,180719578.0,-3902.412749999996,-48.05,5
08:39,761272540.0,151.83459999999891,-45.37,5
08:44,644751433.0,-1197.6933584655385,-100.23,5
08:47,170637730.0,2853.7620618863875,-70.77,5
08:48,401293808.0,-130.71925000000073,-164.47,5
08:50,460463595.0,-1042.2879454185788,-50.04,5
08:54,199016328.0,5375.727041228588,-15.07,7
08:56,496865819.0,-1110.1484318426824,-12.43,5
08:59,248142083.0,-482.7375652974832,-37.78,5
09:00,290818242.0,6625.015491851656,-6.05,9
09:00,169006407.0,11360.506874610672,-6.1,9
09:02,667367404.0,8207.548471791762,-6.5,9
09:03,586315521.0,11176.515413785048,-7.5,9
09:04,119993184.0,-1871.6444029108627,-67.86,5
09:05,570269025.0,2536.976803575495,-29.49,5
09:06,383833857.0,21339.470758106665,-5.25,9
09:07,762700245.0,2698.3147000000017,-5.25,9
09:08,975345315.0,30926.384799999963,-5.7,9
09:09,448004226.0,2424.368461930605,-131.73,5
09:11,779236304.0,589.649526062874,-13.5,7
09:11,220183538.0,754.3965499999996,-123.39,5
09:12,117273481.0,8109.472360178158,-6.5,9
09:12,124102251.0,4410.345302716834,-5.7,9
09:12,480557476.0,10577.07592967474,-37.64,2
09:13,627917561.0,3026.050050000003,-4.75,9
09:15,305778936.0,11410.507277939922,-91.66,5
09:15,116169597.0,862.9559499999996,-19.99,4
09:15,741903302.0,2475.402897988479,-5.4,9
09:15,909669130.0,237.46788473676665,-15.72,5
09:16,799453072.0,250.26214999999897,-9.99,4
09:17,613729471.0,7431.981468984452,-6.0,9
09:18,331450202.0,6396.449528064803,-59.68,5
09:18,851649498.0,9903.337310927142,-5.35,9
09:19,618138606.0,1434.246410892108,-5.0,9
09:19,540159353.0,9989.865049549118,-7.8,9
09:20,624563756.0,-329.61367121644366,-5.4,9
09:21,603375739.0,-249.49593697673305,-123.14,5
09:22,535744551.0,1279.1915159956266,-9.98,7
09:23,417850087.0,15441.860234003403,-4.35,9
09:23,703537476.0,1512.334249999999,-152.99,2
09:23,138609932.0,4323.776003294585,-5.7,9
09:24,214339619.0,180.00408704013722,-7.9,9
09:24,986774156.0,1006.9649316257678,-9.99,7
09:24,559995067.0,3763.1326694246504,-80.53,5
09:25,987656636.0,5942.887650982556,-58.28,2
09:27,816685391.0,-621.8588037084264,-89.46,5
09:28,853907490.0,7151.679529152902,-26.43,5
09:29,409370545.0,335.00427554552016,-23.05,7
09:31,158766229.0,-639.4057358934699,-56.98,5
09:33,280268430.0,4716.739936626336,-14.48,4
09:36,843537309.0,-571.4097177916318,-96.99,2
09:36,282837512.0,13320.503998428996,-28.0,4
09:36,134461671.0,8017.4388864817665,-56.03,2
09:36,348325817.0,10046.351912184096,-71.15,5
09:37,282837512.0,13317.130693507455,-3.37,4
09:39,678851253.0,4748.5895796554905,-69.29,7
09:51,575652395.0,1455.5706378938153,-56.0,2
09:53,137822385.0,3180.786791350627,-132.13,5
09:54,996042490.0,5176.372046170784,-3.98,4
09:57,596171893.0,-156.06825517448888,-20.97,7
09:59,678851253.0,4736.00357965549,-12.59,4
10:00,919185264.0,3900.005255737047,-20.97,7
10:00,822250278.0,6440.099811675504,-65.98,5
10:02,570269025.0,2529.9868035754953,-6.99,4
10:02,192202372.0,556.3884030290111,-230.5,5
10:02,762896656.0,-467.95750184814136,-6.21,5
10:11,163470640.0,1184.6115,-32.97,5
10:12,943829984.0,378.9754091134573,-5.99,2
10:12,743630833.0,313.4879132847012,-116.57,5
10:16,909676212.0,1521.3476174703678,-19.97,1
10:17,298007503.0,748.3881036256333,-17.23,7
10:17,815993333.0,836.1252398123937,-13.4,4
10:19,456246119.0,18190.260305289576,-79.98,4
10:21,137913631.0,1501.7628999999995,-98.97,2
10:29,678851253.0,4701.00357965549,-35.0,2
10:30,145387690.0,5347.535167102794,-27.2,1
10:31,547010927.0,21799.996463914336,-43.25,7
10:32,287480331.0,11608.57305928223,-42.38,4
10:35,687135796.0,24810.598473046375,-103.29,2
10:36,896821055.0,-64.67492631476466,-203.5,7
10:40,843537309.0,-721.8897177916318,-150.48,2
10:44,403383649.0,2087.3405643427586,-74.19,2
10:44,280098744.0,1335.4003778716656,-25.0,2
10:48,815993333.0,663.9752398123937,-172.15,2
11:02,604288474.0,3079.225097706799,-31.75,5
11:05,919185264.0,3883.804536776557,-16.2,2
11:07,403383649.0,1975.3685643427584,-111.97,2
11:10,448004226.0,2407.8784619306048,-16.49,4
11:11,909676212.0,1431.747617470368,-89.6,2
11:13,414454079.0,1446.4118500000018,-90.3,2
11:15,546296727.0,-302.3549226973814,-22.52,5
11:17,896821055.0,-139.17492631476466,-74.5,7
11:22,534204159.0,6470.48068084135,-22.12,7
11:22,137913631.0,1442.7728999999997,-58.99,2
11:24,604288474.0,3060.233409252423,-18.99,2
11:27,668175891.0,726.7227951930411,-57.98,2
11:37,913801979.0,585.4226299144939,-17.97,7
11:37,179173981.0,6515.140759422452,-7.26,2
11:40,909676212.0,1361.747617470368,-70.0,2
11:41,137913631.0,1325.7928999999997,-116.98,2
11:44,403383649.0,1747.1965643427586,-228.17,2
11:47,909676212.0,1263.747617470368,-98.0,2
11:48,407574996.0,3703.726058383695,-13.12,4
11:48,414454079.0,1231.5538500000018,-214.86,2
11:49,843537309.0,-774.8797177916318,-52.99,2
11:50,386277162.0,389.4099999999996,-12.98,4
11:50,896821055.0,-243.67492631476463,-104.5,4
11:52,403383649.0,1642.2105643427583,-104.99,2
11:54,136770968.0,-48.01510000000029,-36.97,4
11:56,637649383.0,872.0574499999984,-20.96,1
11:59,183888402.0,16131.214359271542,-18.61,2
12:03,843537309.0,-790.8597177916319,-15.98,2
12:04,678851253.0,4595.317579655491,-105.69,7
12:15,403383649.0,1546.3245643427583,-95.89,2
12:18,414454079.0,1014.581850000002,-216.97,2
12:19,679943657.0,3915.944450000009,-5.3,9
12:27,678851253.0,4543.5315796554905,-51.79,4
12:28,137913631.0,1253.8128999999994,-71.98,2
12:30,679662108.0,13842.756439997716,-17.25,7
12:32,549414742.0,7100.831579130465,-1.01,4
12:32,843537309.0,-895.8297177916319,-104.97,2
12:40,137913631.0,1175.3328999999994,-78.48,2
12:41,403383649.0,1297.1385643427586,-249.19,2
12:48,678851253.0,4390.2455796554905,-153.29,2
12:49,414454079.0,1001.401850000002,-13.18,2
12:57,775790822.0,-2772.3334192160683,-23.91,5
13:01,978410962.0,-2676.8583395489736,-29.61,5
13:10,843537309.0,-969.829717791632,-74.0,2
13:10,433837402.0,-1012.605868464188,-35.09,9
13:10,585625048.0,1085.9786190586328,-7.9,9
13:11,910730524.0,7446.906550025075,-7.9,9
13:11,923322792.0,-607.3343317536376,-51.19,5
13:13,688712152.0,5996.58399695747,-5.25,9
13:14,812692024.0,4357.439178787427,-6.5,9
13:14,699139822.0,2564.6678362449857,-23.93,9
13:15,749371623.0,-2446.1291535173427,-29.98,5
13:17,414454079.0,840.4018500000019,-161.0,2
13:21,322221939.0,3760.065965093657,-6.1,9
13:24,948069469.0,-650.565500000001,-76.57,5
13:34,462962606.0,370.1515499999989,-5.99,7
13:38,812012103.0,-381.1193000000005,-61.26,5
13:42,678851253.0,4307.64557965549,-82.6,2
13:44,414454079.0,731.2158500000019,-109.19,2
13:45,809499628.0,15074.184474379175,-28.04,8
13:45,637649383.0,826.0874499999984,-45.97,2
13:53,600585971.0,340.75069999999954,-60.53,5
13:58,163470640.0,1149.6115,-35.0,2
13:59,380911501.0,-200.22590000000088,-87.5,5
14:01,637649383.0,702.0974499999984,-123.99,2
14:02,956717493.0,988.452845731273,-29.97,1
14:04,414454079.0,614.3578500000019,-116.86,2
14:09,678851253.0,4252.34557965549,-55.3,2
14:11,896821055.0,-395.17492631476466,-151.5,7
14:14,344522228.0,-2681.1994882083927,-26.42,5
14:19,414454079.0,447.7578500000019,-166.6,2
14:22,678851253.0,4189.35957965549,-62.99,2
14:24,442079728.0,523.6051192193139,-70.98,2
14:27,950234174.0,1558.0664322578348,-37.75,8
14:33,414454079.0,440.1478500000019,-7.61,4
14:34,541639148.0,5250.365841365428,-62.14,2
14:40,554792076.0,24432.55238448783,-0.51,7
14:41,678851253.0,4078.75957965549,-110.6,2
14:42,442079728.0,497.6451192193139,-25.96,1
14:43,137913631.0,1005.8428999999994,-169.49,2
14:43,192202372.0,479.3984030290111,-76.99,2
14:53,678851253.0,3982.18757965549,-96.57,2
15:00,316793091.0,798.8228600549512,-6.99,7
15:08,678851253.0,3975.20157965549,-6.99,2
15:26,331048953.0,-138.80163202150638,-61.61,5
15:26,108481285.0,8253.471059163414,-29.98,7
15:28,678851253.0,3844.31557965549,-130.89,2
15:40,896821055.0,-519.6749263147647,-124.5,7
15:40,494789005.0,3131.1578108911317,-38.98,5
15:48,857997794.0,1090.7106651508873,-201.6,2
15:50,414454079.0,298.0898500000019,-142.06,2
15:54,421881811.0,5623.771712588681,-51.1,4
15:55,508518911.0,204.0667502790105,-49.99,4
15:57,637649383.0,630.5974499999984,-71.5,2
16:04,678851253.0,3677.01557965549,-167.3,2
16:06,724997545.0,-38.82905800221831,-43.25,9
16:09,287480331.0,11579.733059282227,-28.84,9
16:10,414454079.0,218.28985000000188,-79.8,2
16:16,666952234.0,231.67664812448697,-27.99,2
16:23,637649383.0,516.1174499999984,-114.48,2
16:25,409971170.0,2071.7442231083064,-62.65,4
16:26,233981231.0,1884.6584947815136,-59.98,7
16:29,163470640.0,1082.1115,-67.5,2
16:33,666952234.0,151.21664812448697,-80.46,2
16:35,146909202.0,5377.775579490062,-33.08,7
16:38,964702094.0,1596.4702816629351,-49.99,2
16:39,857997794.0,882.1106651508873,-208.6,2
16:40,886921642.0,3494.22908637997,-46.7,5
16:40,678851253.0,3641.35757965549,-35.66,2
16:44,137913631.0,967.3528999999994,-38.49,2
16:45,198946608.0,5754.976168621017,-16.68,5
16:48,603721739.0,158.2688994831841,-145.91,5
16:53,163470640.0,1078.3615,-3.75,2
16:56,627936697.0,1293.5892499999998,-23.97,4
16:57,494977194.0,1947.6339705975768,-53.99,2
16:58,256045540.0,-3048.2138999999993,-16.39,5
16:58,899742927.0,12867.108658232912,-5.39,8
17:00,414454079.0,135.0318500000019,-83.26,2
17:01,527842638.0,1462.3165426329838,-19.03,9
17:02,137913631.0,857.8828999999994,-109.47,2
17:05,779620857.0,-53.456696385175846,-152.0,2
17:08,857997794.0,749.1106651508873,-133.0,2
17:09,666952234.0,27.236648124486976,-123.98,2
17:10,310375875.0,3790.41379722432,-39.72,2
17:10,949032480.0,5287.18780738395,-3.43,5
17:12,414454079.0,77.67385000000189,-57.36,2
17:12,510101371.0,12491.121593691492,-8.09,2
17:14,809499628.0,14931.784474379176,-142.4,2
17:15,581655972.0,38142.24461876961,-131.6,2
17:15,163470640.0,979.3615,-99.0,2
17:17,857754342.0,2129.8332728586615,-9.48,4
17:17,376271050.0,807.7502468611794,-18.97,4
17:17,987163717.0,5979.331850000005,-39.68,9
17:18,510101371.0,12461.231593691493,-29.89,9
17:19,213112754.0,6884.445733237192,-37.19,7
17:19,832564361.0,14476.862078346609,-15.81,4
17:21,137913631.0,748.8828999999994,-109.0,2
17:22,705848712.0,23342.370489180714,-51.9,2
17:23,478651121.0,122.5898295984698,-59.37,5
17:26,314980178.0,2629.0318500000044,-35.0,2
17:27,704517789.0,16428.297872370957,-29.19,7
17:28,675806859.0,6378.7233170618065,-25.0,2
17:30,534325901.0,6514.828318645331,-22.4,2
17:31,690523499.0,948.5285999999996,-5.0,4
17:32,365608668.0,713.9978138595588,-29.97,7
17:32,433917275.0,7917.69068966985,-153.3,2
17:32,779620857.0,-192.95669638517583,-139.5,2
17:33,429556122.0,5761.964750000004,-90.08,2
17:34,130154096.0,1118.0092252012682,-20.97,7
17:35,769311479.0,6744.855579628315,-110.3,2
17:35,126929801.0,1175.8999190559712,-74.99,2
17:36,255814263.0,3939.061237992111,-156.5,7
17:38,824916823.0,8427.431335993382,-0.91,2
17:39,408057540.0,7372.079967773258,-111.08,2
17:40,290818242.0,6553.825491851657,-71.19,5
17:40,113747882.0,10947.24502197071,-21.31,4
17:42,859603181.0,4059.6567724959455,-29.99,2
17:42,151968462.0,8542.29481865438,-29.98,4
17:43,163470640.0,930.9865,-48.38,2
17:43,414454079.0,-2.8261499999981083,-80.5,2
17:43,229205098.0,7347.519791249352,-42.71,7
17:44,806358207.0,10986.83485521716,-12.31,4
17:45,256002321.0,8059.586363158605,-1.59,4
17:46,373163757.0,10358.952620573578,-9.99,4
17:46,779620857.0,-277.45669638517586,-84.5,2
17:46,613427466.0,5744.8929056558745,-11.98,7
17:46,698076160.0,5672.637882081277,-119.43,5
17:47,678851253.0,3516.7715796554903,-124.59,7
17:47,912705941.0,16824.904194113788,-78.39,2
17:48,151278285.0,-209.7216500000004,-92.85,5
17:49,358846516.0,222.23517252721803,-106.75,5
17:51,274818272.0,205.55967856713153,-61.57,5
17:52,769311479.0,6714.805579628315,-30.05,7
17:55,534325901.0,6466.998318645331,-47.83,2
17:55,704517789.0,16407.00096875542,-21.3,2
17:56,399144202.0,2751.7029901725746,-3.91,7
17:57,252701364.0,-3311.366172677917,-27.04,5
17:57,163470640.0,816.9865,-114.0,2
17:58,500843551.0,772.4761499999997,-32.96,7
17:58,570323670.0,3525.966565882394,-11.51,4
18:01,255814263.0,3815.581237992111,-123.48,7
18:02,414454079.0,-123.9261499999981,-121.1,2
18:03,450896297.0,12614.20198777594,-42.85,2
18:05,344219145.0,8549.521996558604,-78.68,2
18:05,779620857.0,-401.95669638517586,-124.5,2
18:05,433917275.0,7778.39068966985,-139.3,2
18:07,383625050.0,5886.076349530559,-24.94,9
18:09,666952234.0,-140.75335187551303,-167.99,2
18:10,687135796.0,24795.658473046376,-14.94,9
18:10,624563756.0,-355.62847121644364,-26.01,5
18:13,857997794.0,403.3106651508873,-345.8,2
18:16,647936800.0,1649.519784793049,-9.8,7
18:17,678851253.0,3398.4995796554904,-118.27,4
18:20,117273481.0,8049.492360178158,-59.98,7
18:22,666952234.0,-177.74335187551304,-36.99,2
18:23,147474476.0,3824.212627031108,-255.32,5
18:24,255814263.0,3756.581237992111,-59.0,4
18:25,140893085.0,4606.8210063654615,-209.36,5
18:32,925037906.0,1335.6018000000015,-12.5,7
18:34,586315521.0,11147.202683220336,-29.31,7
18:37,633345190.0,7190.754904894488,-31.85,9
18:38,433917275.0,7718.53068966985,-59.86,4
18:41,975200042.0,-2754.5051999999982,-49.04,5
18:44,370521542.0,23274.94275749013,-67.87,7
18:45,675231808.0,14444.221086489182,-34.4,5
18:45,690958123.0,17629.152651702552,-7.01,7
18:46,616924659.0,325.28457982308544,-27.58,5
18:48,719586818.0,17218.114401695006,-158.59,5
18:51,678851253.0,3301.8995796554905,-96.6,2
18:51,984783496.0,12916.24869670496,-31.2,7
18:53,651372390.0,-3213.4307499999986,-37.07,5
18:54,441274121.0,11691.2427146541,-4.34,8
18:54,235881534.0,11525.740642934026,-34.03,7
18:56,224112146.0,39.861399999998866,-72.58,5
18:56,421475159.0,-519.7137373255874,-58.53,5
18:59,565175333.0,-3219.463522729827,-15.42,5
18:59,730002588.0,12634.125404821914,-101.88,5
19:00,520418719.0,2577.960100000003,-148.71,5
19:01,435984758.0,5237.6998065171465,-4.26,2
19:01,383833857.0,21309.272758106665,-30.2,5
19:02,809499628.0,14908.572474379176,-23.21,5
19:04,858989281.0,25233.2585777379,-45.6,7
19:04,291580432.0,-752.9435999999997,-49.84,5
19:05,874506295.0,-1586.939256245572,-13.72,5
19:05,204855464.0,-1168.8382386396158,-218.25,5
19:05,887853850.0,10360.027109095774,-8.43,2
19:08,285220959.0,11173.215045686182,-12.19,7
19:12,697140785.0,-251.92438326389689,-71.55,5
19:12,815385232.0,9208.24073049336,-49.64,5
19:13,670427480.0,2169.621900000001,-68.17,5
19:14,419550103.0,17165.551634613523,-10.01,7
19:18,128030172.0,-380.43022744984984,-67.79,5
19:18,472213568.0,-310.65494420605324,-33.52,5
19:19,706301742.0,-2637.8406499999987,-37.24,5
19:19,409370545.0,312.6692755455202,-22.34,5
19:23,522188082.0,7505.716323222141,-9.64,7
19:23,979135922.0,-1801.6241994095492,-29.66,5
19:24,429556122.0,5693.567750000004,-68.4,5
19:25,131388684.0,19646.61772848987,-8.81,5
19:25,736340277.0,7698.862499265831,-30.91,5
19:26,200080192.0,8983.988559418432,-39.55,7
19:28,957821152.0,-1178.4231035715495,-48.43,9
19:28,496674181.0,-1694.1514723307223,-131.95,5
19:28,964702094.0,1447.124581662935,-149.35,5
19:29,624500124.0,3490.7627608576677,-63.58,2
19:30,270374623.0,10041.87162755427,-37.93,5
19:34,493571342.0,-2271.1158809070484,-28.16,5
19:36,892354433.0,-196.9494606343388,-96.89,5
19:36,195895574.0,6693.287279735554,-97.17,5
19:39,550644516.0,-76.90790000000132,-66.95,5
19:41,424397946.0,2194.730783605399,-48.24,5
19:44,574548998.0,510.6187499999992,-59.43,5
19:45,550169791.0,18734.809071039635,-65.0,5
19:46,151916463.0,1481.650555599169,-177.95,5
19:47,486495235.0,1108.336639388716,-58.01,5
19:51,678330503.0,4207.528936476323,-1.53,5
19:56,683319988.0,7477.875542985939,-25.98,9
20:01,854513972.0,396.7266499999995,-68.29,5
20:08,587225252.0,9927.91950060951,-24.3,8
20:16,885259672.0,4129.858203920947,-6.73,2
20:20,610450243.0,-1250.8746,-21.52,5
20:21,290818242.0,6535.385491851657,-18.44,9
20:22,939972497.0,875.7395086000109,-32.5,5
20:22,851181128.0,4511.346994113557,-47.09,9
20:23,551196328.0,4116.383700000005,-132.3,5
20:25,788740658.0,3297.1324083507507,-58.46,5
20:27,553734946.0,497.82599999999894,-99.43,5
20:40,703588001.0,-507.1997500000005,-133.29,5
20:42,859264768.0,192.2450837819385,-68.17,5
20:43,550832673.0,2504.203048823173,-58.16,5
20:49,949032480.0,5255.98780738395,-31.2,9
20:51,128033695.0,3077.494503035747,-8.99,5
20:56,408057540.0,7368.228394620533,-3.85,8
21:09,480557476.0,10561.17592967474,-15.9,9
21:12,670102069.0,4238.296241377078,-3.84,7
01:00,718058208.0,1880.2784619580864,-28.66,2
01:21,414454079.0,-156.75614999999812,-32.83,9
01:24,679662108.0,13839.78827593215,-2.97,2
01:38,370521542.0,23259.292534418026,-15.65,5
01:39,950234174.0,1497.9811702756576,-60.09,7
02:16,779946617.0,15224.331366434844,-2.73,5
02:38,386277162.0,350.9199999999996,-38.49,9
02:41,547010927.0,21779.174677316285,-20.82,5
02:55,408057540.0,7336.988394620534,-31.24,9
02:59,534325901.0,6463.869429737418,-3.13,5
03:19,482513594.0,7758.348161819394,-33.24,2
03:20,128033695.0,3064.9566828374886,-12.54,7
03:21,705848712.0,23324.120489180714,-18.25,9
03:24,907987693.0,-2238.9544999999994,-30.37,9
03:26,187111705.0,6174.505586891136,-8.51,5
03:26,496395938.0,11828.7553002348,-69.7,7
03:28,145387690.0,5320.845167102794,-26.69,9
03:32,480557476.0,10546.954119863203,-14.22,2
03:38,678330503.0,4197.307035895606,-10.22,5
03:39,823208989.0,1864.0968580645024,-19.52,7
03:40,699139822.0,2563.7834245243625,-0.88,5
03:43,179173981.0,6501.160759422452,-13.98,9
03:44,402438092.0,1206.853899999999,-10.24,9
03:48,656812046.0,1113.6022830056572,-47.38,2
03:51,518474507.0,13251.117682713484,-33.13,9
03:52,948069469.0,-664.765500000001,-14.2,9
03:53,216285378.0,21400.2243150068,-32.93,9
03:53,704517789.0,16381.623981419823,-25.38,7
04:01,832564361.0,14425.420302020098,-51.44,2
04:13,399144202.0,2728.3229901725745,-23.38,9
04:19,679911053.0,2324.3093796306107,-2.4,2
04:21,183888402.0,16087.724359271542,-43.49,9
04:22,151968462.0,8537.33999581922,-4.95,2
04:23,441274121.0,11625.026945102349,-66.22,5
04:24,187541224.0,6730.994493051785,-38.23,9
04:29,940569402.0,6246.269038222656,-13.39,9
04:32,506618547.0,17343.27107172617,-63.83,2
04:33,824916823.0,8400.151335993382,-27.28,9
04:34,749378808.0,5283.4934639215635,-6.21,4
04:41,687135796.0,24784.133802091692,-11.52,2
04:42,785749304.0,8208.554548456486,-45.61,5
04:46,713910252.0,-323.14407427145835,-27.45,9
04:46,973086490.0,9295.768620535906,-35.8,5
04:51,709608057.0,3527.547508721738,-33.42,9
04:51,146909202.0,5377.497711400969,-0.28,8
04:52,473820682.0,10918.824726540008,-11.08,5
04:52,145387690.0,5301.6863624765865,-19.16,2
04:54,678851253.0,3282.732872724056,-19.17,2
04:58,992204045.0,10778.897814913738,-76.82,7
05:01,282837512.0,13314.116977629972,-3.01,2
05:02,853907490.0,7096.353355858044,-55.33,5
05:04,522188082.0,7449.903403177117,-55.81,7
05:05,229205098.0,7346.722337397077,-0.8,7
05:05,471897866.0,7899.67972156188,-26.84,7
05:08,858989281.0,25221.3085777379,-11.95,9
05:14,776431321.0,3009.602093226551,-30.32,5
05:14,169006407.0,11350.201501724505,-10.31,5
05:15,417850087.0,15388.930038036811,-52.93,2
05:15,655368335.0,4702.597932091615,-1.8,5
05:17,815385232.0,9200.991332454054,-7.25,8
05:18,324224854.0,4079.142764196567,-20.38,2
05:18,532478725.0,5114.114567767802,-28.94,9
05:18,195895574.0,6671.106283355909,-22.18,2
05:25,824916823.0,8397.292396921566,-2.86,8
05:27,315546581.0,24338.182038161973,-11.06,4
05:28,769311479.0,6699.887889397134,-14.92,2
05:31,296972867.0,-616.0873000000007,-13.6,9
05:34,550169791.0,18700.72805063187,-34.08,5
05:34,494789005.0,3128.906691906997,-2.25,7
05:40,414805878.0,13638.947184154988,-38.87,9
05:42,256002321.0,8043.236363158605,-16.35,9
05:44,639549973.0,6919.945946209534,-14.36,7
05:44,235881534.0,11498.986932873211,-26.75,5
05:44,108481285.0,8227.886100079206,-25.58,2
05:45,675806859.0,6322.683989357352,-56.04,2
05:46,858989281.0,25148.403733967312,-72.9,7
05:47,795847804.0,20360.363461041903,-14.46,2
05:49,285220959.0,11123.82131993583,-49.39,7
06:00,113747882.0,10883.937335897845,-63.31,5
06:00,613729471.0,7428.527247106703,-3.45,2
06:00,315078351.0,6216.259041965706,-23.59,5
06:00,706250160.0,10635.534960416271,-14.68,7
06:05,586315521.0,11072.8453840047,-74.36,7
06:05,170637730.0,2820.0067762887106,-33.76,2
06:06,984783496.0,12906.24106216057,-10.01,4
06:07,259015404.0,4382.604023487287,-39.35,9
06:13,489964679.0,21926.23134900186,-31.49,9
06:16,221868392.0,5103.6096878969465,-31.36,7
06:16,887853850.0,10343.799078729004,-16.23,2
06:16,203466392.0,2628.026352040357,-7.81,8
06:19,873693307.0,8412.812914002068,-10.52,5
06:24,511179916.0,7443.770441217793,-32.14,8
06:26,364357875.0,6372.744190521231,-79.34,5
06:29,532478725.0,5067.7240812196915,-46.39,7
06:32,366477356.0,124.14684999999996,-28.14,9
06:32,930277104.0,10000.55443829672,-15.14,2
06:32,572384506.0,9691.78125191391,-41.98,9
06:33,237684254.0,5594.332060102668,-0.45,5
06:35,905860285.0,15444.401216260248,-15.75,7
06:39,179173981.0,6482.652456211111,-18.51,7
06:39,809499628.0,14891.422474379176,-17.15,9
06:42,719586818.0,17136.173268000246,-81.94,2
06:43,264550521.0,8815.543546971812,-56.21,5
06:46,956717493.0,971.0099937283602,-17.44,7
06:46,383833857.0,21270.907559405103,-38.37,7
06:47,994214354.0,8992.101030034895,-17.37,9
06:48,836110591.0,6871.882830304858,-9.26,5
06:49,143003091.0,19710.550736697056,-18.51,7
06:51,549414742.0,7075.751579130465,-25.08,9
06:54,667367404.0,8203.552507994455,-4.0,2
06:57,270374623.0,10025.06835871346,-16.8,2
07:01,758160963.0,7881.064258288993,-21.67,7
07:03,987656636.0,5908.00907202469,-34.88,7
07:05,308505160.0,12192.32134345571,-10.36,2
07:07,788740658.0,3272.190149797002,-24.94,5
07:08,108563213.0,20963.340557549483,-25.96,2
07:11,433917275.0,7687.69068966985,-30.84,9
07:15,585596026.0,-110.07986118874668,-17.55,5
07:18,802697323.0,19236.164547115073,-34.17,9
07:19,885259672.0,4060.2043874585247,-69.65,2
07:19,213112754.0,6874.873141631903,-9.57,8
07:19,859603181.0,4045.34398629789,-14.31,2
07:25,541639148.0,5209.471771082583,-40.89,2
07:25,829914501.0,1901.1508065709736,-5.0,9
07:26,609939116.0,6479.409253875207,-4.56,5
07:26,897714622.0,8646.545088797773,-3.96,7
07:27,647936800.0,1627.208867889992,-22.31,7
07:28,366550080.0,23233.483883463465,-31.77,5
07:30,408057540.0,7300.190945695006,-36.8,7
07:30,822250278.0,6420.620689570882,-19.48,5
07:35,627622066.0,2465.880235693056,-35.34,7
07:37,383625050.0,5851.121114984705,-34.96,5
07:42,433917275.0,7653.599876528835,-34.09,2
07:46,399144202.0,2717.1264112488147,-11.2,2
07:55,885259672.0,4053.854387458525,-6.35,9
07:57,668329719.0,7580.826838600788,-9.54,4
08:00,624500124.0,3489.106799356238,-1.66,7
08:02,146909202.0,5370.197711400969,-7.3,9
08:07,176922958.0,2260.1280547803585,-26.25,8
08:08,305778936.0,11406.666716222526,-3.84,8
08:12,395284483.0,2000.04592440364,-5.8,9
08:12,806358207.0,10919.61416552298,-67.22,2
08:13,336557504.0,1576.9000891085354,-6.15,9
08:14,838830098.0,1504.6570920877846,-7.15,9
08:17,518474507.0,13242.34113928838,-8.78,7
08:20,237493332.0,12959.506215761863,-35.77,2
08:20,399538448.0,7161.452520655866,-5.6,9
08:21,975345315.0,30906.098799999963,-20.29,5
08:22,771125520.0,484.8415499999994,-25.9,5
08:23,690958123.0,17568.73565170255,-60.42,5
08:25,213112754.0,6822.527141631904,-52.35,5
08:25,191161970.0,-3240.816999999997,-90.24,5
08:26,933491926.0,2719.0123000000003,-49.08,5
08:26,916225911.0,-2042.0467500000009,-18.75,5
08:31,986267641.0,5500.260911525436,-2.82,7
08:31,851649498.0,9868.58025108545,-34.76,2
08:31,615144184.0,629.1132491255189,-56.0,5
08:32,290818242.0,6465.010258320581,-70.38,2
08:33,497809732.0,361.75286955259526,-128.18,5
08:33,322221939.0,3737.433803231814,-22.63,7
08:39,287480331.0,11573.907669172588,-5.83,4
08:40,165691047.0,-369.5480000000009,-80.11,5
08:40,237493332.0,12925.486215761865,-34.02,5
08:40,534204159.0,6468.770134462187,-1.71,2
08:41,482513594.0,7744.628161819393,-13.72,5
08:41,583558311.0,358.69278475133194,-54.77,5
08:41,535804582.0,-910.2916000000008,-158.7,5
08:42,331450202.0,6366.116593948073,-30.33,8
08:43,194023154.0,-2281.0396717847343,-58.21,5
08:48,168414279.0,197.23978427492133,-13.19,5
08:50,406772240.0,-1097.8353500000003,-132.03,5
08:52,766941757.0,9223.509242893988,-46.38,9
08:53,815993333.0,568.7402398123937,-95.23,5
08:54,856147482.0,106.91490140137532,-185.06,5
08:55,119943495.0,-1282.4929121128582,-176.08,5
08:59,441274121.0,11620.026945102349,-5.0,9
09:00,549414742.0,7028.655436718619,-47.1,2
09:02,613729471.0,7421.727247106703,-6.8,9
09:05,214339619.0,174.05408704013723,-5.95,9
09:06,822718326.0,9607.206479462708,-24.88,5
09:07,117273481.0,8043.442360178158,-6.05,9
09:10,131388684.0,19639.81772848987,-6.8,9
09:10,497772347.0,940.3591499999984,-71.97,4
09:12,960208650.0,15279.878347414277,-38.81,5
09:12,558875206.0,2426.526950000001,-7.5,9
09:13,618138606.0,1428.146410892108,-6.1,9
09:14,280098744.0,1318.4203778716656,-16.98,4
09:16,690958123.0,17564.03565170255,-4.7,9
09:19,225210798.0,590.7957737592089,-59.98,4
09:20,792845450.0,1044.932150000001,-40.99,2
09:20,909669130.0,209.93788473676665,-27.53,4
09:21,506618547.0,17337.77107172617,-5.5,9
09:21,138609932.0,4317.426003294585,-6.35,9
09:22,540159353.0,9984.21504954912,-5.65,9
09:27,741903302.0,2467.5028979884787,-7.9,9
09:27,175452235.0,2459.5952500000003,-63.17,2
09:28,441142605.0,2567.232250000003,-27.96,7
09:29,630691258.0,282.8265448748414,-52.99,2
09:30,865748375.0,5200.271431193128,-16.29,7
09:32,138351025.0,-432.6496500000002,-61.37,5
09:33,270374623.0,9923.87835871346,-101.19,2
09:41,462962606.0,218.17154999999892,-151.98,2
09:43,819515373.0,2429.6459860637906,-124.99,2
09:43,170637730.0,2814.9967762887104,-5.01,7
09:45,261793952.0,319.2952602038148,-26.0,7
09:47,370521542.0,23226.602534418023,-32.69,2
09:48,654329190.0,51.83980094851936,-25.96,1
09:48,866941383.0,1961.5248500000048,-77.51,5
09:52,310620484.0,774.3767381437228,-21.1,1
09:54,668175891.0,698.7227951930411,-28.0,2
09:56,402438092.0,1171.618899999999,-35.23,2
09:57,355733816.0,4129.758117498155,-35.95,7
09:58,585133606.0,4654.558765314502,-49.99,4
09:58,799453072.0,149.46214999999893,-100.8,2
09:58,737547541.0,341.8765995677742,-96.6,2
09:58,518466565.0,1125.3905499999996,-149.35,5
09:58,856957948.0,8601.236512498259,-9.97,4
10:02,480557476.0,10535.844119863204,-11.11,7
10:03,823208989.0,1796.7068580645025,-67.39,2
10:08,270374623.0,9809.538358713458,-114.34,2
10:08,503575533.0,7197.975100000014,-162.97,2
10:11,895331556.0,-782.0303000000007,-62.06,5
10:12,737547541.0,178.77659956777418,-163.1,2
10:16,647472692.0,22172.63705305797,-157.77,2
10:16,448004226.0,2394.888461930605,-12.99,2
10:17,469330905.0,856.6560680292155,-134.99,2
10:19,282837512.0,13308.416977629971,-5.7,9
10:21,534583529.0,976.2766880547654,-100.12,7
10:25,402438092.0,1080.118899999999,-91.5,2
10:25,137822385.0,3174.736791350627,-6.05,9
10:27,711045550.0,476.231350000003,-181.3,7
10:33,799453072.0,59.862149999998934,-89.6,2
10:36,246753533.0,559.6009999999987,-36.98,4
10:39,652048867.0,-595.7848500000009,-87.4,5
10:39,534583529.0,865.6516880547654,-110.62,7
10:45,402438092.0,968.368899999999,-111.75,2
10:47,737547541.0,168.2905995677742,-10.49,2
10:47,647472692.0,22165.75222741217,-6.88,5
10:48,322221939.0,3715.285563231814,-22.15,4
10:50,194745206.0,136.54037209124317,-20.05,2
10:50,338022396.0,382.0776893757387,-59.99,2
10:51,711045550.0,338.331350000003,-137.9,7
10:52,583558311.0,328.70278475133193,-29.99,2
10:59,688712152.0,5956.60399695747,-39.98,2
11:01,494789005.0,3118.3856919069967,-10.52,4
11:02,598793068.0,504.8492499999984,-5.99,7
11:04,270374623.0,9673.948358713458,-135.59,2
11:05,462962606.0,208.1815499999989,-9.99,1
11:06,779236304.0,559.7048975480859,-29.94,7
11:09,910730524.0,7431.216599402811,-15.69,2
11:11,703537476.0,1445.344249999999,-66.99,2
11:17,570269025.0,2523.9968035754955,-5.99,2
11:18,593378953.0,1046.482700000005,-19.99,2
11:22,402438092.0,867.508899999999,-100.86,2
11:24,849096144.0,1962.7837896445744,-14.98,1
11:25,270374623.0,9663.838358713458,-10.11,7
11:27,737547541.0,94.7905995677742,-73.5,2
11:29,793781222.0,2224.778878947403,-40.99,6
11:44,402438092.0,710.3913999999991,-157.12,2
11:47,604288474.0,3050.234062409581,-10.0,5
11:47,534583529.0,784.2766880547654,-81.38,7
11:54,979892433.0,-1476.3181000000009,-64.05,5
11:59,538003940.0,1866.570000000008,-25.0,2
12:01,348325817.0,10032.941912184097,-13.41,2
12:01,402438092.0,647.3913999999991,-63.0,2
12:02,585133606.0,4649.568765314502,-4.99,1
12:02,298007503.0,727.2081036256334,-21.18,9
12:03,737547541.0,-18.595400432225816,-113.39,2
12:04,475277431.0,57.00313694361956,-7.99,4
12:07,799453072.0,-94.13785000000108,-154.0,2
12:15,433837402.0,-1051.685868464188,-39.08,9
12:16,534583529.0,687.1516880547654,-97.12,4
12:17,621652856.0,1762.4509696105397,-104.6,5
12:31,816685391.0,-640.9088037084264,-19.05,9
12:33,402438092.0,590.781399999999,-56.61,2
12:43,799453072.0,-264.93785000000105,-170.8,2
12:50,762859681.0,-641.4599000000011,-43.06,5
12:50,441142605.0,2561.232250000003,-6.0,4
12:51,749378808.0,5252.103463921563,-31.39,9
12:53,147341222.0,-1331.9135253207955,-72.1,5
12:54,202320275.0,-629.6716000000004,-95.88,5
12:57,215832575.0,-1586.8219637442194,-37.69,5
13:01,340680761.0,-2674.680599999999,-61.11,5
13:03,290751280.0,480.0162966748256,-47.0,5
13:03,287480331.0,11549.507669172588,-24.4,9
13:04,799286313.0,-1289.9365628758617,-134.3,5
13:07,340321732.0,1846.8470500000028,-5.9,9
13:07,598586358.0,-3068.152449999997,-15.04,5
13:08,290751280.0,472.2162966748256,-7.8,9
13:09,688712152.0,5952.25399695747,-4.35,9
13:10,585625048.0,1080.8286190586327,-5.15,9
13:10,402438092.0,565.2888999999991,-25.49,2
13:16,280098744.0,1148.2153778716656,-170.2,5
13:17,849096144.0,1957.1337896445743,-5.65,9
13:19,750094757.0,-2047.8779,-122.13,5
13:22,277562576.0,1075.0585507952724,-5.0,9
13:23,117308635.0,1255.9950896342311,-35.13,2
13:23,673025413.0,2422.800557376699,-99.29,5
13:24,812692024.0,4349.939178787427,-7.5,9
13:24,187111705.0,6167.9055868911355,-6.6,9
13:25,293609137.0,-351.042507425502,-39.88,5
13:37,856461967.0,-267.9546464705075,-57.25,5
13:41,970298834.0,3021.7218610935283,-7.74,5
13:47,601627384.0,4734.364005444282,-25.0,4
13:48,348525881.0,253.5216245949363,-27.96,7
13:56,585133606.0,4617.578765314503,-31.99,2
14:05,596171893.0,-189.0182551744889,-32.95,7
14:17,970298834.0,2865.441861093528,-156.28,2
14:19,938992364.0,226.6336537313996,-89.1,5
14:29,570323670.0,3465.9265658823942,-60.04,2
14:32,412823730.0,-412.42002414951014,-133.74,5
14:36,421881811.0,5596.059386139153,-27.71,2
14:36,270374623.0,9650.688358713458,-13.15,2
15:00,668175891.0,676.2191951930411,-22.5,5
15:23,552980092.0,16.728719119337455,-14.97,4
15:29,192202372.0,477.8984030290111,-1.5,4
15:34,985188462.0,1043.500248711225,-12.18,7
15:38,903953091.0,3416.6907623694674,-101.97,4
15:56,575652395.0,1411.2844197618267,-44.29,8
15:59,503575533.0,7163.025100000014,-34.95,7
16:02,857997794.0,364.3136651508873,-39.0,5
16:11,899742927.0,12863.093589778247,-4.02,7
16:30,350921975.0,-634.3813289261258,-63.92,5
16:34,605116158.0,2441.5639,-27.97,4
16:36,395284483.0,1776.07392440364,-223.97,2
16:38,519935524.0,-47.01731026248106,-34.53,5
16:39,736310094.0,-717.3680240274259,-30.31,5
16:40,885259672.0,3824.254387458525,-229.6,2
16:41,776108637.0,1367.7658023859055,-53.69,5
16:42,252760664.0,5913.234541512378,-100.51,5
16:43,551755686.0,7153.195067377236,-1.5,4
16:45,838830098.0,1487.6770920877846,-16.98,7
16:49,467207141.0,1587.140467048264,-149.86,5
16:49,886921642.0,3487.480030455394,-6.75,5
16:51,587225252.0,9926.387485653113,-1.53,5
16:56,512989907.0,-2137.2469039753664,-24.73,5
16:56,117308635.0,1245.9650896342312,-10.03,2
16:58,348525881.0,151.9116245949363,-101.61,5
16:58,666952234.0,-311.28865187551304,-133.55,5
17:00,583579399.0,753.4124499999991,-5.99,7
17:05,885259672.0,3817.247387458525,-7.01,4
17:09,266777719.0,142.78143378023967,-80.22,2
17:10,395284483.0,1634.04392440364,-142.03,2
17:11,874431242.0,8367.522700347123,-4.29,7
17:16,556992209.0,10612.813736083051,-3.49,4
17:17,653640811.0,15030.183831496504,-31.99,1
17:17,409971170.0,2025.8099303486983,-10.83,5
17:18,183186021.0,-1182.117549999999,-54.7,5
17:18,519935524.0,-116.14731026248106,-69.13,2
17:19,939972497.0,852.7595086000109,-22.98,2
17:19,705848712.0,23315.513941354035,-8.61,8
17:19,104832000.0,-2669.9798589058446,-22.09,5
17:20,624500124.0,3451.3933993562378,-37.71,4
17:20,904154012.0,973.6774581204324,-23.97,7
17:21,433917275.0,7639.309876528835,-14.29,4
17:21,517934629.0,1558.9676787084263,-12.99,2
17:22,660874296.0,1682.3974499608464,-7.98,4
17:24,559995067.0,3758.237781775229,-4.89,5
17:25,822718326.0,9579.641317538031,-27.57,5
17:25,683319988.0,7477.045777799023,-0.83,2
17:26,992204045.0,10748.468814913738,-30.43,5
17:26,851649498.0,9820.28025108545,-48.3,2
17:27,345582855.0,-650.5419471794509,-51.83,5
17:27,832564361.0,14403.8603020201,-21.56,7
17:28,388862238.0,838.3803021097062,-5.99,4
17:29,256002321.0,8029.947716340325,-13.29,5
17:29,355602925.0,1224.9025938274146,-35.95,7
17:29,180616589.0,1709.5036480339538,-26.98,4
17:29,670102069.0,4210.538036698459,-27.76,7
17:30,221868392.0,5099.569687896947,-4.04,7
17:31,420109571.0,1057.1239833420746,-21.98,4
17:31,536924114.0,-827.5571555930961,-105.81,5
17:32,556992209.0,10572.793736083053,-40.02,2
17:33,874431242.0,8092.422700347122,-275.1,2
17:37,331450202.0,6350.946593948073,-15.17,7
17:38,558119802.0,29303.658647956865,-38.82,5
17:38,482513594.0,7667.268161819394,-77.36,2
17:39,609939116.0,6449.299253875207,-30.11,2
17:39,315078351.0,6181.159041965706,-35.1,2
17:40,876890798.0,3594.572570699929,-22.0,2
17:41,586315521.0,10996.5753840047,-76.27,2
17:41,108563213.0,20933.320557549483,-30.02,2
17:41,690523499.0,908.5485999999996,-39.98,4
17:42,939972497.0,820.2695086000109,-32.49,2
17:42,987163717.0,5935.531850000005,-43.8,2
17:43,897592348.0,13179.108990524595,-32.95,7
17:43,297823329.0,549.0824999999992,-106.99,2
17:44,494977194.0,1850.4176205975768,-97.22,5
17:45,489964679.0,21711.40134900186,-214.83,2
17:47,478986718.0,-908.4263000000004,-18.99,9
17:47,237493332.0,12854.566215761864,-70.92,2
17:48,994214354.0,8983.652940034895,-8.45,4
17:48,344219145.0,8497.531996558604,-51.99,2
17:49,880546403.0,-760.7856000000016,-40.88,5
17:49,435984758.0,5231.796655818791,-5.9,2
17:50,423208402.0,2077.5107000000025,-5.5,4
17:50,939972497.0,775.2695086000109,-45.0,2
17:50,252760664.0,5843.194541512378,-70.04,2
17:50,822135975.0,11862.06352558765,-4.95,5
17:52,296770890.0,1988.8880103790832,-140.64,2
17:52,874431242.0,7955.922700347122,-136.5,2
17:52,113747882.0,10855.487335897844,-28.45,7
17:54,846550094.0,1949.9867141437217,-71.48,4
17:55,287230540.0,1113.1227712942114,-21.97,7
17:59,610645022.0,-913.6115626449182,-77.33,5
18:01,395284483.0,1490.59992440364,-143.44,2
18:02,683319988.0,7444.365777799023,-32.68,9
18:03,851649498.0,9701.28025108545,-119.0,2
18:04,912705941.0,16772.22756767764,-52.68,7
18:04,996042490.0,5148.822046170784,-27.55,9
18:04,215404070.0,481.2595891798497,-22.92,9
18:05,510101371.0,12432.251593691492,-28.98,9
18:07,653667523.0,5675.153140353457,-105.99,5
18:07,704517789.0,16151.799981419825,-229.82,5
18:07,558119802.0,28948.758647956864,-354.9,2
18:08,310375875.0,3790.053245715226,-0.36,7
18:09,390747457.0,131.86009999999823,-103.39,5
18:10,668329719.0,7562.934838600788,-17.89,5
18:10,296770890.0,1869.902010379083,-118.99,2
18:12,730002588.0,12615.486931717867,-18.64,2
18:13,939972497.0,679.2795086000109,-95.99,2
18:17,627723633.0,-1327.9772280037628,-32.65,9
18:17,200080192.0,8957.560859308725,-26.43,7
18:21,690958123.0,17542.13565170255,-21.9,9
18:26,940569402.0,6223.011392167185,-23.26,2
18:30,824916823.0,8393.242396921567,-4.05,7
18:33,314980178.0,2592.0518500000044,-36.98,9
18:36,395284483.0,1393.99992440364,-96.6,2
18:39,627622066.0,2430.788185693056,-35.09,5
18:40,491392945.0,4096.621500000006,-43.92,5
18:41,887853850.0,10309.069078729006,-34.73,9
18:41,294474095.0,-2120.91628649924,-26.51,5
18:42,939972497.0,653.7895086000109,-25.49,2
18:44,873693307.0,8358.394914002069,-54.42,5
18:45,138609932.0,4277.506003294585,-39.92,7
18:47,540159353.0,9913.01104954912,-71.2,5
18:49,758160963.0,7839.932258288994,-41.13,5
18:50,264208990.0,845.2411999999991,-44.13,9
18:51,296770890.0,1832.5640103790831,-37.34,5
18:53,851181128.0,4480.056994113557,-31.29,9
18:53,214339619.0,132.08408704013723,-41.97,7
18:55,500043411.0,12655.244413089376,-16.87,4
18:58,527842638.0,1435.3365426329838,-26.98,7
18:58,995615876.0,1555.6559396983887,-38.54,5
18:59,627936697.0,1105.2213499999998,-188.37,5
19:07,180616589.0,1673.6776480339538,-35.83,5
19:07,893134725.0,2040.692762973209,-50.46,5
19:09,346874167.0,278.6850499999992,-29.53,5
19:14,678330503.0,4007.4040358956054,-189.9,5
19:14,473820682.0,10826.928726540007,-91.9,5
19:15,687135796.0,24775.89380209169,-8.24,9
19:15,902798190.0,-914.2926344310264,-82.09,5
19:16,213096759.0,-1306.2321082144394,-81.02,5
19:16,706361191.0,169.86874849407815,-52.85,5
19:16,245690309.0,8413.555927401376,-28.41,8
19:16,954263768.0,-216.22730000000016,-51.55,5
19:18,445240363.0,-835.0819559632736,-87.9,5
19:18,939972497.0,546.3195086000109,-107.47,2
19:20,691843653.0,-2789.513399999995,-7.72,5
19:21,229205098.0,7299.276337397077,-47.45,5
19:22,684988568.0,-727.4645234272015,-35.09,5
19:23,930271460.0,77.35479753577604,-162.85,5
19:24,450896297.0,12572.543483026924,-41.66,5
19:25,414805878.0,13633.94855639314,-5.0,8
19:32,541639148.0,5187.831771082582,-21.64,9
19:33,835736339.0,2528.6107704145597,-16.32,7
19:35,933491926.0,2701.7723000000005,-17.24,9
19:39,175452235.0,2429.16625,-30.43,5
19:40,868377987.0,3092.526369515681,-30.88,9
19:44,833899961.0,2073.878772838991,-42.07,5
19:46,742223719.0,609.7343073048028,-119.8,5
19:49,653640811.0,14836.311831496503,-193.87,5
19:51,129018172.0,7940.667887752608,-213.59,5
19:58,489964679.0,21698.173629783123,-13.23,2
19:59,741269136.0,1003.7509500000004,-63.23,5
20:02,899742927.0,12586.838589778248,-276.25,5
20:02,868014990.0,-2997.206099999997,-46.16,5
20:07,143061865.0,6739.864632703679,-6.52,8
20:08,373875019.0,14087.627402803744,-54.64,4
20:09,215311171.0,6229.680016312963,-103.89,5
20:13,605116158.0,2390.9042,-50.66,5
20:13,336171116.0,-724.2894000000006,-269.44,5
20:17,698076160.0,5646.143096949639,-26.49,2
20:21,633345190.0,7167.494092468024,-23.26,4
20:28,414805878.0,13536.424556393142,-97.52,5
20:44,558119802.0,28923.388647956865,-25.37,9
20:53,461990622.0,9031.619824420532,-8.28,5
20:55,581655972.0,38128.5490938933,-13.7,2
20:58,994214354.0,8967.671593192626,-15.98,2
20:59,949032480.0,5246.149533574954,-9.84,7
21:08,752362502.0,8447.511837246493,-21.08,5
21:09,592961759.0,-1385.2348000000004,-20.7,9
21:11,853907490.0,7080.423355858044,-15.93,9
21:15,985188462.0,1002.7602487112248,-40.74,9
21:53,480198977.0,11282.576297642572,-13.31,7
00:27,337771621.0,-2503.79765,-37.1,9
00:56,678851253.0,3275.212613812216,-7.52,8
01:04,170637730.0,2784.071283121169,-30.93,7
02:58,324224854.0,3993.273275682683,-85.87,7
02:59,973086490.0,9280.128620535908,-15.64,9
03:03,656812046.0,1075.7082274832435,-37.89,5
03:04,572384506.0,9660.53125191391,-31.25,9
03:06,766941757.0,9201.859242893988,-21.65,9
03:21,187541224.0,6694.714493051785,-36.28,9
03:36,949032480.0,5214.219533574954,-31.93,9
03:41,482513594.0,7649.917039322482,-17.35,8
03:41,822250278.0,6376.110080911052,-44.51,2
03:41,853907490.0,7072.578336410489,-7.85,7
03:42,779236304.0,520.8648975480859,-38.84,9
03:44,235881534.0,11484.99009216903,-14.0,2
03:44,744968736.0,-1429.7513265694238,-12.95,9
03:44,730002588.0,12603.352215773322,-12.13,7
03:47,780463728.0,2893.80202094224,-33.08,9
03:47,873693307.0,8353.83190040644,-4.56,7
03:49,950234174.0,1470.1443294280512,-27.84,7
03:55,633345190.0,7155.494092468024,-12.0,9
03:56,749378808.0,5228.663463921564,-23.44,9
03:57,196289502.0,13958.221850042317,-18.9,9
04:02,679662108.0,13780.839910564506,-58.95,7
04:03,473820682.0,10826.701225060253,-0.23,7
04:05,183888402.0,16062.244359271544,-25.48,9
04:09,108563213.0,20927.20434770003,-6.12,7
04:11,973086490.0,9247.11852178771,-33.01,7
04:11,373163757.0,10313.308829235406,-45.64,5
04:12,506618547.0,17323.50708839607,-14.26,7
04:14,441274121.0,11603.97694510235,-16.05,9
04:21,370521542.0,23219.612534418025,-6.99,9
04:24,709608057.0,3490.6975087217374,-36.85,9
04:26,633345190.0,7152.1689162279545,-3.33,8
04:28,270374623.0,9633.44504857783,-17.24,2
04:30,386729293.0,26625.176107076582,-3.73,5
04:34,216285378.0,21356.584315006803,-43.64,9
04:35,203466392.0,2621.895957922328,-6.13,7
04:43,816685391.0,-654.3988037084264,-13.49,9
04:43,678330503.0,3986.019290241827,-21.38,2
04:43,532478725.0,5035.304081219691,-32.42,9
04:43,994214354.0,8922.031593192627,-45.64,9
04:46,705848712.0,23296.31394135403,-19.2,9
04:50,450896297.0,12541.553483026924,-30.99,9
04:51,310375875.0,3786.3226131166616,-3.73,7
04:55,322221939.0,3676.1355632318146,-39.15,9
04:59,832564361.0,14388.427747839512,-15.43,8
05:00,851181128.0,4450.406994113558,-29.65,9
05:01,435984758.0,5226.68118200008,-5.12,5
05:01,460463595.0,-1072.957945418579,-30.67,9
05:01,550169791.0,18645.6130957684,-55.11,7
05:04,370521542.0,23203.31808137921,-16.29,7
05:07,858989281.0,25142.65254588743,-5.75,7
05:08,604288474.0,3043.244062409581,-6.99,9
05:12,471897866.0,7875.7764272757295,-23.9,7
05:13,812692024.0,4343.939178787427,-6.0,9
05:13,700138124.0,5403.4073000000035,-9.99,9
05:14,480557476.0,10515.36374404832,-20.48,4
05:15,887853850.0,10289.797002769985,-19.27,2
05:15,252760664.0,5827.90503200611,-15.29,5
05:17,414805878.0,13497.274556393142,-39.15,9
05:19,785749304.0,8194.998849619995,-13.56,7
05:20,259015404.0,4382.431190202151,-0.17,2
05:22,687135796.0,24765.90380209169,-9.99,9
05:23,518474507.0,13204.07113928838,-38.27,9
05:29,179173981.0,6458.452456211111,-24.2,9
05:29,519644021.0,2388.0571198931666,-9.3,2
05:30,639409800.0,30873.84007900004,-41.5,8
05:32,854895960.0,2675.1138084062472,-11.76,2
05:41,549414742.0,6988.4654367186195,-40.19,9
05:45,169006407.0,11325.091719531269,-25.11,2
05:45,146909202.0,5357.395598134244,-12.8,5
05:47,749378808.0,5227.847457973349,-0.82,2
05:50,414805878.0,13441.053930259775,-56.22,2
05:51,903663593.0,595.995318582982,-25.7,2
05:56,779236304.0,515.7272470736772,-5.14,5
05:56,305778936.0,11332.326425754216,-74.34,2
05:57,331450202.0,6343.439598648664,-7.51,5
05:58,176922958.0,2239.7607669481786,-20.37,2
05:58,450896297.0,12463.86954634179,-77.68,7
06:02,899742927.0,12556.839458703796,-30.0,7
06:04,547010927.0,21722.28569077429,-56.89,5
06:04,117308635.0,1240.51672133905,-5.45,8
06:06,581655972.0,38109.45657054024,-19.09,2
06:09,776431321.0,2992.9237983243374,-16.68,5
06:09,399144202.0,2687.496411248814,-29.63,9
06:10,609939116.0,6442.993961593035,-6.31,7
06:10,558119802.0,28912.60813783192,-10.78,2
06:11,675806859.0,6311.654625349926,-11.03,7
06:12,549414742.0,6982.286079565263,-6.18,7
06:12,949032480.0,5210.491130211993,-3.73,8
06:16,256002321.0,8019.397716340325,-10.55,9
06:19,245690309.0,8361.00215838703,-52.55,7
06:20,200080192.0,8950.603194923038,-6.96,4
06:21,703478110.0,4057.300288630169,-16.69,2
06:22,322221939.0,3664.651230368628,-11.48,8
06:24,809499628.0,14877.972474379176,-13.45,9
06:25,706250160.0,10615.14011310154,-20.39,5
06:26,124102251.0,4407.052776583642,-3.29,8
06:30,541639148.0,5181.64911749357,-6.18,5
06:31,802697323.0,19202.934547115074,-33.23,9
06:33,779946617.0,15216.056229168224,-8.28,5
06:35,647936800.0,1601.728867889992,-25.48,9
06:36,417850087.0,15383.436343927804,-5.49,5
06:36,191161970.0,-3261.6669999999967,-20.85,9
06:38,290818242.0,6443.717377042793,-21.29,2
06:40,719586818.0,17094.40972205802,-41.76,8
06:41,776108637.0,1340.5466536574957,-27.22,7
06:43,383833857.0,21244.630810779887,-26.28,2
06:44,287480331.0,11544.163907287768,-5.34,7
06:45,264550521.0,8789.264320652957,-26.28,2
06:49,237684254.0,5521.264616752322,-73.07,5
06:49,866941383.0,1932.8348500000047,-28.69,9
06:50,421881811.0,5588.686132534509,-7.37,5
06:54,994214354.0,8868.942293510183,-53.09,2
06:58,815385232.0,9197.601148107377,-3.39,2
06:58,758160963.0,7808.767392756351,-31.16,8
07:01,613729471.0,7409.120304278765,-12.61,2
07:01,842682241.0,7103.228467598478,-0.31,5
07:03,687135796.0,24755.79146690671,-10.11,7
07:17,145387690.0,5265.246362476587,-36.44,9
07:20,930277104.0,9965.56443829672,-34.99,9
07:26,522188082.0,7441.647228455307,-8.26,5
07:27,683319988.0,7401.025777799023,-43.34,9
07:29,985188462.0,959.4302487112246,-43.33,9
07:30,836110591.0,6842.101893154528,-29.78,5
07:33,718058208.0,1876.3726422239797,-3.91,5
07:36,897714622.0,8583.121125638563,-63.42,2
07:38,806358207.0,10902.80634994196,-16.81,4
07:49,520447032.0,8500.891558515794,-28.24,9
07:56,668329719.0,7556.567515240163,-6.37,7
07:59,795847804.0,20298.173809224536,-62.19,5
08:00,383625050.0,5820.369780870858,-30.75,5
08:02,823208989.0,1728.477512840257,-68.23,7
08:02,948558249.0,8459.922015959808,-6.2,9
08:04,399538448.0,7156.352520655865,-5.1,9
08:06,195895574.0,6649.206283355909,-21.9,9
08:06,467207141.0,1581.340467048264,-5.8,9
08:10,308505160.0,12172.120371405514,-20.2,8
08:17,213112754.0,6798.705619107759,-23.82,5
08:18,930277104.0,9909.586006222878,-55.98,8
08:20,520447032.0,8467.298057345204,-33.59,2
08:22,493640090.0,-2264.88095,-17.29,5
08:22,786879739.0,-2054.0657941205577,-37.94,5
08:24,146686559.0,-517.9879111734776,-43.32,5
08:26,641376155.0,-743.6974878985488,-62.12,5
08:28,455831435.0,-1580.4992048014944,-148.15,5
08:28,308897841.0,1105.996299999999,-52.24,5
08:28,241459011.0,788.8460132723471,-17.94,5
08:31,511179916.0,7405.359237409635,-38.41,7
08:31,197865285.0,343.97421173122046,-106.53,5
08:31,647936800.0,1536.6982825035252,-65.03,5
08:33,704517789.0,16147.803639790049,-4.0,8
08:36,472995101.0,1906.7788738883296,-88.34,5
08:36,824916823.0,8354.704000199652,-38.54,5
08:37,262767079.0,-1006.1325000000004,-104.22,5
08:38,310171581.0,-1961.27370434092,-31.45,5
08:40,108481285.0,8224.652337993475,-3.23,7
08:40,482513594.0,7608.939039322482,-40.98,5
08:42,722971557.0,-388.0482791569244,-43.51,5
08:42,229205098.0,7292.933721490069,-6.34,5
08:45,651756497.0,12876.671290150278,-28.17,2
08:48,494156986.0,-294.07565432766495,-67.34,5
08:48,215426302.0,-149.7615959743083,-30.2,5
08:49,690958123.0,17509.08972829008,-33.05,5
08:50,762896656.0,-477.9325018481414,-9.98,5
08:53,990894155.0,-237.67354132115844,-15.52,5
08:53,618138606.0,1393.094260892108,-35.05,5
08:55,500043411.0,12603.13124421663,-52.11,7
08:55,344219145.0,8383.781996558604,-113.75,5
08:57,122884111.0,-1167.73358307297,-61.9,5
09:04,945054126.0,-982.4319000000002,-34.24,5
09:05,613729471.0,7403.620304278765,-5.5,9
09:06,383833857.0,21239.230810779885,-5.4,9
09:07,285115279.0,-2750.0849107892877,-140.75,5
09:07,143061865.0,6702.372632703678,-37.49,5
09:07,570269025.0,2495.1491035754957,-28.85,5
09:09,657528784.0,50.98190000000065,-87.49,5
09:11,844835978.0,9578.30304310472,-55.38,5
09:11,558119802.0,28829.68231783192,-82.93,7
09:13,876890798.0,3362.6025706999294,-231.97,2
09:14,604334058.0,142.25789999999947,-56.98,4
09:16,285428103.0,8483.803950465586,-89.98,5
09:16,853907490.0,7032.008336410489,-40.57,2
09:16,358836279.0,324.588942807586,-81.95,5
09:16,187111705.0,6074.623586891135,-93.28,5
09:16,425964226.0,3396.3576500000017,-32.86,7
09:18,986774156.0,985.9949316257678,-20.97,7
09:19,322221939.0,3653.631230368628,-11.02,1
09:19,441274121.0,11559.186065102347,-44.79,4
09:19,187111705.0,6045.641377616281,-28.98,4
09:20,552980092.0,10.738719119337455,-5.99,2
09:20,282046994.0,-292.4006499999996,-43.87,5
09:21,741903302.0,2462.152897988479,-5.35,9
09:21,499244466.0,-209.980581283422,-79.32,5
09:22,187541224.0,6655.9344930517855,-38.78,7
09:22,626989363.0,368.5533133173756,-31.99,2
09:22,829914501.0,1886.1708065709736,-14.98,7
09:22,374994043.0,-2037.5030500000007,-27.29,5
09:23,699997811.0,1126.2541500000034,-28.0,2
09:24,242218612.0,1187.4838000000009,-9.99,2
09:25,639409800.0,30868.830079000043,-5.01,7
09:26,472995101.0,1834.7888738883296,-71.99,2
09:27,216285378.0,21267.084315006803,-89.5,2
09:28,176922958.0,2177.6217669481784,-62.14,5
09:29,769311479.0,6696.266895683574,-3.62,2
09:31,366550080.0,23194.577883463466,-38.91,5
09:32,871866387.0,-773.8670000000006,-54.13,5
09:33,245690309.0,8322.347368387029,-38.65,4
09:33,277562576.0,967.0810507952724,-107.98,2
09:33,506618547.0,17297.33708839607,-26.17,7
09:34,259015404.0,4280.931190202151,-101.5,2
09:35,822718326.0,9554.681317538032,-24.96,7
09:36,628470485.0,802.2260299001231,-19.98,1
09:37,215311171.0,6069.700016312963,-159.98,2
09:38,435984758.0,5176.491002000081,-50.19,4
09:39,373163757.0,10275.318829235406,-37.99,1
09:39,699997811.0,1119.2641500000034,-6.99,7
09:41,933491926.0,2689.7923000000005,-11.98,7
09:43,518466565.0,855.1905499999996,-270.2,2
09:44,822135975.0,11834.891491572756,-27.17,2
09:45,500051919.0,199.29049665059048,-35.0,2
09:47,856957948.0,8588.736512498259,-12.5,4
09:47,683319988.0,7358.79105703117,-42.23,7
09:48,454129843.0,1596.3280487975244,-75.57,2
09:48,478412511.0,360.9679201974607,-272.08,5
09:48,776108637.0,1134.7746536574955,-205.77,2
09:48,179173981.0,6405.952456211111,-52.5,2
09:49,660561861.0,-285.5271638396998,-34.34,5
09:49,678330503.0,3902.019290241827,-84.0,2
09:50,517190750.0,1725.9310899154125,-34.02,2
09:50,259015404.0,4070.931190202151,-210.0,2
09:50,618138606.0,1289.094260892108,-104.0,2
09:51,277562576.0,937.1035507952724,-29.98,2
09:51,835736339.0,2504.94377041456,-23.67,5
09:52,373163757.0,10235.258809235404,-40.06,4
09:52,473820682.0,10745.274925060254,-81.43,4
09:52,785210466.0,1995.1073016744497,-32.96,7
09:54,836110591.0,6499.0518931545275,-33.05,7
09:55,417850087.0,15339.396343927803,-44.04,4
09:57,196289502.0,13778.335850042316,-179.89,2
09:57,912705941.0,16765.72160164559,-6.51,2
09:58,221868392.0,5048.95764695845,-50.61,7
09:58,419550103.0,17150.56163461352,-14.99,4
09:58,108931112.0,12920.809137426308,-52.42,4
09:59,366550080.0,23193.34807639136,-1.23,4
09:59,637649383.0,462.1274499999984,-53.99,2
10:01,743630833.0,254.5679132847012,-58.92,7
10:02,419550103.0,17150.109560452358,-0.45,8
10:03,678330503.0,3740.129290241828,-161.89,2
10:04,616924659.0,225.90957982308544,-99.38,2
10:04,279149837.0,1020.123049999999,-118.3,2
10:05,497809732.0,591.7728695525952,-79.98,4
10:05,574548998.0,503.6287499999992,-6.99,1
10:06,812692024.0,4326.959178787428,-16.98,4
10:06,924045955.0,-28.6249873413354,-25.45,5
10:06,806358207.0,10881.68094994196,-21.13,4
10:06,675231808.0,14424.261086489185,-19.96,4
10:06,873693307.0,8334.60190040644,-19.23,2
10:07,514362267.0,245.0716691070604,-17.62,7
10:07,553734946.0,472.86599999999896,-24.96,7
10:09,518466565.0,559.7905499999996,-295.4,2
10:12,776108637.0,1056.4026536574956,-78.37,2
10:12,152616936.0,1121.5160078630647,-162.37,2
10:13,558875206.0,2389.566950000001,-36.96,7
10:13,134461671.0,8015.041935517218,-2.4,5
10:15,454356905.0,2489.5834603727517,-10.15,4
10:16,454356905.0,2486.158270191771,-3.43,7
10:18,618138606.0,1259.104260892108,-29.99,2
10:18,179173981.0,6123.152456211111,-282.8,2
10:20,454129843.0,1519.3280487975244,-77.0,2
10:21,986267641.0,5485.2709115254365,-14.99,4
10:23,259015404.0,3990.431190202151,-80.5,2
10:23,639549973.0,6907.945946209534,-12.0,7
10:25,835736339.0,2463.3822504145596,-41.56,4
10:25,514362267.0,145.3291691070604,-99.74,4
10:25,282837512.0,13150.916977629971,-157.5,2
10:25,818552503.0,-282.60365000000115,-145.81,5
10:26,152616936.0,943.7580078630648,-177.76,2
10:26,279149837.0,922.123049999999,-98.0,2
10:27,472995101.0,1819.7988738883296,-14.99,4
10:29,672913754.0,9315.203776019544,-15.98,7
10:31,793781222.0,2158.298878947403,-66.48,4
10:31,874431242.0,7949.072091919514,-6.85,5
10:32,678330503.0,3546.929290241828,-193.2,2
10:32,220183538.0,749.4065499999996,-4.99,4
10:36,859603181.0,3935.78698629789,-109.56,5
10:37,143061865.0,6679.402632703678,-22.97,7
10:39,975345315.0,30856.10879999996,-49.99,4
10:40,340321732.0,1782.3470500000028,-64.5,2
10:40,108931112.0,12773.347137426308,-147.46,5
10:41,279149837.0,845.123049999999,-77.0,2
10:41,851649498.0,9666.460028516629,-34.82,5
10:41,503575533.0,7113.035100000015,-49.99,2
10:42,454129843.0,1450.0280487975244,-69.3,2
10:46,556631012.0,370.6350730856783,-54.97,2
10:47,259015404.0,3874.931190202151,-115.5,2
10:52,656812046.0,1069.6982274832435,-6.01,2
10:52,618138606.0,1206.114260892108,-52.99,2
10:53,767447966.0,4806.100925512111,-31.6,4
10:54,534325901.0,6443.153129737418,-20.72,4
10:56,585625048.0,1046.8386190586327,-33.99,2
10:57,143061865.0,6627.825016898004,-51.58,2
10:58,705848712.0,23296.18685795136,-0.13,2
11:00,618138606.0,1188.134260892108,-17.98,2
11:00,290751280.0,340.2162966748256,-132.0,2
11:03,214339619.0,52.6479508683564,-79.44,7
11:03,425964226.0,3248.6856500000017,-147.67,2
11:04,514362267.0,80.46916910706042,-64.86,2
11:04,264208990.0,823.7511999999991,-21.49,4
11:06,836110591.0,6488.731893154528,-10.32,4
11:07,678330503.0,3349.529290241828,-197.4,2
11:08,405945930.0,4275.6852431977295,-25.97,1
11:09,699139822.0,2527.0843538195945,-36.7,7
11:09,795847804.0,20284.964809224537,-13.21,5
11:10,767447966.0,4582.800925512111,-223.3,2
11:12,454129843.0,1371.6700487975245,-78.36,2
11:12,340321732.0,1618.8470500000028,-163.5,2
11:12,184430449.0,2493.6024761940475,-75.55,5
11:13,971010829.0,509.5812564442454,-28.96,1
11:14,407574996.0,3675.666058383695,-28.06,1
11:15,887853850.0,10284.647002769983,-5.15,7
11:16,259015404.0,3748.931190202151,-126.0,2
11:17,891716230.0,229.58929807062057,-79.98,2
11:17,279149837.0,813.623049999999,-31.5,2
11:17,405416860.0,1619.025753863785,-112.98,2
11:18,667367404.0,8202.009707994455,-1.54,4
11:18,344219145.0,8342.046922857047,-41.74,7
11:20,834581602.0,412.50589999999943,-5.99,2
11:21,184430449.0,2464.6524761940477,-28.95,7
11:22,348325817.0,9918.841912184094,-114.1,2
11:24,425964226.0,3133.2136500000015,-115.47,2
11:25,776108637.0,833.1446536574956,-223.26,2
11:27,407574996.0,3620.97492731128,-54.69,2
11:30,475277431.0,39.00313694361956,-18.0,4
11:30,454129843.0,1335.2700487975244,-36.4,2
11:30,618138606.0,1109.134260892108,-79.0,2
11:32,767447966.0,4341.300925512111,-241.5,2
11:34,704517789.0,15927.303639790049,-220.5,2
11:37,583558311.0,259.4027847513319,-69.3,2
11:37,270374623.0,9627.875048577833,-5.57,4
11:39,514362267.0,21.976669107060417,-58.49,2
11:40,647936800.0,1520.6682825035252,-16.03,7
11:41,250895529.0,1855.161432469287,-54.97,2
11:41,698955014.0,1000.698454940912,-166.68,5
11:47,802697323.0,19094.389407115075,-108.55,4
11:47,290751280.0,226.21629667482563,-114.0,2
11:48,348325817.0,9769.741912184094,-149.1,2
11:49,473820682.0,10709.974925060254,-35.3,2
11:50,518466565.0,307.0905499999996,-252.7,2
11:50,618138606.0,1083.154260892108,-25.98,2
11:51,767447966.0,4258.70092551211,-82.6,2
11:53,704517789.0,15724.303639790049,-203.0,2
11:53,425964226.0,2998.1276500000017,-135.09,2
11:53,277562576.0,785.7362507952724,-151.37,5
11:54,532478725.0,5005.017529004443,-30.29,2
11:55,385685918.0,-223.51005915844755,-203.0,2
11:56,866941383.0,1925.8448500000047,-6.99,4
11:57,583558311.0,158.64478475133194,-100.76,2
12:01,534325901.0,6440.943250425789,-2.21,2
12:02,442070890.0,593.2994624443711,-44.99,2
12:02,364357875.0,6362.237405888494,-10.51,2
12:02,903953091.0,3187.1187623694673,-229.57,2
12:02,675231808.0,14302.271086489183,-121.99,2
12:04,518466565.0,35.490549999999644,-271.6,2
12:05,290751280.0,161.71629667482563,-64.5,2
12:05,776108637.0,694.5866536574956,-138.56,2
12:06,832564361.0,14374.977747839512,-13.45,9
12:07,704517789.0,15542.303639790049,-182.0,2
12:07,497809732.0,585.7828695525952,-5.99,2
12:11,604288474.0,3038.562571331711,-4.68,8
12:11,520447032.0,8465.269967345204,-2.03,4
12:12,196289502.0,13756.005850042317,-22.33,4
12:17,315546581.0,24330.21203816197,-7.97,4
12:17,282837512.0,12924.116977629972,-226.8,2
12:18,836110591.0,6453.501893154528,-35.23,9
12:18,534204159.0,6460.737686671421,-8.03,4
12:19,124102251.0,4377.112776583643,-29.94,4
12:19,629078930.0,1524.7150337040148,-37.99,2
12:19,277562576.0,650.7362507952724,-135.0,2
12:21,633345190.0,7116.848916227955,-35.32,1
12:21,385685918.0,-305.0100591584476,-81.5,2
12:25,250895529.0,1725.187182469287,-129.97,5
12:28,510101371.0,12391.321593691491,-40.93,9
12:29,979892433.0,-1491.3081000000009,-14.99,9
12:32,454356905.0,2451.708270191771,-34.45,9
12:33,277562576.0,594.4937507952725,-56.24,2
12:35,471897866.0,7833.6784272757295,-42.1,5
12:37,385685918.0,-359.5100591584476,-54.5,2
12:37,538003940.0,1728.600000000008,-137.97,2
12:40,496395938.0,11818.303231663607,-10.45,5
12:41,704517789.0,15330.203639790048,-212.1,2
12:44,340321732.0,1566.3470500000028,-52.5,2
12:44,905860285.0,15401.216475564528,-43.18,7
12:45,282837512.0,12705.016977629972,-219.1,2
12:45,194745206.0,69.36037209124316,-67.18,2
12:48,907987693.0,-2267.0569999999993,-28.1,5
12:50,534097839.0,-4105.553549999998,-16.33,5
12:51,298007503.0,676.2411036256334,-50.97,5
12:52,261793952.0,174.1752602038148,-145.12,2
12:52,282837512.0,12523.016977629972,-182.0,2
12:53,299871610.0,657.3931530587668,-51.01,5
12:55,657139925.0,12021.384305719625,-17.24,9
12:55,616924659.0,159.53457982308544,-66.38,2
12:56,454129843.0,1256.9120487975244,-78.36,2
13:01,421881811.0,5576.556132534509,-12.13,4
13:01,385685918.0,-464.5100591584476,-105.0,2
13:03,187111705.0,6038.341377616281,-7.3,9
13:05,767447966.0,4031.20092551211,-227.5,2
13:05,585625048.0,1041.4386190586326,-5.4,9
13:06,256045540.0,-3080.4263999999994,-32.21,5
13:06,340321732.0,1471.3470500000028,-95.0,2
13:06,348325817.0,9463.841912184094,-305.9,2
13:07,248625662.0,-1761.7944157151476,-36.64,5
13:09,987229118.0,3919.593335083234,-25.0,2
13:09,385685918.0,-591.5100591584476,-127.0,2
13:12,152616936.0,847.9000078630647,-95.86,2
13:13,282837512.0,12421.516977629972,-101.5,2
13:14,282837512.0,12394.046977629972,-27.47,9
13:16,624500124.0,3384.8793993562376,-66.51,5
13:16,903953091.0,3108.7327623694673,-78.39,2
13:17,405945930.0,4220.69524319773,-54.99,2
13:17,291580432.0,-791.8235999999997,-38.88,9
13:17,616924659.0,99.53457982308544,-60.0,2
13:21,993039226.0,-3804.219499999995,-38.18,5
13:23,240643705.0,119.16194112061554,-18.48,7
13:23,340321732.0,1240.3470500000028,-231.0,2
13:26,152616936.0,752.0280078630648,-95.87,2
13:26,964913066.0,-2079.2597000000005,-22.32,5
13:30,454129843.0,1138.6260487975244,-118.29,2
13:31,385685918.0,-741.0100591584476,-149.5,2
13:32,514362267.0,-75.14833089293958,-97.12,7
13:32,760704118.0,1368.6083127174886,-91.8,5
13:36,916225911.0,-2067.986750000001,-25.94,9
13:41,442070890.0,573.3294624443711,-19.97,1
13:41,971010829.0,497.5812564442454,-12.0,4
13:44,601627384.0,4710.944005444282,-23.42,2
13:47,586315521.0,10973.9253840047,-22.65,1
13:47,713641917.0,950.2954404874208,-54.99,2
13:48,749378808.0,5221.847457973349,-6.0,9
13:48,678330503.0,3136.7292902418276,-212.8,2
13:50,487051121.0,395.2516399891073,-52.61,5
13:50,867987292.0,4299.576806142828,-48.04,2
13:51,215404070.0,468.2695891798497,-12.99,2
13:51,385685918.0,-1004.0100591584476,-263.0,2
13:52,454129843.0,1119.7400487975244,-18.89,2
13:53,152616936.0,544.1280078630648,-207.9,2
13:55,514362267.0,-161.39083089293956,-86.24,4
13:57,414454079.0,-435.7831499999981,-279.03,5
14:02,726913482.0,-934.012098526476,-99.25,5
14:03,349614277.0,871.5792499999995,-75.27,5
14:04,490790931.0,241.81234999999876,-125.57,5
14:06,282837512.0,12275.746977629971,-118.3,2
14:09,290751280.0,32.71629667482563,-129.0,2
14:11,454129843.0,1009.1540487975244,-110.59,2
14:12,678330503.0,2822.4292902418274,-314.3,2
14:14,514362267.0,-207.89083089293956,-46.5,2
14:24,616924659.0,-62.46542017691456,-162.0,2
14:24,583558311.0,-22.62721524866808,-181.27,2
14:27,578131296.0,556.9535694440439,-104.26,5
14:27,538003940.0,1704.6300000000078,-23.97,4
14:27,454129843.0,819.4680487975244,-189.69,2
14:28,385685918.0,-1216.5100591584476,-212.5,2
14:29,678330503.0,2647.4292902418274,-175.0,2
14:30,290751280.0,-156.28370332517437,-189.0,2
14:40,235663459.0,-148.55307018798484,-53.36,5
14:43,583558311.0,-196.22721524866807,-173.6,2
14:50,514362267.0,-262.2508308929396,-54.36,2
14:58,903953091.0,2956.1327623694674,-152.6,2
15:06,315546581.0,24313.875565142283,-16.34,7
15:15,152616936.0,493.7420078630648,-50.39,2
15:18,618138606.0,963.654260892108,-119.5,2
15:18,583558311.0,-315.88521524866803,-119.66,2
15:24,741269136.0,981.7909500000004,-21.96,7
15:33,121113546.0,86.00015606986972,-92.11,5
15:34,611143859.0,5422.69640000001,-128.54,5
15:42,583558311.0,-420.171215248668,-104.29,2
15:51,581655972.0,38070.506570540245,-38.95,7
15:52,489964679.0,21677.99106605324,-20.18,7
15:53,833499132.0,2218.64735,-31.08,5
16:13,510101371.0,12380.811593691493,-10.51,4
16:14,903953091.0,2722.332762369467,-233.8,2
16:20,489964679.0,21671.47231605324,-6.52,4
16:20,678330503.0,2550.129290241827,-97.3,2
16:20,738958551.0,8113.751894982234,-0.67,5
16:25,514362267.0,-303.8608308929396,-41.61,7
16:34,670102069.0,4028.5660366984594,-181.97,2
16:35,143003091.0,19703.71704236508,-6.83,8
16:41,198946608.0,5704.886168621017,-50.09,2
16:42,903953091.0,2483.646762369467,-238.69,2
16:48,187541224.0,6579.51255922144,-76.42,5
16:49,514362267.0,-408.1033308929396,-104.24,4
16:50,678330503.0,2312.829290241827,-237.3,2
16:55,170233640.0,-1058.1142100501029,-79.92,5
16:58,272538745.0,13070.039900000022,-44.59,9
17:01,200080192.0,8904.879194923038,-45.72,5
17:04,152488934.0,980.7508573137306,-88.99,2
17:05,670102069.0,3901.208036698459,-127.36,2
17:07,280098744.0,1135.2353778716656,-12.98,4
17:14,678330503.0,2127.329290241827,-185.5,2
17:22,514362267.0,-502.9783308929396,-94.88,2
17:25,198946608.0,5591.759168621016,-113.13,5
17:26,444428189.0,1179.7528000000027,-108.01,5
17:33,766812921.0,-270.3969000000007,-261.86,5
17:34,912584712.0,507.680619544733,-73.19,5
17:39,670102069.0,3782.922036698459,-118.29,2
17:39,678330503.0,2040.529290241827,-86.8,2
17:44,514362267.0,-576.0958308929396,-73.12,2
17:49,583558311.0,-591.6432152486681,-171.47,2
17:51,399144202.0,2635.2191092121975,-52.28,2
17:52,106601471.0,8958.268543012839,-11.94,2
18:04,361201224.0,6472.6042320678935,-37.83,9
18:04,736340277.0,7679.162499265831,-19.7,9
18:07,345582855.0,-661.0319471794509,-10.49,9
18:09,514362267.0,-616.9708308929396,-40.88,2
18:10,436430134.0,-425.44390133718167,-19.44,9
18:10,690523499.0,903.0485999999996,-5.5,7
18:10,399538448.0,7142.182712652365,-14.17,7
18:12,670102069.0,3677.236036698459,-105.69,2
18:14,518466565.0,-94.00945000000036,-129.5,2
18:21,509627909.0,200.68464999999907,-29.44,9
18:22,587225252.0,9889.947485653112,-36.44,9
18:23,583558311.0,-776.443215248668,-184.8,2
18:26,479456865.0,1129.7639814894048,-5.5,7
18:28,788740658.0,3266.2940296683705,-5.9,7
18:29,859603181.0,3916.5736457190274,-19.21,2
18:35,176922958.0,2142.9717669481784,-34.65,9
18:39,785749304.0,8173.848849619995,-21.15,9
18:41,558119802.0,28802.53231783192,-27.15,9
18:42,820686957.0,-665.1862163111958,-51.99,5
18:43,344219145.0,8331.066922857048,-10.98,9
18:45,198946608.0,5580.214971382752,-11.54,7
18:54,886921642.0,3425.5406726540004,-61.94,2
18:59,955035930.0,883.3484791714773,-34.98,7
19:00,383833857.0,21150.526810779884,-88.7,5
19:02,195895574.0,6619.4062207154975,-29.8,7
19:02,903468956.0,-232.44270000000057,-68.55,5
19:03,621181115.0,-446.8522495707712,-148.95,5
19:05,845648250.0,244.39984999999945,-73.54,5
19:06,145553416.0,-2448.8831499999997,-56.98,5
19:07,709608057.0,3450.7306242700733,-39.97,8
19:10,409370545.0,269.58177554552014,-43.09,5
19:20,352291960.0,2138.6424033035737,-73.7,5
19:27,995615876.0,1503.6662396983886,-51.99,5
19:31,535744551.0,1132.1600159956265,-147.03,5
19:48,461029994.0,6028.12908234387,-61.1,5
19:55,660789920.0,-2267.0183473823727,-37.83,5
19:56,867987292.0,4198.377806142828,-101.2,5
19:57,128033695.0,3026.3166828374888,-38.64,9
19:59,180616589.0,1617.145648033954,-56.53,5
20:09,691789577.0,-477.486,-222.66,5
20:17,137913631.0,684.7287499999994,-74.15,5
20:20,984783496.0,12891.65106216057,-14.59,9
20:28,128033695.0,3023.4402773302427,-2.88,2
20:40,163470640.0,775.3707999999999,-41.62,5
20:49,556992209.0,10518.669736083051,-54.12,5
20:58,696333897.0,693.0755999999992,-48.0,5
21:15,305778936.0,11301.646425754216,-30.68,9
00:11,421881811.0,5564.741913960589,-11.81,2
00:11,833899961.0,2041.198772838991,-32.68,9
00:12,802697323.0,19057.199407115077,-37.19,9
00:15,987656636.0,5887.834428572545,-20.17,7
00:18,873693307.0,8280.373960967743,-54.23,7
00:20,471897866.0,7791.627713160076,-42.05,5
00:20,113747882.0,10833.7244367687,-21.76,7
00:26,471897866.0,7775.577713160076,-16.05,9
00:29,940569402.0,6206.121392167184,-16.89,9
00:36,473820682.0,10692.13691954076,-17.84,7
00:38,534204159.0,6460.526371678398,-0.21,8
00:45,795847804.0,20283.943858832397,-1.02,8
00:45,651756497.0,12868.920583624038,-7.75,4
00:47,704517789.0,15261.78972976882,-68.41,7
00:48,324224854.0,3984.3039272534943,-8.97,7
00:52,656812046.0,1048.830976883317,-20.87,2
01:06,264550521.0,8769.285566333161,-19.98,5
01:08,815385232.0,9187.261449469486,-10.34,2
01:18,905860285.0,15390.08150507356,-11.13,4
01:33,853907490.0,7017.658336410489,-14.35,9
01:36,490790931.0,205.18234999999876,-36.63,9
01:38,633345190.0,7085.308916227955,-31.54,9
01:41,858989281.0,25135.26254588743,-7.39,9
01:42,310620484.0,730.4867381437228,-33.89,9
01:42,822135975.0,11834.013218231465,-0.88,5
01:53,450896297.0,12456.859228685053,-7.01,7
02:01,541639148.0,5130.6966528771445,-50.95,7
02:12,237493332.0,12831.376215761862,-23.19,9
02:30,532478725.0,4975.947529004443,-29.07,9
02:36,647936800.0,1498.3387068580796,-22.33,8
02:36,348325817.0,9427.721912184094,-36.12,9
02:40,435984758.0,5133.52733690231,-42.96,7
02:41,216285378.0,21232.414315006805,-34.67,9
02:50,586315521.0,10953.163794337315,-20.76,7
02:51,851181128.0,4419.826994113558,-30.58,9
02:52,349614277.0,833.4492499999996,-38.13,9
02:54,417850087.0,15338.206835280458,-1.19,7
02:56,779236304.0,493.2372470736772,-22.49,9
02:58,290818242.0,6424.911979288464,-18.81,2
03:00,187541224.0,6540.13255922144,-39.38,9
03:03,836110591.0,6447.614702612228,-5.89,5
03:07,348325817.0,9411.44773281886,-16.27,5
03:07,940569402.0,6181.11123588337,-25.01,7
03:11,522188082.0,7421.702039397825,-19.95,5
03:12,655368335.0,4699.277797514056,-3.32,2
03:14,885259672.0,3737.4270861624095,-17.53,5
03:18,887853850.0,10219.748812404086,-64.9,2
03:19,546296727.0,-337.3549226973814,-35.0,9
03:24,572384506.0,9624.59412591602,-35.94,7
03:27,779236304.0,429.6154732989362,-63.62,5
03:29,322221939.0,3632.247788774981,-21.38,2
03:29,229205098.0,7289.909053447312,-3.02,2
03:31,383833857.0,21139.576810779883,-10.95,9
03:47,809499628.0,14858.022474379177,-19.95,9
03:48,256002321.0,8004.017716340325,-15.38,9
03:52,270374623.0,9614.127519584154,-13.75,2
03:56,683319988.0,7322.04105703117,-36.75,9
03:56,919185264.0,3872.405527740503,-11.4,2
03:58,899742927.0,12545.468181351938,-11.37,2
03:59,851181128.0,4419.031087266787,-0.8,7
04:06,252760664.0,5823.154705919531,-4.75,2
04:09,399144202.0,2611.3291092121976,-23.89,9
04:10,506618547.0,17253.973583470022,-43.36,5
04:12,383833857.0,21129.943656502594,-9.63,8
04:16,146909202.0,5352.34427660048,-5.05,8
04:19,256002321.0,7997.98432196028,-6.03,7
04:21,169006407.0,11281.543018048576,-43.55,2
04:22,730002588.0,12554.941309284928,-48.41,5
04:23,496395938.0,11765.840930307262,-52.46,4
04:26,874431242.0,7909.777274699065,-39.29,5
04:26,322720763.0,6690.870223538681,-28.69,8
04:26,873701090.0,1969.675982586864,-33.36,7
04:27,949032480.0,5183.301130211993,-27.19,9
04:27,832564361.0,14350.501997627727,-24.48,5
04:36,822250278.0,6355.578519485201,-20.53,4
04:41,519644021.0,2352.216572866385,-35.84,7
04:42,500043411.0,12591.53871934098,-11.59,5
04:46,985188462.0,918.1902487112246,-41.24,9
04:47,170637730.0,2754.4162701318705,-29.66,5
04:51,558119802.0,28798.186278347115,-4.35,7
04:52,203466392.0,2578.562381506236,-43.33,7
04:54,511179916.0,7384.290915069927,-21.07,2
04:57,609939116.0,6441.278908810139,-1.72,4
04:58,994214354.0,8845.334896968461,-23.61,8
04:58,949032480.0,5150.719299960639,-32.58,2
04:58,383625050.0,5789.47679195403,-30.89,5
04:59,108931112.0,12725.997137426308,-47.35,9
04:59,624500124.0,3372.1167611728815,-12.76,5
05:01,824916823.0,8327.114000199652,-27.59,9
05:02,549414742.0,6946.886079565264,-35.4,9
05:02,699139822.0,2459.3001598599326,-67.78,2
05:04,145387690.0,5191.109245333447,-74.14,4
05:05,587225252.0,9868.875019690358,-21.07,7
05:06,183888402.0,16029.964359271542,-32.28,9
05:10,108563213.0,20864.415655354467,-62.79,7
05:13,176922958.0,2096.3711973625254,-46.6,8
05:15,489964679.0,21644.59231605324,-26.88,9
05:16,779946617.0,15137.427114293248,-78.63,5
05:19,547010927.0,21694.68569077429,-27.6,9
05:23,518474507.0,13172.95113928838,-31.12,9
05:29,187111705.0,5994.980274171578,-43.36,5
05:33,195895574.0,6601.335717359046,-18.07,2
05:34,399144202.0,2608.4347816480085,-2.89,8
05:37,806358207.0,10854.92274365978,-26.76,2
05:40,766941757.0,9177.829242893988,-24.03,9
05:40,851649498.0,9617.966597998526,-48.49,2
05:42,858989281.0,25129.535761241044,-5.73,7
05:43,853907490.0,7007.658258761506,-10.0,5
05:46,282837512.0,12272.820191816649,-2.93,5
05:50,547010927.0,21678.10667173046,-16.58,8
05:50,823208989.0,1659.1233507289032,-69.35,2
05:57,736340277.0,7624.19522523651,-54.97,7
05:59,719586818.0,17091.213120391636,-3.2,2
06:01,679662108.0,13767.049629416064,-13.79,5
06:01,518474507.0,13172.258751168025,-0.69,7
06:02,809499628.0,14848.68898232112,-9.33,5
06:08,366550080.0,23167.491152498256,-25.86,5
06:18,897714622.0,8574.02334823691,-9.1,2
06:20,960208650.0,15226.873690498687,-53.0,8
06:23,143606916.0,205.75260402918977,-31.44,9
06:24,687135796.0,24727.904730360016,-27.89,5
06:25,824916823.0,8290.355320053222,-36.76,7
06:31,137822385.0,3151.5411171514747,-23.2,7
06:34,678851253.0,3244.436523415766,-30.78,2
06:40,482513594.0,7571.393085178303,-37.55,7
06:42,647472692.0,22123.422227412168,-42.33,9
06:43,930277104.0,9899.994500466652,-9.59,5
06:45,749378808.0,5201.1074579733495,-20.74,9
06:48,618138606.0,957.6198621516974,-6.03,5
06:57,785749304.0,8159.667874211555,-14.18,7
07:01,414805878.0,13408.753930259776,-32.3,9
07:02,151968462.0,8526.759164590929,-10.58,2
07:11,683319988.0,7248.565080279286,-73.48,2
07:13,441274121.0,11549.218061632848,-9.97,7
07:13,237684254.0,5513.207735669594,-8.06,5
07:18,550169791.0,18640.710279349827,-4.9,5
07:22,461990622.0,9031.175084618631,-0.44,7
07:27,709608057.0,3419.5406242700733,-31.19,9
07:30,706250160.0,10576.665445592726,-38.47,5
07:31,259015404.0,3713.551190202151,-35.38,9
07:32,675806859.0,6258.127172993389,-53.53,5
07:33,718058208.0,1836.2703124564307,-40.1,7
07:34,409971170.0,2021.3352292615143,-4.47,5
07:39,298000165.0,22605.043639639644,-4.96,7
07:47,633345190.0,7085.258804834579,-0.05,5
07:48,992204045.0,10686.669174610051,-61.8,7
07:50,534325901.0,6425.026518263923,-15.92,8
07:57,950234174.0,1462.909103629113,-7.24,2
08:01,970298834.0,2864.4925008160203,-0.95,2
08:02,912705941.0,16721.469912509594,-44.25,7
08:05,237493332.0,12810.62385255271,-20.75,5
08:08,308505160.0,12167.35693480602,-4.76,5
08:08,678330503.0,2019.4776099062744,-21.05,7
08:15,285220959.0,11083.413038878609,-40.41,7
08:20,310375875.0,3714.145800740072,-72.18,5
08:20,859603181.0,3909.129549493991,-7.44,5
08:24,613729471.0,7340.899872929704,-62.72,2
08:28,973086490.0,9240.287042470249,-6.83,8
08:29,480557476.0,10494.646098334064,-20.72,5
08:40,667367404.0,8185.354342182571,-16.66,2
08:41,305778936.0,11242.510971192987,-59.14,2
08:45,657139925.0,12020.3763187598,-1.01,7
08:47,259015404.0,3710.3978520675905,-3.15,2
08:58,749378808.0,5190.4647674672005,-10.64,8
09:00,336557504.0,1555.9897692497414,-20.91,7
09:13,169006407.0,11266.553018048577,-14.99,9
09:13,532478725.0,4975.26005917084,-0.69,5
09:14,216285378.0,21213.26638463492,-19.15,2
09:16,703478110.0,4034.330288630169,-22.97,7
09:17,520239952.0,-288.2912266547629,-70.0,2
09:22,245690309.0,8301.395625008878,-20.95,2
09:27,170637730.0,2749.4062701318703,-5.01,7
09:28,651756497.0,12827.770583624038,-41.15,1
09:28,933491926.0,2654.8423000000007,-34.95,7
09:29,213112754.0,6755.994794947334,-42.71,8
09:30,282102606.0,398.1728124228265,-105.0,2
09:30,155867488.0,486.4116999999985,-51.98,4
09:33,532478725.0,4944.7100591708395,-30.55,1
09:35,792845450.0,944.952150000001,-99.98,4
09:37,858989281.0,24966.43576124105,-163.1,2
09:38,489964679.0,21584.61679284989,-59.98,8
09:40,414805878.0,13385.023170259776,-23.73,4
09:41,348325817.0,9358.20685281886,-53.24,4
09:41,520239952.0,-485.7712266547629,-197.48,2
09:46,282102606.0,298.6728124228265,-99.5,2
09:46,315546581.0,24313.8633129501,-0.01,8
09:48,581655972.0,38057.89315420985,-12.61,7
09:49,698955014.0,945.728454940912,-54.97,4
09:50,822135975.0,11816.853218231465,-17.16,7
09:51,146909202.0,5234.04427660048,-118.3,2
09:53,633345190.0,7047.434004834579,-37.82,4
09:54,482513594.0,7481.093085178303,-90.3,2
09:56,833499132.0,2196.68735,-21.96,7
09:56,668175891.0,639.239195193041,-36.98,4
10:00,176922958.0,1999.0711973625257,-97.3,2
10:01,572384506.0,9592.804125916018,-31.79,7
10:04,254853117.0,2979.9299131312773,-10.99,1
10:06,279149837.0,798.643049999999,-14.98,1
10:08,454129843.0,779.5180487975243,-39.95,1
10:08,623156843.0,5109.295387921985,-110.54,2
10:09,215311171.0,5965.400016312963,-104.3,2
10:10,858989281.0,24857.249761241044,-109.19,2
10:10,659415300.0,2681.4716708942274,-4.35,9
10:10,520239952.0,-625.2312266547628,-139.46,2
10:11,699997811.0,1106.2841500000034,-12.98,7
10:12,147474476.0,3796.262627031109,-27.95,7
10:12,574548998.0,471.6687499999992,-31.96,1
10:15,730002588.0,12453.767889284927,-101.17,4
10:15,184430449.0,2432.662476194048,-31.99,2
10:15,776431321.0,2985.9337983243377,-6.99,7
10:15,420109571.0,961.6339833420744,-95.49,2
10:16,492850697.0,-210.2739133341367,-224.0,2
10:17,779236304.0,390.1354732989362,-39.48,6
10:18,482513594.0,7357.907085178304,-123.19,2
10:18,821971408.0,2090.2012292356317,-8.09,5
10:19,621652856.0,1741.4609696105397,-20.99,7
10:20,688712152.0,5911.26399695747,-40.99,2
10:20,314980178.0,2484.0718500000044,-107.98,2
10:20,146909202.0,5048.55827660048,-185.49,2
10:21,564214408.0,-111.3961152742738,-14.36,5
10:22,168414279.0,181.25978427492137,-15.98,2
10:22,531186970.0,900.5435562436195,-12.99,2
10:23,851649498.0,9574.762597998526,-43.2,5
10:23,166019891.0,7330.352814996685,-80.54,2
10:23,858989281.0,24846.763761241044,-10.49,2
10:24,860360312.0,203.77810888268036,-31.99,2
10:25,134461671.0,7992.011935517218,-23.03,6
10:27,890567652.0,-135.4223003203994,-113.99,5
10:27,854513972.0,606.7366499999995,-79.99,2
10:27,885259672.0,3711.4170861624098,-26.01,2
10:28,679911053.0,2261.7713796306107,-62.54,5
10:30,616924659.0,-268.4354201769146,-205.97,2
10:31,215311171.0,5881.400016312963,-84.0,2
10:31,242218612.0,1146.6088000000009,-40.88,2
10:31,897714622.0,8544.89334823691,-29.13,1
10:31,601627384.0,4705.864005444282,-5.08,7
10:32,551196328.0,3972.393700000005,-143.99,2
10:32,478986718.0,-964.3661000000004,-55.94,5
10:33,131388684.0,19551.76772848987,-88.05,2
10:33,626989363.0,284.0451133173756,-84.51,5
10:33,196289502.0,13743.220134867168,-12.79,7
10:34,179173981.0,6096.15271611478,-27.0,7
10:35,858560423.0,10815.285645306974,-15.96,5
10:35,552980092.0,-13.201280880662546,-23.94,4
10:37,998405607.0,-886.8189999999979,-59.44,5
10:37,675398089.0,-627.5417407746509,-150.64,5
10:37,718058208.0,1771.8843124564307,-64.39,2
10:38,758885184.0,1230.157182274345,-60.98,2
10:38,683078800.0,1573.1638920384876,-16.97,7
10:38,570269025.0,2489.159103575496,-5.99,1
10:39,506618547.0,17140.09358347002,-113.88,2
10:39,705848712.0,23265.786309296866,-30.4,7
10:39,868033067.0,-2050.0482864510827,-53.25,5
10:39,873701090.0,1765.303982586864,-204.37,2
10:39,737547541.0,-116.0984004322258,-97.5,5
10:40,166019891.0,7311.746814996685,-18.61,5
10:41,403383649.0,1292.1485643427586,-4.99,1
10:41,348460748.0,-73.03570000000084,-66.97,5
10:42,146909202.0,4960.37227660048,-88.19,2
10:42,492850697.0,-388.07391333413665,-177.8,2
10:43,783650950.0,-1019.6956434110116,-118.31,5
10:43,760753808.0,-689.2439500000004,-149.55,5
10:44,524425303.0,-242.34250000000108,-55.01,5
10:45,108812033.0,624.8951499999986,-102.1,5
10:46,482513594.0,7280.221085178304,-77.69,2
10:46,858989281.0,24711.705761241043,-135.06,2
10:48,405945930.0,4198.69524319773,-22.0,2
10:49,737645298.0,-2388.734199999999,-22.3,5
10:49,982949451.0,-3282.376667052509,-43.39,5
10:49,992204045.0,10649.111654610051,-37.56,4
10:50,420109571.0,877.1339833420745,-84.5,2
10:50,456246119.0,18182.280305289576,-7.98,7
10:52,822135975.0,11810.803218231466,-6.05,4
10:54,364357875.0,6286.685072339472,-75.55,7
10:56,990461108.0,165.69636862061094,-30.95,1
10:57,623156843.0,5036.537387921985,-72.76,2
10:58,660874296.0,1675.4074499608464,-6.99,4
10:58,242218612.0,1094.1088000000009,-52.5,2
10:58,858989281.0,24692.015761241044,-19.69,7
10:58,146909202.0,4910.72827660048,-49.64,2
10:59,143061865.0,6597.835016898004,-29.99,4
10:59,426474982.0,-3376.39975,-37.39,5
11:00,188263947.0,616.5300000000002,-99.99,2
11:00,155867488.0,458.4116999999985,-28.0,2
11:02,162370388.0,-2150.0479,-13.18,5
11:04,388862238.0,787.5876021097063,-50.79,5
11:04,520239952.0,-755.7212266547629,-130.49,2
11:04,286484726.0,543.6967764574821,-84.98,2
11:04,987229118.0,3878.113335083234,-41.48,4
11:07,698076160.0,5619.163096949639,-26.98,4
11:07,282102606.0,238.6728124228265,-60.0,2
11:07,497772347.0,905.3591499999984,-35.0,2
11:08,196289502.0,13741.675814867169,-1.54,4
11:08,700138124.0,5269.297300000004,-134.11,2
11:09,685959099.0,2519.316866099241,-44.25,5
11:09,943329213.0,2205.824643070922,-84.32,2
11:09,130154096.0,1112.0192252012682,-5.99,4
11:09,744211756.0,-3715.3982499999943,-19.4,5
11:10,653640811.0,14824.321831496503,-11.99,2
11:11,950234174.0,1431.7291036291128,-31.18,7
11:12,170637730.0,2734.2709701318704,-15.14,4
11:13,280130290.0,-13.286250000000392,-90.83,5
11:13,366477356.0,-133.32785,-257.47,5
11:13,873701090.0,1686.217982586864,-79.09,2
11:14,146909202.0,4828.14227660048,-82.59,2
11:14,909676212.0,1174.959617470368,-88.79,5
11:14,255814263.0,3736.591237992111,-19.99,4
11:15,424397946.0,2142.750783605399,-51.98,2
11:15,245690309.0,8271.165625008878,-30.23,7
11:17,821971408.0,1958.2212292356317,-131.98,2
11:18,331450202.0,6337.784946834956,-5.65,5
11:22,940569402.0,6146.81123588337,-34.3,2
11:23,849096144.0,1929.1337896445743,-28.0,2
11:24,684284526.0,-2793.3388667457584,-35.82,5
11:24,433917275.0,7636.417595472115,-2.89,4
11:24,450896297.0,12405.358128685051,-51.5,4
11:25,701070224.0,931.72875,-35.97,2
11:26,108481285.0,8199.419793097515,-25.23,7
11:26,623156843.0,4938.551387921985,-97.99,2
11:27,245690309.0,8250.879625008878,-20.29,5
11:27,627622066.0,2365.798185693056,-64.99,2
11:27,842682241.0,4937.818410354602,-45.41,7
11:28,229205098.0,7167.769053447311,-122.14,2
11:28,771125520.0,426.46784999999943,-58.37,5
11:29,255814263.0,3708.591237992111,-28.0,2
11:30,604288474.0,3017.135739982091,-21.43,2
11:30,624563756.0,-384.3298712164436,-28.7,5
11:30,492215823.0,96.21297381544296,-41.77,1
11:30,585596026.0,-174.0395611887467,-63.96,5
11:31,588565416.0,6644.100594039148,-127.39,5
11:31,220183538.0,683.4365499999996,-65.97,2
11:32,713910252.0,-448.5298242714583,-125.39,5
11:32,480557476.0,10459.196098334063,-35.45,2
11:32,282102606.0,7.172812422826496,-231.5,2
11:33,520239952.0,-809.2012266547629,-53.48,2
11:34,873701090.0,1456.6319825868638,-229.59,2
11:35,851649498.0,9513.722597998523,-61.04,7
11:35,878989510.0,4766.034077321595,-112.98,2
11:36,835736339.0,2443.3722504145594,-20.01,2
11:36,583579399.0,654.8993499999991,-98.51,5
11:38,417850087.0,15264.166835280455,-74.04,2
11:38,245198540.0,-605.9436011982206,-16.43,5
11:39,519644021.0,2279.9365728663847,-72.28,2
11:39,891716230.0,157.5992980706205,-71.99,2
11:40,575652395.0,1311.2944197618267,-99.99,2
11:41,768271776.0,-459.6702967665793,-62.42,5
11:41,407574996.0,3545.68492731128,-75.29,2
11:42,940569402.0,6091.511235883369,-55.3,2
11:42,136770968.0,-179.99510000000026,-131.98,2
11:44,497809732.0,535.7928695525952,-49.99,2
11:45,466649401.0,97.32896572319672,-19.96,7
11:48,769311479.0,6687.695934828812,-8.57,8
11:50,781554833.0,2473.251313609717,-37.98,2
11:51,108481285.0,8133.542793097515,-65.88,5
11:51,298000165.0,22603.543639639644,-1.5,4
11:52,639420537.0,-1563.72645,-24.64,5
11:52,858989281.0,24629.015761241044,-63.0,2
11:54,672994751.0,-78.7686924158626,-5.99,2
11:54,131388684.0,19500.577728489872,-51.19,2
11:55,540159353.0,9857.695005190488,-55.32,4
11:57,429556122.0,5633.517750000004,-60.05,2
12:01,949032480.0,5071.919299960638,-78.8,2
12:01,500043411.0,12529.94871934098,-61.59,7
12:01,310620484.0,667.1067381437229,-63.38,2
12:03,873701090.0,1269.731982586864,-186.9,2
12:06,486495235.0,1102.346639388716,-5.99,2
12:06,940569402.0,6049.511235883369,-42.0,2
12:07,858989281.0,24490.429761241045,-138.59,2
12:08,699139822.0,2426.330159859933,-32.97,9
12:08,196289502.0,13645.313814867168,-96.36,5
12:08,558875206.0,2361.566950000001,-28.0,2
12:08,782058249.0,-1223.9777733101616,-17.94,9
12:09,844835978.0,9469.84504310472,-108.46,2
12:12,365608668.0,676.5178138595588,-37.48,4
12:12,419550103.0,17144.01464423418,-6.09,8
12:13,871200314.0,400.3566742426384,-51.01,5
12:14,355602925.0,1201.6725938274146,-23.23,9
12:14,482513594.0,7141.6210851783035,-138.6,2
12:17,520239952.0,-883.7012266547629,-74.5,2
12:17,541639148.0,5057.896652877144,-72.8,2
12:17,304455868.0,1570.0671597158298,-18.01,2
12:21,940569402.0,5937.511235883369,-112.0,2
12:22,138351025.0,-457.5896500000002,-24.94,9
12:22,705848712.0,23249.496309296865,-16.29,9
12:23,623156843.0,4732.765387921985,-205.79,2
12:25,957821152.0,-1293.2553035715498,-114.83,5
12:26,141521177.0,6336.257900000011,-12.99,2
12:26,836110591.0,6416.394702612228,-31.22,9
12:30,242218612.0,1022.8588000000008,-71.25,2
12:30,668329719.0,7523.003780393347,-33.56,4
12:31,639409800.0,30866.830079000043,-2.0,4
12:32,541639148.0,4969.010652877144,-88.89,2
12:32,520239952.0,-918.6912266547628,-34.99,2
12:34,169006407.0,11157.591018048575,-108.96,5
12:35,407574996.0,3542.206296149474,-3.48,4
12:35,420109571.0,779.1539833420745,-97.98,2
12:36,224524792.0,-2039.443182430849,-16.19,5
12:40,661295096.0,2951.6212044119343,-5.99,4
12:40,143061865.0,6582.845016898004,-14.99,9
12:41,913801979.0,547.5575299144939,-37.87,5
12:43,940569402.0,5867.511235883369,-70.0,2
12:44,258201793.0,-547.8048000000005,-124.99,2
12:44,570323670.0,3402.8665658823943,-63.06,2
12:44,989506909.0,-2263.5223707594378,-32.38,5
12:46,635679314.0,-2650.0508291195197,-29.09,5
12:46,450896297.0,12386.128128685054,-19.23,9
12:46,492850697.0,-589.6739133341366,-201.6,2
12:46,482513594.0,7031.735085178303,-109.89,2
12:46,844835978.0,9215.05904310472,-254.79,2
12:47,558119802.0,28778.73627834711,-19.45,9
12:47,575652395.0,1292.814419761827,-18.48,4
12:48,851181128.0,4366.5203372667875,-52.51,4
12:48,631111289.0,-900.1115000000007,-44.53,5
12:51,127809299.0,601.9533928980364,-98.27,5
12:53,158766229.0,-706.3978358934698,-66.99,5
12:54,874431242.0,7864.127274699065,-45.65,2
12:54,736340277.0,7610.48922523651,-13.71,5
12:55,534908754.0,-680.7476500000002,-58.01,5
12:55,736310094.0,-752.347024027426,-34.98,5
12:55,873693307.0,8262.433960967743,-17.94,9
12:57,713641917.0,947.309769503842,-2.99,2
12:58,623156843.0,4621.535387921986,-111.23,2
12:58,496395938.0,11748.914930307265,-16.93,5
12:58,141521177.0,6278.241900000012,-58.02,5
12:58,868377987.0,3073.546369515681,-18.98,2
12:59,541639148.0,4851.410652877144,-117.6,2
12:59,242218612.0,854.1088000000007,-168.75,2
13:01,187111705.0,5988.980274171578,-6.0,9
13:01,420109571.0,710.6739833420745,-68.48,2
13:02,585625048.0,1035.5386190586323,-5.9,9
13:02,250895529.0,1625.197182469287,-99.99,2
13:04,482513594.0,6883.349085178303,-148.39,2
13:05,718058208.0,1536.040312456431,-235.84,2
13:06,685959099.0,2491.316866099241,-28.0,2
13:06,868377987.0,3060.556369515681,-12.99,2
13:07,441274121.0,11440.872061632848,-108.35,5
13:07,737547541.0,-137.0884004322258,-20.99,9
13:07,388862238.0,787.4344772385228,-0.15,8
13:08,322221939.0,3626.097788774981,-6.15,9
13:08,277562576.0,589.0937507952725,-5.4,9
13:09,939972497.0,474.32950860001085,-71.99,2
13:12,215311171.0,5710.600016312963,-170.8,2
13:13,971129830.0,-1394.1981499999995,-60.64,5
13:16,858989281.0,24395.243761241043,-95.19,2
13:17,668329719.0,7438.527780393348,-84.48,5
13:17,639409800.0,30862.414551796865,-4.42,2
13:19,134847904.0,4017.596694386293,-25.0,2
13:22,480557476.0,10453.546098334064,-5.65,9
13:23,978951113.0,-647.5144925904192,-146.89,5
13:24,572333122.0,-3291.365049999997,-92.95,5
13:25,627622066.0,2343.828185693056,-21.97,1
13:25,158414827.0,-1519.9377000000015,-61.54,5
13:25,348325817.0,9352.80685281886,-5.4,9
13:26,939972497.0,453.3495086000109,-20.98,4
13:27,254853117.0,2965.3628099012703,-14.57,5
13:28,758160963.0,7772.767392756351,-36.0,4
13:29,229502829.0,-3082.3031741862483,-131.37,5
13:30,570323670.0,3372.816545882394,-30.05,4
13:32,630691258.0,241.10654487484135,-41.72,9
13:33,815385232.0,9181.241449469486,-6.02,2
13:36,806358207.0,10822.08274365978,-32.84,7
13:36,349614277.0,688.4692499999995,-144.98,2
13:40,482513594.0,6803.577085178303,-79.77,2
13:41,718058208.0,1494.0543124564306,-41.99,2
13:41,124125096.0,289.17199438780233,-156.93,5
13:43,583558311.0,-837.5322152486681,-61.09,5
13:46,858989281.0,24264.357761241044,-130.89,2
13:48,113747882.0,10808.4344367687,-25.29,9
13:48,824916823.0,8248.675320053222,-41.68,7
13:49,354894456.0,-151.59000000000046,-35.93,9
13:50,264550521.0,8756.25556633316,-13.03,2
13:51,624500124.0,3351.9067611728815,-20.21,2
13:55,425964226.0,2966.2076500000016,-31.92,7
13:56,497772347.0,860.4091499999984,-44.95,4
13:57,242218612.0,790.3588000000007,-63.75,2
14:00,822718326.0,9542.389317538033,-12.29,5
14:00,541639148.0,4663.110652877143,-188.3,7
14:04,593191200.0,1190.414999999999,-82.99,2
14:07,824916823.0,8243.075320053222,-5.6,4
14:07,124102251.0,4367.122776583643,-9.99,2
14:07,785210466.0,1978.2088041968257,-16.9,7
14:08,534325901.0,6223.426518263923,-201.6,2
14:11,858989281.0,24212.585761241044,-51.77,2
14:13,482513594.0,6716.791085178303,-86.79,2
14:13,282102606.0,-62.827187577173504,-70.0,2
14:14,718058208.0,1395.3823124564306,-98.67,2
14:15,349614277.0,460.46924999999953,-228.0,2
14:20,982286721.0,-3120.1905240177307,-19.7,5
14:22,520239952.0,-969.1712266547628,-50.48,2
14:22,361201224.0,6457.594232067893,-15.01,7
14:22,541639148.0,4530.152652877144,-132.96,7
14:24,858989281.0,24185.285761241044,-27.3,2
14:27,736340277.0,7593.11922523651,-17.37,7
14:28,874506295.0,-1610.2567562455722,-23.32,5
14:30,492850697.0,-795.4739133341366,-205.8,2
14:31,176922958.0,1861.8851973625256,-137.19,2
14:33,149684419.0,621.8271999999985,-21.91,5
14:36,420109571.0,485.6939833420745,-224.98,2
14:37,858989281.0,24143.285761241044,-42.0,2
14:39,331048953.0,-208.24863202150635,-69.45,5
14:40,500043411.0,12515.94871934098,-14.0,9
14:42,151968462.0,8479.34116459093,-47.42,5
14:43,541639148.0,4460.866652877144,-69.29,4
14:43,355733816.0,4128.865349227419,-0.89,5
14:45,758160963.0,7681.739392756351,-91.03,5
14:45,252701364.0,-3368.156172677917,-56.79,5
14:46,885259672.0,3705.4110861624094,-6.01,4
14:47,482513594.0,6562.091085178303,-154.7,2
14:49,282102606.0,-145.3271875771735,-82.5,2
14:50,857455726.0,-1003.7588141243156,-179.63,5
14:50,718058208.0,1262.4103124564306,-132.97,2
14:51,176922958.0,1672.9131973625256,-188.97,2
14:59,975345315.0,30770.37279999996,-85.74,5
15:00,520239952.0,-1013.1412266547628,-43.97,2
15:00,538003940.0,1624.6500000000078,-79.98,4
15:03,192202372.0,367.9184030290111,-109.98,2
15:04,706361191.0,124.38274849407814,-45.49,5
15:06,541639148.0,4413.280652877143,-47.59,4
15:08,680773155.0,350.81938333109184,-29.25,5
15:09,718058208.0,1191.7243124564309,-70.69,2
15:12,420109571.0,353.71398334207447,-131.98,2
15:13,698076160.0,5575.4369562194215,-43.73,5
15:13,858989281.0,24097.799761241044,-45.49,2
15:14,176922958.0,1475.5271973625256,-197.39,2
15:16,282837512.0,12242.200191816646,-30.62,2
15:22,873701090.0,1168.945982586864,-100.79,2
15:23,282102606.0,-338.3271875771735,-193.0,2
15:24,639409800.0,30767.914551796865,-94.5,2
15:26,844835978.0,8823.85704310472,-166.56,2
15:31,690523499.0,894.0485999999996,-9.0,7
15:31,176922958.0,1232.6551973625255,-242.87,2
15:31,195895574.0,6562.215717359046,-39.12,7
15:34,213112754.0,6723.136794947334,-32.86,5
15:34,143061865.0,6532.845016898004,-50.0,2
15:36,214339619.0,-0.2195491316435962,-52.87,5
15:39,639409800.0,30663.670551796866,-104.24,2
15:43,242218612.0,753.2338000000007,-37.12,2
15:44,718058208.0,1112.6523124564303,-79.07,2
15:46,146909202.0,4765.18427660048,-62.96,2
15:48,873701090.0,957.573982586864,-211.37,2
15:49,176922958.0,1073.0691973625255,-159.59,2
15:50,858989281.0,23986.513761241044,-111.29,2
15:51,815385232.0,9166.201449469483,-15.04,4
15:52,266777719.0,135.77143378023968,-7.01,1
15:58,844835978.0,8722.399043104719,-101.46,2
15:58,812012103.0,-419.0693000000005,-37.95,1
15:58,166019891.0,7250.934084996686,-60.81,4
16:02,242218612.0,650.4838000000007,-102.75,2
16:06,627917561.0,3006.0600500000032,-19.99,2
16:06,215311171.0,5570.600016312963,-140.0,2
16:07,456221621.0,884.7531673026282,-56.99,2
16:12,655368335.0,4636.227797514056,-63.05,2
16:13,670102069.0,3660.095443672017,-17.14,2
16:15,282102606.0,-542.8271875771735,-204.5,2
16:15,287480331.0,11543.84677016377,-0.32,4
16:16,858989281.0,23972.527761241043,-13.99,2
16:16,873701090.0,870.801982586864,-86.77,2
16:22,534325901.0,6098.126518263923,-125.3,2
16:23,146909202.0,4629.41227660048,-135.77,2
16:24,492850697.0,-1015.2739133341364,-219.8,2
16:25,844835978.0,8568.399043104719,-154.0,2
16:26,176922958.0,909.2831973625256,-163.79,2
16:27,738958551.0,8043.491894982234,-70.26,2
16:27,520239952.0,-1089.121226654763,-75.98,2
16:30,454356905.0,2441.166197310051,-10.54,2
16:32,551755686.0,7148.205067377236,-4.99,1
16:39,601627384.0,4661.131422840747,-44.73,8
16:46,492850697.0,-1154.5739133341365,-139.3,2
16:46,145387690.0,5142.8892453334465,-48.22,6
16:46,282102606.0,-636.8271875771735,-94.0,2
16:47,762700245.0,2535.324700000002,-162.99,2
16:55,899742927.0,12460.478181351938,-84.99,2
16:55,520239952.0,-1186.591226654763,-97.47,2
16:56,176922958.0,791.0251973625257,-118.26,2
16:57,399144202.0,2597.670721648009,-10.76,4
16:59,696333897.0,673.0855999999992,-19.99,4
17:00,146909202.0,4552.41227660048,-77.0,2
17:08,233981231.0,1871.9377391616956,-12.72,4
17:09,176922958.0,722.4671973625257,-68.56,2
17:16,492850697.0,-1352.6739133341364,-198.1,2
17:18,709608057.0,3399.005637164448,-20.53,7
17:21,653667523.0,5651.193140353457,-23.96,7
17:24,956717493.0,951.0199937283602,-19.99,4
17:27,146909202.0,4448.11227660048,-104.3,2
17:27,587225252.0,9616.175019690358,-252.7,7
17:32,510101371.0,12364.01855662382,-16.79,2
17:35,873701090.0,838.7519825868641,-32.05,1
17:38,627936697.0,934.2213499999998,-171.0,2
17:41,618514666.0,18247.58444726166,-162.37,2
17:45,520239952.0,-1250.581226654763,-63.99,2
17:48,587225252.0,9319.375019690358,-296.8,4
17:54,129018172.0,7917.697887752608,-22.97,1
17:57,940569402.0,5692.511235883369,-175.0,2
17:57,587225252.0,9153.47501969036,-165.9,4
17:58,176922958.0,555.8951973625257,-166.57,2
18:00,475117511.0,7979.287576607248,-7.15,7
18:02,520239952.0,-1380.051226654763,-129.47,2
18:03,653640811.0,14809.797074617629,-14.52,7
18:17,819515373.0,2424.0459860637907,-5.6,9
18:21,497809732.0,529.7928695525952,-6.0,9
18:22,627936697.0,876.7213499999998,-57.5,7
18:27,819515373.0,2409.5459860637907,-14.5,9
18:32,940569402.0,5531.511235883369,-161.0,2
18:33,497809732.0,520.2928695525952,-9.5,9
18:34,176922958.0,313.70919736252563,-242.19,2
18:38,195895574.0,6541.875717359046,-20.34,9
18:39,627936697.0,694.7213499999998,-182.0,4
18:39,600185455.0,223.12000224748152,-21.93,9
18:42,105375973.0,-1545.4703471810594,-24.43,9
18:58,819515373.0,2404.345986063791,-5.2,9
19:04,497809732.0,514.6928695525952,-5.6,9
19:13,819515373.0,2399.095986063791,-5.25,9
19:22,752362502.0,8439.135442497332,-8.38,7
19:23,497809732.0,505.1928695525952,-9.5,9
19:35,128033695.0,3001.2518986900886,-22.19,5
19:40,687135796.0,24721.904730360016,-6.0,9
19:42,473820682.0,10675.93691954076,-16.2,9
20:20,395284483.0,1347.517813566968,-46.48,5
20:37,392270893.0,10961.030896994424,-46.19,7
20:45,554792076.0,24412.687462300928,-19.86,2
20:52,370521542.0,23194.27875698173,-9.04,2
00:12,352291960.0,2103.962403303574,-34.68,9
00:16,471897866.0,7772.473206688103,-3.1,5
00:17,815385232.0,9140.884329002429,-25.32,7
00:21,417850087.0,15262.728098356003,-1.44,7
00:25,221868392.0,5036.210338455458,-12.75,2
00:26,179173981.0,6045.088521731494,-51.06,8
00:27,858989281.0,23909.314738111847,-63.21,7
00:30,985188462.0,880.7202487112246,-37.47,9
00:36,887853850.0,10147.021228553054,-72.73,2
00:39,454129843.0,775.6338507917889,-3.88,2
00:42,421881811.0,5529.478582912095,-35.26,7
00:43,836110591.0,6389.864702612228,-26.53,9
00:44,802697323.0,19052.064797749936,-5.13,2
00:45,108481285.0,8117.141000629897,-16.4,8
00:46,858989281.0,23897.314738111847,-12.0,9
00:47,221868392.0,5004.610338455458,-31.6,9
00:53,518474507.0,13136.778751168024,-35.48,9
00:58,704517789.0,15243.640886953384,-18.15,8
01:01,795847804.0,20282.09762154154,-1.85,4
01:05,822135975.0,11789.717879825772,-21.09,8
01:07,667367404.0,8183.688469376625,-1.67,2
01:08,383625050.0,5788.862305837049,-0.61,2
01:08,586315521.0,10942.409716308566,-10.75,2
01:09,887853850.0,10112.041228553056,-34.98,9
01:10,213112754.0,6709.630383731805,-13.51,2
01:10,851649498.0,9509.880457971589,-3.84,7
01:13,699139822.0,2395.3642221785453,-30.97,7
01:17,215311171.0,5567.3753842277865,-3.22,5
01:22,113747882.0,10769.933503475111,-38.5,5
01:24,802697323.0,19011.674797749936,-40.39,9
01:40,541639148.0,4346.01368053736,-67.27,2
01:41,237684254.0,5504.378205879465,-8.83,2
01:49,785749304.0,8121.2037426240495,-38.46,2
01:49,897714622.0,8542.119481750813,-2.77,4
01:53,769311479.0,6647.4117561615985,-40.28,2
01:58,441274121.0,11433.162030460491,-7.71,2
02:01,604288474.0,3014.4489463380623,-2.69,2
02:16,237493332.0,12803.63385255271,-6.99,9
02:20,851181128.0,4349.3569336245255,-17.16,2
02:26,823208989.0,1610.6585685183472,-48.46,5
02:33,383833857.0,21125.00526434522,-4.94,5
02:40,534325901.0,6076.2876591186905,-21.84,7
02:40,549414742.0,6926.416079565263,-20.47,9
02:50,558119802.0,28750.666278347115,-28.07,9
02:53,647936800.0,1452.2097889650115,-46.13,5
02:56,679662108.0,13714.657236598425,-52.39,5
03:01,203466392.0,2529.892233731548,-48.67,4
03:02,237493332.0,12802.602468411516,-1.03,2
03:02,433917275.0,7612.677595472115,-23.74,9
03:06,766941757.0,9155.499242893988,-22.33,9
03:06,718058208.0,1088.3013851555957,-24.35,5
03:06,809499628.0,14838.488982321118,-10.2,9
03:08,683319988.0,7230.6250802792865,-17.94,9
03:21,905860285.0,15319.594229032014,-70.49,2
03:22,259015404.0,3710.063695000921,-0.33,7
03:26,549414742.0,6894.119675922238,-32.3,8
03:26,315546581.0,24282.075277929896,-31.79,7
03:39,683319988.0,7189.009646808403,-41.62,2
03:42,558119802.0,28739.94176651361,-10.72,2
03:42,108563213.0,20834.935864640353,-29.48,7
03:43,581655972.0,37987.024982463015,-70.87,7
03:44,593378953.0,1007.742700000005,-38.74,9
03:47,678851253.0,3189.4380626240386,-55.0,8
03:47,308505160.0,12165.569764662574,-1.79,8
03:51,270374623.0,9592.476340967673,-21.65,7
03:54,950234174.0,1428.9979419816957,-2.73,2
03:55,749378808.0,5159.884767467201,-30.58,9
03:55,282837512.0,12212.360191816646,-29.84,9
03:55,305778936.0,11205.628324484323,-36.88,5
04:01,779236304.0,351.3054732989362,-38.83,9
04:18,196289502.0,13617.56799437772,-27.75,5
04:20,587225252.0,9107.214690216411,-46.26,7
04:26,409971170.0,2008.9503502933796,-12.38,4
04:32,259015404.0,3687.573695000922,-22.49,9
04:33,749378808.0,5157.293309604829,-2.59,4
04:37,520447032.0,8448.04818666013,-17.22,2
04:47,216285378.0,21166.46638463492,-46.8,9
04:52,287480331.0,11523.538706804176,-20.31,5
04:53,709608057.0,3360.965637164448,-38.04,9
04:53,824916823.0,8221.145320053221,-21.93,9
04:54,324224854.0,3978.148385141299,-6.16,2
05:02,687135796.0,24711.914730360015,-9.99,9
05:15,822250278.0,6327.940727780981,-27.64,5
05:15,899742927.0,12454.782621696484,-5.7,7
05:18,836110591.0,6344.269849072512,-45.59,5
05:24,824916823.0,8174.636308929324,-46.51,5
05:29,407574996.0,3536.173363734572,-6.03,7
05:34,705848712.0,23231.606309296865,-17.89,9
05:35,519644021.0,2267.8672952905767,-12.07,2
05:38,187541224.0,6504.23255922144,-35.9,9
05:41,994214354.0,8811.04489696846,-34.29,9
05:42,687135796.0,24706.997915530777,-4.92,7
05:44,146909202.0,4364.689396267706,-83.42,5
05:46,124102251.0,4307.5996517594895,-59.52,8
05:52,912705941.0,16706.503876203402,-14.97,5
05:58,940569402.0,5517.57123588337,-13.94,9
06:02,853907490.0,6991.595397263034,-16.06,7
06:05,547010927.0,21677.778365000588,-0.33,7
06:07,264550521.0,8723.038942454366,-33.22,5
06:13,633345190.0,7016.104004834579,-31.33,9
06:20,489964679.0,21555.766792849892,-28.85,9
06:20,419550103.0,17089.661427913863,-54.35,8
06:23,183888402.0,16001.784359271542,-28.18,9
06:24,511179916.0,7383.392940537054,-0.9,4
06:28,310375875.0,3696.865098225596,-17.28,5
06:39,364357875.0,6243.175383802882,-43.51,5
06:46,940569402.0,5487.33825894952,-30.23,5
06:46,280268430.0,4681.7424643597815,-35.0,5
06:46,166019891.0,7245.487975917083,-5.45,8
06:48,987656636.0,5882.096188395514,-5.74,2
06:53,865748375.0,5192.3755339182535,-7.9,2
06:54,435984758.0,5132.364154735668,-1.16,7
06:54,506618547.0,17109.403583470023,-30.69,9
06:57,187111705.0,5987.84770511203,-1.13,5
06:58,366550080.0,23152.361296427753,-15.13,8
07:00,730002588.0,12410.664180612002,-43.1,7
07:03,480557476.0,10406.62180066454,-46.92,2
07:04,886921642.0,3398.205111668006,-27.34,2
07:07,609939116.0,6404.3242147343335,-36.95,7
07:09,709608057.0,3313.57046869124,-47.4,5
07:10,116598243.0,2203.24932775601,-5.75,9
07:18,738958551.0,8040.2066579030015,-3.29,2
07:26,856147482.0,87.77490140137532,-19.14,9
07:28,656812046.0,1018.4009768833168,-30.43,9
07:31,473820682.0,10648.632600927978,-27.3,2
07:38,832564361.0,14310.55730377641,-39.94,7
07:38,930277104.0,9874.06256753956,-25.93,5
07:39,973086490.0,9207.822774716216,-32.46,7
07:42,414805878.0,13350.2872204676,-34.74,7
07:43,195895574.0,6516.1172446603505,-25.76,8
07:43,873693307.0,8251.786169310028,-10.65,5
07:45,449871732.0,8977.176113265705,-15.55,7
07:47,806358207.0,10818.95112238945,-3.13,7
07:48,633345190.0,6959.425064461874,-56.68,5
07:49,145387690.0,5126.762861556148,-16.13,7
07:50,506618547.0,17087.176793631934,-22.23,7
07:50,282837512.0,12204.464404532377,-7.9,4
07:51,550169791.0,18621.996719758434,-18.71,7
07:54,679943657.0,3878.574450000009,-37.37,9
07:56,994214354.0,8803.884547212863,-7.16,8
07:58,128033695.0,2998.040692331087,-3.21,7
08:00,885259672.0,3699.01108616241,-6.4,9
08:00,252760664.0,5811.0939010871125,-12.06,2
08:01,169006407.0,11150.377389758662,-7.21,2
08:01,532478725.0,4917.820059170839,-26.89,9
08:03,133755851.0,721.6366308829103,-51.95,2
08:09,395284483.0,1342.117813566968,-5.4,9
08:11,651756497.0,12826.102187621622,-1.67,2
08:12,613729471.0,7321.941626146587,-18.96,2
08:15,456221621.0,877.2531673026282,-7.5,9
08:15,758160963.0,7670.406939320514,-11.33,2
08:20,659008214.0,-2995.042602290424,-22.33,5
08:23,668329719.0,7414.945761141746,-23.58,8
08:26,518378868.0,-1249.2764000000002,-63.0,5
08:28,522188082.0,7392.117875957753,-29.58,2
08:28,956717493.0,920.9885937283602,-30.03,5
08:30,775790822.0,-2810.4184192160683,-38.09,5
08:31,987163717.0,5908.6728500000045,-26.86,5
08:34,703478110.0,3998.326084266246,-36.0,7
08:35,322720763.0,6649.332223538681,-41.54,5
08:35,786141370.0,-640.7947000000008,-61.63,5
08:37,124377686.0,-2471.2323999999985,-37.39,5
08:39,474951915.0,-2379.3810952340123,-21.93,5
08:39,832564361.0,14253.955303776407,-56.6,5
08:41,713057426.0,-1089.7717500000003,-29.75,5
08:42,999752672.0,494.1204935333344,-92.11,5
08:42,348325817.0,9345.868143097134,-6.94,7
08:44,283027736.0,-506.3807560298272,-6.81,5
08:45,762785862.0,812.2135999999996,-67.37,5
08:47,709151315.0,-835.04578162584,-74.49,5
08:48,950234174.0,1338.1099419816958,-90.89,5
08:48,284905540.0,7425.321818960157,-124.46,5
08:49,822718326.0,9521.683317538032,-20.71,5
08:50,510101371.0,12249.90455662382,-114.11,5
08:50,435984758.0,5083.140154735668,-49.22,5
08:51,212560376.0,-546.3948742208978,-189.48,5
08:52,564744955.0,-147.53664141115803,-93.29,5
08:53,235881534.0,11414.521333483646,-33.92,7
08:57,135937041.0,-172.7815982684117,-95.88,5
08:57,675806859.0,6129.187172993389,-128.94,5
08:58,785749304.0,8096.71774262405,-24.49,5
08:59,613427466.0,5660.934905655875,-83.96,5
08:59,532525712.0,-543.2143000000004,-45.64,5
08:59,598586358.0,-3105.5399499999967,-37.39,5
08:59,469561218.0,21.54414999999915,-68.79,5
09:01,316793091.0,730.4143100549512,-68.41,5
09:03,936813994.0,-215.9261391672117,-118.2,5
09:03,117273481.0,8037.142360178158,-6.3,9
09:05,478651121.0,25.15402959846976,-97.44,5
09:05,762700245.0,2424.927700000002,-110.4,5
09:09,215426302.0,-201.7575959743083,-52.0,5
09:09,339791565.0,-3264.5436999999974,-45.7,5
09:10,659415300.0,2590.419870894227,-91.05,5
09:12,504055745.0,-648.0901386582331,-41.97,5
09:12,675806859.0,6125.881035557273,-3.31,2
09:13,131388684.0,19494.777728489873,-5.8,9
09:15,581655972.0,37980.874982463014,-6.15,9
09:15,853907490.0,6957.631397263034,-33.96,5
09:16,264208990.0,660.0215499999991,-163.73,5
09:17,779376323.0,2794.333215820126,-34.51,5
09:17,899692478.0,-1475.063143524007,-125.13,5
09:17,851649498.0,9504.530457971588,-5.35,9
09:18,540159353.0,9852.695005190488,-5.0,9
09:18,383833857.0,21098.51526434522,-26.49,1
09:19,690958123.0,17503.38972829008,-5.7,9
09:20,361955473.0,-1031.8687047559156,-104.08,5
09:21,667367404.0,8177.638469376625,-6.05,9
09:21,169006407.0,11144.327389758662,-6.05,9
09:21,779620857.0,-466.11589638517586,-64.16,5
09:22,683078800.0,1567.8638920384876,-5.3,9
09:22,417850087.0,15256.928098356006,-5.8,9
09:23,237684254.0,5436.468205879465,-67.91,1
09:23,587225252.0,9074.744690216412,-32.47,2
09:23,398429109.0,1861.934950000001,-68.49,2
09:24,506618547.0,17081.026793631932,-6.15,9
09:24,661295096.0,2861.6312044119345,-89.99,2
09:25,913127700.0,711.3542380111165,-70.42,5
09:25,346874167.0,243.7924999999992,-34.89,5
09:25,558875206.0,2355.566950000001,-6.0,9
09:26,741903302.0,2431.182897988479,-30.97,4
09:26,386277162.0,279.9399999999996,-70.98,2
09:27,452974357.0,-2516.3439499999963,-6.74,5
09:27,198946608.0,5553.204971382752,-27.01,7
09:27,250895529.0,1571.2771824692873,-53.92,1
09:29,960208650.0,15189.25101740381,-37.62,5
09:30,472213568.0,-395.3027942060533,-84.65,5
09:30,886921642.0,3346.165111668006,-52.04,2
09:31,903663593.0,590.005318582982,-5.99,7
09:31,370521542.0,23146.315848615297,-47.96,7
09:32,610450243.0,-1276.5446000000002,-25.67,5
09:32,727417797.0,5153.8135000000075,-31.99,2
09:33,767447966.0,3987.0528055121104,-44.15,4
09:33,277562576.0,559.1137507952725,-29.98,4
09:34,776431321.0,2921.963798324338,-63.97,4
09:35,779376323.0,2758.423215820126,-35.91,4
09:36,136770968.0,-189.98510000000027,-9.99,4
09:37,256002321.0,7885.29832196028,-112.69,2
09:37,719742742.0,282.50649222203657,-90.27,2
09:38,865748375.0,5142.3755339182535,-50.0,2
09:39,170637730.0,2712.1909701318705,-22.08,7
09:41,460463595.0,-1157.197945418579,-84.24,5
09:42,866941383.0,1895.8848500000047,-29.96,7
09:45,398429109.0,1618.434950000001,-243.5,2
09:46,508518911.0,129.07675027901053,-74.99,2
09:47,170637730.0,2650.1620741850707,-62.03,5
09:48,962295212.0,-2946.9601499999976,-94.91,5
09:49,246753533.0,523.6209999999987,-35.98,2
09:51,494977194.0,1752.4376205975768,-97.98,2
09:53,653667523.0,5631.2031403534575,-19.99,2
09:53,285220959.0,11050.852028707584,-32.56,5
09:55,479366718.0,1604.5000976323995,-11.98,4
09:55,970298834.0,2829.42250081602,-35.07,2
09:56,575652395.0,1086.314419761827,-206.5,2
10:00,828532554.0,1037.6725095129466,-35.98,2
10:03,781554833.0,2418.289063609717,-54.96,5
10:03,256002321.0,7775.41232196028,-109.89,2
10:04,892354433.0,-246.9494606343388,-50.0,2
10:05,659415300.0,2584.369870894227,-6.05,9
10:06,266777719.0,88.63143378023968,-47.14,2
10:06,556992209.0,10502.669736083051,-16.0,4
10:07,449387287.0,-346.4083061648985,-100.97,5
10:08,856957948.0,8553.736512498259,-35.0,2
10:09,987229118.0,3858.1233350832335,-19.99,2
10:11,950234174.0,1193.1099419816958,-145.0,2
10:12,480198977.0,11183.225297642572,-99.35,5
10:13,272538745.0,13050.049900000022,-19.99,4
10:15,873701090.0,766.551982586864,-72.2,2
10:16,151916463.0,1424.5905555991687,-57.06,2
10:19,575652395.0,865.8144197618267,-220.5,2
10:21,657139925.0,12019.086334208236,-1.29,2
10:22,256002321.0,7665.54032196028,-109.87,2
10:22,246753533.0,518.6209999999987,-5.0,9
10:22,913801979.0,543.5675299144939,-3.99,4
10:25,183888402.0,15950.116828599448,-51.67,2
10:25,904154012.0,947.7174581204324,-25.96,7
10:25,475277431.0,28.013136943619557,-10.99,4
10:26,261894284.0,-2600.806299999998,-58.91,5
10:27,960208650.0,15029.291017403812,-159.96,4
10:27,685959099.0,2463.316866099241,-28.0,2
10:31,586041848.0,665.1186999999991,-115.81,5
10:34,398429109.0,1455.944950000001,-162.49,2
10:35,873701090.0,728.6658227806067,-37.89,8
10:40,901432314.0,3926.419716771268,-29.79,5
10:41,901432314.0,3849.695064711854,-76.72,2
10:41,648644594.0,-860.7578500000009,-88.88,5
10:44,256002321.0,7656.417060889148,-9.12,2
10:44,162162212.0,-240.2798066726911,-98.65,5
10:49,788740658.0,3241.3140296683705,-24.98,7
10:57,719742742.0,213.92049222203656,-68.59,2
10:58,611143859.0,5409.69640000001,-13.0,2
11:00,657139925.0,11884.700334208235,-134.39,2
11:01,534204159.0,6456.569108672216,-3.96,7
11:01,461029994.0,5978.149082343871,-49.98,2
11:04,441142605.0,2555.252250000003,-5.98,4
11:06,398429109.0,1385.454950000001,-70.49,2
11:11,215404070.0,286.2995891798497,-181.97,2
11:14,892354433.0,-326.9494606343388,-80.0,2
11:16,480198977.0,11143.245297642572,-39.98,4
11:17,719742742.0,50.834492222036545,-163.09,2
11:17,192202372.0,317.93840302901106,-49.98,2
11:18,604288474.0,3000.070946338062,-14.38,5
11:20,386277162.0,181.9499999999996,-97.99,2
11:22,788740658.0,3148.1580296683705,-93.16,5
11:25,409370545.0,235.49177554552017,-34.09,7
11:29,679943657.0,3798.1844500000097,-80.39,2
11:39,738958551.0,7979.986657903001,-60.22,2
11:40,479456865.0,1113.2639814894048,-16.5,4
11:47,719742742.0,-96.16550777796346,-147.0,2
11:50,527842638.0,1389.2919426329838,-46.04,5
11:50,310620484.0,631.8967381437228,-35.21,2
11:54,779236304.0,337.8083608200531,-13.5,2
12:05,176922958.0,244.6182528044484,-69.09,7
12:05,960208650.0,14993.271017403811,-36.02,2
12:05,930277104.0,9823.32256753956,-50.74,2
12:10,655368335.0,4632.859304228785,-3.37,2
12:18,719742742.0,-201.15150777796345,-104.99,2
12:21,892354433.0,-405.9494606343388,-79.0,2
12:33,444428189.0,1149.792800000003,-29.96,7
12:36,915666111.0,-3705.2070747720377,-24.43,5
12:36,425730826.0,75.78190938871967,-22.18,5
12:37,160166876.0,973.283690586244,-29.98,2
12:40,399144202.0,2592.7256343681165,-4.95,8
12:41,145387690.0,5092.362861556148,-34.4,9
12:43,322221939.0,3590.6807305418224,-35.42,7
12:45,776431321.0,2915.973798324338,-5.99,1
12:46,987656636.0,5739.233188395514,-142.86,5
12:50,333054026.0,-1023.50010597681,-14.37,5
12:50,766692943.0,-1816.6867500000003,-26.67,5
12:51,867679563.0,-37.79464629828417,-39.95,5
13:00,398429109.0,1302.964950000001,-82.49,2
13:00,719742742.0,-360.02350777796346,-158.87,2
13:03,564214408.0,-141.2945152742738,-29.9,5
13:04,984783496.0,12856.941062160571,-34.71,7
13:05,256002321.0,7517.145060889148,-139.27,2
13:05,217540156.0,-3105.1873199999955,-27.13,5
13:06,910730524.0,7425.516599402811,-5.7,9
13:08,849096144.0,1923.4337896445743,-5.7,9
13:18,688712152.0,5905.113996957471,-6.15,9
13:19,715068825.0,573.4244999999999,-77.99,2
13:33,679943657.0,3706.4774500000094,-91.71,5
13:33,718058208.0,1055.2713851555957,-33.03,4
13:34,663479159.0,989.4335418277084,-21.97,7
13:36,575652395.0,771.3144197618267,-94.5,2
13:38,256002321.0,7407.9590608891485,-109.19,2
13:43,892354433.0,-490.9494606343388,-85.0,2
13:43,933745726.0,-1951.0089435706768,-69.39,5
13:46,948558249.0,8436.024015959809,-23.9,5
13:47,398429109.0,535.4949500000009,-101.49,2
13:53,386277162.0,16.979999999999563,-164.97,2
13:55,553734946.0,450.86599999999896,-22.0,2
13:56,252419513.0,-1720.4284358134162,-50.81,5
14:07,834383043.0,4944.628043977827,-55.98,2
14:07,828750680.0,344.3445452136799,-132.75,5
14:08,575652395.0,543.1144197618266,-228.2,2
14:09,892354433.0,-550.9494606343387,-60.0,2
14:12,189757473.0,-1973.7611500000007,-30.86,5
14:13,256002321.0,7276.359060889148,-131.6,2
14:17,522188082.0,7344.077875957753,-48.04,4
14:19,605711527.0,-196.5294861674165,-123.77,5
14:21,719742742.0,-445.3955077779635,-85.37,2
14:29,386277162.0,-192.00000000000043,-208.98,2
14:32,383345285.0,735.9803264119239,-35.0,2
14:37,162162212.0,-253.25980667269113,-12.98,7
14:39,719742742.0,-632.9675077779634,-187.57,2
14:40,575652395.0,327.5144197618266,-215.6,2
14:42,383345285.0,604.0003264119239,-131.98,2
14:46,912584712.0,480.72061954473304,-26.96,1
14:46,256002321.0,7139.873060889148,-136.49,2
14:48,386277162.0,-239.99000000000044,-47.99,2
14:51,575652395.0,240.7144197618266,-86.8,2
14:51,892354433.0,-729.9494606343387,-179.0,2
14:51,279149837.0,782.663049999999,-15.98,1
14:54,886921642.0,3330.3451116680058,-15.82,5
14:58,892354433.0,-855.9494606343387,-126.0,2
14:58,233981231.0,1818.4927391616957,-53.44,5
15:00,133755851.0,631.6666308829102,-89.97,4
15:04,383345285.0,552.0103264119239,-51.99,2
15:11,719742742.0,-889.8675077779634,-256.9,2
15:11,901432314.0,3832.5768647118534,-17.12,4
15:12,598793068.0,478.8892499999984,-25.96,7
15:15,985188462.0,840.0202487112246,-40.7,2
15:16,892354433.0,-894.9494606343387,-39.0,2
15:23,399538448.0,7042.382712652365,-99.8,4
15:27,670102069.0,3640.825443672017,-19.27,7
15:29,691012931.0,-1643.992250000001,-15.13,5
15:38,517934629.0,1495.9676787084263,-63.0,2
15:41,321372947.0,-378.9413507890993,-48.23,5
15:42,116598243.0,2147.98932775601,-55.26,2
15:43,761272540.0,56.1543999999989,-95.68,5
15:44,198946608.0,5468.20418566311,-85.0,7
15:47,892354433.0,-1071.4494606343387,-176.5,2
15:47,407574996.0,3396.544363734572,-139.63,5
15:53,280098744.0,1119.2653778716656,-15.97,4
15:56,719742742.0,-981.5535077779634,-91.69,2
15:56,176922958.0,204.0382528044484,-40.58,2
15:57,812692024.0,4276.447178787428,-50.51,5
16:09,865748375.0,5012.405533918253,-129.97,2
16:10,296972867.0,-623.3273000000007,-7.24,9
16:11,719742742.0,-1075.2835077779637,-93.73,2
16:13,398429109.0,455.0149500000009,-80.48,2
16:17,403383649.0,1282.1485643427586,-10.0,1
16:18,256002321.0,7008.273060889148,-131.6,2
16:25,310375875.0,3671.585098225596,-25.28,9
16:25,398429109.0,406.0249500000009,-48.99,2
16:26,670102069.0,3627.226003960067,-13.6,7
16:29,241459011.0,771.8353132723471,-17.01,5
16:29,865748375.0,4991.435533918253,-20.97,1
16:30,575652395.0,88.11441976182661,-152.6,2
16:43,256002321.0,6889.287060889148,-118.99,2
16:49,398429109.0,306.55495000000093,-99.47,2
16:50,719742742.0,-1165.5695077779635,-90.29,2
16:50,838830098.0,1437.6870920877843,-49.99,2
16:56,383345285.0,492.03032641192385,-59.98,2
17:03,398429109.0,192.06495000000092,-114.49,2
17:07,822250278.0,6300.990727780982,-26.95,9
17:07,383345285.0,425.04032641192384,-66.99,2
17:09,496395938.0,11746.3481894828,-2.57,4
17:11,331450202.0,6318.575321558276,-19.21,8
17:13,598793068.0,469.8992499999984,-8.99,4
17:13,256002321.0,6826.987060889148,-62.3,2
17:14,500843551.0,392.4861499999997,-9.99,7
17:15,398429109.0,85.58495000000093,-106.48,2
17:15,752362502.0,8417.723470259989,-21.41,7
17:15,500043411.0,12435.866534497109,-42.59,7
17:17,336557504.0,1542.9997692497411,-12.99,2
17:19,376271050.0,749.2702468611794,-58.48,4
17:20,435984758.0,5081.637154735668,-1.5,4
17:21,629078930.0,1510.3976723281828,-14.32,7
17:22,449871732.0,8970.186113265705,-6.99,1
17:22,310375875.0,3644.975098225596,-26.61,7
17:23,117273481.0,7985.162360178158,-51.98,4
17:23,679911053.0,2194.781379630611,-66.99,2
17:25,245690309.0,8214.252925008877,-36.63,4
17:27,892354433.0,-1205.9494606343387,-134.5,2
17:29,886837068.0,-85.2419000000005,-89.98,2
17:30,586315521.0,10934.169716308566,-8.24,4
17:31,373875019.0,14060.667402803743,-26.96,1
17:31,256002321.0,6696.115060889148,-130.87,2
17:31,510101371.0,11947.50455662382,-302.4,2
17:32,719742742.0,-1297.8695077779637,-132.3,2
17:32,769311479.0,6631.391756161598,-16.02,7
17:33,138609932.0,4262.556003294585,-14.95,4
17:33,146909202.0,4263.499396267706,-101.19,2
17:34,785210466.0,1911.6423041968255,-66.57,5
17:34,675231808.0,14256.932086489183,-45.34,5
17:34,706250160.0,10279.865445592726,-296.8,2
17:36,449871732.0,8964.196113265705,-5.99,2
17:37,398429109.0,-117.91504999999908,-203.5,2
17:37,679911053.0,2132.2823283397133,-62.5,2
17:37,531186970.0,887.5535562436195,-12.99,2
17:38,117273481.0,7973.182360178159,-11.98,7
17:40,146909202.0,4190.669396267706,-72.83,2
17:40,785749304.0,7876.95974262405,-219.76,2
17:45,424397946.0,2009.736783605399,-133.01,5
17:47,534325901.0,6020.203659118691,-56.08,5
17:48,534325901.0,6005.213659118691,-14.99,9
17:49,892354433.0,-1300.9494606343387,-95.0,2
17:50,719742742.0,-1428.0555077779634,-130.19,2
17:50,416060965.0,878.1172320979584,-24.85,9
17:51,398429109.0,-262.40504999999905,-144.49,2
17:51,131388684.0,19466.107728489875,-28.67,2
17:52,425964226.0,2905.2276500000016,-60.98,2
17:53,518474507.0,13103.089551030893,-33.69,2
17:55,706250160.0,10111.865445592726,-168.0,2
17:55,417850087.0,15206.838058356008,-50.09,4
17:56,806358207.0,10786.06112238945,-32.89,2
18:03,785749304.0,7738.37374262405,-138.59,2
18:05,618514666.0,18174.40644726166,-73.18,5
18:05,329840194.0,911.2086501431478,-48.89,5
18:06,878989510.0,4632.138077321595,-133.9,5
18:06,516051449.0,1944.5655090142911,-182.0,2
18:06,256002321.0,6534.429060889148,-161.69,2
18:06,290818242.0,6415.598883871575,-9.31,5
18:08,245690309.0,8151.154925008877,-63.1,5
18:10,510101371.0,11909.25455662382,-38.25,9
18:13,719742742.0,-1460.3055077779634,-32.25,9
18:14,706250160.0,9819.265445592726,-292.6,2
18:17,287480331.0,11486.588706804174,-36.95,9
18:18,892354433.0,-1368.4494606343387,-67.5,2
18:21,919185264.0,3817.637527740503,-54.77,5
18:21,601627384.0,4618.731422840748,-42.4,9
18:24,462962606.0,176.8165499999989,-31.37,5
18:24,391559884.0,148.65684999999945,-29.71,9
18:25,486495235.0,1072.6566393887158,-29.69,9
18:28,229205098.0,7121.4185660360245,-46.35,5
18:29,245690309.0,8112.292849275228,-38.86,2
18:29,706250160.0,9792.406445592726,-26.86,5
18:30,844835978.0,8557.419265270117,-10.98,5
18:33,834581602.0,376.5258999999994,-35.98,7
18:34,516051449.0,1804.5655090142911,-140.0,2
18:37,310375875.0,3549.131098225596,-95.84,5
18:42,705848712.0,23219.74148885897,-11.86,7
18:42,892354433.0,-1532.4494606343387,-164.0,2
18:44,195895574.0,6490.1172446603505,-26.0,9
18:46,720221651.0,-2168.266366598435,-16.55,5
18:47,555804115.0,-1557.6885475587026,-16.83,5
18:48,414454079.0,799.1468500000018,-5.07,7
18:48,270374623.0,9517.520340967672,-74.96,5
18:49,851181128.0,4322.116933624526,-27.24,9
18:51,296770890.0,1750.097010379083,-82.47,5
18:52,349107386.0,-3049.963473194562,-47.89,5
18:52,672913754.0,9195.566776019545,-119.64,5
18:52,806358207.0,10764.95628238945,-21.1,7
18:53,859603181.0,3881.1758386093466,-27.95,5
18:57,229205098.0,7067.154566036024,-54.26,5
19:00,901432314.0,3805.3048647118535,-27.27,5
19:02,516051449.0,1755.5655090142914,-49.0,2
19:04,433917275.0,7600.440200951215,-12.24,7
19:04,678851253.0,3100.4820626240385,-88.96,5
19:06,585133606.0,4401.3606653145025,-216.22,5
19:10,627723633.0,-1455.1584780037629,-127.18,5
19:11,943329213.0,2196.3859058462144,-9.44,7
19:13,280200287.0,-1174.845453386949,-80.47,5
19:16,203466392.0,2452.962233731548,-76.93,5
19:17,951817450.0,8711.778883968387,-87.25,5
19:18,482513594.0,6555.681014574439,-6.41,7
19:23,414805878.0,13320.767220467598,-29.52,9
19:24,518474507.0,13058.401551030893,-44.69,5
19:33,331450202.0,6278.297321558276,-40.28,5
19:33,672913754.0,9124.933518387368,-70.63,8
19:40,838830098.0,1379.6525420877845,-58.03,5
19:47,429235692.0,-1401.17,-193.24,5
19:53,547010927.0,21646.88836500059,-30.89,9
19:54,764450279.0,19060.713000746244,-117.96,5
19:56,867987292.0,4120.640934581185,-77.74,7
20:00,720742759.0,1076.049830883008,-274.63,5
20:01,373875019.0,13957.200402803745,-103.47,5
20:04,885259672.0,3647.059198714838,-51.95,7
20:06,949032480.0,5035.819299960638,-36.1,9
20:06,795847804.0,20220.42062154154,-61.68,5
20:07,627936697.0,649.8713499999998,-44.85,9
20:10,690523499.0,778.6178999999996,-115.43,5
20:12,166019891.0,7214.715975917083,-30.77,5
20:15,994947671.0,1448.8957000000005,-17.69,9
20:16,874431242.0,7836.26338311599,-27.86,7
20:24,785749304.0,7724.43374262405,-13.94,9
20:25,639409800.0,30591.050466582783,-72.62,8
20:25,175452235.0,2409.65725,-19.51,5
20:28,191992682.0,-2356.244460292064,-117.66,5
20:29,235881534.0,11334.007333483649,-80.51,5
20:38,287230540.0,1097.8844326671558,-15.24,5
20:45,433837402.0,-1091.105868464188,-39.42,9
20:47,532478725.0,4887.2258471131145,-30.59,5
20:52,131388684.0,19438.387728489874,-27.72,5
20:56,719586818.0,17059.95846717648,-31.25,2
20:58,364357875.0,6136.516383802882,-106.66,5
21:08,653667523.0,5621.3914558132565,-9.81,8
21:30,624500124.0,3320.613178850582,-31.29,7
00:12,252760664.0,5807.507614350947,-3.59,8
00:13,337184232.0,-1320.8290000000004,-16.94,9
00:43,766941757.0,9119.049242893989,-36.45,9
00:50,348325817.0,9344.521676373632,-1.35,5
00:51,886921642.0,3258.6675861793105,-71.68,4
01:21,480557476.0,10396.556213204947,-10.07,2
01:35,613729471.0,7319.90490110678,-2.04,7
01:43,537487133.0,-1001.0576500000004,-31.73,9
01:47,899742927.0,12442.152653162297,-12.63,2
02:12,399144202.0,2552.5956343681164,-40.13,9
02:42,779236304.0,329.85759547953245,-7.95,4
02:47,169006407.0,11122.926822930422,-21.4,7
02:50,559995067.0,3712.374572716836,-45.86,2
02:50,518474507.0,13016.671551030891,-41.73,9
02:53,146909202.0,4174.661221828023,-16.01,5
03:01,547010927.0,21623.548365000588,-23.34,9
03:06,851181128.0,4289.976933624525,-32.14,9
03:18,779236304.0,287.81759547953243,-42.04,9
03:20,315546581.0,24272.085755649143,-9.99,4
03:23,179173981.0,6027.783596412558,-17.3,8
03:34,802697323.0,18980.294797749935,-31.38,9
03:35,550169791.0,18615.310999003283,-6.69,4
03:43,709608057.0,3280.05046869124,-33.52,9
03:45,987163717.0,5868.932850000005,-39.74,9
03:46,195895574.0,6470.127244660351,-19.99,9
03:50,534204159.0,6429.220818094493,-27.35,7
03:54,795847804.0,20213.595083663226,-6.83,4
03:55,785749304.0,7707.415354631155,-17.02,5
03:58,461990622.0,9001.243460630685,-29.93,2
04:02,730002588.0,12402.961631073444,-7.7,2
04:02,489964679.0,21520.016792849892,-35.75,9
04:06,454356905.0,2409.196197310051,-31.97,9
04:10,679662108.0,13705.95837225668,-8.7,2
04:11,675806859.0,6092.108860915226,-33.77,2
04:12,858989281.0,23882.614738111846,-14.7,9
04:12,687135796.0,24696.81380941285,-10.18,7
04:15,985188462.0,803.3002487112245,-36.72,9
04:19,195895574.0,6468.387310293516,-1.74,5
04:23,949032480.0,5011.829299960638,-23.99,9
04:25,196289502.0,13607.587994377722,-9.98,9
04:25,679911053.0,2115.8348570618687,-16.45,7
04:30,216285378.0,21129.82638463492,-36.64,9
04:31,417850087.0,15186.612117498686,-20.23,4
04:38,851649498.0,9459.652332591748,-44.88,7
04:40,407574996.0,3364.30851829354,-32.24,5
04:41,667367404.0,8141.159533828076,-36.48,2
04:42,633345190.0,6932.495064461874,-26.93,9
04:51,779946617.0,15126.388997182486,-11.04,7
04:51,905860285.0,15282.830406096964,-36.76,2
04:52,627622066.0,2310.698185693056,-33.13,9
04:55,572384506.0,9561.814125916018,-30.99,9
04:59,500043411.0,12389.259774547,-46.61,2
05:00,450896297.0,12379.708723864807,-6.42,5
05:00,836110591.0,6305.279849072513,-38.99,9
05:00,435984758.0,5006.9328526984345,-74.7,2
05:02,183888402.0,15923.436828599448,-26.68,9
05:07,973086490.0,9167.249405580653,-40.57,2
05:09,802697323.0,18973.481891052223,-6.81,2
05:10,221868392.0,4950.430110737616,-54.18,5
05:15,581655972.0,37978.46838323543,-2.41,7
05:16,824916823.0,8144.656308929324,-29.98,9
05:19,224215364.0,-1523.2764420882788,-25.59,9
05:21,113747882.0,10763.00293803664,-6.93,2
05:24,668329719.0,7389.963042090206,-24.98,7
05:25,383833857.0,21081.685749060627,-16.83,7
05:25,308505160.0,12165.32763454362,-0.24,7
05:29,853907490.0,6955.788288006355,-1.84,5
05:29,705848712.0,23204.29148885897,-15.45,9
05:38,873693307.0,8251.067231915484,-0.72,5
05:39,822135975.0,11755.46501923611,-34.25,2
05:42,532478725.0,4857.2258471131145,-30.0,9
05:46,806358207.0,10724.136597589344,-40.82,7
05:49,510101371.0,11872.12455662382,-37.13,9
05:50,994214354.0,8766.844547212862,-37.04,9
05:53,305778936.0,11192.804900985077,-12.82,2
05:55,213112754.0,6690.869466129938,-18.76,7
05:58,585133606.0,4377.340665314502,-24.02,9
06:04,719586818.0,17057.609357975787,-2.35,7
06:05,851181128.0,4264.490819439575,-25.49,7
06:05,108481285.0,8100.148337065129,-16.99,7
06:06,187541224.0,6468.74255922144,-35.49,9
06:09,511179916.0,7343.522799829511,-39.87,7
06:10,473820682.0,10642.820773944102,-5.81,2
06:12,897714622.0,8527.05751865913,-15.06,4
06:13,364357875.0,6100.998955863107,-35.52,2
06:18,668692488.0,1676.372303563902,-5.16,7
06:19,506618547.0,17064.808630700838,-16.22,4
06:24,324224854.0,3976.4937434145136,-1.65,5
06:24,433917275.0,7552.564666233125,-47.88,2
06:25,834383043.0,4928.262802200215,-16.37,8
06:28,541639148.0,4325.288354625638,-20.73,4
06:29,706250160.0,9774.71684377603,-17.69,5
06:30,229205098.0,7051.773525547313,-15.38,2
06:30,858989281.0,23861.57221536716,-21.04,7
06:32,383625050.0,5722.72524424987,-66.14,5
06:34,688712152.0,5902.263242207534,-2.85,7
06:35,454356905.0,2401.1548748617947,-8.04,2
06:36,421881811.0,5497.958582912094,-31.52,9
06:37,203466392.0,2412.421656642418,-40.54,2
06:39,532478725.0,4826.467369723395,-30.76,7
06:40,200080192.0,8881.584778205182,-23.29,7
06:43,108563213.0,20827.846078615356,-7.09,5
06:44,441274121.0,11376.968806655326,-56.19,8
06:46,749378808.0,5153.625099738364,-3.67,7
06:48,678851253.0,3064.736232103421,-35.75,7
06:48,822250278.0,6268.198317753434,-32.79,2
06:49,912705941.0,16690.226609010708,-16.28,7
06:50,647936800.0,1442.011597448665,-10.2,4
06:53,290818242.0,6385.090677666662,-30.51,4
06:54,705848712.0,23168.312202906654,-35.98,5
06:56,842682241.0,4929.539385261871,-8.28,2
06:59,849096144.0,1911.213858910517,-12.22,4
07:03,287480331.0,11455.751342514566,-30.84,8
07:06,815385232.0,9132.925718611325,-7.96,4
07:07,124102251.0,4262.922680570114,-44.68,8
07:10,131388684.0,19377.656884980297,-60.73,2
07:10,887853850.0,10088.382910178305,-23.66,2
07:10,414805878.0,13279.6172204676,-41.15,9
07:18,517934629.0,1490.4676787084263,-5.5,9
07:23,930277104.0,9821.510802682296,-1.81,4
07:24,809499628.0,14822.748982321118,-15.74,9
07:27,270374623.0,9457.80842195037,-59.71,8
07:29,699139822.0,2360.1939000561347,-35.17,8
07:31,176922958.0,141.69611153184658,-62.34,8
07:35,651756497.0,12812.16364600121,-13.94,7
07:38,496395938.0,11737.96276748762,-8.39,5
07:44,128033695.0,2997.2359310667157,-0.8,7
07:45,824916823.0,8130.4669640713855,-14.19,2
07:47,366550080.0,23094.33838078444,-58.02,5
07:50,482513594.0,6546.075934697298,-9.61,7
07:56,547010927.0,21606.07737837101,-17.47,7
08:07,454129843.0,769.9338507917888,-5.7,9
08:08,395284483.0,1334.9678135669678,-7.15,9
08:11,683319988.0,7167.451781541657,-21.56,5
08:12,241459011.0,765.3353132723471,-6.5,9
08:19,885259672.0,3641.409198714838,-5.65,9
08:20,237684254.0,5435.326269952562,-1.14,2
08:20,259015404.0,3654.633662081242,-32.94,7
08:27,494404688.0,-2364.608265336208,-30.42,5
08:30,569687509.0,-1994.8179,-21.64,5
08:31,607629901.0,-3740.490819908144,-32.68,5
08:33,548549094.0,-223.11362992650868,-64.2,5
08:34,891716230.0,107.18564807062054,-50.41,5
08:34,155867488.0,386.46569999999855,-71.95,5
08:35,111137699.0,-162.01474999999965,-59.77,5
08:36,986267641.0,5474.791911525436,-10.48,5
08:36,820686957.0,-794.5420163111959,-129.36,5
08:36,494789005.0,3079.6756919069967,-38.71,5
08:37,782013626.0,1813.9041993116275,-67.18,5
08:37,218795010.0,-134.15355000000037,-75.93,5
08:38,494156462.0,-848.6033864817604,-104.5,5
08:46,399538448.0,7003.385712652364,-39.0,5
08:47,380911501.0,-282.55955000000085,-82.33,5
08:47,196289502.0,13598.75141517573,-8.84,5
08:47,449871732.0,8821.732113265705,-142.46,5
08:47,189335192.0,-942.2570017578604,-156.33,5
08:51,119993184.0,-1949.8994029108624,-78.25,5
08:54,854513972.0,460.5430499999995,-146.19,5
08:55,767447966.0,3861.8298055121104,-125.22,5
08:56,643610517.0,-2787.018690729657,-45.11,5
08:56,949032480.0,5008.216954623108,-3.61,5
08:59,832564361.0,14200.602488744917,-53.35,2
09:05,581655972.0,37973.068383235426,-5.4,9
09:06,197865285.0,338.72421173122046,-5.25,9
09:08,609939116.0,6389.524724499457,-14.8,2
09:08,851649498.0,9454.502332591748,-5.15,9
09:08,519644021.0,2266.736327020282,-1.13,2
09:09,849096144.0,1812.9128589105171,-98.3,5
09:09,290751280.0,-293.75915332517434,-137.48,5
09:10,117273481.0,7968.0823601781585,-5.1,9
09:10,290818242.0,6379.590677666662,-5.5,9
09:14,815385232.0,9023.291718611325,-109.63,5
09:16,856957948.0,8540.75651249826,-12.98,4
09:16,522188082.0,7334.534859009522,-9.54,5
09:16,999752672.0,488.7204935333344,-5.4,9
09:16,116169597.0,853.9759499999996,-8.98,4
09:17,587225252.0,8999.669690216411,-75.07,5
09:17,984783496.0,12854.866402160573,-2.07,4
09:17,683319988.0,7161.751781541657,-5.7,9
09:17,598793068.0,460.9092499999984,-8.99,4
09:17,506618547.0,17059.808630700838,-5.0,9
09:17,246753533.0,488.6028999999987,-30.02,5
09:18,624563756.0,-391.4298712164437,-7.1,9
09:18,558875206.0,2349.066950000001,-6.5,9
09:19,264208990.0,654.7715499999991,-5.25,9
09:19,520239952.0,-1662.882376654763,-282.83,5
09:20,169006407.0,11115.426822930422,-7.5,9
09:20,690958123.0,17496.58972829008,-6.8,9
09:20,613729471.0,7284.69490110678,-35.21,6
09:22,586315521.0,10928.369716308567,-5.8,9
09:22,540159353.0,9845.195005190488,-7.5,9
09:23,383345285.0,330.54032641192384,-94.5,2
09:24,618138606.0,952.2698621516972,-5.35,9
09:24,425964226.0,2899.777650000002,-5.45,9
09:25,683078800.0,1562.1638920384876,-5.7,9
09:26,727417797.0,5088.727500000007,-65.09,2
09:28,120634201.0,4653.817500000004,-27.96,4
09:28,585625048.0,912.5416190586326,-123.0,5
09:29,943829984.0,309.0054091134573,-69.97,2
09:30,654329190.0,41.84980094851936,-9.99,1
09:30,106601471.0,8933.25034315919,-25.02,7
09:31,987656636.0,5718.565833472913,-20.67,7
09:32,280098744.0,1113.2753778716656,-5.99,2
09:32,697140785.0,-402.9983832638968,-151.07,5
09:33,169689461.0,1309.9960999999992,-79.98,2
09:34,352291960.0,2087.087403303574,-16.88,2
09:36,821971408.0,1898.1192292356316,-60.1,5
09:37,406862520.0,429.2605265374105,-206.86,5
09:41,383345285.0,263.55032641192383,-66.99,2
09:41,497809732.0,450.7128695525952,-54.48,2
09:41,175452235.0,2263.35725,-146.3,2
09:42,903663593.0,532.429618582982,-57.58,5
09:42,596171893.0,-215.9782551744889,-26.96,7
09:42,547010927.0,21583.37737837101,-22.7,2
09:43,647472692.0,21996.18222741217,-127.24,2
09:47,348525881.0,123.9516245949363,-27.96,7
09:50,223207876.0,183.54410000000007,-100.19,2
09:51,657139925.0,11825.970334208236,-58.73,5
09:51,551755686.0,7137.205067377236,-11.0,4
09:56,352291960.0,2060.837403303574,-26.25,2
10:00,727417797.0,4924.2555000000075,-164.47,2
10:01,844206657.0,-115.5022448534302,-94.28,5
10:01,282046994.0,-398.7656499999996,-106.36,5
10:03,593378953.0,871.242700000005,-136.5,2
10:03,647472692.0,21951.284227412165,-44.9,5
10:04,383345285.0,238.55032641192383,-25.0,2
10:05,834383043.0,4838.292802200215,-89.97,4
10:09,176922958.0,103.17611153184656,-38.52,1
10:09,155867488.0,382.4856999999986,-3.98,4
10:11,282837512.0,12200.114404532376,-4.35,9
10:11,544961962.0,1013.0543230056088,-172.0,2
10:13,187111705.0,5953.81770511203,-34.03,7
10:13,228136274.0,507.25094999999914,-275.1,2
10:13,284905540.0,7324.131818960158,-101.19,2
10:14,246753533.0,483.5528999999987,-5.05,9
10:16,391688371.0,624.9502895685231,-65.1,4
10:16,145387690.0,5080.941189028824,-11.42,8
10:21,298000165.0,22553.55363963964,-49.99,2
10:21,175452235.0,2016.25725,-247.1,2
10:25,250895529.0,1459.2771824692873,-112.0,2
10:26,352291960.0,1930.337403303574,-130.5,2
10:29,520447032.0,8427.633815684829,-20.41,2
10:33,383345285.0,181.06032641192385,-57.49,2
10:33,228136274.0,463.8789499999991,-43.37,2
10:34,709608057.0,3253.91046869124,-26.14,7
10:37,799453072.0,-353.21660000000105,-88.28,5
10:42,169689461.0,1277.0160999999991,-32.98,2
10:49,933491926.0,2648.872300000001,-5.97,7
10:52,909669130.0,197.98788473676663,-11.95,4
10:54,986774156.0,671.0509316257677,-97.27,2
10:55,250895529.0,1294.2771824692873,-165.0,2
10:56,644751433.0,-1246.1718584655382,-48.48,5
10:57,920830317.0,-147.79042936251847,-184.1,5
10:58,352291960.0,1822.712403303574,-107.62,2
10:59,228136274.0,386.89294999999913,-76.99,2
11:01,933745726.0,628.0110564293234,-40.98,2
11:02,593378953.0,704.242700000005,-167.0,2
11:02,535744551.0,542.1700159956265,-9.99,7
11:09,391688371.0,618.6712895685231,-6.28,5
11:12,175452235.0,1651.55725,-364.7,2
11:16,933745726.0,516.0410564293234,-111.97,2
11:18,228136274.0,50.19294999999914,-336.7,2
11:21,322221939.0,3574.9163629643613,-15.76,5
11:21,383345285.0,149.58032641192383,-31.48,2
11:22,366550080.0,23032.22038078444,-62.12,5
11:23,448004226.0,2359.888461930605,-35.0,2
11:25,886921642.0,3226.6175861793104,-32.05,2
11:28,527842638.0,1227.3219426329838,-161.97,2
11:28,910730524.0,7394.74160767615,-30.77,5
11:29,469330905.0,788.0560680292155,-68.6,2
11:33,933745726.0,501.06105642932334,-14.98,1
11:37,593378953.0,505.242700000005,-199.0,2
11:39,403383649.0,1254.1585643427586,-27.99,1
11:43,497809732.0,396.2428695525951,-54.47,2
11:44,469330905.0,608.1840680292155,-179.87,2
11:44,143003091.0,19675.74704236508,-27.97,4
11:45,383345285.0,120.08032641192383,-29.5,2
11:45,895331556.0,-807.0077000000007,-24.98,5
11:46,670102069.0,3588.889673774298,-38.34,2
11:50,175452235.0,1407.25725,-244.3,2
12:11,984783496.0,12746.030402160572,-108.84,5
12:12,155867488.0,220.15569999999855,-162.33,2
12:13,187111705.0,5906.451588751743,-47.37,4
12:14,285873880.0,10299.014772702203,-6.27,7
12:16,254853117.0,2939.3728099012706,-25.99,7
12:16,497809732.0,261.2728695525952,-134.97,2
12:17,383345285.0,57.09032641192384,-62.99,2
12:18,655368335.0,4619.879304228785,-12.98,9
12:18,950234174.0,1154.540429530981,-38.57,2
12:30,718058208.0,1033.4877922064777,-21.78,7
12:32,535744551.0,533.1800159956265,-8.99,4
12:39,497809732.0,65.29286955259516,-195.98,2
12:40,175452235.0,1246.25725,-161.0,2
12:41,570269025.0,2464.189103575496,-24.97,1
12:41,147341222.0,-1396.3320753207956,-64.42,5
12:42,749378808.0,5120.185099738364,-33.44,9
12:55,284905540.0,7152.101818960158,-172.03,6
12:56,348325817.0,9128.921676373631,-215.6,2
12:56,214765415.0,-609.6337488501354,-79.3,5
12:57,727417797.0,4764.655500000007,-159.6,2
12:58,856461967.0,-306.3636464705075,-38.41,5
12:59,670102069.0,3552.899673774298,-35.99,9
12:59,849096144.0,1806.4128589105171,-6.5,9
12:59,383345285.0,-15.38967358807615,-72.48,2
13:00,593378953.0,282.242700000005,-223.0,2
13:00,899983008.0,-2769.911149999998,-40.99,5
13:01,817294757.0,-2619.8333,-26.69,5
13:07,175452235.0,978.1572500000002,-268.1,2
13:17,175452235.0,859.8572500000002,-118.3,2
13:19,522188082.0,7315.514859009521,-19.02,2
13:19,910730524.0,7389.04160767615,-5.7,9
13:21,688712152.0,5897.963242207534,-4.3,9
13:23,550832673.0,2452.319048823173,-51.88,5
13:24,727417797.0,4694.655500000007,-70.0,2
13:26,909676212.0,1151.989617470368,-22.97,1
13:28,348325817.0,8869.921676373633,-259.0,2
13:29,383345285.0,-54.88967358807615,-39.5,2
13:33,152616936.0,415.5170078630648,-78.22,5
13:34,198946608.0,5462.90976344583,-5.29,8
13:34,637649383.0,434.58744999999834,-27.54,9
13:35,475117511.0,7925.307576607248,-53.98,2
13:40,899742927.0,12367.162653162295,-74.99,2
13:40,593378953.0,204.74270000000504,-77.5,2
13:41,987390838.0,-2714.238741210379,-35.82,5
13:43,175452235.0,607.8572500000002,-252.0,2
13:46,435313070.0,2666.768357353609,-51.04,5
13:46,475117511.0,7875.327576607248,-49.98,4
13:51,479456865.0,995.0602314894048,-118.2,5
13:52,383345285.0,-110.88967358807616,-56.0,2
13:55,593378953.0,79.74270000000502,-125.0,2
13:57,399144202.0,2500.3526373799677,-52.24,2
14:00,964702094.0,1441.134581662935,-5.99,2
14:05,549414742.0,6864.719675922238,-29.4,9
14:07,383833857.0,21068.445749060626,-13.24,1
14:13,250895529.0,1214.2771824692873,-80.0,2
14:15,653667523.0,5393.191455813257,-228.2,2
14:15,175452235.0,392.2572500000002,-215.6,2
14:15,348325817.0,8803.421676373633,-66.5,2
14:27,993663752.0,175.92544241039658,-42.23,5
14:28,973086490.0,9151.009405580651,-16.24,9
14:32,593378953.0,-9.757299999994984,-89.5,2
14:33,383345285.0,-158.37967358807614,-47.49,2
14:43,348325817.0,8559.821676373633,-243.6,2
14:44,469330905.0,424.1120680292155,-184.07,2
14:46,593378953.0,-115.75729999999498,-106.0,2
14:49,970298834.0,2821.596444986502,-7.83,4
14:49,556992209.0,10333.297736083052,-169.37,2
14:54,175452235.0,120.65725000000026,-271.6,2
14:54,250895529.0,1154.2771824692873,-60.0,2
14:56,383345285.0,-265.8696735880761,-107.49,2
14:56,653667523.0,5279.105455813256,-114.09,2
15:00,696333897.0,362.0955999999992,-40.99,2
15:02,556992209.0,10296.925736083052,-36.37,2
15:03,933745726.0,376.07105642932333,-124.99,2
15:07,709608057.0,3249.967990325142,-3.94,7
15:08,383345285.0,-344.8696735880761,-79.0,2
15:20,469330905.0,250.5540680292155,-173.56,2
15:20,225210798.0,440.5617737592089,-150.23,5
15:25,228136274.0,-61.79305000000086,-111.99,2
15:29,155867488.0,-5.916300000001456,-226.07,2
15:31,653667523.0,5231.533455813256,-47.57,2
15:32,593378953.0,-249.75729999999496,-134.0,2
15:33,173335108.0,4701.939999999999,-6.99,4
15:38,469330905.0,201.58206802921552,-48.97,2
15:42,383345285.0,-393.35967358807613,-48.49,2
15:44,175452235.0,-67.64274999999972,-188.3,2
15:44,329840194.0,873.0686501431478,-38.14,2
15:47,653667523.0,5104.147455813256,-127.39,2
15:50,593378953.0,-349.257299999995,-99.5,2
15:55,383345285.0,-457.85967358807613,-64.5,2
15:57,228136274.0,-191.9650500000008,-130.17,2
15:58,632065391.0,-2227.2336499999997,-102.43,5
15:59,175452235.0,-284.64274999999975,-217.0,2
16:01,613427466.0,5655.944905655875,-4.99,7
16:02,383345285.0,-527.3496735880761,-69.49,2
16:02,469330905.0,61.62406802921552,-139.96,2
16:03,742223719.0,580.4843073048028,-29.25,7
16:04,653667523.0,5052.361455813256,-51.79,2
16:04,823208989.0,1559.315038696223,-51.34,2
16:12,348325817.0,8368.721676373632,-191.1,2
16:14,587225252.0,8995.814341746163,-3.86,2
16:19,593378953.0,-418.757299999995,-69.5,2
16:28,516051449.0,1705.5755090142914,-49.99,4
16:33,742223719.0,533.9843073048028,-46.5,7
16:36,867987292.0,3879.840934581185,-240.8,2
16:36,228136274.0,-270.3510500000008,-78.39,2
16:37,587225252.0,8970.444341746163,-25.37,2
16:39,383345285.0,-646.8296735880762,-119.48,2
16:40,534097839.0,-4140.466049999998,-34.91,5
16:41,653667523.0,4793.417455813255,-258.94,2
16:42,175452235.0,-688.5427499999997,-197.4,2
16:43,678330503.0,1976.1744181306528,-43.3,2
16:47,736310094.0,-789.946124027426,-37.6,5
16:47,126929801.0,1128.8999190559712,-47.0,2
16:48,409971170.0,1911.2163502933795,-97.73,5
16:50,492215823.0,65.01117381544302,-31.2,4
16:51,409971170.0,1878.71908083112,-32.5,2
16:54,469330905.0,-142.73393197078445,-204.36,2
16:55,698076160.0,5536.496956219422,-38.94,1
16:55,742223719.0,485.9843073048028,-48.0,4
16:57,298000165.0,22543.56363963964,-9.99,4
16:58,698076160.0,5510.846418168622,-25.65,4
16:58,583579399.0,604.8993499999991,-50.0,2
17:01,383345285.0,-686.3296735880762,-39.5,2
17:02,527842638.0,1190.3419426329838,-36.98,4
17:07,901037631.0,1294.7473230964065,-213.49,2
17:08,887853850.0,10056.132910178305,-32.25,9
17:09,522188082.0,7113.214859009521,-202.3,2
17:10,653667523.0,4710.887455813256,-82.53,2
17:12,228136274.0,-428.5370500000008,-158.19,2
17:14,549414742.0,6852.340764228613,-12.38,4
17:15,874431242.0,7834.20722715701,-2.06,8
17:15,984783496.0,12741.295021700447,-4.74,2
17:17,235881534.0,11298.16910319123,-35.84,4
17:20,469330905.0,-364.6339319707844,-221.9,2
17:20,417850087.0,15138.144117498685,-48.47,5
17:22,310375875.0,3521.938460149276,-27.19,2
17:22,510101371.0,11835.20455662382,-36.92,4
17:23,660874296.0,1605.4174499608464,-69.99,2
17:23,435984758.0,4980.912852698434,-26.02,7
17:23,314980178.0,2426.0818500000046,-57.99,2
17:24,909676212.0,1001.999617470368,-149.99,2
17:27,469330905.0,-518.6059319707845,-153.97,2
17:27,241459011.0,758.0336132723471,-7.3,5
17:28,383345285.0,-825.8096735880762,-139.48,2
17:28,720742759.0,1047.0898308830078,-28.96,1
17:31,901037631.0,1119.7473230964065,-175.0,2
17:32,699997811.0,1077.324150000003,-28.96,7
17:33,854895960.0,2653.2238084062474,-21.89,9
17:33,992204045.0,10627.121654610051,-21.99,7
17:34,196289502.0,13590.631415175729,-8.12,4
17:34,618514666.0,18141.45644726166,-32.95,1
17:35,705848712.0,23020.792202906658,-147.52,2
17:35,104832000.0,-2707.8173589058447,-37.84,5
17:36,639409800.0,30580.960266582784,-10.09,4
17:37,496395938.0,11674.58476748762,-63.38,5
17:38,280268430.0,4648.752464359782,-32.99,4
17:38,228136274.0,-539.0950500000008,-110.56,2
17:39,331450202.0,6273.237321558276,-5.06,7
17:40,531186970.0,560.6535562436195,-326.9,2
17:40,308068836.0,1641.959522568192,-98.8,5
17:42,250895529.0,1039.7771824692873,-114.5,2
17:43,522188082.0,6947.314859009522,-165.9,2
17:43,901037631.0,975.5893230964066,-144.16,2
17:44,414454079.0,794.0768500000017,-5.07,4
17:46,540159353.0,9790.205005190488,-54.99,2
17:47,140893085.0,4578.8210063654615,-28.0,2
17:47,310375875.0,3500.895200149276,-21.04,4
17:48,698076160.0,5480.856418168622,-29.99,2
17:48,383345285.0,-855.3096735880762,-29.5,2
17:48,867987292.0,3620.140934581186,-259.7,2
17:49,987163717.0,5853.372720000005,-15.56,4
17:50,151968462.0,8471.368769548113,-7.97,7
17:50,701070224.0,893.1987500000001,-38.53,9
17:53,462962606.0,155.8465499999989,-20.97,1
17:53,461990622.0,8808.043460630684,-193.2,2
17:54,282102606.0,-708.7868375771735,-71.96,5
17:54,469330905.0,-718.0639319707844,-199.46,2
17:56,534325901.0,5969.490977143181,-35.72,2
17:58,660874296.0,1505.4474499608464,-99.97,4
18:00,348325817.0,8317.121676373632,-51.6,2
18:01,867987292.0,3445.840934581185,-174.3,2
18:02,226703987.0,2348.633949999999,-135.8,2
18:04,522188082.0,6885.014859009521,-62.3,2
18:04,548638376.0,-295.58481324453345,-28.38,9
18:05,859603181.0,3825.807106889057,-55.37,7
18:06,558119802.0,28739.48426869439,-0.46,2
18:07,570575024.0,-893.7287000000005,-37.0,9
18:07,624563756.0,-470.4298712164437,-79.0,2
18:09,653667523.0,4603.0874558132555,-107.8,2
18:13,383345285.0,-881.7796735880762,-26.47,2
18:13,556992209.0,10094.639736083052,-202.29,2
18:14,155867488.0,-220.10230000000143,-214.19,2
18:15,469330905.0,-917.5499319707844,-199.49,2
18:15,421475159.0,-551.6037373255874,-31.89,9
18:17,824916823.0,8126.406964071385,-4.06,7
18:22,581655972.0,37945.950383235424,-27.12,5
18:22,450896297.0,12354.638723864808,-25.07,9
18:23,131388684.0,19329.958884980297,-47.7,5
18:23,500843551.0,243.87859999999972,-148.61,5
18:25,461990622.0,8557.443460630684,-250.6,2
18:26,690958123.0,17377.28872829008,-119.3,5
18:27,226703987.0,2313.633949999999,-35.0,2
18:29,653667523.0,4266.401455813256,-336.69,2
18:30,687135796.0,24690.81380941285,-6.0,9
18:33,624563756.0,-569.9298712164436,-99.5,2
18:35,534325901.0,5942.4609771431815,-27.03,7
18:38,291128777.0,-2569.0964405263694,-27.04,5
18:43,736340277.0,7577.32722523651,-15.79,5
18:44,456221621.0,838.5900673026282,-38.66,5
18:45,656812046.0,997.244528435378,-21.16,7
18:45,696758548.0,-3047.4253963201377,-13.49,5
18:48,482513594.0,6500.085934697298,-45.99,5
18:48,155317149.0,207.85954999999927,-86.68,5
18:49,383345285.0,-906.7796735880762,-25.0,2
18:51,155867488.0,-447.5883000000015,-227.49,2
18:53,850290152.0,-2610.0634999999984,-23.52,5
18:54,245690309.0,8085.2898594345725,-27.0,2
18:54,314980178.0,2273.4118500000045,-152.67,5
18:57,758160963.0,7590.266879320514,-80.14,7
18:58,653640811.0,14790.475973563356,-19.32,7
18:58,256002321.0,6515.689060889148,-18.74,9
19:00,226703987.0,2271.633949999999,-42.0,2
19:03,565175333.0,-3263.2560227298272,-43.79,5
19:04,138609932.0,4161.882003294585,-100.67,5
19:04,383345285.0,-1015.7696735880762,-108.99,2
19:07,237493332.0,12717.020601125983,-56.78,5
19:07,421881811.0,5434.580251310564,-63.38,7
19:08,764450279.0,19035.917841391245,-24.8,2
19:09,466649401.0,56.91026572319672,-40.42,5
19:09,446720287.0,-791.2172591815944,-114.79,5
19:14,499410772.0,-2737.3318629051623,-39.63,5
19:15,668175891.0,567.9340731584991,-71.31,2
19:18,704517789.0,15224.239709921269,-19.4,5
19:24,822135975.0,11743.21501923611,-12.25,9
19:26,969804197.0,-1764.8087500000006,-18.07,5
19:26,631744379.0,-1994.9112594910675,-37.58,5
19:31,518474507.0,13013.687512628883,-2.98,2
19:34,874431242.0,7684.14122715701,-150.07,5
19:36,120634201.0,4584.167500000004,-69.65,5
19:39,170637730.0,2649.410541233168,-0.75,2
19:40,752362502.0,8377.20408366253,-40.52,8
19:48,298007503.0,599.6961036256334,-76.55,5
19:51,678726554.0,-204.2292476516103,-145.82,5
19:54,487051121.0,259.5118399891072,-135.74,5
19:57,940569402.0,5474.95825894952,-12.38,9
19:58,948558249.0,8389.845015959809,-46.18,5
19:59,461029994.0,5954.5003759148185,-23.65,7
20:00,771125520.0,384.93784999999946,-41.53,9
20:12,138351025.0,-579.1649500000002,-121.58,5
20:13,380228542.0,-732.6501581844345,-163.69,5
20:19,550169791.0,18570.972999003283,-44.34,5
20:24,175452235.0,-706.3927499999998,-17.85,5
20:25,255814263.0,3585.399987992111,-123.19,5
20:39,425964226.0,2766.9106500000016,-132.87,5
20:43,213112754.0,6655.029466129938,-35.84,5
20:45,896821055.0,-652.0365263147646,-132.36,5
20:46,414805878.0,13267.087224460074,-12.53,7
20:50,259015404.0,3620.8936620812424,-33.74,9
20:58,700138124.0,5185.381300000004,-83.92,5
21:09,788740658.0,3106.443296496712,-41.71,2
21:09,472995101.0,1789.8988738883295,-29.9,9
21:58,510101371.0,11813.893696671026,-21.31,5
02:15,187541224.0,6426.212559221441,-42.53,9
02:26,417850087.0,15121.444117498684,-16.7,9
02:32,836110591.0,6266.349849072512,-38.93,9
02:32,879091637.0,-953.9654762620232,-28.5,9
02:41,749378808.0,5082.995099738365,-37.19,9
02:49,834581602.0,341.2858999999994,-35.24,9
03:07,558119802.0,28704.45426869439,-35.03,9
03:27,912705941.0,16661.20819270283,-29.02,2
03:28,736340277.0,7576.994327752441,-0.33,2
03:30,687135796.0,24675.57380941285,-15.24,9
03:33,766941757.0,9085.019242893986,-34.03,9
03:39,749378808.0,5078.036726785512,-4.96,7
03:42,510101371.0,11774.803696671026,-39.09,9
03:44,417850087.0,15115.88068645866,-5.56,5
03:46,558119802.0,28702.974583882893,-1.48,2
03:49,183888402.0,15883.506828599448,-39.93,9
03:50,678330503.0,1934.232110687512,-41.94,5
03:50,706250160.0,9769.2463823917,-5.47,5
03:51,179173981.0,6005.293596412558,-22.49,9
03:52,113747882.0,10729.432938036642,-33.57,9
03:52,760753808.0,-721.7839500000003,-32.54,9
03:54,252760664.0,5727.707224991921,-79.8,5
03:58,992204045.0,10616.814006343548,-10.31,4
04:03,987656636.0,5701.999682282695,-16.57,2
04:04,264550521.0,8699.63219530677,-23.41,8
04:04,779946617.0,15108.939755508123,-17.45,8
04:10,851649498.0,9453.57691886678,-0.93,2
04:22,489964679.0,21473.516792849892,-46.5,9
04:23,994214354.0,8734.004547212862,-32.84,9
04:27,441274121.0,11337.460472740848,-39.51,2
04:28,305778936.0,11185.662175976538,-7.14,2
04:28,679662108.0,13685.241495102468,-20.72,2
04:29,270374623.0,9447.895622771484,-9.91,5
04:31,815385232.0,9006.359287327967,-16.93,2
04:38,518474507.0,12971.937512628883,-41.75,9
04:38,687135796.0,24667.25574434823,-8.32,5
04:45,213112754.0,6643.363114548134,-11.67,2
04:47,285220959.0,11050.108822308484,-0.74,2
04:53,699139822.0,2346.4596661522983,-13.73,2
04:54,329840194.0,843.8786501431478,-29.19,9
04:55,414805878.0,13243.397224460074,-23.69,9
04:55,785749304.0,7644.151478665786,-63.26,4
04:55,601627384.0,4576.291422840748,-42.44,9
04:56,522188082.0,6861.135154534096,-23.88,7
05:01,604288474.0,2997.791611969657,-2.28,7
05:05,865748375.0,4972.966461881173,-18.47,5
05:08,718058208.0,979.9060432583922,-53.58,7
05:10,821971408.0,1883.399721374878,-14.72,5
05:11,675806859.0,6074.823791201016,-17.29,2
05:14,519644021.0,2217.5355405958844,-49.2,7
05:14,235881534.0,11274.04156284496,-24.13,5
05:15,570269025.0,2415.1597602572556,-49.03,8
05:17,858989281.0,23843.12221536716,-18.45,9
05:18,822135975.0,11682.63678607382,-60.58,7
05:18,496395938.0,11634.87757402837,-39.71,2
05:19,550169791.0,18509.81637077611,-61.16,2
05:24,986267641.0,5456.382534883459,-18.41,7
05:27,905860285.0,15247.785054225547,-35.05,2
05:27,766941757.0,9075.760802466417,-9.26,2
05:28,842682241.0,4917.567796922549,-11.97,2
05:30,518474507.0,12943.437022133186,-28.5,7
05:40,609939116.0,6377.396830321655,-12.13,2
05:40,145387690.0,5026.345988100015,-54.6,2
05:42,403383649.0,1220.0036702776326,-34.15,8
05:42,633345190.0,6899.035064461874,-33.46,9
05:45,203466392.0,2387.869280399577,-24.55,7
05:46,887853850.0,10032.302910178303,-23.83,9
05:50,287480331.0,11431.331342514566,-24.42,9
05:51,147474476.0,3778.326696701949,-17.94,5
05:53,282837512.0,12185.091206880905,-15.02,7
05:54,237493332.0,12707.980601125984,-9.04,9
05:56,613729471.0,7273.850233799617,-10.84,5
05:57,752362502.0,8353.737476894095,-23.47,2
05:59,124102251.0,4243.072495212477,-19.85,8
06:01,668329719.0,7312.903471431094,-77.06,5
06:04,985188462.0,774.8102487112245,-28.49,9
06:06,414454079.0,767.4868500000017,-26.59,9
06:06,656812046.0,995.4113325183174,-1.83,2
06:07,885259672.0,3637.928772412143,-3.48,4
06:13,364357875.0,6099.856198660601,-1.14,5
06:16,450896297.0,12316.758723864808,-37.88,9
06:17,858989281.0,23841.21572341807,-1.91,2
06:18,705848712.0,23008.792202906658,-12.0,9
06:19,769311479.0,6603.378852854935,-28.01,5
06:21,113747882.0,10683.801322110015,-45.63,7
06:23,500043411.0,12311.306412013011,-77.95,8
06:26,930277104.0,9783.896222466648,-37.61,2
06:27,704517789.0,15201.243458505036,-23.0,2
06:28,587225252.0,8951.955446793347,-18.49,8
06:30,836110591.0,6236.006863785764,-30.34,5
06:32,216285378.0,21085.18638463492,-44.64,9
06:34,383833857.0,21066.279571723215,-2.17,5
06:36,366550080.0,23020.522848518773,-11.7,2
06:43,473820682.0,10598.756197065712,-44.06,7
06:43,409971170.0,1860.687046311919,-18.03,2
06:44,549414742.0,6813.840764228613,-38.5,9
06:44,823208989.0,1553.2934809242042,-6.02,8
06:45,832564361.0,14157.399474899485,-43.2,4
06:46,348325817.0,8276.579373547675,-40.54,2
06:47,336557504.0,1510.029769249741,-32.97,9
06:53,229205098.0,6977.465721259049,-74.31,2
06:57,287480331.0,11398.525275333684,-32.81,2
06:59,435984758.0,4914.765751426933,-66.15,5
07:00,853907490.0,6903.605006844551,-52.18,7
07:00,170637730.0,2631.83727979702,-17.57,2
07:01,554792076.0,24409.921676292233,-2.77,5
07:01,809499628.0,14810.548982321116,-12.2,9
07:02,683319988.0,7136.5717815416565,-25.18,9
07:02,195895574.0,6465.653682774756,-2.73,5
07:07,887853850.0,9988.938434931944,-43.36,7
07:09,802697323.0,18935.551891052222,-37.93,9
07:10,187111705.0,5903.026486591242,-3.43,5
07:12,541639148.0,4325.255754839696,-0.03,7
07:12,547010927.0,21555.00737837101,-28.37,9
07:13,899742927.0,12362.853431686266,-4.31,5
07:14,738958551.0,7951.006657903002,-28.98,9
07:15,940569402.0,5462.416712785959,-12.54,2
07:17,259015404.0,3587.323662081242,-33.57,9
07:23,166019891.0,7166.430396373269,-48.29,7
07:27,146909202.0,4171.79786724463,-2.86,2
07:34,601627384.0,4545.667629447824,-30.62,7
07:37,480557476.0,10370.441676888457,-26.11,7
07:39,822250278.0,6253.340416751748,-14.86,8
07:39,399144202.0,2499.4215114313706,-0.93,5
07:41,308505160.0,12155.777889382349,-9.55,5
07:44,450896297.0,12278.931100635831,-37.83,4
07:49,290818242.0,6342.6451137944405,-36.95,2
07:49,482513594.0,6475.961205988743,-24.12,5
07:53,324224854.0,1353.4273763221297,-3.07,7
07:56,586315521.0,10887.517501153745,-40.85,2
07:56,949032480.0,5005.0743677938135,-3.14,2
07:58,237684254.0,5371.815047324772,-63.51,7
08:00,806358207.0,10715.722593496232,-8.41,5
08:05,901432314.0,3799.6048647118537,-5.7,9
08:05,527842638.0,1184.9419426329837,-5.4,9
08:10,973086490.0,9116.456650227929,-34.55,7
08:14,241459011.0,752.2336132723472,-5.8,9
08:18,191161970.0,-3285.354999999997,-23.69,5
08:20,399538448.0,6997.335712652364,-6.05,9
08:21,948558249.0,8382.245015959808,-7.6,9
08:22,979135922.0,-1834.6691994095493,-33.05,5
08:23,667367404.0,8136.291915446603,-4.87,8
08:23,395284483.0,1329.167813566968,-5.8,9
08:23,990461108.0,132.59931862061094,-33.1,5
08:24,782058249.0,-1258.4513733101617,-34.47,5
08:25,885259672.0,3632.2287724121434,-5.7,9
08:28,261793952.0,84.63126020381479,-89.54,5
08:28,490868147.0,-341.29822087869854,-44.04,5
08:31,581655972.0,37935.95251830802,-10.0,2
08:33,491392945.0,4043.7435000000055,-52.88,5
08:34,604288474.0,2949.673611969657,-48.12,5
08:34,454129843.0,764.1838507917888,-5.75,9
08:34,984783496.0,12731.61630990258,-9.68,7
08:35,758160963.0,7566.57537657823,-23.69,5
08:36,768271776.0,-577.2755467665793,-117.61,5
08:37,180719578.0,-3935.225249999996,-32.81,5
08:37,722358036.0,-253.2857093729174,-69.09,5
08:37,506618547.0,16996.788222840372,-63.02,7
08:38,621652856.0,1625.1419696105395,-116.32,5
08:38,549414742.0,6801.206734320096,-12.63,5
08:38,954263768.0,-275.9044000000002,-59.68,5
08:41,948069469.0,-777.842100000001,-113.08,5
08:41,108563213.0,20827.21666389401,-0.63,4
08:47,266777719.0,39.79143378023967,-48.84,5
08:47,163470640.0,699.0953,-76.28,5
08:47,873693307.0,8189.113847306631,-61.95,2
08:47,587202562.0,67.1428994170686,-106.03,5
08:48,237493332.0,12637.20090258408,-70.78,5
08:50,616924659.0,-315.2579201769146,-46.82,5
08:54,960208650.0,14968.794523938692,-24.48,4
08:54,815993333.0,532.1931690614072,-36.55,2
08:56,254853117.0,2799.8698099012704,-139.5,5
09:00,822718326.0,9452.985317538032,-68.7,5
09:00,659415300.0,2516.7025402507034,-67.67,2
09:01,741903302.0,2424.732897988479,-6.45,9
09:02,618138606.0,946.1698621516972,-6.1,9
09:03,290818242.0,6277.76911379444,-64.88,5
09:03,673025413.0,2365.5335573766993,-57.27,5
09:03,558875206.0,2343.6669500000007,-5.4,9
09:04,169006407.0,11110.07682293042,-5.35,9
09:05,117273481.0,7961.882360178159,-6.2,9
09:07,943829984.0,209.89380911345728,-99.11,5
09:07,809499628.0,14789.335021053888,-21.21,2
09:10,998390769.0,282.0372509405242,-123.76,5
09:11,290818242.0,6272.41911379444,-5.35,9
09:12,554792076.0,24309.863676292232,-100.06,5
09:12,992204045.0,10608.914006343548,-7.9,9
09:12,609939116.0,6279.026830321655,-98.37,2
09:13,417850087.0,15110.23068645866,-5.65,9
09:13,905860285.0,15133.167054225549,-114.62,5
09:14,613729471.0,7268.200233799617,-5.65,9
09:15,999752672.0,483.07049353333446,-5.65,9
09:17,355733816.0,4094.915349227419,-33.95,7
09:18,956717493.0,834.8843937283602,-86.1,5
09:18,593191200.0,1140.340499999999,-50.07,5
09:21,987229118.0,3717.9693350832335,-140.15,5
09:21,727417797.0,4666.695500000007,-27.96,1
09:22,540159353.0,9785.205005190488,-5.0,9
09:23,506618547.0,16991.13822284037,-5.65,9
09:24,722971557.0,-439.9602791569244,-51.91,5
09:26,298007503.0,567.2261036256334,-32.47,2
09:27,943829984.0,111.91380911345728,-97.98,2
09:28,480557476.0,10339.031676888457,-31.41,7
09:28,661295096.0,2860.1312044119345,-1.5,4
09:28,873701090.0,706.5440301237691,-22.12,7
09:32,987656636.0,5641.719682282695,-60.28,2
09:34,727417797.0,4615.2155000000075,-51.48,4
09:41,943329213.0,2160.9382207869253,-35.45,5
09:42,298007503.0,562.1661036256335,-5.06,1
09:43,266777719.0,27.771433780239672,-12.02,7
09:45,950234174.0,1152.6823535605738,-1.86,5
09:45,508518911.0,79.08675027901052,-49.99,2
09:45,776431321.0,2887.013798324338,-28.96,1
09:46,168414279.0,144.61478427492136,-36.64,5
09:47,553734946.0,428.38599999999894,-22.48,4
09:48,534204159.0,6393.2829256028135,-35.94,7
09:50,621652856.0,1574.1219696105395,-51.02,2
09:56,866941383.0,1805.914850000005,-89.97,4
10:04,943829984.0,76.92380911345728,-34.99,2
10:05,782013626.0,1733.4041993116275,-80.5,2
10:06,475277431.0,15.033136943619557,-12.98,7
10:07,903953091.0,2478.146762369467,-5.5,9
10:09,246753533.0,477.65289999999874,-5.9,9
10:11,287480331.0,11391.025275333684,-7.5,9
10:11,982286721.0,-3164.68802401773,-44.5,5
10:14,718058208.0,912.8560432583922,-67.05,2
10:14,792845450.0,893.972150000001,-50.98,2
10:15,973388795.0,811.9176761636216,-163.15,2
10:18,407574996.0,3327.9039883831115,-36.4,5
10:18,782013626.0,1611.6041993116276,-121.8,2
10:20,943829984.0,-29.57619088654272,-106.5,2
10:21,421881811.0,5396.7890713105635,-37.79,4
10:22,421881811.0,5392.993171251384,-3.8,5
10:23,322221939.0,3454.4393629643614,-120.48,5
10:25,370521542.0,22984.391848615294,-161.92,5
10:30,520447032.0,8404.74657336531,-22.89,7
10:30,346874167.0,132.41164999999918,-111.38,5
10:30,223207876.0,-52.34089999999992,-125.68,5
10:34,679943657.0,3350.205450000009,-202.97,2
10:35,943829984.0,-104.0461908865427,-74.47,2
10:40,402438092.0,530.2988999999991,-34.99,2
10:51,168414279.0,27.014784274921368,-117.6,2
10:52,973086490.0,9063.256650227928,-53.2,5
10:53,679943657.0,3143.047450000009,-207.16,2
10:53,703537476.0,1110.314249999999,-45.03,2
10:57,355733816.0,4088.9253492274192,-5.99,2
11:02,970298834.0,2689.3564449865016,-132.24,2
11:03,687135796.0,24649.70574434823,-17.55,1
11:08,370521542.0,22921.410077426735,-62.98,5
11:11,364357875.0,6089.746198660601,-10.11,2
11:12,679943657.0,2977.875450000009,-165.17,2
11:19,687135796.0,24583.447024348232,-66.26,4
11:19,782013626.0,1503.1041993116276,-108.5,2
11:22,454356905.0,2360.728299903114,-40.43,8
11:22,133755851.0,502.1666308829102,-129.5,2
11:22,916270283.0,1400.4182499999986,-22.96,7
11:25,168414279.0,2.014784274921368,-25.0,2
11:25,475277431.0,-6.946863056380444,-21.98,4
11:27,679943657.0,2937.303450000009,-40.57,2
11:32,687135796.0,24575.187024348234,-8.26,4
11:37,497772347.0,847.4291499999983,-12.98,4
11:42,472995101.0,1756.9488738883297,-32.95,7
11:45,179173981.0,5998.7925674894095,-6.5,8
11:46,782013626.0,1242.0041993116276,-261.1,2
11:51,133755851.0,385.1766308829102,-116.99,2
11:58,766941757.0,9062.120802466416,-13.64,2
12:03,671824917.0,-705.6732000000003,-22.48,9
12:04,679943657.0,2760.931450000009,-176.37,2
12:06,943829984.0,-303.0261908865427,-198.98,2
12:08,152616936.0,268.5270078630648,-146.99,2
12:10,782013626.0,1020.1041993116276,-221.9,2
12:13,550169791.0,18493.166370776107,-16.65,9
12:18,849096144.0,1775.452858910517,-30.96,1
12:23,598793068.0,438.9292499999984,-21.98,4
12:30,147508204.0,-335.40028221811343,-30.74,9
12:31,782013626.0,809.4041993116277,-210.7,2
12:31,412823730.0,-437.66002414951015,-25.24,9
12:34,598793068.0,416.9492499999984,-21.98,4
12:36,688712152.0,5873.9932422075335,-23.97,1
12:38,657528784.0,-62.06109999999934,-113.04,5
12:43,793781222.0,2039.998878947403,-118.3,7
12:44,117308635.0,1231.125615882456,-9.39,8
12:48,943829984.0,-358.0261908865427,-55.0,2
12:49,183888402.0,15857.686828599448,-25.82,2
12:51,538003940.0,1585.7000000000078,-38.95,1
12:53,165691047.0,-416.8694000000009,-47.32,5
12:58,903663593.0,479.439618582982,-52.99,2
12:59,823208989.0,1476.2579809242045,-77.04,4
13:01,192202372.0,197.04840302901107,-120.89,4
13:02,812839908.0,-1693.0223500000002,-56.84,5
13:04,688712152.0,5868.643242207533,-5.35,9
13:05,943829984.0,-457.5161908865427,-99.49,2
13:05,480557476.0,10332.531676888457,-6.5,9
13:09,277562576.0,554.1637507952724,-4.95,9
13:10,793781222.0,1949.698878947403,-90.3,4
13:10,187111705.0,5897.926486591242,-5.1,9
13:11,340321732.0,1234.2970500000029,-6.05,9
13:13,744211756.0,-3750.520749999994,-35.12,5
13:14,407574996.0,3320.1039883831113,-7.8,9
13:16,414454079.0,759.3868500000017,-8.1,4
13:18,749378808.0,5071.536726785512,-6.5,9
13:18,936917570.0,-2518.7699999999986,-56.64,5
13:23,812692024.0,4269.947178787428,-6.5,9
13:26,585625048.0,907.1416190586326,-5.4,9
13:47,168414279.0,-3.975215725078632,-5.99,4
13:51,668175891.0,485.0019231584991,-82.93,5
14:01,518746136.0,-1159.8897282369169,-32.15,5
14:09,792845450.0,887.982150000001,-5.99,4
14:35,586041848.0,609.1386999999991,-55.98,2
14:36,596171893.0,-235.96825517448892,-19.99,2
14:56,681955876.0,-1302.5131000000003,-67.89,5
14:58,358836279.0,197.66704280758603,-126.92,5
15:34,108931112.0,12721.623324972426,-4.37,5
15:35,517934629.0,1461.4976787084263,-28.97,2
15:39,776108637.0,635.8405536574957,-58.75,5
15:56,596171893.0,-268.9282551744889,-32.96,7
16:05,964913066.0,-2107.2122000000004,-27.95,5
16:22,964702094.0,1435.144581662935,-5.99,7
16:24,108931112.0,12694.793324972426,-26.83,9
16:25,310375875.0,3467.825559415609,-33.07,8
16:28,444428189.0,1008.4068000000028,-141.39,2
16:30,647472692.0,21920.8098777837,-30.47,5
16:32,168414279.0,-143.97521572507864,-140.0,2
16:32,516051449.0,1673.615509014291,-31.96,7
16:39,605116158.0,2362.9342,-27.97,4
16:40,995615876.0,1451.6862396983886,-51.98,2
16:43,345582855.0,-691.3160471794508,-30.28,5
16:44,286484726.0,451.5676764574821,-92.13,5
16:46,108481285.0,8094.364230175986,-5.78,2
16:47,494789005.0,3049.5054519069968,-30.17,4
16:51,914806976.0,1279.553250185486,-79.97,4
16:51,444428189.0,843.2348000000027,-165.17,2
16:55,168414279.0,-321.7752157250786,-177.8,2
16:56,128033695.0,2956.290411066716,-40.95,4
16:57,128033695.0,2914.2409143200452,-42.05,7
17:00,399144202.0,2467.108571431371,-32.31,4
17:01,679911053.0,2085.777299469892,-30.06,7
17:07,647936800.0,1413.5494659444148,-28.46,5
17:11,618138606.0,928.2298621516971,-17.94,9
17:11,444428189.0,646.5488000000026,-196.69,2
17:14,256045540.0,-3116.1638999999996,-35.74,5
17:16,683319988.0,7058.3617815416565,-78.21,2
17:16,336557504.0,1484.0697692497413,-25.96,1
17:18,668329719.0,7290.973471431093,-21.93,9
17:19,858560423.0,10724.305645306977,-49.99,4
17:19,180616589.0,1600.165648033954,-16.98,7
17:20,187541224.0,6404.78255922144,-21.43,7
17:21,116598243.0,1969.59432775601,-178.39,5
17:21,383625050.0,5675.234774344959,-47.49,2
17:23,395284483.0,1236.011813566968,-93.16,5
17:23,641764023.0,-1320.5313037720043,-55.14,5
17:24,416060965.0,815.1172320979584,-63.0,2
17:24,196289502.0,13576.05924274426,-14.57,5
17:26,220183538.0,650.4665499999995,-32.97,7
17:27,651756497.0,12801.477009690676,-10.69,5
17:27,532478725.0,4815.399662094434,-11.07,8
17:27,586315521.0,10789.517501153745,-98.0,2
17:28,769311479.0,6447.292852854935,-156.09,2
17:28,285428103.0,8331.833950465587,-151.97,2
17:30,795847804.0,20177.245083663227,-36.35,7
17:31,169006407.0,10986.890822930422,-123.19,2
17:31,168414279.0,-405.7752157250786,-84.0,2
17:32,444428189.0,605.9628000000026,-40.59,2
17:33,898104045.0,-1563.0530500000018,-195.13,5
17:38,583579399.0,587.9193499999991,-16.98,7
17:38,859603181.0,3801.8371068890574,-23.97,7
17:38,698076160.0,5461.043833144397,-19.81,8
17:41,166019891.0,7140.2803963732695,-26.15,7
17:41,556992209.0,9918.953736083053,-175.69,2
17:42,315078351.0,5960.001041965706,-221.16,2
17:42,383625050.0,5650.034774344959,-25.2,2
17:43,887853850.0,9783.838434931942,-205.1,2
17:47,198946608.0,5410.81976344583,-52.09,2
17:48,151278285.0,-350.3492000000004,-140.63,5
17:48,949032480.0,4877.688367793813,-127.39,2
17:49,143061865.0,6475.669016898004,-57.18,5
17:49,200080192.0,8805.802778205183,-75.78,5
17:50,736340277.0,7545.368327752441,-31.63,5
17:51,169006407.0,10739.11882293042,-247.77,2
17:53,858989281.0,23687.46572341807,-153.75,2
17:53,547010927.0,21554.13256443178,-0.87,2
17:54,531186970.0,472.3275562436195,-88.33,5
17:54,583558311.0,-876.991215248668,-39.46,5
17:55,785749304.0,7615.531478665786,-28.62,2
17:56,315078351.0,5821.415041965705,-138.59,2
17:59,315546581.0,24191.945695649145,-80.14,4
17:59,769311479.0,6226.820852854935,-220.47,2
18:00,613729471.0,7248.090233799618,-20.11,2
18:00,392270893.0,10806.386896994423,-154.64,5
18:05,452974357.0,-2537.396449999996,-21.05,5
18:06,315078351.0,5742.329041965705,-79.09,2
18:09,949032480.0,4653.0163677938135,-224.67,2
18:13,893134725.0,1993.131962973209,-47.56,5
18:13,392270893.0,10805.564655115528,-0.82,5
18:17,795847804.0,20166.936164534756,-10.31,7
18:19,656317661.0,-413.7004584585971,-158.2,5
18:21,532478725.0,4785.849662094433,-29.55,9
18:24,587225252.0,8918.025446793346,-33.93,9
18:26,108931112.0,12690.615404972426,-4.18,7
18:26,511179916.0,7169.445384594563,-114.18,5
18:27,256002321.0,6500.719060889148,-14.97,9
18:30,166019891.0,7083.104396373269,-57.18,5
18:35,897714622.0,8499.106195671566,-27.95,7
18:38,909669130.0,183.76788473676663,-14.22,5
18:41,492215823.0,22.171173815443012,-42.84,9
18:42,955035930.0,881.3584791714773,-1.99,7
18:42,873693307.0,8149.255847306631,-39.86,5
18:43,121858569.0,-102.10884999999776,-68.23,5
18:45,670427480.0,1595.223550000001,-104.4,5
18:47,585133606.0,4257.370665314502,-119.97,7
18:49,709608057.0,3216.0879903251425,-33.88,9
18:54,683319988.0,6992.857420047853,-65.5,7
18:55,224215364.0,-1574.6875920882787,-51.41,5
18:57,131388684.0,19304.458884980297,-25.5,9
18:59,511179916.0,7146.255384594563,-23.19,9
18:59,940569402.0,5371.234712785959,-91.18,5
19:03,824916823.0,8095.7569640713855,-30.65,9
19:04,550644516.0,-127.76045000000131,-50.85,5
19:07,851181128.0,4240.000819439575,-24.49,9
19:08,138969884.0,654.5882999999993,-33.86,5
19:09,248658670.0,-1762.0808499999998,-33.05,5
19:10,744968736.0,-1512.517226569424,-82.77,5
19:11,423208402.0,2039.6456000000023,-37.87,5
19:13,221868392.0,4935.085307532422,-15.34,8
19:14,296972867.0,-659.9821000000007,-36.65,5
19:14,558875206.0,2146.361450000001,-197.31,5
19:14,941285623.0,-335.12460093322966,-83.54,5
19:16,620227043.0,-1845.307771013424,-69.11,5
19:17,833899961.0,2015.2637728389911,-25.93,5
19:19,845648250.0,164.12104999999946,-80.28,5
19:22,738958551.0,7946.087259817107,-4.92,2
19:23,128030172.0,-487.3023774498498,-106.87,5
19:24,398429109.0,-365.6662499999991,-103.26,5
19:24,844835978.0,8541.627265270117,-15.79,5
19:25,331450202.0,6264.697243818739,-8.54,7
19:35,494977194.0,1593.1568205975768,-159.28,5
19:38,282837512.0,12145.861206880903,-39.23,9
19:46,151968462.0,8421.993229856742,-49.38,7
19:47,639409800.0,30528.901266582783,-52.06,5
19:49,890830949.0,536.2046499999981,-109.45,5
19:56,678851253.0,3060.4277999495284,-4.31,2
20:01,654329190.0,-40.503799051480655,-82.35,5
20:01,886921642.0,3176.4275861793103,-50.19,5
20:03,500043411.0,12233.158412013012,-78.15,5
20:04,285873880.0,10228.748772702203,-70.27,5
20:04,706250160.0,9750.306382391698,-18.94,9
20:09,670102069.0,3534.295988249768,-18.6,2
20:13,471897866.0,7714.737206688104,-57.74,5
20:17,117273481.0,7948.930996469387,-12.95,7
20:34,709608057.0,3195.4837723834535,-20.6,7
20:48,785749304.0,7600.411478665787,-15.12,5
20:49,461990622.0,8545.301770165695,-12.14,5
20:53,639420537.0,-1601.63895,-37.91,5
20:54,519935524.0,-139.61481026248106,-23.47,5
21:15,322221939.0,3444.039694350847,-10.4,5
21:41,198946608.0,5388.754517769284,-22.07,2
21:58,399144202.0,2443.4785714313707,-23.63,9
22:22,901432314.0,3776.2824595210714,-23.32,7
01:23,547010927.0,21551.636037123302,-2.5,5
01:34,779946617.0,15099.247797392209,-9.69,7
01:58,809499628.0,14733.874298424667,-55.46,2
02:04,809499628.0,14714.944298424669,-18.93,9
02:09,987656636.0,5627.615393828552,-14.1,5
02:33,609939116.0,6271.300661385755,-7.73,4
02:46,572384506.0,9526.024125916018,-35.79,9
02:50,290818242.0,6261.546642583709,-10.87,7
02:50,547010927.0,21518.446037123304,-33.19,9
02:53,383833857.0,21064.328390136045,-1.95,2
02:59,973086490.0,9053.266650227928,-9.99,9
03:01,758160963.0,7550.33537657823,-16.24,9
03:22,496395938.0,11572.5063051663,-62.37,4
03:22,795847804.0,20112.243019240548,-54.69,5
03:23,324224854.0,1350.5418429895362,-2.89,2
03:23,256002321.0,6477.819060889148,-22.9,9
03:25,187541224.0,6366.6625592214405,-38.12,9
03:30,435984758.0,4893.689803340287,-21.08,7
03:31,730002588.0,12362.681209051894,-40.28,5
03:32,305778936.0,11162.667021716416,-23.0,2
03:35,414454079.0,719.0868500000017,-40.3,9
03:39,651756497.0,12790.970001194632,-10.51,2
03:40,518474507.0,12908.657022133186,-34.78,9
03:45,949032480.0,4622.232839252443,-30.78,2
03:46,897592348.0,13176.41487719656,-2.69,7
03:47,678851253.0,3054.3897922533956,-6.04,8
03:47,494789005.0,3025.3238794393587,-24.18,4
03:47,705848712.0,22990.862202906657,-17.93,9
03:49,237684254.0,5358.057110424462,-13.76,5
03:51,180616589.0,1575.7156480339538,-24.45,9
03:54,370521542.0,22919.803310084855,-1.61,8
04:00,308505160.0,12136.863176971236,-18.91,2
04:01,788740658.0,3096.4953560678314,-9.95,5
04:04,383625050.0,5648.367435623553,-1.67,5
04:06,143061865.0,6462.9082283029775,-12.76,2
04:14,179173981.0,5973.1995111707965,-25.59,2
04:17,229205098.0,6942.845651782877,-34.62,7
04:19,873693307.0,8122.064656873292,-27.19,8
04:21,973086490.0,9050.367658732544,-2.9,8
04:23,235881534.0,11271.933060905934,-2.11,7
04:26,203466392.0,2362.106348432194,-25.76,7
04:34,656812046.0,992.4491747510588,-2.96,7
04:35,706250160.0,9747.935890605138,-2.37,7
04:42,679662108.0,13606.082777068626,-79.16,2
04:42,414805878.0,13201.507224460074,-41.89,9
04:43,687135796.0,24556.382680839084,-18.8,4
04:45,550169791.0,18471.283548212938,-21.88,2
04:46,897714622.0,8495.231838834117,-3.87,2
04:48,912705941.0,16652.176224210598,-9.03,7
04:52,116598243.0,1921.502423393848,-48.09,2
04:52,815385232.0,8995.979287327968,-10.38,9
04:52,549414742.0,6777.876734320096,-23.33,9
04:54,287480331.0,11361.845275333682,-29.18,9
05:01,170637730.0,2622.1326777141676,-9.7,7
05:04,581655972.0,37910.15094116175,-25.8,2
05:08,704517789.0,15165.460571241954,-35.78,7
05:09,285220959.0,11026.159259327833,-23.95,8
05:10,113747882.0,10681.20790304214,-2.59,5
05:11,270374623.0,9414.647239876922,-33.25,8
05:15,183888402.0,15831.966828599448,-25.72,9
05:15,639409800.0,30521.876882312295,-7.02,2
05:21,994214354.0,8699.064547212862,-34.94,9
05:23,815385232.0,8993.907720442061,-2.07,8
05:24,633345190.0,6861.735064461874,-37.3,9
05:26,128033695.0,2892.0409143200454,-22.2,9
05:30,421881811.0,5350.92492907556,-42.07,4
05:32,858989281.0,23674.915723418075,-12.55,9
05:33,657139925.0,11806.270334208237,-19.7,9
05:33,252760664.0,5678.894437228214,-48.81,2
05:36,213112754.0,6582.36040872567,-61.0,7
05:37,824916823.0,8049.139557995049,-46.62,7
05:42,518474507.0,12902.645321225493,-6.01,2
05:42,414805878.0,13171.87738583435,-29.63,2
05:44,154246234.0,-59.625107897895845,-20.65,9
05:44,683319988.0,6932.5577831379305,-60.3,2
05:46,237493332.0,12579.26751939659,-57.93,8
05:47,176922958.0,78.27302156485634,-24.9,5
05:50,549414742.0,6771.49563014264,-6.38,5
05:50,473820682.0,10589.524595930496,-9.23,7
05:58,482513594.0,6465.563443426709,-10.4,2
05:59,117273481.0,7939.044790178035,-9.89,7
06:03,822250278.0,6209.364586671483,-43.98,5
06:03,905860285.0,15060.319599119954,-72.85,4
06:04,471897866.0,7702.884926461692,-11.85,2
06:08,994214354.0,8656.077234174672,-42.99,5
06:09,699139822.0,2310.2754204823677,-36.18,5
06:09,984783496.0,12709.97630990258,-21.64,9
06:10,806358207.0,10695.245879348357,-20.48,2
06:14,823208989.0,1474.676680145231,-1.58,5
06:16,613729471.0,7220.179863266241,-27.91,8
06:19,867987292.0,3422.6424017116337,-23.2,2
06:20,480557476.0,10268.19687178874,-64.33,8
06:22,749378808.0,5064.69342167717,-6.84,7
06:23,541639148.0,4322.987023050682,-2.27,5
06:27,985188462.0,735.5702487112245,-39.24,9
06:30,366550080.0,23008.259908690732,-12.26,2
06:30,166019891.0,7077.278303261447,-5.83,7
06:31,489964679.0,21428.096792849898,-45.42,9
06:34,532478725.0,4749.469662094433,-36.38,9
06:40,853907490.0,6897.605006844551,-6.0,9
06:41,769311479.0,6216.260384233753,-10.56,5
06:41,667367404.0,8124.149183696232,-12.14,5
06:43,134461671.0,7953.305578113717,-38.71,5
06:46,264550521.0,8635.902537640844,-63.73,4
06:48,259015404.0,3537.5336620812423,-49.79,9
06:50,195895574.0,6441.004039399114,-24.65,2
06:50,802697323.0,18899.881891052224,-35.67,9
06:53,315546581.0,24152.872370645615,-39.07,7
06:55,899742927.0,12324.547461343818,-38.31,7
06:55,441274121.0,11332.819148319424,-4.64,7
06:57,187111705.0,5861.17681878668,-36.75,2
06:57,128033695.0,2829.024398498833,-63.02,7
06:59,851181128.0,4222.310819439575,-17.69,9
07:00,842682241.0,4913.56809532199,-4.0,5
07:02,776431321.0,2880.971936130677,-6.04,2
07:03,647472692.0,21908.869777254808,-11.94,2
07:07,709608057.0,3161.5437723834534,-33.94,9
07:14,678330503.0,1928.532110687512,-5.7,9
07:14,901037631.0,969.5393230964066,-6.05,9
07:16,116598243.0,1915.302423393848,-6.2,9
07:17,653640811.0,14729.557028542862,-60.92,2
07:19,364357875.0,6087.577898339113,-2.17,8
07:20,506618547.0,16990.593712206814,-0.54,4
07:21,520447032.0,8396.70885254062,-8.04,7
07:25,558119802.0,28699.402217290735,-3.57,7
07:26,853907490.0,6896.405927406036,-1.2,8
07:32,407574996.0,3305.3553651560906,-14.75,4
07:38,216285378.0,21038.996384634924,-46.19,9
07:40,758160963.0,7485.199285165507,-65.14,2
07:40,131388684.0,19287.712721944445,-16.75,5
07:50,718058208.0,895.6905453971257,-17.17,7
07:51,738958551.0,7893.092889039286,-52.99,7
08:01,245690309.0,8065.725147037844,-19.56,8
08:02,838830098.0,1373.1525420877845,-6.5,9
08:03,910730524.0,7384.842173579131,-4.2,7
08:04,108563213.0,20805.664094717595,-21.55,8
08:05,527842638.0,1179.6419426329835,-5.3,9
08:07,832564361.0,14131.294130809209,-26.11,2
08:11,395284483.0,1229.8618135669678,-6.15,9
08:12,146909202.0,4166.09786724463,-5.7,9
08:13,948558249.0,8376.545015959808,-5.7,9
08:13,450896297.0,12253.882216043745,-25.05,8
08:13,241459011.0,746.5836132723472,-5.65,9
08:13,951817450.0,8675.075185992684,-36.7,2
08:14,336557504.0,1477.269769249741,-6.8,9
08:19,399538448.0,6991.985712652364,-5.35,9
08:21,200080192.0,8785.06127168378,-20.74,7
08:27,887156614.0,-1049.0151710407736,-73.36,5
08:28,245198540.0,-618.8286011982206,-12.88,5
08:34,637649383.0,327.75519999999835,-106.83,5
08:35,719742742.0,-1559.1525077779634,-98.85,5
08:35,534325901.0,5901.763932060744,-40.7,2
08:35,331450202.0,6260.309613327194,-4.39,2
08:36,108563213.0,20755.936094717596,-49.73,5
08:36,815993333.0,443.69916906140713,-88.49,5
08:37,680773155.0,320.1362833310918,-30.68,5
08:37,799453072.0,-387.61660000000103,-34.4,9
08:38,851649498.0,9388.94643717364,-64.63,5
08:39,762896656.0,-505.8775018481414,-27.95,5
08:40,596463612.0,-1139.9826047251397,-48.11,5
08:42,706361191.0,-15.486701505921856,-139.87,5
08:42,586315521.0,10783.494595868646,-6.02,2
08:48,812692024.0,4230.495178787428,-39.45,5
08:49,835736339.0,2370.775250414559,-72.6,5
08:49,519933553.0,-783.6689958492716,-24.59,5
08:50,430910686.0,71.3934000000003,-173.96,5
08:55,175452235.0,-781.6777499999997,-75.28,5
08:55,604288474.0,2910.061354853604,-39.61,7
08:56,308897841.0,1088.5998999999993,-17.4,5
08:57,138609932.0,4154.582003294585,-7.3,9
09:04,618138606.0,921.3298621516972,-6.9,9
09:06,945054126.0,-1052.4319,-70.0,5
09:07,667367404.0,8118.449183696232,-5.7,9
09:07,417850087.0,15102.33068645866,-7.9,9
09:09,690958123.0,17372.23872829008,-5.05,9
09:09,999752672.0,476.57049353333446,-6.5,9
09:10,613729471.0,7212.679863266241,-7.5,9
09:10,930277104.0,9745.648614507723,-38.25,7
09:12,331048953.0,-333.93363202150636,-125.68,5
09:12,570410059.0,869.1687467763097,-118.42,5
09:12,383833857.0,21058.678390136043,-5.65,9
09:13,454356905.0,2351.605899903114,-9.12,4
09:14,116169597.0,812.0059499999995,-41.97,4
09:14,572136270.0,-257.30965066642227,-34.67,5
09:15,242218612.0,624.1963000000006,-26.29,5
09:15,414454079.0,655.1668500000018,-63.92,2
09:16,461029994.0,5926.530375914818,-27.97,4
09:16,851649498.0,9306.13643717364,-82.81,5
09:17,540159353.0,9777.605005190488,-7.6,9
09:18,117273481.0,7850.746790178036,-88.3,5
09:18,741903302.0,2419.732897988479,-5.0,9
09:18,506618547.0,16982.793712206814,-7.8,9
09:19,683319988.0,6926.407783137931,-6.15,9
09:21,683078800.0,1555.3638920384876,-6.8,9
09:22,117273481.0,7843.946790178035,-6.8,9
09:23,909676212.0,975.0296174703678,-26.97,4
09:24,558875206.0,2138.5614500000006,-7.8,9
09:28,324046160.0,-773.0635332130709,-87.7,5
09:28,534204159.0,6167.182925602813,-226.1,2
09:30,462962606.0,125.8565499999989,-29.99,2
09:30,871866387.0,-849.2381000000007,-75.37,5
09:32,601627384.0,4509.037629447824,-36.63,1
09:32,933491926.0,2599.970300000001,-48.9,5
09:37,145387690.0,4998.458045694766,-27.89,7
09:42,282837512.0,12118.5252034323,-27.34,5
09:43,308897841.0,980.9973999999992,-107.6,2
09:43,925659248.0,-738.9501392295712,-130.39,5
09:45,570323670.0,3262.7365458823942,-110.08,2
09:45,909669130.0,160.76788473676663,-23.0,2
09:46,116169597.0,684.6199499999996,-127.39,2
09:48,678851253.0,3044.3697922533956,-10.02,2
09:51,279149837.0,763.693049999999,-18.97,1
09:52,977899503.0,-1201.1271064191474,-85.15,5
09:53,534204159.0,5922.882925602813,-244.3,2
09:54,534583529.0,615.5577880547654,-71.59,5
09:55,287480331.0,11323.527755333682,-38.32,4
09:55,308897841.0,888.0198999999993,-92.98,2
09:57,280268430.0,4551.762464359782,-96.99,2
10:02,137822385.0,3146.441117151475,-5.1,9
10:02,448004226.0,2294.908461930605,-64.98,2
10:02,943329213.0,2123.8382207869254,-37.1,7
10:05,535744551.0,522.1900159956265,-10.99,4
10:06,547010927.0,21460.686037123305,-57.76,2
10:08,322221939.0,3278.181694350847,-165.86,2
10:09,116169597.0,555.8339499999996,-128.79,2
10:09,308897841.0,818.2923999999994,-69.73,2
10:11,639549973.0,6712.645946209534,-195.3,2
10:11,508518911.0,59.09675027901052,-19.99,4
10:13,534204159.0,5654.082925602813,-268.8,2
10:16,427909748.0,735.663200000012,-16.49,4
10:17,225210798.0,418.5817737592089,-21.98,4
10:18,659415300.0,2510.402540250703,-6.3,9
10:19,541639148.0,4271.947023050682,-51.04,2
10:26,348525881.0,-8.028375405063684,-131.98,2
10:27,639549973.0,6651.045946209533,-61.6,2
10:29,534204159.0,5532.282925602813,-121.8,2
10:39,998390769.0,199.5372509405242,-82.5,2
10:40,308897841.0,780.0498999999994,-38.24,2
10:42,519644021.0,2213.8441217788404,-3.69,2
10:45,246753533.0,421.6828999999988,-55.97,4
10:51,916270283.0,1372.4182499999986,-28.0,2
10:56,639549973.0,6532.745946209533,-118.3,2
11:02,534204159.0,5463.682925602812,-68.6,2
11:03,322221939.0,3238.50080703054,-39.68,7
11:07,998390769.0,-36.96274905947581,-236.5,2
11:08,647472692.0,21850.853957254807,-58.02,4
11:12,718058208.0,888.6905453971257,-7.0,1
11:14,534204159.0,5337.682925602812,-126.0,2
11:18,163470640.0,667.1252999999999,-31.97,4
11:30,998390769.0,-215.4627490594758,-178.5,2
11:33,854895960.0,2633.2338084062476,-19.99,2
11:34,639549973.0,6394.845946209533,-137.9,2
11:51,280098744.0,1063.2853778716656,-49.99,4
11:52,639549973.0,6311.545946209533,-83.3,2
11:54,919185264.0,3795.677527740503,-21.96,1
11:54,998390769.0,-320.4627490594758,-105.0,2
12:03,348325817.0,8245.189373547675,-31.39,9
12:04,585625048.0,885.2416190586326,-21.9,9
12:05,308897841.0,649.5648999999994,-130.48,2
12:21,749378808.0,5031.50342167717,-33.19,9
12:26,223207876.0,-100.38089999999993,-48.04,9
12:27,699139822.0,2278.0454204823677,-32.23,9
12:28,639549973.0,6304.545946209533,-7.0,2
12:29,280268430.0,4541.749732378334,-10.01,5
12:30,116169597.0,328.37594999999965,-227.46,2
12:35,520447032.0,8348.23885254062,-48.47,2
12:38,572384506.0,9519.864125916018,-6.16,2
12:41,308897841.0,558.8298999999994,-90.73,2
12:42,191161970.0,-3305.913999999997,-20.56,5
12:43,895331556.0,-843.0374000000007,-36.03,5
12:44,753525749.0,-2180.9559,-28.99,5
12:45,998390769.0,-380.4627490594758,-60.0,2
12:48,639549973.0,6263.245946209533,-41.3,2
12:50,454356905.0,2318.9758999031137,-32.63,9
12:50,202320275.0,-722.8979500000004,-93.23,5
12:53,907987693.0,-2289.0244999999995,-21.97,5
13:03,585625048.0,880.1916190586327,-5.05,9
13:04,687135796.0,24550.39268083908,-5.99,9
13:09,812692024.0,4225.795178787428,-4.7,9
13:09,259015404.0,3531.483662081242,-6.05,9
13:10,998390769.0,-519.4627490594758,-139.0,2
13:13,688712152.0,5863.143242207533,-5.5,9
13:14,691843653.0,-2818.583399999995,-29.07,5
13:14,916225911.0,-2082.829250000001,-14.84,5
13:14,849096144.0,1770.052858910517,-5.4,9
13:14,116169597.0,53.289949999999635,-275.09,2
13:16,340321732.0,1229.2970500000029,-5.0,9
13:17,541639148.0,4211.787023050682,-60.16,7
13:21,146686559.0,-598.5726111734776,-80.58,5
13:22,322221939.0,3233.00080703054,-5.5,9
13:25,812012103.0,-507.8393000000005,-88.77,5
13:25,534204159.0,5201.182925602812,-136.5,2
13:26,659008214.0,-3052.215102290424,-57.17,5
13:27,824218857.0,-3233.426160845429,-84.55,5
13:46,441142605.0,2546.252250000003,-9.0,4
13:47,546296727.0,-383.73867269738145,-46.38,5
14:34,370521542.0,22894.253310084856,-25.55,2
14:37,293609137.0,-113.73950742550198,-32.7,5
14:38,316793091.0,701.4643100549512,-28.95,1
14:47,421881811.0,5317.228299075559,-33.7,4
15:13,950234174.0,1149.846496728756,-2.84,5
15:14,679662108.0,13586.812777068626,-19.27,7
15:18,441142605.0,2471.272250000003,-74.98,2
15:34,414454079.0,649.0968500000017,-6.07,4
15:35,108481285.0,8062.836869443608,-31.53,2
15:43,779946617.0,15006.987797392208,-92.26,2
15:56,996042490.0,4931.822046170784,-217.0,2
16:07,867987292.0,3268.0614017116336,-154.58,5
16:17,521611005.0,-271.65538585104656,-31.2,9
16:18,996042490.0,4823.3500461707845,-108.47,2
16:18,352899149.0,243.9296999999989,-59.92,1
16:22,376271050.0,684.2902468611794,-64.98,4
16:28,158414827.0,-1547.5352000000016,-27.6,5
16:28,409971170.0,1836.0727656666209,-24.61,5
16:37,233981231.0,1656.5227391616957,-161.97,2
16:39,639549973.0,6213.105946209533,-50.14,2
16:45,508518911.0,34.13675027901052,-24.96,7
16:51,996042490.0,4636.478046170784,-186.87,2
16:51,903953091.0,2448.186762369467,-29.96,7
17:05,170233640.0,-1141.0663100501029,-82.95,5
17:07,675806859.0,6064.751726717365,-10.07,2
17:08,198630866.0,-328.6535735612685,-132.89,5
17:08,491392945.0,4025.2535000000057,-18.49,9
17:11,456221621.0,747.0900673026282,-91.5,2
17:11,785210466.0,1876.7032041968257,-34.94,5
17:13,858989281.0,23635.57171332206,-39.34,2
17:14,604334058.0,14.551299999999472,-127.71,5
17:16,836110591.0,6190.456863785764,-45.55,9
17:17,846550094.0,1901.7568360368743,-48.23,2
17:19,213112754.0,6571.87040872567,-10.49,9
17:20,996042490.0,4432.7920461707845,-203.69,2
17:21,466649401.0,11.960265723196713,-44.95,7
17:21,423208402.0,2017.6656000000023,-21.98,4
17:22,887853850.0,9771.418434931942,-12.42,7
17:22,315078351.0,5722.178761965705,-20.15,4
17:23,494156462.0,128.4166135182396,-112.98,2
17:23,994214354.0,8624.260534174673,-31.82,4
17:25,124102251.0,3954.6724952124778,-288.4,2
17:28,365608668.0,669.0178138595588,-7.5,4
17:29,141521177.0,6163.261900000012,-114.98,2
17:29,169006407.0,10730.53104358933,-8.59,5
17:31,925037906.0,1232.9748000000016,-102.63,5
17:32,391559884.0,-34.663700000000546,-183.32,5
17:32,556992209.0,9896.953736083053,-22.0,7
17:33,901432314.0,3716.9924595210714,-59.29,5
17:33,417850087.0,15089.506829621218,-12.82,7
17:38,876890798.0,3336.6325706999296,-25.97,2
17:38,285428103.0,8275.843950465587,-55.99,2
17:39,151968462.0,8364.43327081423,-5.99,2
17:39,420109571.0,331.71398334207447,-22.0,2
17:39,951817450.0,8652.085185992684,-22.99,7
17:40,736340277.0,7540.26832775244,-5.1,1
17:42,117273481.0,7811.986790178035,-31.96,7
17:42,419550103.0,17079.67142791386,-9.99,2
17:43,815385232.0,8939.597720442061,-54.31,2
17:43,956717493.0,814.8943937283602,-19.99,2
17:43,520418719.0,2545.880500000003,-32.08,5
17:44,940569402.0,5353.282975298625,-17.95,2
17:45,456221621.0,501.5900673026282,-245.5,2
17:46,500043411.0,12212.598412013012,-20.56,2
17:46,987163717.0,5807.802720000005,-45.57,9
17:47,939972497.0,424.3595086000108,-28.99,2
17:47,214339619.0,-56.7977491316436,-56.58,5
17:47,124102251.0,3746.0724952124774,-208.6,2
17:48,365608668.0,598.0478138595588,-70.97,4
17:48,291580432.0,-875.6933999999997,-83.87,5
17:49,639549973.0,6129.105946209533,-84.0,2
17:51,719586818.0,16949.809357975788,-107.8,2
17:52,151968462.0,8294.46327081423,-69.97,4
17:52,361201224.0,6447.574232067893,-10.02,7
17:53,670102069.0,3530.3686541292523,-3.93,8
17:53,785749304.0,7598.611385976416,-1.8,2
17:55,496395938.0,11559.5163051663,-12.99,7
17:55,494156462.0,73.43661351823962,-54.98,2
17:56,417850087.0,15088.005329621215,-1.5,4
17:56,486495235.0,995.6666393887158,-76.99,2
17:57,887853850.0,9749.398434931942,-22.02,9
17:57,237493332.0,12520.567519396587,-58.7,2
17:57,605116158.0,2359.9342,-3.0,4
17:58,203466392.0,2292.106348432194,-70.0,2
17:59,500043411.0,12196.731232013011,-15.87,4
18:00,500043411.0,12195.28663616416,-1.44,7
18:02,949032480.0,4603.332839252444,-18.9,9
18:03,370757362.0,947.1172134689168,-121.8,2
18:05,262767079.0,-1037.2325000000003,-31.1,9
18:07,824916823.0,8044.049557995048,-5.09,7
18:08,657528784.0,-106.18109999999932,-44.12,9
18:09,419550103.0,16867.59942791386,-212.07,2
18:09,691789577.0,-508.936,-31.45,9
18:10,639549973.0,6073.8059462095325,-55.3,2
18:10,605116158.0,2350.2651,-9.67,5
18:12,263882093.0,-1426.1863000000003,-29.19,9
18:14,683319988.0,6902.067783137931,-24.34,9
18:16,719586818.0,16917.715702639187,-32.09,2
18:17,873701090.0,665.6228384384394,-40.92,8
18:17,203466392.0,2024.006348432194,-268.1,2
18:20,365608668.0,451.7478138595589,-146.3,2
18:20,486495235.0,970.6666393887158,-25.0,2
18:20,859603181.0,3768.6991068890575,-33.14,5
18:21,859603181.0,3753.5420015261775,-15.16,7
18:22,450896297.0,12220.202216043745,-33.68,9
18:23,419550103.0,16748.59942791386,-119.0,2
18:24,939972497.0,384.8595086000108,-39.5,2
18:27,321372947.0,-392.34775078909934,-13.41,5
18:27,192202372.0,147.05840302901106,-49.99,7
18:33,399144202.0,2416.0535041020185,-27.43,5
18:33,532478725.0,4743.05535007251,-6.41,5
18:34,433917275.0,7521.874666233126,-30.69,9
18:35,146909202.0,4148.671448231955,-17.43,2
18:39,203466392.0,1891.006348432194,-133.0,2
18:39,690523499.0,773.1178999999996,-5.5,7
18:39,639549973.0,6018.505946209532,-55.3,2
18:40,241459011.0,699.7942132723472,-46.79,5
18:40,844835978.0,8531.637265270117,-9.99,7
18:41,609939116.0,5952.7936613857555,-318.51,5
18:41,365608668.0,397.8618138595588,-53.89,2
18:42,891716230.0,85.20564807062054,-21.98,7
18:43,993039226.0,-3821.671999999995,-17.45,5
18:44,668692488.0,1674.872303563902,-1.5,7
18:48,535273662.0,325.4128999999995,-15.95,9
18:49,696758548.0,-3071.9053963201377,-24.48,5
18:52,940569402.0,5342.582975298626,-10.7,9
18:54,226703987.0,2176.791649999999,-94.84,5
18:56,802697323.0,18896.761167910583,-3.12,2
18:58,203466392.0,1863.706348432194,-27.3,2
18:58,138609932.0,4140.652003294585,-13.93,7
18:58,486495235.0,901.1666393887158,-69.5,2
18:59,183186021.0,-1242.155049999999,-60.04,5
19:00,939972497.0,335.3595086000108,-49.5,2
19:03,409370545.0,187.45427554552015,-48.04,5
19:05,433917275.0,7474.403828843972,-47.47,2
19:07,856461967.0,-339.10264647050747,-32.74,5
19:13,939972497.0,263.3695086000108,-71.99,2
19:16,365608668.0,309.67581385955884,-88.19,2
19:18,752362502.0,8351.811329241536,-1.93,7
19:21,358846516.0,96.45042252721802,-125.78,5
19:26,203466392.0,1800.706348432194,-63.0,2
19:27,556992209.0,9861.561736083053,-35.39,5
19:28,836110591.0,6188.7331691675345,-1.72,5
19:30,581655972.0,37876.46494116176,-27.99,5
19:35,558119802.0,28666.062217290735,-33.34,9
19:38,365608668.0,272.58981385955883,-37.09,2
19:39,170637730.0,2573.9866777141674,-48.15,5
19:48,992204045.0,10573.610631102098,-4.24,8
19:48,383625050.0,5521.464435623553,-126.9,5
19:53,124102251.0,3708.440495212478,-37.63,5
19:54,969697937.0,-4270.330265670551,-41.78,5
19:57,668329719.0,7279.544586985737,-11.43,2
20:03,993663752.0,51.59704241039657,-124.33,5
20:04,425730826.0,41.61190938871967,-34.17,5
20:05,124102251.0,3680.6549564754214,-27.79,2
20:07,365608668.0,108.10381385955884,-164.49,2
20:11,310375875.0,3433.675559415609,-34.15,9
20:14,613729471.0,7161.439863266241,-51.24,5
20:15,709632525.0,-1675.4723500000007,-105.19,5
20:15,331450202.0,6246.197613327194,-14.11,5
20:23,441274121.0,11314.319148319424,-18.5,9
20:26,399144202.0,2391.3735041020186,-24.68,9
20:29,553734946.0,356.6457999999989,-71.74,5
20:33,874431242.0,7634.266158330311,-49.88,7
20:37,809499628.0,14638.140298424669,-76.8,5
20:38,220183538.0,564.3024999999996,-86.16,5
20:41,221868392.0,4892.785009605695,-42.3,7
20:45,196289502.0,13563.67924274426,-12.38,9
20:46,986267641.0,5384.835534883459,-71.55,5
20:49,624563756.0,-608.2072712164436,-38.28,5
20:50,785749304.0,7560.321385976416,-38.29,5
20:51,633345190.0,6859.651516732055,-2.08,5
21:20,779236304.0,261.17759547953244,-26.64,9
21:45,678330503.0,1922.5665820305371,-5.97,2
00:29,639409800.0,30499.337762705512,-22.54,2
01:00,985188462.0,695.8402487112245,-39.73,9
01:08,310620484.0,624.2730461952984,-7.62,7
01:26,679662108.0,13586.488122653733,-0.32,7
01:48,370521542.0,22883.380823980155,-10.87,5
02:04,779946617.0,14968.052429801455,-38.94,5
02:14,699139822.0,2192.8870727547555,-85.16,2
02:35,687135796.0,24529.708297784848,-20.68,5
02:37,802697323.0,18852.421167910583,-44.34,9
02:46,601627384.0,4477.1076294478235,-31.93,9
02:49,532478725.0,4700.42535007251,-42.63,9
02:55,683319988.0,6867.627783137931,-34.44,9
02:58,558119802.0,28633.122217290736,-32.94,9
02:59,195895574.0,6393.624039399115,-22.19,9
03:01,672994751.0,-126.9986924158626,-48.23,9
03:03,519644021.0,2179.691015183104,-34.15,8
03:04,709608057.0,3135.4637723834535,-26.08,9
03:18,668329719.0,7263.419432501712,-16.13,5
03:19,421881811.0,5305.045410349318,-12.18,7
03:26,749378808.0,5002.40342167717,-29.1,9
03:31,399144202.0,2362.2735041020187,-29.1,9
03:33,858989281.0,23621.881713322065,-13.69,9
03:36,683319988.0,6845.044796221284,-22.58,2
03:40,549414742.0,6742.29563014264,-29.2,9
03:45,586315521.0,10776.94426463081,-6.55,7
03:46,408057540.0,7277.145216695361,-23.05,8
03:48,547010927.0,21428.346665998557,-32.34,7
03:56,785749304.0,7557.526765338045,-2.79,5
04:02,324224854.0,1327.0778796776904,-23.46,2
04:08,905860285.0,15031.319467030644,-29.0,7
04:08,221868392.0,4863.035009605695,-29.75,9
04:12,473820682.0,10587.336943947148,-2.19,5
04:15,558119802.0,28628.255401574697,-4.87,5
04:16,836110591.0,6147.393169167534,-41.34,9
04:18,482513594.0,6458.183743193415,-7.38,7
04:24,779236304.0,237.8475954795325,-23.33,9
04:27,541639148.0,4175.847910602948,-35.94,7
04:30,450896297.0,12180.76531361277,-14.35,5
04:32,213112754.0,6568.191043216412,-3.68,8
04:40,216285378.0,21004.866384634923,-34.13,9
04:43,383625050.0,5503.332645799094,-18.13,7
04:45,221868392.0,4860.635480345217,-2.4,7
04:48,496395938.0,11557.145400300824,-2.37,7
04:50,581655972.0,37874.79081182855,-1.67,2
04:57,912705941.0,16631.124582026703,-21.05,8
04:58,809499628.0,14624.600298424666,-13.54,9
04:59,749378808.0,4997.193455342611,-5.21,7
05:00,264550521.0,8616.52346327199,-19.38,5
05:01,365608668.0,99.15381385955884,-8.95,9
05:04,549414742.0,6736.121873245171,-6.17,7
05:04,705848712.0,22972.972202906654,-17.89,9
05:05,647936800.0,1400.4747567224872,-13.07,2
05:10,331450202.0,6230.557613327193,-15.64,9
05:12,822250278.0,6175.742556729908,-33.62,4
05:23,229205098.0,6932.29069163607,-10.55,7
05:25,667367404.0,8069.901169780753,-48.55,7
05:26,949032480.0,4569.902839252443,-33.43,9
05:30,510101371.0,11739.513696671023,-35.29,9
05:31,940569402.0,5320.342975298626,-22.24,9
05:32,613729471.0,7131.430171619245,-30.01,5
05:33,108931112.0,12665.649681396144,-24.97,5
05:39,950234174.0,1135.7122312762422,-14.13,7
05:40,719586818.0,16906.62843757325,-11.09,7
05:42,706250160.0,9711.789027253371,-36.15,5
05:45,851649498.0,9255.622327255192,-50.51,8
05:47,179173981.0,5951.660943227055,-21.54,8
05:49,203466392.0,1785.881887366601,-14.82,7
05:52,730002588.0,12350.04368870496,-12.64,5
05:53,683078800.0,1524.6932972194538,-30.67,7
05:55,806358207.0,10681.82496005099,-13.42,5
05:56,417850087.0,15082.118821055932,-5.89,5
05:58,550832673.0,2428.429048823173,-23.89,9
05:59,131388684.0,19280.635388623217,-7.08,2
06:00,500043411.0,12177.79214786078,-17.49,2
06:01,769311479.0,6203.490909265119,-12.77,5
06:04,766941757.0,9024.120802466416,-38.0,9
06:05,270374623.0,9354.148792955848,-60.5,2
06:05,176922958.0,58.5856877654301,-19.69,2
06:14,901432314.0,3698.51267634675,-18.48,5
06:17,885259672.0,3596.900019828518,-21.41,2
06:17,554792076.0,24290.474422284904,-19.39,5
06:18,200080192.0,8770.21698882089,-14.84,2
06:20,166019891.0,7018.336574637642,-58.94,7
06:23,656812046.0,971.0780025577624,-21.37,5
06:23,237493332.0,12514.443695173126,-6.12,5
06:25,151968462.0,8257.960792037295,-36.5,8
06:26,196289502.0,13491.856438880606,-71.82,5
06:26,657139925.0,11757.077246606934,-49.19,7
06:27,887853850.0,9714.5765514075,-34.82,5
06:27,973086490.0,9011.139870492074,-39.23,7
06:30,551755686.0,7134.641585195959,-2.56,2
06:31,348325817.0,8223.64191783771,-21.55,5
06:35,146909202.0,4113.971448231955,-34.7,9
06:35,842682241.0,4841.179657824375,-72.39,7
06:41,873693307.0,8046.282331265673,-75.78,2
06:45,758160963.0,7426.245231356007,-58.95,7
06:46,718058208.0,825.3921035344468,-63.3,5
06:46,766812921.0,-410.3969000000007,-140.0,1
06:51,832564361.0,14127.565034334017,-3.73,7
06:54,407574996.0,3258.880150968193,-46.48,5
06:55,858989281.0,23610.284410254604,-11.6,7
06:59,256002321.0,6461.769060889148,-16.05,9
06:59,128033695.0,2820.8128929624427,-8.21,7
07:04,822135975.0,11679.699650672455,-2.94,7
07:05,169006407.0,10695.092586419294,-35.44,2
07:06,435984758.0,4860.392904821339,-33.3,7
07:06,853907490.0,6878.684477010431,-17.72,2
07:07,823208989.0,1451.7549902701955,-22.92,2
07:08,364357875.0,6066.837898339113,-20.74,9
07:10,331450202.0,6223.33508356684,-7.22,5
07:12,829914501.0,1881.120806570974,-5.05,9
07:12,252760664.0,5671.1717782295345,-7.72,5
07:14,235881534.0,11266.313148384996,-5.62,8
07:18,698076160.0,5406.987900319555,-54.06,5
07:21,183888402.0,15800.226828599449,-31.74,9
07:25,639549973.0,5983.578561923535,-34.93,7
07:26,518474507.0,12864.775321225492,-37.87,9
07:30,284905540.0,7132.951818960159,-19.15,9
07:36,108563213.0,20753.792157910815,-2.14,2
07:38,187111705.0,5835.983651563909,-25.19,8
07:38,511179916.0,7137.008031311578,-9.25,8
07:38,143003091.0,19632.30045334093,-43.45,5
07:39,633345190.0,6855.96356387677,-3.69,2
07:41,940569402.0,5312.524339351636,-7.82,5
07:45,836110591.0,6131.055015766439,-16.34,2
07:53,899742927.0,12292.223407434229,-32.32,2
07:57,187541224.0,6322.57255922144,-44.09,9
07:59,364357875.0,5988.498829459525,-78.34,2
08:02,489964679.0,21392.706792849895,-35.39,9
08:03,984783496.0,12695.04630990258,-14.93,9
08:05,297823329.0,542.2324999999992,-6.85,9
08:07,824916823.0,8037.435226432237,-6.61,8
08:08,395284483.0,1224.1618135669678,-5.7,9
08:10,874431242.0,7601.031457715122,-33.23,4
08:13,678851253.0,3023.4105151324434,-20.96,8
08:16,256002321.0,6439.743759335732,-22.03,7
08:18,290818242.0,6259.770776940809,-1.78,4
08:19,623156843.0,4596.4888115683825,-25.05,5
08:20,399538448.0,6986.285712652364,-5.7,9
08:22,815385232.0,8939.377929690278,-0.22,2
08:25,752362502.0,8323.114873243469,-28.7,2
08:25,775790822.0,-2840.8384192160684,-30.42,5
08:26,930277104.0,9728.168614507726,-17.48,9
08:27,503575533.0,7054.697100000015,-58.34,5
08:30,285220959.0,11008.393182337932,-17.77,5
08:33,520447032.0,8335.132153964509,-13.11,5
08:33,478986718.0,-981.3635000000004,-17.0,5
08:34,454129843.0,757.8338507917888,-6.35,9
08:36,500051919.0,100.25869665059044,-99.03,5
08:38,213096759.0,-1439.8551082144395,-133.62,5
08:38,141521177.0,6059.7319000000125,-103.53,5
08:40,252419513.0,-1807.131135813416,-86.7,5
08:40,173317688.0,-2101.1262348842856,-42.88,5
08:42,992204045.0,10551.21684484967,-22.39,2
08:42,822135975.0,11588.111650672456,-91.59,5
08:43,711045550.0,219.408350000003,-118.92,5
08:43,644751433.0,-1309.7325584655382,-63.56,5
08:44,660789920.0,-2277.1433473823727,-10.12,5
08:46,250957494.0,354.1104999999989,-134.54,5
08:47,550169791.0,18460.993393086796,-10.29,2
08:48,609939116.0,5921.407382714228,-31.39,7
08:50,414805878.0,13132.92738583435,-38.95,9
08:50,216286013.0,-40.763143346059906,-41.04,5
08:51,819515373.0,1679.3611360637908,-129.73,5
08:52,466649401.0,-133.93408427680328,-145.89,5
08:52,853907490.0,6839.93247701043,-38.75,5
08:52,795847804.0,20061.214409424003,-51.03,5
08:53,915666111.0,-3762.3870747720375,-57.18,5
08:54,715068825.0,482.53949999999986,-90.89,5
08:59,506618547.0,16977.793712206814,-5.0,9
09:01,138609932.0,4134.602003294584,-6.05,9
09:01,994214354.0,8598.920534174673,-25.34,9
09:01,865748375.0,4958.006126291713,-14.96,5
09:02,383833857.0,21053.428390136043,-5.25,9
09:02,264208990.0,649.0715499999991,-5.7,9
09:03,331684336.0,-1487.0327199513215,-103.26,5
09:03,117273481.0,7806.0367901780355,-5.95,9
09:05,558875206.0,2131.7614500000004,-6.8,9
09:08,851649498.0,9249.472327255193,-6.15,9
09:09,195895574.0,6378.669489986151,-14.95,7
09:12,407574996.0,3211.750150968193,-47.13,1
09:13,127809299.0,543.0011428980364,-58.95,5
09:15,613729471.0,7125.530171619245,-5.9,9
09:17,663479159.0,958.4835418277085,-30.95,7
09:18,604288474.0,2866.143514853604,-43.92,4
09:19,960208650.0,14967.294901874582,-1.5,8
09:19,540159353.0,9771.955005190488,-5.65,9
09:21,441274121.0,11308.719148319424,-5.6,9
09:21,930277104.0,9628.518614507726,-99.65,2
09:22,417850087.0,15076.718821055932,-5.4,9
09:23,352291960.0,1788.2388033035738,-34.47,5
09:24,169006407.0,10689.492586419294,-5.6,9
09:25,979892433.0,-1558.153900000001,-66.85,5
09:31,683078800.0,1518.9932972194538,-5.7,9
09:33,919185264.0,3745.6875277405034,-49.99,2
09:37,264550521.0,8566.13270327199,-50.39,4
09:43,903663593.0,464.459618582982,-14.98,7
09:49,910730524.0,7377.158881757133,-7.68,5
09:57,987229118.0,3706.234370041726,-11.73,8
09:57,215311171.0,5548.458788837051,-18.92,8
09:58,280268430.0,4509.779732378333,-31.97,4
10:09,136770968.0,-199.97510000000028,-9.99,2
10:15,472995101.0,1657.5579738883296,-99.39,5
10:15,454356905.0,2313.9458999031135,-5.03,7
10:15,588565416.0,6609.70844468425,-34.39,7
10:17,480557476.0,10146.41687178874,-121.78,2
10:18,604288474.0,2850.796381453268,-15.35,5
10:23,137822385.0,3138.941117151475,-7.5,9
10:24,503575533.0,6960.211100000015,-94.49,2
10:26,504055745.0,-708.645038658233,-60.55,5
10:26,700138124.0,5153.361300000003,-32.02,2
10:30,145387690.0,4981.826772444849,-16.63,7
10:32,987656636.0,5626.081454586602,-1.53,7
10:46,727417797.0,4466.409500000008,-148.81,5
10:51,422955974.0,-355.66461500095,-118.96,5
10:51,284905540.0,6958.651818960158,-174.3,2
10:51,549414742.0,6676.0545932451705,-60.07,4
10:56,570269025.0,2335.110583359887,-80.05,7
10:59,322221939.0,3192.2099140245937,-40.79,5
11:04,985188462.0,650.0402487112245,-45.8,2
11:06,284905540.0,6720.651818960158,-238.0,2
11:11,277562576.0,447.1937507952724,-106.97,4
11:16,133755851.0,384.9640038000929,-0.21,7
11:16,672994751.0,-138.97869241586258,-11.98,7
11:19,570269025.0,2290.6819333598874,-44.43,5
11:20,930277104.0,9579.580878339562,-48.94,8
11:26,240643705.0,62.16479112061553,-57.0,5
11:29,909669130.0,139.81788473676664,-20.95,4
11:39,766941757.0,9020.111787055976,-4.01,5
11:42,572384506.0,9506.728270579331,-13.14,2
12:01,284905540.0,6581.351818960158,-139.3,2
12:05,899983008.0,-2799.091149999998,-29.18,9
12:09,812692024.0,4219.805178787428,-5.99,4
12:14,284905540.0,6340.551818960158,-240.8,2
12:16,259015404.0,3470.801086371928,-60.68,8
12:27,519644021.0,2163.651015183104,-16.04,4
12:34,564214408.0,-179.9443152742738,-38.65,5
12:38,472995101.0,1605.5779738883296,-51.98,4
12:45,612304466.0,-1945.9032500000003,-24.96,5
12:48,843174694.0,-4348.658499999998,-44.8,5
12:51,494156986.0,-363.26225432766495,-69.19,5
12:52,792845450.0,804.3391500000009,-83.64,5
12:56,480557476.0,10082.226871788738,-64.19,5
12:58,308897841.0,531.8574999999994,-26.97,5
12:59,284905540.0,6002.451818960158,-338.1,2
12:59,910730524.0,7371.108881757133,-6.05,9
13:03,786141370.0,-731.7135000000009,-90.92,5
13:03,503575533.0,6792.911100000015,-167.3,2
13:05,402438092.0,486.5950999999991,-43.7,5
13:05,111137699.0,-248.11894999999964,-86.1,5
13:12,909669130.0,83.33788473676664,-56.48,2
13:13,117308635.0,1130.735615882456,-100.39,2
13:17,322221939.0,3186.8599140245938,-5.35,9
13:18,277562576.0,442.1937507952724,-5.0,9
13:18,688712152.0,5856.9932422075335,-6.15,9
13:20,469561218.0,-27.113900000000857,-48.66,5
13:22,874506295.0,-1641.4867562455722,-31.23,5
13:24,187111705.0,5829.083651563909,-6.9,9
13:24,585625048.0,874.6916190586327,-5.5,9
13:27,136770968.0,-249.9651000000003,-49.99,4
13:27,783650950.0,-1033.6756434110114,-13.98,9
13:28,433837402.0,-1124.995868464188,-33.89,9
13:33,348525881.0,-32.448375405063686,-24.42,5
13:39,316793091.0,649.4843100549512,-51.98,4
13:42,904154012.0,929.7174581204324,-18.0,4
13:45,503575533.0,6703.339100000015,-89.57,2
13:46,441142605.0,2421.2822500000034,-49.99,2
14:00,682194230.0,-2055.218350000001,-61.66,5
14:02,191161970.0,-3318.513999999997,-12.6,5
14:05,503575533.0,6516.495100000015,-186.84,2
14:08,287480331.0,11307.113295653604,-16.41,7
14:19,570323670.0,3233.8465458823944,-28.89,9
14:44,596171893.0,-312.8782551744889,-43.95,7
14:46,503575533.0,6394.737100000015,-121.76,2
14:47,593191200.0,1010.0470499999992,-130.29,5
14:52,287480331.0,11255.307275653604,-51.81,4
15:10,792845450.0,779.3391500000009,-25.0,2
15:11,679911053.0,2064.610107249582,-21.17,7
15:23,503575533.0,6199.465100000015,-195.27,2
15:24,792845450.0,737.3891500000009,-41.95,1
15:32,909669130.0,11.33788473676664,-72.0,2
15:39,720742759.0,985.0898308830078,-62.0,4
15:41,625281433.0,-754.9145573707567,-40.64,5
15:41,165098840.0,-811.7406263623731,-50.96,5
15:54,909669130.0,-131.64211526323334,-142.98,2
16:01,720742759.0,842.5998308830078,-142.49,7
16:05,583558311.0,-911.200215248668,-34.21,5
16:20,678330503.0,1893.870426109025,-28.7,2
16:25,786879739.0,-2069.4107941205575,-15.35,5
16:28,970298834.0,2674.3064049865015,-15.05,4
16:29,624500124.0,3286.509178850582,-34.1,5
16:30,892354433.0,-1565.7925606343388,-33.34,5
16:37,208381936.0,-238.5255782217451,-29.7,9
16:37,198946608.0,5340.538517769283,-48.22,5
16:39,718058208.0,751.9971035344469,-73.39,5
16:40,670102069.0,3464.8728420837015,-65.5,7
16:40,399144202.0,2358.3581339344364,-3.92,2
16:42,570575024.0,-964.7307500000004,-71.0,5
16:45,435313070.0,2636.7783573536094,-29.99,2
16:49,532478725.0,4646.8648115703545,-53.56,4
16:50,610645022.0,-991.0973626449182,-77.49,5
16:51,345582855.0,-731.8411471794508,-40.53,5
16:52,252760664.0,5632.167778229535,-39.0,5
16:53,473820682.0,10581.210283947148,-6.13,4
16:56,807714284.0,657.4054607360001,-45.58,5
16:57,180616589.0,1538.489648033954,-37.23,5
16:59,666952234.0,-375.088751875513,-63.8,5
17:03,736310094.0,-884.429324027426,-94.48,5
17:04,673818591.0,1006.6028753758412,-41.93,1
17:06,227104649.0,1829.1960543161777,-27.54,4
17:09,420109571.0,303.0964189636076,-28.62,7
17:09,315078351.0,5662.874649122869,-59.3,2
17:11,272538745.0,12950.059900000022,-99.99,2
17:11,433917275.0,7435.583828843973,-38.82,9
17:12,887853850.0,9692.1465514075,-22.43,9
17:13,226703987.0,2150.451649999999,-26.34,9
17:13,880546403.0,-920.4255000000016,-159.64,5
17:16,146909202.0,4092.9527256970114,-21.02,7
17:20,698955014.0,914.5484549409122,-31.18,9
17:21,720221651.0,-2191.111366598435,-22.84,5
17:22,551755686.0,7119.651585195959,-14.99,4
17:24,522188082.0,6847.598134534096,-13.54,4
17:25,383625050.0,5452.942645799094,-50.39,2
17:26,166019891.0,7016.816004637642,-1.52,4
17:28,516051449.0,1631.4895090142911,-42.13,5
17:29,108481285.0,8010.386524704508,-52.45,2
17:30,675806859.0,6061.199302106993,-3.55,7
17:30,651756497.0,12742.640001194632,-48.33,2
17:30,373875019.0,13880.220402803743,-76.98,2
17:30,315078351.0,5562.484649122869,-100.39,2
17:32,618514666.0,18126.466447261657,-14.99,4
17:33,425964226.0,2741.9106500000016,-25.0,2
17:34,604334058.0,-12.428700000000529,-26.98,4
17:36,534325901.0,5880.521412458371,-21.24,5
17:36,672913754.0,9090.983518387367,-33.95,7
17:38,581655972.0,37851.82081182855,-22.97,7
17:39,788740658.0,3087.3498337594806,-9.15,4
17:40,131388684.0,19238.131388623216,-42.5,5
17:41,705848712.0,22960.512202906655,-12.46,7
17:41,200080192.0,8765.19698882089,-5.02,7
17:41,229205098.0,6613.79069163607,-318.5,2
17:43,361201224.0,6415.524232067893,-32.05,7
17:43,315546581.0,24067.675370645615,-85.2,5
17:44,315546581.0,24043.149604084316,-24.53,2
17:45,795847804.0,19956.949409424004,-104.26,5
17:48,137913631.0,643.2327499999994,-41.5,5
17:48,108563213.0,20683.742157910816,-70.05,2
17:49,237493332.0,12335.285695173126,-179.16,2
17:49,329840194.0,777.3837301431478,-66.49,4
17:50,806358207.0,10577.72796005099,-104.1,5
17:51,540159353.0,9708.605005190488,-63.35,5
17:51,996042490.0,4349.301296170785,-83.49,5
17:52,124102251.0,3667.6649564754216,-12.99,2
17:53,228136274.0,-599.7231000000008,-60.63,5
17:54,399144202.0,2267.038133934436,-91.32,6
17:54,583579399.0,516.9493499999991,-70.97,4
17:55,720742759.0,692.6198308830078,-149.98,4
17:55,449871732.0,8810.752113265706,-10.98,1
17:57,897714622.0,8461.290794823404,-33.94,7
17:57,909669130.0,-210.63211526323337,-78.99,2
17:57,108481285.0,7905.306524704508,-105.08,2
17:58,667367404.0,8062.687569780753,-7.21,4
17:58,719586818.0,16861.52043757325,-45.11,5
18:00,471897866.0,7672.413086461692,-30.47,4
18:04,416060965.0,750.6172320979584,-64.5,2
18:07,719586818.0,16836.57043757325,-24.95,9
18:08,500043411.0,12095.906147860778,-81.89,2
18:08,229205098.0,6470.29069163607,-143.5,2
18:09,918160369.0,-811.9636500000004,-37.85,9
18:09,957821152.0,-1336.2874535715498,-43.03,5
18:12,736340277.0,7496.50432775244,-43.76,5
18:12,999752672.0,356.4515435333344,-120.12,5
18:16,376271050.0,660.3202468611794,-23.97,7
18:21,416060965.0,695.6272320979584,-54.99,2
18:22,519935524.0,-181.14981026248103,-41.54,5
18:23,994214354.0,8561.729439845069,-37.19,5
18:23,116598243.0,1877.315561085252,-37.99,8
18:24,192202372.0,141.06840302901105,-5.99,7
18:24,471897866.0,7666.750927155047,-5.66,5
18:28,245690309.0,8027.547147037844,-38.18,5
18:29,441274121.0,11293.896817366798,-14.82,7
18:29,454129843.0,662.1536507917888,-95.68,5
18:30,833499132.0,2170.7373500000003,-25.95,9
18:30,310375875.0,3405.4137084559243,-28.26,7
18:30,197865285.0,307.59421173122047,-31.13,9
18:33,500043411.0,11960.82014786078,-135.09,2
18:34,170637730.0,2566.1618526470515,-7.82,2
18:34,653667523.0,4212.263455813256,-54.14,5
18:36,704517789.0,15123.89704766776,-41.56,2
18:36,705848712.0,22933.181134968087,-27.33,7
18:38,196289502.0,13407.079318880606,-84.78,7
18:38,450896297.0,12157.10566361277,-23.66,7
18:40,158766229.0,-774.9659858934699,-68.57,5
18:42,120634201.0,4565.277500000004,-18.89,9
18:43,687135796.0,24518.328297784847,-11.38,7
18:43,868014990.0,-3014.876099999997,-17.67,5
18:45,482513594.0,6444.197743193415,-13.99,5
18:46,196289502.0,13400.979318880603,-6.1,7
18:51,856957948.0,8398.58651249826,-142.17,5
18:51,779816907.0,-2713.223582922913,-40.09,5
18:51,701070224.0,670.3173500000001,-222.88,5
18:54,196289502.0,13379.039318880605,-21.94,9
18:58,189757473.0,-2011.8236500000007,-38.06,5
18:59,345514953.0,1310.528199999999,-140.93,5
19:00,435984758.0,4858.398924821338,-1.99,7
19:00,583579399.0,479.8622999999991,-37.09,5
19:01,829914501.0,1734.183806570974,-146.94,5
19:01,119943495.0,-1380.1481621128582,-97.66,5
19:01,248625662.0,-1803.5394157151477,-41.74,5
19:04,364396689.0,-618.14825,-45.09,5
19:05,809499628.0,14622.292327063651,-2.31,5
19:06,975200042.0,-2796.460199999998,-41.95,5
19:12,897714622.0,8443.840794823403,-17.45,9
19:16,603721739.0,37.03589948318413,-121.23,5
19:17,213112754.0,6508.327043216413,-59.86,5
19:19,188263947.0,525.2188500000002,-91.31,5
19:20,308505160.0,12125.369704975205,-11.49,8
19:21,198946608.0,5337.715008030265,-2.82,7
19:26,435984758.0,4778.570924821338,-79.83,5
19:26,419550103.0,16709.857551280213,-38.74,2
19:30,321372947.0,-444.03155078909936,-51.68,5
19:32,824916823.0,8022.805226432237,-14.63,9
19:32,419550103.0,16674.257551280214,-35.6,9
19:36,804317849.0,-3489.1241330205207,-88.41,5
19:39,585596026.0,-259.1462611887467,-85.11,5
19:41,547010927.0,21403.866665998557,-24.48,9
19:42,492215823.0,-85.03382618455697,-107.2,5
19:49,801500539.0,-2942.9836999999993,-99.08,5
19:50,939972497.0,225.30490860001083,-38.06,5
19:52,913127700.0,644.0961380111165,-67.26,5
19:53,854895960.0,2447.7898084062476,-185.44,5
19:58,155867488.0,-549.9423000000015,-102.35,5
19:59,651756497.0,12733.353367392478,-9.29,5
19:59,551196328.0,3864.978700000005,-107.41,5
20:16,383833857.0,21036.956600621295,-16.47,8
20:22,552980092.0,-76.32728088066254,-63.13,5
20:27,605116158.0,2307.2795,-42.99,5
20:27,124102251.0,3606.039941028751,-61.63,2
20:30,587225252.0,8910.933250655597,-7.09,2
20:34,506618547.0,16975.274114042943,-2.52,5
20:45,844835978.0,8499.325265270118,-32.31,5
20:51,113747882.0,10643.19427836144,-38.01,5
21:01,859603181.0,3731.3936320015146,-22.15,8
21:13,366550080.0,22972.903180653346,-35.36,5
21:18,259015404.0,3441.8110863719285,-28.99,9
00:12,678851253.0,3009.3378476484777,-14.07,8
02:11,270374623.0,9334.723999078842,-19.42,4
02:39,940569402.0,5286.569541567843,-25.95,7
02:39,169006407.0,10652.693977040588,-36.8,8
02:41,518474507.0,12822.545321225492,-42.23,9
02:42,414805878.0,13105.147385834349,-27.78,9
02:44,779620857.0,-500.6658963851758,-34.55,9
02:52,795847804.0,19946.9678374818,-9.98,8
03:08,128033695.0,2798.572892962443,-22.24,9
03:13,124102251.0,3553.013587516066,-53.03,2
03:14,259015404.0,3415.9210863719286,-25.89,9
03:20,517190750.0,1697.2910899154124,-28.64,9
03:25,409971170.0,1831.2829425251464,-4.79,2
03:27,656812046.0,949.6876775465154,-21.39,5
03:35,366550080.0,22950.653180653346,-22.25,9
03:48,802697323.0,18823.471167910586,-28.95,9
03:53,730002588.0,12284.091281070088,-65.95,7
04:02,216285378.0,20962.12638463492,-42.74,9
04:07,237493332.0,12321.096787214738,-14.19,8
04:10,183888402.0,15755.106828599448,-45.12,9
04:11,259015404.0,3341.998367364721,-73.92,7
04:17,899742927.0,12290.95906523457,-1.26,5
04:27,709608057.0,3111.6937723834535,-23.77,9
04:32,414805878.0,13075.954015719724,-29.19,7
04:39,668329719.0,7255.508991612241,-7.91,8
04:42,749378808.0,4970.903455342611,-26.29,9
04:42,706250160.0,9669.806856787078,-41.98,8
04:43,264550521.0,8540.34009246277,-25.79,8
04:45,769311479.0,6196.993527720106,-6.5,7
04:48,984783496.0,12685.182774615396,-9.86,5
04:49,835736339.0,2351.4052504145593,-19.37,9
05:03,949032480.0,4511.8428322734035,-58.06,5
05:06,766941757.0,8986.921787055975,-33.19,9
05:08,718058208.0,748.5029362248013,-3.49,2
05:11,653640811.0,14722.215761484476,-7.34,7
05:11,873701090.0,661.7882253720448,-3.83,7
05:13,749378808.0,4902.189545220836,-68.71,5
05:14,408057540.0,7274.990359314665,-2.15,7
05:15,145387690.0,4973.012819594804,-8.81,4
05:16,613729471.0,7095.690322308836,-29.84,5
05:16,832564361.0,14068.620622757377,-20.36,5
05:18,675806859.0,6054.939626470018,-6.26,7
05:19,930277104.0,9554.027398729784,-25.55,5
05:26,858989281.0,23580.82956037653,-29.45,7
05:26,785749304.0,7531.024143757756,-26.5,8
05:28,417850087.0,15060.1350175328,-16.58,5
05:28,657139925.0,11751.766028973574,-5.31,5
05:29,994214354.0,8524.699439845068,-37.03,9
05:33,586315521.0,10701.606088230435,-75.34,7
05:34,519644021.0,2149.7196791528745,-13.93,2
05:35,806358207.0,10551.906787488386,-25.82,5
05:37,766941757.0,8970.088637935922,-16.83,7
05:40,128033695.0,2788.6007267497953,-9.97,2
05:45,853907490.0,6829.55247701043,-10.38,9
05:46,719586818.0,16811.689035159612,-24.88,5
05:47,687135796.0,24508.338297784845,-9.99,9
05:55,473820682.0,10545.659710187856,-35.55,8
05:57,305778936.0,11061.637904640147,-56.61,2
05:58,364357875.0,5979.802855900709,-8.7,7
05:59,836110591.0,6104.82501576644,-26.23,9
05:59,510101371.0,11718.157489687646,-21.36,7
06:00,496395938.0,11504.513444488062,-52.63,7
06:00,633345190.0,6824.313563876771,-31.65,9
06:07,985188462.0,613.7502487112246,-36.29,9
06:07,559995067.0,3695.3137650710582,-17.06,7
06:08,116598243.0,1845.0763553364368,-32.24,8
06:11,822250278.0,6163.74853842456,-11.99,2
06:13,252760664.0,5631.0132515203295,-1.15,5
06:16,106601471.0,8882.800298574051,-50.45,2
06:16,134461671.0,7933.044032673117,-20.26,7
06:18,687135796.0,24495.173905376058,-13.16,2
06:18,779946617.0,14949.342773171114,-18.71,5
06:22,873693307.0,8002.498167130372,-43.78,7
06:23,195895574.0,6376.186740893764,-2.48,4
06:24,912705941.0,16576.87848276782,-54.25,8
06:31,187541224.0,6283.43255922144,-39.14,9
06:33,324224854.0,1308.4975715909345,-18.58,5
06:35,547010927.0,21330.14632007763,-73.72,4
06:36,282837512.0,12081.82082497424,-36.7,7
06:37,874431242.0,7596.629744815148,-4.4,2
06:37,897714622.0,8430.28916600582,-13.55,4
06:40,489964679.0,21352.266792849896,-40.44,9
06:41,366550080.0,22923.340403260576,-27.31,7
06:44,679911053.0,1998.864761533524,-65.75,5
06:46,587225252.0,8872.703250655597,-38.23,9
06:49,647472692.0,21829.292420035665,-21.56,2
06:50,256002321.0,6425.803759335732,-13.94,9
06:51,683319988.0,6818.124796221284,-26.92,9
06:51,433917275.0,7424.563529444719,-11.02,8
06:53,213112754.0,6453.113125372115,-55.21,2
06:53,298000165.0,22493.71215433322,-49.85,2
06:54,348325817.0,8188.111917837709,-35.53,9
07:01,887853850.0,9657.5965514075,-34.55,9
07:01,549414742.0,6650.654593245171,-25.4,9
07:01,287480331.0,11223.617275653603,-31.69,9
07:02,639409800.0,30476.848307747307,-22.49,7
07:02,235881534.0,11247.469345848976,-18.84,2
07:05,170637730.0,2526.349733882766,-39.81,2
07:06,506618547.0,16958.191164922122,-17.08,7
07:08,823208989.0,1420.3288435760708,-31.43,5
07:08,842682241.0,4804.200983418676,-36.98,5
07:10,290818242.0,6209.037803955698,-50.73,2
07:15,435984758.0,4762.601610941197,-15.97,5
07:17,905860285.0,15017.442674880456,-13.88,5
07:19,310375875.0,3363.7418021936223,-41.67,7
07:21,648644594.0,-897.0978500000009,-36.34,9
07:22,500043411.0,11952.709512527092,-8.11,2
07:26,853907490.0,6810.622250945812,-18.93,5
07:28,200080192.0,8706.988952668431,-58.21,2
07:28,471897866.0,7645.783210432915,-20.97,2
07:28,970298834.0,2673.002059202782,-1.3,7
07:29,482513594.0,6441.514643180612,-2.68,5
07:32,822135975.0,11576.521789978156,-11.59,5
07:35,198946608.0,5321.9331175943935,-15.78,8
07:38,609939116.0,5837.656407413113,-83.75,4
07:44,203466392.0,1772.18478847463,-13.7,5
07:47,679662108.0,13515.472814027866,-71.02,2
07:49,331450202.0,6170.104287543309,-53.23,5
07:51,407574996.0,3153.246119938584,-58.5,8
07:51,399144202.0,2244.1481339344364,-22.89,9
07:52,683319988.0,6773.8600557955215,-44.26,2
07:55,383833857.0,20990.384717451885,-46.57,8
07:55,454356905.0,2293.0409462550756,-20.9,2
08:01,550169791.0,18456.93759425528,-4.06,5
08:02,822718326.0,9399.677197351906,-53.31,5
08:03,310620484.0,584.934870395092,-39.34,5
08:05,705848712.0,22906.351853687753,-26.83,7
08:08,824916823.0,8007.201060353238,-15.6,2
08:13,187111705.0,5810.809132689663,-18.27,5
08:14,736340277.0,7495.039914845908,-1.46,7
08:15,647936800.0,1381.126924810824,-19.35,2
08:20,176922958.0,51.64319692933929,-6.94,5
08:20,667367404.0,8008.009548312582,-54.68,2
08:21,399538448.0,6980.885712652364,-5.4,9
08:23,532478725.0,4620.344540993914,-26.52,8
08:25,147341222.0,-1504.3413753207956,-108.01,5
08:27,217540156.0,-3132.6073199999955,-27.42,5
08:28,678330503.0,1821.4856024734277,-72.38,2
08:29,987656636.0,5616.378196296691,-9.7,8
08:30,703478110.0,3926.1700842662462,-72.16,5
08:31,294474095.0,-2138.98378649924,-18.07,5
08:31,194023154.0,-2303.8621717847345,-22.82,5
08:32,713910252.0,-505.16787427145834,-56.64,5
08:33,308505160.0,12121.913554243396,-3.46,5
08:33,145387690.0,4946.562819594804,-26.45,9
08:33,558119802.0,28624.95897639339,-3.3,8
08:33,311467864.0,313.88469999999916,-129.48,5
08:33,108481285.0,7858.409617520582,-46.9,8
08:34,578131296.0,463.90676944404385,-93.05,5
08:35,541639148.0,4107.515823120029,-68.33,2
08:37,298007503.0,436.6701036256335,-125.5,5
08:40,215426302.0,-217.14359597430828,-15.39,5
08:40,480557476.0,10048.537042683196,-33.69,2
08:44,851649498.0,9240.775391861367,-8.7,2
08:44,581655972.0,37844.51996796652,-7.3,7
08:44,282102606.0,-806.0630375771735,-97.28,5
08:44,556631012.0,265.35892308567827,-105.28,5
08:45,490868147.0,-385.98622087869853,-44.69,5
08:45,455831435.0,-1721.9846048014945,-141.49,5
08:45,143606916.0,-19.901845970810285,-225.65,5
08:47,456221621.0,456.5695673026282,-45.02,5
08:48,956717493.0,809.0678776068376,-5.83,2
08:48,317161035.0,-3280.252599999997,-56.87,5
08:51,426466211.0,-2952.86825,-7.49,5
08:52,348325817.0,8174.491992662976,-13.62,2
08:52,151968462.0,8255.823839168452,-2.14,5
08:53,250895529.0,908.1670324692872,-131.61,5
08:54,383833857.0,20969.426717451886,-20.96,5
08:59,994214354.0,8501.271118518067,-23.43,8
09:01,108481285.0,7771.133617520582,-87.28,5
09:01,520447032.0,8325.889594792376,-9.24,7
09:02,392790315.0,-4069.0213943720664,-95.01,5
09:03,331450202.0,6125.598287543308,-44.51,5
09:06,595800644.0,-1068.20015,-92.85,5
09:08,221356538.0,63.98489999999961,-135.83,5
09:10,913801979.0,403.4786299144939,-140.09,5
09:10,383625050.0,5443.453741642609,-9.49,2
09:12,454356905.0,2282.8903862550756,-10.15,4
09:13,534325901.0,5874.009531287005,-6.51,7
09:15,403902116.0,55.68374999999941,-243.15,5
09:16,441274121.0,11285.936838139463,-7.96,8
09:17,486495235.0,869.1766393887158,-31.99,2
09:17,143061865.0,6324.336228302977,-138.57,2
09:17,897714622.0,8420.22916600582,-10.06,2
09:20,169006407.0,10619.713977040588,-32.98,1
09:22,370521542.0,22835.515419519343,-47.87,4
09:22,290818242.0,6155.717803955698,-53.32,6
09:23,510101371.0,11711.837489687648,-6.32,4
09:24,876890798.0,3276.6525706999296,-59.98,2
09:24,126929801.0,961.9199190559711,-166.98,2
09:24,679911053.0,1997.364761533524,-1.5,4
09:25,473820682.0,10493.173710187855,-52.49,5
09:25,242218612.0,584.2163000000006,-39.98,2
09:25,781554833.0,2414.7685792775105,-3.52,8
09:25,308505160.0,12116.163554243396,-5.75,9
09:25,822250278.0,6121.90783842456,-41.84,4
09:25,779946617.0,14897.283773171115,-52.06,5
09:26,450896297.0,12133.795663612773,-23.31,7
09:28,149684419.0,567.8371999999985,-53.99,2
09:28,960208650.0,14957.260807139775,-10.03,2
09:28,361201224.0,6246.124232067893,-169.4,2
09:30,971010829.0,484.6012564442454,-12.98,7
09:30,423208402.0,1963.6756000000023,-53.99,2
09:30,621652856.0,1387.22196961054,-186.9,2
09:32,833899961.0,1942.2737728389911,-72.99,2
09:33,285428103.0,8191.521950465587,-84.32,5
09:35,147474476.0,3624.346696701949,-153.98,2
09:36,823208989.0,1390.0988435760707,-30.23,2
09:37,169006407.0,10591.683977040588,-28.03,2
09:37,992204045.0,10526.19684484967,-25.02,2
09:39,651756497.0,12711.60896547151,-21.74,7
09:39,867679563.0,-65.84434629828417,-28.05,5
09:39,893134725.0,1903.131962973209,-90.0,2
09:39,229205098.0,6470.104734482322,-0.19,5
09:40,713641917.0,802.3297695038419,-144.98,2
09:40,518474507.0,12802.253354420172,-20.29,2
09:40,134847904.0,2693.616694386293,-83.98,2
09:41,108563213.0,20679.20879002656,-4.53,2
09:41,386729293.0,26607.697378393328,-17.48,8
09:42,433917275.0,7392.80858944472,-31.75,4
09:42,280098744.0,1041.2853778716656,-22.0,2
09:45,819515373.0,1669.3711360637908,-9.99,4
09:46,419550103.0,16624.277551280215,-49.98,4
09:46,736340277.0,7481.7599148459085,-13.28,7
09:49,838830098.0,1343.1625420877845,-29.99,2
09:50,630691258.0,239.11654487484137,-1.99,4
09:50,699139822.0,2190.661561032655,-2.23,5
09:51,822135975.0,11571.481789978156,-5.04,4
09:52,113747882.0,10621.86427836144,-21.33,4
09:53,570323670.0,3182.2550058823945,-51.59,4
09:53,856957948.0,8383.60651249826,-14.98,7
09:55,198051483.0,-1481.8096104088568,-55.2,5
09:55,849096144.0,1670.072858910517,-99.98,4
09:56,264550521.0,8513.27009246277,-27.07,7
09:57,854513972.0,444.56304999999946,-15.98,1
09:58,414805878.0,13036.454015719724,-39.5,2
10:00,454129843.0,642.1636507917888,-19.99,2
10:01,621652856.0,1226.22196961054,-161.0,2
10:01,887853850.0,9645.896773486293,-11.7,2
10:03,893134725.0,1808.631962973209,-94.5,2
10:04,971010829.0,436.1112564442454,-48.49,2
10:04,559995067.0,3639.2737650710583,-56.04,2
10:05,987229118.0,3696.244370041726,-9.99,4
10:05,549414742.0,6635.722451684781,-14.93,2
10:06,838830098.0,1303.1825420877844,-39.98,2
10:07,134847904.0,2631.616694386293,-62.0,2
10:08,479456865.0,977.0802314894048,-17.98,4
10:09,987163717.0,5719.082720000005,-88.72,2
10:09,117273481.0,7789.546790178036,-16.49,4
10:10,355602925.0,1129.3737938274146,-72.3,5
10:10,322720763.0,6637.322223538681,-12.01,4
10:15,815385232.0,8928.893571577522,-10.48,7
10:15,496395938.0,11462.429444488062,-42.08,5
10:16,742223719.0,455.9943073048027,-29.99,2
10:16,425964226.0,2713.9506500000016,-27.96,1
10:17,939972497.0,197.34490860001085,-27.96,7
10:17,141521177.0,6029.741900000013,-29.99,2
10:18,971010829.0,322.13125644424537,-113.98,2
10:19,630691258.0,149.61654487484137,-89.5,2
10:21,331450202.0,6082.008287543308,-43.59,7
10:22,628470485.0,777.2460299001231,-24.98,4
10:22,270374623.0,9318.563999078842,-16.16,1
10:22,780463728.0,2588.61602094224,-305.19,2
10:24,795847804.0,19933.8378374818,-13.13,2
10:27,414454079.0,646.5568500000018,-2.54,4
10:27,700138124.0,5006.361300000003,-147.0,2
10:27,893134725.0,1615.131962973209,-193.5,2
10:28,574548998.0,439.6787499999992,-31.99,2
10:29,730002588.0,12065.719281070087,-218.37,2
10:30,698076160.0,5385.007900319555,-21.98,4
10:32,461990622.0,8544.119821658358,-1.18,7
10:34,975345315.0,30692.77079999996,-77.6,5
10:36,698955014.0,904.5584549409122,-9.99,4
10:36,780463728.0,2485.04402094224,-103.57,2
10:36,973086490.0,8993.920981351372,-17.22,8
10:36,683078800.0,1471.0032972194538,-47.99,2
10:38,303843160.0,331.0688000000017,-5.99,4
10:40,700138124.0,4853.061300000003,-153.3,2
10:40,146909202.0,4089.6583649994486,-3.29,2
10:43,752362502.0,8289.094873243468,-34.02,7
10:46,858560423.0,10569.325645306975,-154.98,2
10:49,987656636.0,5582.228196296692,-34.15,1
10:51,441274121.0,11245.626838139464,-40.31,7
10:51,621652856.0,1009.22196961054,-217.0,2
10:52,893134725.0,1585.131962973209,-30.0,2
10:52,690523499.0,770.1178999999996,-3.0,7
10:52,117308635.0,1124.725615882456,-6.01,7
10:55,287480331.0,11213.709098236306,-9.91,7
10:56,361201224.0,5989.924232067893,-256.2,2
10:59,429556122.0,5522.217750000003,-111.3,2
11:01,282837512.0,12068.56082497424,-13.26,2
11:03,405945930.0,4031.3952431977295,-167.3,2
11:05,781554833.0,2320.7785792775107,-93.99,2
11:06,489964679.0,21334.508274736312,-17.76,2
11:07,531186970.0,442.3375562436195,-29.99,4
11:07,237684254.0,5327.79884011956,-30.26,7
11:08,336557504.0,1362.4375692497413,-114.83,5
11:10,621652856.0,751.62196961054,-257.6,2
11:12,785210466.0,1846.7132041968257,-29.99,4
11:12,780463728.0,2339.48602094224,-145.56,2
11:13,822135975.0,11546.985259978155,-24.5,4
11:15,585133606.0,4189.484665314501,-67.89,2
11:15,973388795.0,805.9176761636216,-6.0,7
11:15,758160963.0,7405.375964991655,-20.87,2
11:16,405945930.0,3740.1952431977297,-291.2,2
11:17,506618547.0,16805.591164922123,-152.6,2
11:17,893134725.0,1412.131962973209,-173.0,2
11:17,361201224.0,5738.624232067893,-251.3,2
11:18,730002588.0,12059.689281070088,-6.03,7
11:18,246753533.0,384.0970999999987,-37.59,5
11:20,471897866.0,7587.283210432915,-58.5,2
11:21,846550094.0,1884.7768360368743,-16.98,4
11:27,429556122.0,5318.517750000004,-203.7,2
11:27,823208989.0,1124.7988435760708,-265.3,2
11:30,246753533.0,378.1070999999987,-5.99,6
11:31,506618547.0,16693.591164922123,-112.0,2
11:34,824916823.0,7951.2210603532385,-55.98,2
11:35,405945930.0,3492.3952431977295,-247.8,2
11:42,700138124.0,4790.061300000003,-63.0,2
11:43,651756497.0,12663.26896547151,-48.34,4
11:44,520447032.0,8207.739594792376,-118.15,2
11:45,893134725.0,1248.131962973209,-164.0,2
11:47,943329213.0,2120.691012560709,-3.15,7
11:50,506618547.0,16627.091164922123,-66.5,2
11:52,134847904.0,2616.626694386294,-14.99,4
11:53,429556122.0,5025.917750000003,-292.6,2
11:54,630691258.0,90.61654487484137,-59.0,2
11:54,361201224.0,5559.424232067893,-179.2,2
11:56,950234174.0,1096.0666161468769,-39.65,7
11:56,588565416.0,6580.74844468425,-28.96,1
11:57,713641917.0,776.3497695038419,-25.98,2
11:57,639409800.0,30467.828307747302,-9.02,4
11:58,985188462.0,585.2902487112245,-28.46,7
11:59,893134725.0,997.131962973209,-251.0,2
12:00,823208989.0,946.9988435760708,-177.8,2
12:01,688712152.0,5852.121582591819,-4.87,5
12:04,860360312.0,39.27810888268036,-164.5,2
12:04,506618547.0,16342.891164922125,-284.2,2
12:06,621652856.0,464.62196961054,-287.0,2
12:09,585133606.0,4071.8986653145016,-117.59,2
12:09,448004226.0,2234.938461930605,-59.97,2
12:11,700138124.0,4713.761300000003,-76.3,2
12:12,429556122.0,4977.617750000003,-48.3,2
12:12,949032480.0,4490.832832273403,-21.01,1
12:14,752362502.0,8270.203639124149,-18.89,2
12:15,785749304.0,7517.824143757756,-13.2,9
12:17,310620484.0,571.864870395092,-13.07,7
12:18,152488934.0,926.7262573137308,-54.02,5
12:18,224112146.0,-10.532300000001143,-50.39,5
12:19,971010829.0,246.64125644424536,-75.49,2
12:22,510101371.0,11669.147489687646,-42.69,9
12:23,657139925.0,11735.476028973571,-16.29,9
12:24,621652856.0,133.52196961054,-331.1,2
12:31,200080192.0,8615.45895266843,-91.53,2
12:31,630691258.0,-67.88345512515863,-158.5,2
12:31,405945930.0,3335.59524319773,-156.8,2
12:32,585133606.0,3981.5986653145014,-90.3,2
12:32,270374623.0,9016.163999078844,-302.4,2
12:34,700138124.0,4484.1613000000025,-229.6,2
12:35,506618547.0,16195.891164922125,-147.0,2
12:35,298007503.0,423.5001036256334,-13.17,1
12:39,780463728.0,2095.18602094224,-244.3,2
12:40,518378868.0,-1320.7772000000002,-71.5,5
12:45,448004226.0,2223.4484619306054,-11.49,4
12:46,621652856.0,-67.37803038945998,-200.9,2
12:46,630468201.0,-738.1115838897017,-127.98,5
12:46,625281433.0,-780.3145573707567,-25.4,9
12:47,651756497.0,12633.06896547151,-30.2,2
12:48,191161970.0,-3408.708999999997,-90.2,5
12:49,262767079.0,-1074.4392500000004,-37.21,5
12:51,390747457.0,69.93529999999822,-61.92,5
12:53,691012931.0,-1683.659750000001,-39.67,5
12:55,506618547.0,16156.591164922123,-39.3,7
12:57,310620484.0,534.974870395092,-36.89,9
12:58,158414827.0,-1575.6913000000015,-28.16,5
12:59,585625048.0,868.9916190586326,-5.7,9
12:59,361201224.0,5303.224232067893,-256.2,2
13:01,259015404.0,3335.7583673647214,-6.24,7
13:01,780463728.0,2009.8140209422395,-85.37,2
13:02,727417797.0,4408.439500000008,-57.97,4
13:03,297823329.0,537.2424999999992,-4.99,1
13:03,885259672.0,3549.832999828518,-47.07,4
13:03,690958123.0,17321.93582772021,-20.99,7
13:03,277562576.0,437.8937507952724,-4.3,9
13:06,187111705.0,5803.659132689663,-7.15,9
13:07,541639148.0,4086.6772131200296,-20.84,4
13:08,444371478.0,423.6287499999988,-77.33,5
13:09,270374623.0,8763.463999078842,-252.7,2
13:11,113747882.0,10567.051778122792,-54.81,5
13:14,287230540.0,1091.8944326671558,-5.99,1
13:15,340321732.0,1221.497050000003,-7.8,9
13:16,885259672.0,3523.7425228747447,-26.09,2
13:16,500043411.0,11896.16951252709,-56.54,4
13:17,990894155.0,-255.61354132115844,-17.94,9
13:20,704517789.0,15107.697156230315,-16.2,2
13:20,913801979.0,376.51862991449394,-26.96,7
13:21,429556122.0,4872.911750000003,-104.71,5
13:21,812692024.0,4213.505178787428,-6.3,9
13:24,494789005.0,3009.237879439359,-16.09,5
13:27,971010829.0,124.16125644424535,-122.48,2
13:28,844835978.0,8449.2624355929,-50.06,7
13:28,834581602.0,288.2958999999994,-52.99,2
13:29,642015139.0,-245.19366253436175,-36.47,5
13:29,494789005.0,2991.747879439359,-17.49,9
13:30,282837512.0,12027.51082497424,-41.05,9
13:31,823208989.0,783.8988435760708,-163.1,2
13:36,433917275.0,7383.548589444719,-9.26,4
13:37,374994043.0,-2082.9830500000007,-45.48,5
13:38,229205098.0,6377.340734482322,-92.76,5
13:38,456246119.0,18167.06588468511,-15.21,8
13:39,783650950.0,-1158.8566434110114,-125.18,5
13:42,534325901.0,5872.447401287005,-1.56,4
13:46,860360312.0,-150.22189111731964,-189.5,2
13:50,274818272.0,145.98897856713154,-59.57,5
13:51,280098744.0,1014.3053778716657,-26.98,4
13:53,511179916.0,7134.320210826434,-2.69,7
13:55,971010829.0,84.68125644424535,-39.48,2
13:56,506618547.0,16058.591164922123,-98.0,2
13:59,364396689.0,-649.40825,-31.26,9
14:00,823208989.0,623.5988435760709,-160.3,2
14:13,429556122.0,4747.611750000003,-125.3,2
14:13,475277431.0,-23.446863056380444,-16.5,4
14:14,780463728.0,1790.0420209422398,-219.77,2
14:16,200080192.0,8563.16895266843,-52.29,2
14:18,860360312.0,-242.72189111731964,-92.5,2
14:20,532478725.0,4582.354540993914,-37.99,9
14:22,621652856.0,-343.17803038945993,-275.8,2
14:23,506618547.0,15992.091164922123,-66.5,2
14:24,615144184.0,473.2837991255189,-155.83,5
14:37,730002588.0,11885.865281070088,-173.82,5
14:44,506618547.0,15901.091164922123,-91.0,2
14:47,373163757.0,10219.258809235404,-16.0,4
14:48,395284483.0,1196.210408642973,-27.95,2
14:49,361201224.0,5240.224232067893,-63.0,2
14:50,322720763.0,6587.272223538681,-50.05,2
14:58,780463728.0,1554.8700209422398,-235.17,2
15:15,621652856.0,-455.17803038945993,-112.0,2
15:29,361201224.0,5142.224232067893,-98.0,2
15:36,315546581.0,24035.904210786975,-7.25,4
15:43,455052690.0,-621.7432600513724,-82.0,5
15:47,361201224.0,5009.224232067893,-133.0,2
16:02,361201224.0,4914.724232067893,-94.5,2
16:03,742223719.0,392.02430730480273,-63.97,4
16:04,971010829.0,-46.79874355575467,-131.48,2
16:06,187541224.0,6267.11255922144,-16.32,7
16:19,780463728.0,1430.27002094224,-124.6,2
16:23,653640811.0,14676.215761484476,-46.0,1
16:23,272538745.0,12918.089900000024,-31.97,4
16:24,233981231.0,1619.5427391616956,-36.98,7
16:30,199016328.0,5364.675718310745,-11.05,7
16:32,823208989.0,525.5988435760709,-98.0,2
16:38,361201224.0,4783.124232067893,-131.6,2
16:38,912584712.0,333.72061954473304,-147.0,2
16:43,613427466.0,5624.984905655875,-30.96,7
17:03,587225252.0,8842.243250655598,-30.46,2
17:06,809499628.0,14605.952327063653,-16.34,9
17:13,670102069.0,3303.7608420837014,-161.11,5
17:18,971010829.0,-176.7787435557547,-129.98,2
17:19,621652856.0,-736.5780303894599,-281.4,2
17:21,106601471.0,8872.800298574051,-10.0,7
17:22,769311479.0,6180.973527720105,-16.02,1
17:23,996042490.0,4339.311296170785,-9.99,4
17:28,610450243.0,-1310.7596,-34.22,5
17:33,474951915.0,-2421.4860952340123,-42.11,5
17:39,444428189.0,383.89935000000264,-222.06,5
17:41,316793091.0,624.4843100549512,-25.0,2
17:43,361201224.0,4428.224232067893,-354.9,2
17:50,621652856.0,-914.3780303894598,-177.8,2
17:57,200080192.0,8539.058952668429,-24.11,7
17:59,618514666.0,18059.336447261656,-67.13,5
18:01,780463728.0,1295.19802094224,-135.07,2
18:13,487051121.0,238.6118399891072,-20.9,9
18:18,361201224.0,4267.224232067893,-161.0,2
18:20,886921642.0,3157.0025406412205,-19.43,4
18:22,305778936.0,11035.707904640149,-25.93,9
18:25,984783496.0,12671.732774615395,-13.45,9
18:36,955035930.0,831.3684791714772,-49.99,7
18:45,651372390.0,-3229.773249999999,-16.34,5
18:54,581655972.0,37790.157967966516,-54.36,5
18:56,762859681.0,-656.6624000000011,-15.2,5
18:58,256002321.0,6413.578125139913,-12.23,5
18:58,690523499.0,755.1478999999996,-14.97,7
19:01,215426302.0,-261.62159597430826,-44.48,5
19:01,902798190.0,-1093.9266344310263,-179.63,5
19:05,865748375.0,4836.668126291714,-121.34,5
19:05,454356905.0,2251.2503862550757,-31.64,9
19:07,817294757.0,-2650.7108000000003,-30.88,5
19:08,455052690.0,-650.4332600513724,-28.69,9
19:11,679662108.0,13380.883814027866,-134.59,5
19:14,520418719.0,2405.7118000000028,-140.17,5
19:18,859603181.0,3569.1686320015147,-162.22,5
19:22,949032480.0,4453.892832273404,-36.94,9
19:31,993039226.0,-3839.506999999995,-17.84,5
19:44,235310449.0,703.1371848303087,-123.82,5
19:45,370521542.0,22828.265419519343,-7.25,9
19:45,859603181.0,3561.2574990595,-7.91,2
19:48,203466392.0,1665.61678847463,-106.57,5
19:49,349107386.0,-3157.6784731945622,-107.72,5
19:52,547010927.0,21297.15632007763,-32.99,9
19:56,954263768.0,-322.0022000000002,-46.1,5
19:59,964702094.0,1323.245031662935,-111.9,5
20:04,550169791.0,18377.80959425528,-79.13,5
20:08,587225252.0,8831.165631880844,-11.08,8
20:09,399144202.0,2178.912539049177,-65.24,2
20:11,741903302.0,2301.309697988479,-118.42,5
20:17,124102251.0,3483.237587516066,-69.78,5
20:20,554792076.0,24246.86468267546,-43.61,8
20:31,604288474.0,2813.958030489387,-36.84,7
20:53,221868392.0,4835.2054803452165,-25.43,9
21:10,143003091.0,19614.593587656997,-17.71,5
00:10,853907490.0,6792.422250945812,-18.2,9
00:13,601627384.0,4443.217629447823,-33.89,9
00:17,471897866.0,7583.773541462536,-3.51,5
00:19,873693307.0,7998.546358420163,-3.95,2
00:25,704517789.0,15102.20855992326,-5.49,8
00:27,169006407.0,10544.249725580625,-47.43,7
00:28,858989281.0,23568.87956037653,-11.95,9
00:30,264550521.0,8442.608847407822,-70.66,7
00:43,905860285.0,14974.116068416855,-43.33,5
00:44,719586818.0,16805.049931422014,-6.64,2
00:44,822135975.0,11525.86724920626,-21.12,2
00:44,853907490.0,6760.272686750558,-32.15,7
00:46,324224854.0,1300.7202643750643,-7.78,5
00:56,776431321.0,2861.3293209279227,-19.64,4
00:56,795847804.0,19921.08778401349,-12.75,2
00:57,940569402.0,5285.459850814979,-1.11,5
00:59,656812046.0,943.3729355959176,-6.31,5
01:01,541639148.0,4023.317325308008,-63.36,7
01:03,940569402.0,5264.51985081498,-20.94,9
01:06,858989281.0,23563.120799758806,-5.76,5
01:11,874431242.0,7590.134074534411,-6.5,5
01:15,184430449.0,2364.062013885164,-68.6,2
01:21,192202372.0,124.10901903907369,-16.96,7
01:21,473820682.0,10465.5015007703,-27.67,2
01:29,851181128.0,4195.390819439575,-26.92,9
01:31,117273481.0,7770.935613964114,-18.61,2
01:42,290818242.0,6146.409855731342,-9.31,2
01:48,832564361.0,14044.688422095658,-23.93,4
02:02,433917275.0,7372.541903809121,-11.01,5
02:07,836655156.0,-2728.8814552191566,-180.0,1
02:08,758160963.0,7398.407684843142,-6.97,5
02:15,145387690.0,4921.348694075154,-25.21,7
02:19,506618547.0,15877.001886125692,-24.09,4
02:19,200080192.0,8493.631046026843,-45.43,7
02:19,730002588.0,11849.951432778747,-35.91,2
02:20,885259672.0,3517.94723207884,-5.8,2
02:23,705848712.0,22885.461853687753,-20.89,9
02:31,987656636.0,5576.437136497541,-5.79,8
02:34,679662108.0,13369.931103281398,-10.95,2
02:34,836110591.0,6065.53501576644,-39.29,9
02:35,534204159.0,5194.293162037269,-6.89,2
02:37,824916823.0,7927.751060353238,-23.47,9
02:39,749378808.0,4877.699545220837,-24.49,9
02:47,802697323.0,18789.541167910586,-33.93,9
02:56,108931112.0,12638.329681396144,-27.32,9
02:57,706250160.0,9623.767219319525,-46.04,2
02:58,670102069.0,3264.5808420837016,-39.18,9
02:59,450896297.0,12110.305663612771,-23.49,9
03:11,844835978.0,8442.6680683951,-6.59,8
03:14,647936800.0,1370.2333326263893,-10.89,2
03:18,767447966.0,3833.81980551211,-28.01,9
03:18,836110591.0,6054.55420631282,-10.98,5
03:22,749378808.0,4875.579809327411,-2.12,8
03:23,766941757.0,8937.858637935922,-32.23,9
03:24,815385232.0,8882.07897493504,-46.81,7
03:27,824916823.0,7895.939322686134,-31.81,5
03:31,973086490.0,8980.890981351371,-13.03,9
03:33,510101371.0,11632.027489687644,-37.12,9
03:34,216285378.0,20925.63638463492,-36.49,9
03:37,912705941.0,16552.288034545294,-24.59,7
03:39,809499628.0,14581.50232706365,-24.45,9
03:51,667367404.0,7973.301792880259,-34.71,2
03:53,441274121.0,11228.139061246837,-17.49,2
03:56,383833857.0,20963.575603734014,-5.85,5
03:58,170637730.0,2516.504096022554,-9.85,2
04:00,887853850.0,9599.806231260116,-46.09,8
04:03,683319988.0,6735.970055795521,-37.89,9
04:05,752362502.0,8260.346884754388,-9.86,5
04:11,496395938.0,11454.227492122092,-8.2,8
04:11,235881534.0,11231.054831415797,-16.41,7
04:15,522188082.0,6839.621235733116,-7.98,7
04:21,518474507.0,12766.923354420172,-35.33,9
04:24,117308635.0,1099.908408157428,-24.82,5
04:27,930277104.0,9547.393165814836,-6.63,5
04:32,532478725.0,4547.554540993914,-34.8,9
04:33,322221939.0,3183.840134597861,-3.02,5
04:33,282837512.0,12010.49301974694,-17.02,7
04:35,259015404.0,3316.228367364721,-19.53,9
04:36,421881811.0,5293.598682098255,-11.45,5
04:36,399144202.0,2129.634436277769,-49.28,7
04:40,179173981.0,5948.982816449248,-2.68,2
04:46,851181128.0,4164.651448713274,-30.74,7
04:46,252760664.0,5629.0197138948515,-1.99,2
04:49,788740658.0,3071.6657130788763,-15.68,8
04:50,520447032.0,8202.317656812593,-5.42,8
04:50,305778936.0,11006.409851655982,-29.3,4
04:50,287480331.0,11186.569098236308,-27.14,9
05:03,315546581.0,24017.596789196257,-18.31,5
05:05,572384506.0,9479.28827057933,-27.44,9
05:05,183888402.0,15709.706828599448,-45.4,9
05:11,414805878.0,13008.704015719724,-27.75,9
05:13,657139925.0,11710.836028973574,-24.64,9
05:14,519644021.0,2140.7883976553035,-8.93,5
05:14,668329719.0,7222.974490578882,-32.53,5
05:15,500043411.0,11890.174385115692,-6.0,2
05:16,586315521.0,10668.842872540534,-32.76,5
05:17,678851253.0,2956.981885540504,-52.36,5
05:18,897714622.0,8386.654874261616,-33.57,2
05:18,450896297.0,12057.875907709107,-52.43,5
05:20,823208989.0,512.7137539205422,-12.89,7
05:21,678330503.0,1810.3371428964365,-11.15,2
05:32,259015404.0,3309.147764473352,-7.08,4
05:36,581655972.0,37780.67083013486,-9.49,5
05:36,572384506.0,9465.774241439069,-13.51,2
05:38,806358207.0,10550.212196475157,-1.69,7
05:41,984783496.0,12651.782774615394,-19.95,9
05:44,108481285.0,7753.163024001352,-17.97,7
05:44,705848712.0,22876.84274962505,-8.62,8
05:44,613729471.0,7055.690346559724,-40.0,7
05:45,116598243.0,1805.7493636854113,-39.33,2
05:46,482513594.0,6373.9720712470025,-67.54,4
05:51,308505160.0,12075.956362958286,-40.21,2
05:56,609939116.0,5826.400033722626,-11.26,4
05:57,899742927.0,12243.837466636918,-47.12,7
05:58,146909202.0,4087.181221906176,-2.48,2
06:00,769311479.0,6165.350133860187,-15.62,5
06:01,270374623.0,8758.708444476357,-4.76,5
06:04,131388684.0,19184.047189675177,-54.08,7
06:07,992204045.0,10476.162756425829,-50.03,7
06:07,229205098.0,6358.793268775457,-18.55,8
06:11,994214354.0,8469.771118518067,-31.5,9
06:12,785749304.0,7497.54759408845,-20.28,2
06:14,949032480.0,4432.738537440916,-21.15,2
06:20,822250278.0,6096.707838424561,-25.2,9
06:20,987163717.0,5677.602720000005,-41.48,9
06:20,809499628.0,14554.018864640802,-27.48,8
06:22,213112754.0,6439.565322100323,-13.55,7
06:23,709608057.0,3082.2037723834537,-29.49,9
06:23,370521542.0,22809.20297425359,-19.06,5
06:27,187111705.0,5797.9659290800555,-5.69,7
06:28,344219145.0,8328.615902539494,-2.45,7
06:31,287480331.0,11168.029266926278,-18.54,7
06:31,366550080.0,22920.63649332083,-2.7,2
06:32,383625050.0,5399.259176400237,-44.19,2
06:37,718058208.0,693.0223913069024,-55.48,5
06:39,950234174.0,1077.4120696686805,-18.65,4
06:44,534325901.0,5869.330555281728,-3.12,7
06:44,779236304.0,210.1575954795325,-27.69,9
06:50,203466392.0,1639.6390077396122,-25.98,7
06:52,834383043.0,4817.912802200215,-20.38,9
06:53,851649498.0,9232.642699833494,-8.13,5
06:58,435984758.0,4759.618398471875,-2.98,5
06:59,237493332.0,12309.734112768376,-11.36,4
07:00,187541224.0,6236.672559221441,-30.44,9
07:07,417850087.0,15046.196114876262,-13.94,2
07:08,518474507.0,12724.17066428184,-42.75,7
07:08,675806859.0,6048.418793741673,-6.52,7
07:08,699139822.0,2170.1409485328095,-20.52,5
07:09,984783496.0,12628.1554650328,-23.63,7
07:19,822250278.0,6075.298911384277,-21.41,5
07:19,392270893.0,10797.2302526951,-8.33,2
07:24,687135796.0,24491.80122279284,-3.37,8
07:30,604288474.0,2812.6275089478645,-1.33,7
07:31,549414742.0,6622.95179255782,-12.77,7
07:33,489964679.0,21292.35827473631,-42.15,9
07:36,985188462.0,554.8602487112246,-30.43,9
07:50,624500124.0,3218.9761749632576,-44.0,2
07:51,510101371.0,11582.955794330706,-49.07,5
07:52,113747882.0,10534.154294956885,-32.9,8
07:52,151968462.0,8222.896684450621,-32.93,7
07:57,237684254.0,5286.361719085146,-41.44,5
07:59,651756497.0,12625.82156786021,-7.25,7
07:59,511179916.0,7110.395262845006,-23.92,5
08:03,414805878.0,12951.306002198042,-57.4,4
08:03,221868392.0,4806.115480345216,-29.09,9
08:06,285220959.0,10986.549727159276,-21.84,8
08:09,407574996.0,3148.2614545947013,-4.98,7
08:11,364357875.0,5932.641108757713,-47.16,5
08:19,245690309.0,8005.717205530341,-21.83,7
08:20,195895574.0,6367.897736015059,-8.29,2
08:20,409971170.0,1801.9047241030123,-29.38,5
08:34,221868392.0,4800.341982591989,-5.77,2
08:39,310620484.0,533.3336945341213,-1.64,5
08:41,480557476.0,10009.58274744141,-38.95,5
08:56,532478725.0,4537.700078694315,-9.85,4
09:04,108563213.0,20629.117551049247,-50.09,5
09:17,867987292.0,3182.5720456162862,-85.49,5
09:17,170637730.0,2479.168346022554,-37.34,4
09:19,344219145.0,8140.343902539494,-188.27,2
09:19,279149837.0,728.7430499999989,-34.95,7
09:20,386729293.0,26501.71737839333,-105.98,6
09:21,633345190.0,6799.19120663298,-25.12,7
09:21,409370545.0,161.38427554552015,-26.07,7
09:22,856957948.0,8333.61651249826,-49.99,4
09:24,558119802.0,28614.37949573155,-10.58,7
09:30,108931112.0,12628.899681396144,-9.43,4
09:30,858989281.0,23555.840799758807,-7.28,7
09:31,846550094.0,1878.7868360368743,-5.99,7
09:32,554792076.0,24223.190198730794,-23.67,2
09:32,240643705.0,6.184791120615536,-55.98,4
09:33,994214354.0,8426.89807823512,-42.87,5
09:33,873701090.0,631.6179853720448,-30.17,4
09:34,570269025.0,2243.7119333598876,-46.97,4
09:34,108481285.0,7733.133014001352,-20.03,4
09:34,473820682.0,10434.8479807703,-30.65,4
09:35,188263947.0,488.2688500000002,-36.95,7
09:37,235881534.0,11224.047831415795,-7.01,4
09:37,151968462.0,8132.596684450621,-90.3,2
09:39,857754342.0,2094.8532728586615,-34.98,4
09:41,331450202.0,6080.772836405436,-1.24,5
09:42,179173981.0,5925.942816449248,-23.04,4
09:43,491392945.0,3990.2535000000057,-35.0,2
09:45,170637730.0,2458.098346022554,-21.07,7
09:53,409971170.0,1770.590644103013,-31.31,4
09:56,215311171.0,5512.7164346584905,-35.74,5
09:57,344219145.0,7888.357902539494,-251.99,2
09:58,618138606.0,899.3298621516973,-22.0,6
10:00,264208990.0,542.1015499999991,-106.97,4
10:02,520418719.0,2233.7118000000028,-172.0,2
10:04,508518911.0,10.166750279010522,-23.97,4
10:06,535744551.0,510.21001599562646,-11.98,7
10:06,758160963.0,7333.367684843142,-65.04,6
10:09,491392945.0,3882.4535000000055,-107.8,2
10:10,151968462.0,8028.296684450621,-104.3,2
10:10,286484726.0,394.5676764574821,-57.0,2
10:14,508518911.0,-271.9192497209895,-282.09,2
10:16,199016328.0,5294.675718310745,-70.0,2
10:17,285428103.0,8153.541950465587,-37.98,2
10:19,373163757.0,10180.268809235406,-38.99,1
10:19,491392945.0,3832.7675000000054,-49.69,2
10:21,384497904.0,639.6748999999993,-54.82,5
10:21,574548998.0,414.7187499999992,-24.96,7
10:23,296972867.0,-695.3069000000007,-35.32,5
10:23,994947671.0,1426.8957000000005,-22.0,4
10:24,324224854.0,1169.1902643750643,-131.53,2
10:25,494404688.0,-2393.6632653362076,-29.05,5
10:26,531186970.0,399.36755624361945,-42.97,2
10:27,165691047.0,-471.0935000000009,-54.22,5
10:28,510101371.0,11561.795794330706,-21.16,4
10:29,310375875.0,3335.9658643833804,-27.78,2
10:29,344219145.0,7756.085902539494,-132.27,2
10:29,701070224.0,630.3373500000001,-39.98,2
10:30,136770968.0,-280.8876000000003,-30.92,5
10:30,506618547.0,15838.681886125692,-38.32,2
10:30,352291960.0,1746.2588033035738,-41.98,2
10:30,683078800.0,1339.2734472194538,-131.73,5
10:30,199016328.0,5240.075718310744,-54.6,2
10:32,315078351.0,5490.274649122869,-72.21,4
10:32,414454079.0,474.0168500000018,-172.54,2
10:32,524425303.0,-302.9373000000011,-60.59,5
10:32,939972497.0,114.37490860001084,-82.97,2
10:33,596171893.0,-440.8682551744889,-127.99,2
10:33,737537711.0,-1718.2769663984643,-54.85,5
10:33,257633312.0,213.1683499999993,-5.97,5
10:33,951817450.0,8594.475185992684,-57.61,5
10:34,152616936.0,121.2330078630648,-147.29,5
10:35,224524792.0,-2094.290682430849,-54.85,5
10:35,737547541.0,-245.04940043222575,-107.96,5
10:37,423208402.0,1933.6856000000023,-29.99,2
10:37,141521177.0,5947.761900000013,-81.98,2
10:37,145387690.0,4884.528694075154,-36.82,2
10:37,138609932.0,4094.682003294584,-39.92,4
10:38,188263947.0,388.2788500000002,-99.99,2
10:39,534325901.0,5842.352555281728,-26.98,5
10:41,605711527.0,-361.8834861674165,-165.35,5
10:45,930271460.0,31.928647535776037,-45.43,5
10:46,215832575.0,-1636.2619637442194,-49.44,5
10:47,938992364.0,109.1386537313996,-117.5,5
10:48,491392945.0,3750.909500000005,-81.86,2
10:48,555804115.0,-1577.8985475587026,-20.21,5
10:49,699997811.0,1048.3641500000033,-28.96,7
10:49,348525881.0,-111.13837540506368,-78.69,5
10:49,842682241.0,4795.57039775066,-8.63,5
10:51,184430449.0,2214.082013885164,-149.98,2
10:56,496395938.0,11399.187492122091,-55.04,2
10:57,176922958.0,26.771177788879264,-24.87,2
10:58,604288474.0,2763.8095089478643,-48.82,5
10:58,119993184.0,-1972.819402910863,-22.92,5
11:01,441142605.0,2415.3122500000036,-5.97,4
11:01,544961962.0,987.0743230056088,-25.98,2
11:03,195895574.0,6349.018736015059,-18.88,5
11:03,834581602.0,279.8058999999994,-8.49,4
11:05,344843570.0,-551.5843175093338,-54.68,5
11:06,654329190.0,-115.05694905148066,-74.55,5
11:06,975345315.0,30612.79079999996,-79.98,4
11:07,492058070.0,692.355968740471,-49.99,2
11:09,873693307.0,7973.934358420163,-24.61,5
11:10,199016328.0,5083.975718310744,-156.1,2
11:11,727417797.0,4377.449500000008,-30.99,2
11:13,639409800.0,30462.086229552773,-5.74,2
11:14,241459011.0,641.8461132723472,-57.95,5
11:14,572384506.0,9312.474241439068,-153.3,2
11:14,414454079.0,468.4368500000018,-5.58,4
11:16,116169597.0,-222.2930500000003,-275.58,5
11:18,973086490.0,8963.929531829077,-16.96,7
11:18,679911053.0,1961.414761533524,-35.95,7
11:20,534204159.0,5156.57976203727,-37.71,4
11:20,821971408.0,1830.815721374878,-52.58,5
11:21,344219145.0,7679.421902539494,-76.66,5
11:23,857754342.0,1968.5099228586616,-126.34,5
11:25,134461671.0,7899.994032673117,-33.05,2
11:28,303843160.0,301.0788000000017,-29.99,2
11:28,570323670.0,3150.2750058823945,-31.98,1
11:29,215404070.0,228.3095891798497,-57.99,2
11:29,199016328.0,4933.475718310744,-150.5,2
11:30,726913482.0,-991.966848526476,-57.95,5
11:32,315546581.0,24002.596789196257,-15.0,4
11:32,340321732.0,1078.997050000003,-142.5,2
11:34,824916823.0,7893.399322686134,-2.54,7
11:36,885259672.0,3440.87723207884,-77.07,2
11:38,780463728.0,1248.19802094224,-47.0,2
11:39,572384506.0,9235.474241439068,-77.0,2
11:40,482513594.0,6363.486071247003,-10.49,2
11:41,298000165.0,22416.92215433322,-76.79,5
11:43,344219145.0,7645.135902539494,-34.29,2
11:43,766941757.0,8925.425665236811,-12.43,5
11:47,719586818.0,16741.939931422014,-63.11,2
11:49,340321732.0,966.9970500000028,-112.0,2
11:49,916270283.0,1322.4382499999986,-49.98,2
11:53,792845450.0,672.4091500000009,-64.98,4
11:59,624500124.0,3119.408174963258,-99.57,5
11:59,558875206.0,2118.7714500000006,-12.99,2
12:01,572384506.0,9201.556341439067,-33.92,4
12:02,419550103.0,16603.279428995178,-21.0,2
12:02,785749304.0,7473.35759408845,-24.19,9
12:05,845648250.0,9.169399999999456,-154.95,5
12:07,656812046.0,912.2929355959176,-31.08,2
12:07,558875206.0,1958.7814500000009,-159.99,2
12:08,538003940.0,1550.7700000000077,-34.93,7
12:08,293609137.0,-265.14950742550195,-151.41,5
12:10,344219145.0,7444.263902539494,-200.87,2
12:12,449871732.0,8732.772113265706,-77.98,2
12:12,482513594.0,6308.1860712470025,-55.3,2
12:12,137822385.0,3056.507717151475,-82.43,5
12:16,656812046.0,845.1129355959176,-67.18,2
12:16,176922958.0,-15.70882221112074,-42.48,9
12:18,887853850.0,9568.116231260115,-31.69,9
12:19,340321732.0,854.9970500000029,-112.0,2
12:24,195895574.0,6322.86873601506,-26.15,9
12:24,344219145.0,7230.805902539494,-213.46,2
12:25,424927189.0,-264.8536672558946,-99.03,5
12:25,478412511.0,337.99792019746076,-22.97,7
12:25,370757362.0,914.1372134689168,-32.98,2
12:26,143061865.0,6303.356228302978,-20.98,4
12:26,419550103.0,16459.289428995176,-143.99,2
12:31,541639148.0,4010.057325308008,-13.26,2
12:32,170637730.0,2382.974346022554,-75.12,5
12:32,675231808.0,14196.137086489183,-60.79,5
12:33,912705941.0,16509.235024545294,-43.05,4
12:34,626989363.0,223.4968633173756,-60.55,5
12:36,779376323.0,2730.923215820126,-27.5,4
12:38,482513594.0,6290.6860712470025,-17.5,2
12:40,698076160.0,5342.398900319555,-42.61,5
12:41,534325901.0,5836.362555281728,-5.99,9
12:41,549414742.0,6599.261792557821,-23.69,9
12:43,903663593.0,461.1517126197981,-3.31,2
12:44,993238248.0,-719.6924873928839,-203.89,5
12:45,668692488.0,1636.922303563902,-37.95,1
12:48,229502829.0,-3155.2802741862483,-72.98,5
12:50,675231808.0,14164.167086489184,-31.97,4
12:51,823208989.0,484.8047539205422,-27.91,5
12:52,280098744.0,958.0673778716656,-56.24,5
12:52,874431242.0,7552.5540745344115,-37.58,1
12:52,822135975.0,11447.01724920626,-78.85,2
12:53,344219145.0,7107.619902539494,-123.19,2
12:54,482513594.0,6257.968071247003,-32.72,5
12:56,478986718.0,-1086.6330000000005,-105.27,5
12:57,448279144.0,747.7823499999996,-100.95,5
12:58,903953091.0,2416.1967623694673,-31.99,2
12:58,338022396.0,261.1008893757387,-120.98,5
13:00,932820758.0,-2295.596566775555,-52.01,5
13:02,187111705.0,5791.065929080056,-6.9,9
13:02,130154096.0,1078.0692252012682,-33.95,7
13:02,904154012.0,923.7274581204324,-5.99,7
13:02,491392945.0,3589.223500000005,-161.69,2
13:04,799861885.0,584.121149999999,-123.73,5
13:05,480557476.0,10001.682747441411,-7.9,9
13:06,277562576.0,430.3937507952724,-7.5,9
13:07,949032480.0,4391.138537440916,-41.6,9
13:07,585625048.0,861.6916190586327,-7.3,9
13:07,407574996.0,3142.611454594701,-5.65,9
13:08,535804582.0,-1017.901900000001,-107.61,5
13:10,322221939.0,3178.190134597861,-5.65,9
13:11,940569402.0,5232.5098508149795,-32.01,1
13:12,441274121.0,11214.679061246838,-13.46,2
13:12,621181115.0,-524.6572495707711,-77.8,5
13:13,965038148.0,-1104.485014367672,-28.76,5
13:13,555393405.0,-1141.66895,-87.44,5
13:14,851181128.0,4084.411448713274,-80.24,2
13:16,104832000.0,-2721.9023589058447,-14.09,5
13:19,812692024.0,4208.555178787428,-4.95,9
13:19,199016328.0,4759.875718310744,-173.6,2
13:23,520418719.0,2119.7118000000028,-114.0,2
13:23,668692488.0,1504.434353563902,-132.49,5
13:27,252701364.0,-3382.616172677917,-14.46,5
13:29,518466565.0,-159.16615000000036,-65.16,5
13:30,491392945.0,3548.6375000000053,-40.59,2
13:31,304455868.0,1426.8071597158298,-143.26,2
13:35,895331556.0,-886.6215000000008,-43.58,5
13:39,629078930.0,1458.4176723281828,-51.98,2
13:41,558119802.0,28586.24949573155,-28.13,9
13:44,344219145.0,6985.833902539494,-121.79,2
13:44,572136270.0,-306.7590506664223,-49.45,5
13:47,482513594.0,6112.368071247002,-145.6,2
13:51,199016328.0,4588.375718310744,-171.5,2
13:54,667367404.0,7894.7283728802595,-78.57,4
13:55,441274121.0,11150.302021246838,-64.38,4
13:56,785210466.0,1796.7232041968257,-49.99,2
13:58,388862238.0,757.4444772385228,-29.99,4
13:59,627917561.0,2846.090050000003,-159.97,2
14:00,508518911.0,-452.4632497209895,-74.16,2
14:00,435984758.0,4716.548398471875,-43.07,2
14:02,290818242.0,6112.179855731342,-34.23,5
14:03,124102251.0,3418.558329112445,-64.68,7
14:03,920031185.0,-277.210570516292,-36.89,5
14:03,631111289.0,-935.5315000000006,-35.42,5
14:04,668175891.0,459.02192315849913,-25.98,2
14:08,403765849.0,-2202.195499999999,-37.39,5
14:09,441274121.0,11127.512021246836,-22.79,2
14:10,143003091.0,19545.353357448377,-69.24,7
14:12,344219145.0,6817.833902539494,-168.0,2
14:12,482513594.0,5980.096071247002,-132.27,2
14:13,642924505.0,8.142220183526234,-140.67,5
14:14,108563213.0,20489.530551049247,-139.59,5
14:16,833499132.0,2152.7673500000005,-17.97,7
14:21,776431321.0,2839.3493209279227,-21.98,4
14:22,605116158.0,2305.7795,-1.5,4
14:26,482513594.0,5945.096071247002,-35.0,2
14:31,760704118.0,1298.2163127174886,-70.39,5
14:36,851181128.0,4064.839868713274,-19.57,4
14:38,520418719.0,1983.7118000000028,-136.0,2
14:43,285428103.0,8117.631950465588,-35.91,4
14:44,124125096.0,180.7437443878023,-108.43,5
14:44,131388684.0,19137.977189675177,-46.07,2
14:46,227104649.0,1677.0660543161775,-152.13,2
14:47,703537476.0,1078.294249999999,-32.02,2
14:49,482513594.0,5845.710071247002,-99.39,2
14:52,859603181.0,3480.776670677982,-80.48,5
14:53,520418719.0,1944.2118000000028,-39.5,2
14:54,699997811.0,963.3741500000032,-84.99,2
14:54,344219145.0,6699.547902539494,-118.29,2
14:54,679911053.0,1944.571376222686,-16.84,7
14:56,517190750.0,1648.9160899154124,-48.38,5
15:00,667367404.0,7818.14137288026,-76.59,5
15:01,683319988.0,6726.7440412999895,-9.23,2
15:06,237493332.0,12296.794112768375,-12.94,9
15:06,355733816.0,4068.9453492274192,-19.98,7
15:07,282837512.0,11866.72701974694,-143.77,5
15:09,344219145.0,6467.189902539494,-232.36,2
15:09,489964679.0,21273.317619219444,-19.04,2
15:11,166019891.0,7000.809402050688,-16.01,5
15:12,867987292.0,3114.522045616286,-68.05,2
15:14,491392945.0,3535.351500000005,-13.29,2
15:15,822718326.0,9357.697197351908,-41.98,2
15:19,572384506.0,8909.656341439068,-291.9,2
15:23,758160963.0,7233.277684843142,-100.09,2
15:35,117308635.0,1087.858408157428,-12.05,7
15:39,245690309.0,7986.767205530341,-18.95,9
15:39,873701090.0,592.7608756705013,-38.86,5
15:40,140893085.0,4565.831006365462,-12.99,2
15:46,793781222.0,1896.708878947403,-52.99,4
15:52,491392945.0,3468.8655000000053,-66.49,2
15:52,520418719.0,1724.7118000000028,-219.5,2
15:53,874431242.0,7530.184074534412,-22.37,2
15:54,475277431.0,-36.42686305638044,-12.98,7
15:57,344219145.0,6278.889902539494,-188.3,2
15:59,586041848.0,572.8296999999991,-36.31,5
16:01,844835978.0,8422.6780683951,-19.99,4
16:07,491392945.0,3405.8655000000053,-63.0,2
16:09,898104045.0,-1597.993050000002,-34.94,9
16:13,482513594.0,5810.710071247002,-35.0,2
16:14,344219145.0,6034.603902539494,-244.29,2
16:23,491392945.0,3397.4795000000054,-8.39,2
16:34,344219145.0,5842.131902539494,-192.47,2
16:40,482513594.0,5763.124071247002,-47.59,2
16:40,491392945.0,3386.293500000005,-11.19,2
16:43,252760664.0,5600.989713894852,-28.03,2
16:47,151968462.0,7869.396684450621,-158.9,2
16:48,628470485.0,660.3740299001231,-116.87,2
16:59,551755686.0,7089.66158519596,-29.99,2
17:04,482513594.0,5651.852071247002,-111.27,2
17:06,151968462.0,7678.296684450621,-191.1,2
17:13,151968462.0,7601.996684450621,-76.3,2
17:17,628470485.0,562.3740299001231,-98.0,2
17:19,482513594.0,5493.666071247002,-158.19,2
17:21,613729471.0,7040.620346559725,-15.07,7
17:25,613427466.0,5560.0049056558755,-64.98,4
17:35,151968462.0,7379.39668445062,-222.6,2
17:41,628470485.0,442.7160299001231,-119.66,2
17:46,435313070.0,2636.5584990480256,-0.22,7
17:48,462962606.0,100.8865499999989,-24.97,7
17:49,345514953.0,1151.028199999999,-159.5,2
17:55,520418719.0,1620.2118000000028,-104.5,2
18:01,628470485.0,274.7300299001231,-167.99,2
18:04,106601471.0,8871.057921731817,-1.74,2
18:11,298007503.0,383.5401036256335,-39.96,9
18:18,345514953.0,940.5281999999992,-210.5,2
18:19,467207141.0,1561.150467048264,-20.19,9
18:23,586041848.0,540.3396999999991,-32.49,9
18:32,520418719.0,1400.7118000000028,-219.5,2
18:45,901432314.0,3642.546109764859,-55.97,5
18:51,655368335.0,4611.310303275579,-8.57,5
19:07,550169791.0,18336.728661546516,-41.08,2
19:39,886921642.0,3141.3625406412207,-15.64,9
19:41,145387690.0,4855.648694075154,-28.88,9
19:46,256002321.0,6397.828125139913,-15.75,9
19:55,585133606.0,3959.9987440430887,-21.6,2
19:57,399144202.0,2100.244436277769,-29.39,9
20:02,547010927.0,21259.026320077628,-38.13,9
20:34,886921642.0,3140.760939748898,-0.6,7
20:51,834383043.0,4795.822290432127,-22.09,2
20:53,865748375.0,4835.259450100162,-1.41,7
20:54,618514666.0,18055.82990598546,-3.51,8
21:06,930277104.0,9506.803165814836,-40.59,9
21:17,670102069.0,3257.643986953963,-6.94,7
21:41,461990622.0,8520.008309192104,-24.11,7
21:43,256002321.0,6345.657161992725,-52.17,2
21:59,128033695.0,2745.254382141222,-43.35,2
00:11,657139925.0,11696.386028973571,-14.45,9
00:16,605116158.0,2285.4795,-20.3,9
00:20,802697323.0,18756.311167910582,-33.23,9
00:28,815385232.0,8867.902063823554,-14.18,5
00:32,237684254.0,5281.576495631487,-4.79,7
00:33,769311479.0,6156.1963756192545,-9.15,2
00:35,824916823.0,7872.509322686134,-20.89,9
00:35,949032480.0,4353.538537440915,-37.6,9
00:37,336557504.0,1328.2281584030245,-34.21,5
00:39,540159353.0,9658.020802445555,-50.58,7
00:39,116598243.0,1731.8055374728365,-73.94,7
00:40,874431242.0,7500.854074534412,-29.33,9
00:43,221868392.0,4768.685553057874,-31.66,8
00:43,887853850.0,9505.888484937275,-62.23,7
00:43,518474507.0,12686.58066428184,-37.59,9
00:43,264550521.0,8441.772196007689,-0.84,2
00:47,383625050.0,5378.765928809646,-20.49,5
00:47,651756497.0,12616.653326646823,-9.17,5
00:54,858989281.0,23544.890799758807,-10.95,9
01:00,639409800.0,30426.199786547422,-35.89,2
01:01,315078351.0,5475.26095066468,-15.01,2
01:06,633345190.0,6756.511206632979,-42.68,9
01:11,519644021.0,2122.360231719507,-18.43,5
01:15,985188462.0,508.77024871122455,-46.09,9
01:15,822135975.0,11431.643116994506,-15.37,5
01:24,541639148.0,3974.043814462729,-36.01,2
01:30,108481285.0,7699.061176619173,-34.07,7
01:32,433917275.0,7367.014896226992,-5.53,7
01:35,897714622.0,8374.929025413381,-11.73,5
01:41,131388684.0,19113.12154626263,-24.86,5
01:56,912705941.0,16427.655485002066,-81.58,2
02:01,698076160.0,5332.501179996693,-9.9,2
02:05,282837512.0,11864.194136942957,-2.53,2
02:18,187541224.0,6200.24255922144,-36.43,9
02:20,930277104.0,9503.14353356708,-3.66,2
02:23,441274121.0,11075.39444040368,-52.12,4
02:26,992204045.0,10475.898419883257,-0.26,7
02:27,254853117.0,2798.2682267563987,-1.6,4
02:28,718058208.0,650.1136995314802,-42.91,8
02:31,310620484.0,511.68467114539453,-21.65,8
02:31,874431242.0,7465.241118890902,-35.61,7
02:32,851649498.0,9187.141285043168,-45.5,8
02:33,824916823.0,7819.574451084806,-52.93,2
02:33,950234174.0,1027.7368842634148,-49.68,4
02:36,853907490.0,6751.322686750558,-8.95,9
02:38,858989281.0,23507.32956870552,-37.56,7
03:00,534325901.0,5803.444440852097,-32.92,8
03:05,613729471.0,7037.00502616123,-3.62,7
03:07,853907490.0,6732.70537377807,-18.62,4
03:07,822250278.0,6051.6989113842765,-23.6,9
03:19,287480331.0,11146.849266926278,-21.18,9
03:22,237493332.0,12239.380252958692,-57.41,5
03:24,179173981.0,5878.458478861252,-47.48,7
03:26,534204159.0,5128.2801935375965,-28.3,8
03:28,471897866.0,7535.538349549729,-48.24,7
03:32,303843160.0,281.4388000000017,-19.64,9
03:34,994214354.0,8389.65807823512,-37.24,9
03:36,558119802.0,28557.69949573155,-28.55,9
03:37,315546581.0,23994.76559920453,-7.83,7
03:38,832564361.0,13966.063658200945,-78.62,7
03:43,822250278.0,6039.566404048409,-12.13,5
03:43,601627384.0,4400.677629447823,-42.54,9
03:47,656812046.0,814.9930074204497,-30.12,2
03:47,170637730.0,2377.705459348548,-5.27,5
03:48,473820682.0,10406.812720850956,-28.04,2
03:50,287480331.0,11145.339802797002,-1.51,5
03:52,213112754.0,6416.436564954461,-23.13,2
03:58,183888402.0,15673.24682859945,-36.46,9
04:00,124102251.0,3417.2179893386947,-1.34,7
04:01,749378808.0,4871.465151783604,-4.11,2
04:02,639549973.0,5983.345208802452,-0.23,2
04:06,838830098.0,465.1425420877844,-38.04,9
04:07,256002321.0,6337.417161992726,-8.24,9
04:11,687135796.0,24475.90122279284,-15.9,9
04:13,675806859.0,6016.219854782208,-32.2,4
04:14,417850087.0,15044.499635078972,-1.7,5
04:19,609939116.0,5751.397667194,-75.0,4
04:28,187111705.0,5747.466778247837,-43.6,2
04:29,940569402.0,5225.51985081498,-6.99,9
04:37,823208989.0,470.73705555020774,-14.07,2
04:38,581655972.0,37778.37635463868,-2.29,7
04:39,690523499.0,736.9078999999996,-18.24,9
04:40,324224854.0,1165.0509062093613,-4.14,2
04:46,414805878.0,12917.666002198042,-33.64,9
04:46,795847804.0,19905.645405808107,-15.44,7
04:49,766941757.0,8889.275665236812,-36.15,9
04:51,973086490.0,8950.689531829077,-13.24,9
04:51,200080192.0,8430.92054536445,-62.71,2
04:52,785749304.0,7420.810207137297,-52.55,2
04:53,221868392.0,4732.595553057874,-36.09,9
04:54,558119802.0,28516.157814527254,-41.54,8
04:54,670102069.0,3224.4039869539633,-33.24,9
04:55,899742927.0,12164.498905593397,-79.34,7
04:56,489964679.0,21232.127619219445,-41.19,9
04:56,383833857.0,20938.571702139045,-25.0,5
04:59,679662108.0,13359.087873073508,-10.84,5
05:00,836110591.0,6044.207628672962,-10.35,4
05:00,704517789.0,15096.809234864888,-5.4,2
05:04,305778936.0,10995.376553933964,-11.03,7
05:12,510101371.0,11517.455794330706,-44.34,9
05:24,851181128.0,4049.325700535027,-15.51,5
05:24,678851253.0,2955.129268059402,-1.85,2
05:28,709608057.0,3044.7837723834537,-37.42,9
05:30,647936800.0,1315.9662299762529,-54.27,7
05:33,678330503.0,1772.558683543593,-37.78,2
05:36,229205098.0,6331.6705380852345,-27.12,2
05:37,547010927.0,21246.557714330633,-12.47,5
05:38,450896297.0,12018.74590770911,-39.13,9
05:40,414805878.0,12886.05670565718,-31.61,2
05:40,984783496.0,12611.9554650328,-16.2,9
05:41,554792076.0,24210.232811334394,-12.96,7
05:42,245690309.0,7951.225996153668,-35.54,5
05:44,588565416.0,6576.067782068405,-4.68,5
05:48,399538448.0,6954.985712652365,-25.9,9
05:51,522188082.0,6835.766347030268,-3.85,5
05:53,496395938.0,11396.951973468776,-2.24,2
05:54,779946617.0,14889.3525663253,-7.93,5
05:57,308505160.0,12066.36257816737,-9.59,7
05:58,683319988.0,6722.267543169119,-4.48,2
06:00,216285378.0,20880.75638463492,-44.88,9
06:02,203466392.0,1634.5064632590957,-5.13,7
06:06,705848712.0,22865.01844139954,-11.82,7
06:10,108563213.0,20487.656134656736,-1.87,2
06:10,910730524.0,7346.437611173414,-24.67,7
06:18,421881811.0,5236.342129341968,-57.26,5
06:23,901432314.0,3579.538037583814,-63.01,7
06:23,973086490.0,8949.189056229363,-1.5,8
06:24,145387690.0,4832.026433322957,-23.62,2
06:28,435984758.0,4681.996075871918,-34.55,5
06:30,460463595.0,-1189.5279454185788,-32.33,9
06:35,668329719.0,7202.692553563047,-20.28,2
06:36,259015404.0,3282.4977644733517,-26.65,9
06:42,532478725.0,4507.820078694315,-29.88,9
06:52,873693307.0,7934.288041144957,-39.65,7
06:53,364357875.0,5924.977966283732,-7.66,2
06:53,348325817.0,8158.117246104805,-16.37,5
06:57,290818242.0,6110.893008752515,-1.29,5
06:57,117308635.0,1067.9890945704883,-19.87,2
06:59,550169791.0,18326.272031280005,-10.46,5
07:03,482513594.0,5462.365946723708,-31.3,4
07:04,407574996.0,3116.500090253078,-26.11,2
07:04,670102069.0,3154.081126796913,-70.32,5
07:07,259015404.0,3233.038103099682,-49.46,7
07:19,270374623.0,8715.6727696782,-43.04,5
07:22,905860285.0,14963.6202161905,-10.5,5
07:24,706250160.0,9608.06390565232,-15.7,7
07:38,511179916.0,7068.177061239607,-42.22,7
07:38,940569402.0,5223.249029112456,-2.27,4
07:43,699139822.0,2157.9903663367127,-12.15,4
07:47,169006407.0,10528.536799452586,-15.71,4
07:47,195895574.0,6301.88873601506,-20.98,9
07:48,532478725.0,4450.635950412732,-57.18,7
07:49,987656636.0,5575.92175972163,-0.52,7
07:51,286484726.0,390.1296094356156,-4.44,5
07:51,719586818.0,16737.6322977389,-4.31,7
07:51,128033695.0,2737.2550243742826,-8.0,8
07:53,687135796.0,24462.029683827244,-13.87,2
08:00,252760664.0,5600.352082054502,-0.64,5
08:06,255814263.0,3530.7242967005445,-54.68,7
08:06,395284483.0,1191.1604086429734,-5.05,9
08:07,572136270.0,-316.7490506664223,-9.99,9
08:07,456221621.0,450.6195673026282,-5.95,9
08:11,480557476.0,9980.799362855973,-20.88,2
08:20,235881534.0,11207.929479695596,-16.12,4
08:24,675398089.0,-679.5513907746508,-52.01,5
08:24,760753808.0,-753.2850000000003,-31.5,5
08:25,399144202.0,2049.389252991875,-50.86,7
08:26,149684419.0,552.3160999999984,-15.52,5
08:26,383345285.0,-1050.6023735880765,-34.83,5
08:26,452974357.0,-2543.396449999996,-6.0,5
08:27,885259672.0,3435.77723207884,-5.1,9
08:28,987390838.0,-2736.6262412103792,-22.39,5
08:29,822718326.0,9346.511197351909,-11.19,5
08:31,613427466.0,5456.327905655876,-103.68,5
08:34,838415080.0,-3259.563999999999,-30.7,5
08:37,752362502.0,8256.361816907965,-3.99,8
08:37,493571342.0,-2308.5258809070483,-37.41,5
08:37,551755686.0,6947.38658519596,-142.27,5
08:39,564214408.0,-224.4062152742738,-44.46,5
08:39,696758548.0,-3127.0528963201377,-55.15,5
08:39,308897841.0,490.81369999999936,-41.04,5
08:40,340680761.0,-2713.8005999999987,-39.12,5
08:40,270374623.0,8595.7907696782,-119.88,5
08:42,659415300.0,2421.325790250703,-89.08,5
08:42,391688371.0,585.5122895685231,-33.16,5
08:43,872286364.0,1172.3816541869005,-88.9,5
08:44,366550080.0,22808.734493320833,-111.9,5
08:44,624563756.0,-642.8271712164436,-34.62,5
08:45,245198540.0,-652.8536011982205,-34.02,5
08:47,818552503.0,-456.2285000000012,-173.62,5
08:47,419084831.0,-331.5557255261031,-170.85,5
08:47,761272540.0,-60.67280000000112,-116.83,5
08:49,101531259.0,-172.74320000000034,-129.71,5
08:50,816685391.0,-695.0702037084263,-40.67,5
08:50,472213568.0,-554.9825942060532,-159.68,5
08:50,151968462.0,7332.16768445062,-47.23,5
08:50,475117511.0,7854.05939373982,-21.27,2
08:51,758160963.0,7141.087684843143,-92.19,5
08:52,899692478.0,-1557.1573935240071,-82.09,5
08:52,399538448.0,6877.558712652365,-77.43,5
08:55,868014990.0,-3054.153599999998,-39.28,5
08:55,680773155.0,265.79248333109183,-54.34,5
08:55,198946608.0,5304.497256556526,-17.44,2
08:56,668329719.0,7149.800553563047,-52.89,5
08:56,596328017.0,-2394.7403499999996,-80.61,5
08:57,842682241.0,4665.03439775066,-130.54,5
08:59,673818591.0,989.0867753758412,-17.52,5
08:59,812692024.0,4136.36293134288,-72.19,5
09:00,441274121.0,11069.24444040368,-6.15,9
09:00,749371623.0,-2467.0166535173425,-20.89,5
09:00,586315521.0,10663.142872540531,-5.7,9
09:02,197865285.0,301.09421173122047,-6.5,9
09:05,506618547.0,15833.031886125693,-5.65,9
09:05,540159353.0,9650.720802445558,-7.3,9
09:09,535273662.0,175.9873999999995,-149.43,5
09:10,117273481.0,7764.985613964114,-5.95,9
09:10,856461967.0,-459.05464647050746,-119.95,5
09:11,713057426.0,-1119.8917500000002,-30.12,5
09:14,999752672.0,351.4015435333344,-5.05,9
09:16,337771621.0,-2606.63765,-102.84,5
09:17,169006407.0,10522.236799452588,-6.3,9
09:17,683319988.0,6715.4675431691185,-6.8,9
09:18,277562576.0,380.4037507952724,-49.99,4
09:18,558875206.0,1952.7814500000009,-6.0,9
09:19,690523499.0,638.6541499999996,-98.25,5
09:20,176922958.0,-92.83882221112074,-77.13,2
09:21,225210798.0,357.10177375920887,-61.48,4
09:22,675806859.0,5956.169854782208,-60.05,2
09:23,912584712.0,295.33261954473306,-38.39,5
09:24,180616589.0,1486.999648033954,-51.49,4
09:24,779946617.0,14645.752566325298,-243.6,2
09:24,414454079.0,459.3368500000018,-9.1,4
09:25,143003091.0,19506.873357448378,-38.48,4
09:26,143003091.0,19452.05004741449,-54.82,5
09:26,535744551.0,500.2300159956265,-9.98,4
09:27,678851253.0,2803.698268059402,-151.43,5
09:27,237684254.0,5196.586495631487,-84.99,2
09:28,687135796.0,24361.467683827243,-100.56,5
09:30,760704118.0,1181.3303127174886,-116.89,2
09:31,176922958.0,-96.28523441422516,-3.45,7
09:32,583558311.0,-1091.233215248668,-180.03,5
09:35,685959099.0,2186.816866099241,-276.5,2
09:36,383833857.0,20918.181702139045,-20.39,1
09:37,456246119.0,18149.58588468511,-17.48,4
09:37,403383649.0,1201.0136702776326,-18.99,1
09:38,820686957.0,-927.528716311196,-132.99,5
09:38,741903302.0,2299.319697988479,-1.99,4
09:38,766941757.0,8736.675665236811,-152.6,2
09:39,283027736.0,-521.0057560298271,-14.62,5
09:40,551755686.0,6877.40658519596,-69.98,2
09:42,235663459.0,-174.91557018798483,-26.36,5
09:43,834383043.0,4696.842290432128,-98.98,2
09:45,441142605.0,2315.322250000004,-99.99,2
09:46,727417797.0,4254.263500000008,-123.19,2
09:48,886921642.0,3109.1349397488984,-31.63,5
09:52,494789005.0,2968.6618794393594,-23.09,5
09:52,696333897.0,310.9637499999992,-51.13,5
09:56,383833857.0,20896.789702139045,-21.39,5
09:58,834383043.0,4663.892290432128,-32.95,7
10:00,246753533.0,372.6070999999987,-5.5,9
10:00,948558249.0,8291.369015959808,-85.18,5
10:00,287480331.0,11128.713802797,-16.63,4
10:02,741903302.0,2271.319697988479,-28.0,2
10:02,760704118.0,1139.3443127174885,-41.99,2
10:03,766941757.0,8589.675665236811,-147.0,2
10:07,287480331.0,11121.863802797,-6.85,9
10:09,960208650.0,14938.998164121662,-18.26,2
10:10,254853117.0,2728.2082267563987,-70.06,2
10:10,685959099.0,1935.516866099241,-251.3,2
10:12,903468956.0,-309.94180000000057,-77.5,5
10:17,598793068.0,398.9492499999984,-18.0,4
10:22,596171893.0,-469.8282551744889,-28.96,7
10:22,762700245.0,2345.3797000000022,-79.55,5
10:22,535744551.0,425.8763659956264,-74.35,5
10:23,903953091.0,2409.396762369467,-6.8,9
10:25,305778936.0,10967.396553933964,-27.98,7
10:26,866941383.0,1792.9348500000046,-12.98,4
10:26,195895574.0,6300.174290803265,-1.71,2
10:28,760704118.0,993.7583127174884,-145.59,2
10:29,421881811.0,5021.470129341968,-214.87,2
10:31,414454079.0,443.1168500000018,-16.22,2
10:37,901432314.0,3553.418037583814,-26.12,1
10:39,556992209.0,9812.001736083052,-49.56,5
10:41,494789005.0,2958.420952396568,-10.24,2
10:44,133755851.0,354.9740038000929,-29.99,4
10:47,421881811.0,4805.912129341968,-215.56,2
10:48,901432314.0,3523.067017583814,-30.35,4
10:49,760704118.0,885.9863127174884,-107.77,2
10:50,285873880.0,10166.768772702204,-61.98,2
10:54,527842638.0,1140.1519426329835,-39.49,2
10:59,684988568.0,-855.3839234272015,-127.92,5
10:59,534204159.0,5067.880193537597,-60.4,4
11:01,892354433.0,-1588.109960634339,-22.32,5
11:07,866941383.0,1755.9848500000046,-36.95,7
11:08,856957948.0,8283.62651249826,-49.99,2
11:08,760704118.0,662.0143127174885,-223.97,2
11:11,709608057.0,2994.4437723834535,-50.34,2
11:15,527842638.0,1059.1519426329835,-81.0,2
11:23,421881811.0,4696.740129341968,-109.17,2
11:32,550832673.0,2331.101048823173,-97.33,5
11:35,551755686.0,6841.4565851959605,-35.95,1
11:35,760704118.0,459.7283127174885,-202.29,2
11:36,497772347.0,562.9820499999983,-284.45,5
11:38,964702094.0,1275.255031662935,-47.99,2
11:43,240643705.0,-73.79520887938446,-79.98,2
11:49,685959099.0,1879.516866099241,-56.0,2
11:50,766941757.0,8308.97566523681,-280.7,2
11:50,522188082.0,6769.636347030268,-66.13,4
11:56,421881811.0,4467.868129341968,-228.87,2
11:58,904154012.0,896.7674581204324,-26.96,7
11:58,322221939.0,3156.588554958046,-21.6,2
11:59,256002321.0,6262.996637617142,-74.42,2
11:59,264550521.0,8423.147996007689,-18.62,4
12:00,435313070.0,2605.5984990480256,-30.96,1
12:00,497772347.0,497.04204999999826,-65.94,7
12:05,828532554.0,1017.6825095129466,-19.99,2
12:06,760704118.0,368.04231271748847,-91.69,2
12:11,727417797.0,4182.891500000008,-71.37,2
12:13,549414742.0,6593.420520173808,-5.84,2
12:15,779236304.0,181.92759547953247,-28.23,9
12:21,766941757.0,8161.975665236811,-147.0,2
12:23,284161641.0,-438.0776889594243,-25.19,9
12:25,757115616.0,700.7600000000026,-45.09,9
12:29,886921642.0,3048.9674504114137,-60.17,8
12:35,891513205.0,646.1126796590692,-38.86,5
12:38,760704118.0,279.8563127174885,-88.19,2
12:41,499244466.0,-272.404131283422,-62.42,5
12:42,170233640.0,-1196.8864100501028,-55.82,5
12:46,298000165.0,22387.95215433322,-28.97,4
12:46,454356905.0,2234.462245839061,-16.79,7
12:49,108812033.0,530.1725499999986,-94.72,5
12:49,711140907.0,914.4605999999994,-18.95,5
12:50,769319491.0,-620.8930000000005,-51.28,5
13:01,180719578.0,-3964.610249999997,-29.38,5
13:03,688712152.0,5846.421582591819,-5.7,9
13:05,673025413.0,2285.5445573766992,-79.99,5
13:06,564744955.0,-185.41504141115803,-37.88,5
13:06,366550080.0,22807.730580566527,-1.0,2
13:08,807098817.0,147.5169499999992,-100.03,5
13:12,180616589.0,1440.575648033954,-46.42,5
13:12,535744551.0,415.8863659956264,-9.99,2
13:14,401293808.0,-247.70605000000072,-116.99,5
13:14,187111705.0,5667.512778247838,-79.95,5
13:20,916270283.0,1262.4582499999983,-59.98,2
13:21,587225252.0,8827.456600813395,-3.71,5
13:21,910730524.0,7340.337611173413,-6.1,9
13:25,546296727.0,-504.7154726973814,-120.98,5
13:27,768271776.0,-712.8357967665793,-135.56,5
13:28,865748375.0,4801.986223075988,-33.27,7
13:32,549414742.0,6563.430520173808,-29.99,9
13:34,399144202.0,2021.789252991875,-27.6,9
13:45,300095518.0,510.8212283414176,-18.11,5
13:52,685959099.0,1869.526866099241,-9.99,4
13:53,812692024.0,4090.17693134288,-46.19,5
14:05,421881811.0,4226.382129341968,-241.49,2
14:11,598793068.0,179.06034999999835,-219.89,5
14:11,738958551.0,7884.4859332133055,-8.61,2
14:13,298000165.0,22362.92688254222,-25.03,5
14:19,950234174.0,942.3298842634148,-85.41,5
14:30,409370545.0,113.00927554552015,-48.38,2
14:36,132400709.0,423.9793351539398,-112.46,5
14:38,252760664.0,5518.970082054502,-81.38,5
14:42,520447032.0,8149.322696030164,-52.99,2
14:53,348325817.0,8156.516096104805,-1.6,4
14:53,527842638.0,913.1619426329836,-145.99,2
14:59,448004226.0,2179.9774119306053,-43.47,5
15:06,409370545.0,86.75927554552015,-26.25,2
15:06,187111705.0,5638.492778247837,-29.02,7
15:11,151916463.0,251.54055559916873,-53.05,2
15:38,409370545.0,-16.365724454479846,-103.12,2
15:47,329840194.0,702.2667301431478,-75.12,5
15:52,527842638.0,806.1719426329837,-106.99,2
15:57,409971170.0,1743.0406441030127,-27.55,7
15:58,718058208.0,627.1336995314801,-22.98,7
16:02,924045955.0,-63.82998734133539,-35.2,5
16:07,409370545.0,-104.11572445447985,-87.75,2
16:14,556992209.0,9802.502246083051,-9.5,4
16:23,345582855.0,-746.8701471794508,-15.03,5
16:25,310375875.0,3322.3741615724766,-13.59,2
16:25,556992209.0,9796.492246083051,-6.01,4
16:26,838830098.0,332.6425420877844,-132.5,2
16:27,527842638.0,757.6819426329837,-48.49,2
16:33,807714284.0,623.7697607360001,-33.64,5
16:39,796709231.0,-788.6299221037024,-139.53,5
16:41,108481285.0,7668.081176619174,-30.98,7
16:42,838830098.0,208.1425420877844,-124.5,2
16:49,340295966.0,-1670.7369500000002,-20.15,5
16:53,838830098.0,100.64254208778442,-107.5,2
17:07,812692024.0,3968.18693134288,-121.99,2
17:10,865748375.0,4774.026223075988,-27.96,1
17:12,500043411.0,11885.273869093906,-4.9,7
17:13,256045540.0,-3155.9513999999995,-39.79,5
17:17,303843160.0,201.46880000000172,-79.97,2
17:18,887853850.0,9487.688484937276,-18.2,9
17:18,409370545.0,-204.99072445447985,-100.88,2
17:19,874431242.0,7450.260708890902,-14.98,4
17:19,901037631.0,872.2693230964067,-97.27,2
17:21,618514666.0,18027.82990598546,-28.0,2
17:22,633345190.0,6755.89237826851,-0.62,8
17:25,668692488.0,1459.464353563902,-44.97,4
17:26,933491926.0,2579.9783000000007,-19.99,5
17:26,534097839.0,-4147.591049999998,-7.12,5
17:27,876890798.0,3241.7025706999298,-34.95,7
17:29,806358207.0,10519.21184780713,-31.0,2
17:31,558119802.0,28514.535414527258,-1.62,4
17:31,701070224.0,555.3573500000001,-74.98,2
17:32,581655972.0,37743.42635463869,-34.95,7
17:33,857754342.0,1899.5199228586616,-68.99,2
17:33,822135975.0,11411.453116994506,-20.19,7
17:34,345514953.0,851.548199999999,-88.98,2
17:34,487051121.0,214.18746887350216,-24.42,8
17:35,574548998.0,383.7287499999992,-30.99,2
17:35,703478110.0,3899.210084266246,-26.96,7
17:35,482513594.0,5449.115946723708,-13.25,2
17:36,838830098.0,56.14254208778442,-44.5,2
17:36,956717493.0,799.5878776068375,-9.48,4
17:36,990461108.0,-35.900681379389056,-168.5,2
17:37,550832673.0,2314.121048823173,-16.98,4
17:37,461029994.0,5817.268375914818,-54.97,4
17:38,858560423.0,10451.725645306977,-117.6,2
17:38,802697323.0,18686.592847910582,-69.72,4
17:39,992204045.0,10465.888419883257,-10.01,4
17:39,939972497.0,94.38490860001085,-19.99,2
17:40,851649498.0,9097.541285043168,-89.6,2
17:41,409370545.0,-223.74072445447985,-18.75,2
17:42,893134725.0,951.8188629732092,-45.31,5
17:46,822718326.0,9329.541197351908,-16.97,7
17:46,822135975.0,11408.923116994503,-2.53,4
17:48,423208402.0,1915.6856000000023,-18.0,4
17:49,824916823.0,7804.3344510848065,-15.24,4
17:51,308505160.0,12038.37657816737,-27.99,2
17:52,678330503.0,1532.0246835435928,-240.53,5
17:53,117273481.0,7731.025613964114,-33.96,7
17:55,851649498.0,8920.441285043167,-177.1,2
17:58,838830098.0,-33.85745791221558,-90.0,2
17:58,758160963.0,7107.39367472151,-33.69,7
17:59,715068825.0,460.53949999999986,-22.0,6
17:59,137822385.0,3026.527717151475,-29.98,2
18:00,522188082.0,6763.624347030268,-6.01,4
18:00,287230540.0,904.8944326671558,-187.0,2
18:00,854895960.0,2347.799808406248,-99.99,2
18:02,871200314.0,258.8513242426384,-141.51,5
18:03,151278285.0,-374.0792000000004,-23.73,9
18:03,785210466.0,1712.4411041968256,-84.28,5
18:07,245690309.0,7935.934596153668,-15.29,4
18:08,730002588.0,11849.748559359936,-0.2,8
18:08,990461108.0,-80.90068137938906,-45.0,2
18:08,679911053.0,1776.508376222686,-168.06,5
18:09,137913631.0,563.9514499999995,-79.28,5
18:10,450896297.0,12003.632019554672,-15.11,7
18:10,169006407.0,10462.680799452586,-59.56,5
18:15,192202372.0,-53.550980960926296,-177.66,5
18:19,310375875.0,3291.934161572477,-30.44,9
18:19,647936800.0,1289.136229976253,-26.83,9
18:21,166019891.0,6973.229413652447,-27.58,2
18:21,143061865.0,6216.192228302978,-87.16,5
18:21,836110591.0,6021.447628672961,-22.76,9
18:22,851181128.0,4006.785700535027,-42.54,9
18:22,146909202.0,4086.9840038507778,-0.2,7
18:26,308505160.0,11917.99057816737,-120.39,2
18:27,683319988.0,6687.767543169119,-27.7,9
18:29,741269136.0,888.9484500000004,-92.84,5
18:29,806358207.0,10506.90184780713,-12.31,7
18:31,395284483.0,1164.9304086429734,-26.23,9
18:32,679911053.0,1748.068376222686,-28.44,9
18:32,287230540.0,840.3944326671558,-64.5,2
18:37,512989907.0,-2186.6419039753664,-49.39,5
18:37,832564361.0,13914.025658200944,-52.04,5
18:38,660874296.0,1440.4774499608463,-64.97,7
18:40,113747882.0,10509.974294956884,-24.18,9
18:46,409971170.0,1678.6424973272578,-64.4,5
18:47,426474982.0,-3443.23225,-54.86,5
18:50,246753533.0,301.6370999999988,-70.97,7
18:50,308505160.0,11885.10457816737,-32.89,2
18:50,433917275.0,7336.924896226992,-30.09,9
18:50,349614277.0,393.4571999999995,-67.01,5
18:51,890567652.0,-244.8281003203994,-109.41,5
19:00,822718326.0,9304.649197351908,-24.89,5
19:01,896821055.0,-659.0265263147646,-6.99,9
19:01,421475159.0,-591.4197373255874,-39.82,5
19:02,627723633.0,-1549.0631280037628,-93.9,5
19:07,294474095.0,-2193.02128649924,-54.04,5
19:09,699997811.0,892.4319500000033,-70.94,5
19:09,964702094.0,1269.9179228782896,-5.34,2
19:09,490868147.0,-516.2282208786985,-130.24,5
19:10,598586358.0,-3126.9674499999965,-21.43,5
19:10,637433131.0,-54.91300000000089,-86.88,5
19:11,506618547.0,15831.124678768365,-1.91,2
19:12,762859681.0,-701.624900000001,-44.96,5
19:12,237493332.0,12211.394252958691,-27.99,5
19:14,361201224.0,4158.843232067893,-108.38,5
19:15,364396689.0,-736.87325,-87.46,5
19:15,373163757.0,10032.806809235406,-147.46,5
19:16,403383649.0,1106.3456702776327,-94.67,5
19:16,667367404.0,7800.2893728908175,-17.85,2
19:16,885259672.0,3400.7022953492465,-35.07,5
19:18,308505160.0,11785.718578167369,-99.39,2
19:22,224112146.0,-49.17545000000115,-38.64,5
19:23,370521542.0,22772.87355061047,-36.33,7
19:24,370757362.0,884.1972134689167,-29.94,9
19:27,957821152.0,-1400.0476535715495,-63.76,5
19:27,469561218.0,-185.61665000000087,-158.5,5
19:30,520447032.0,7985.039696030163,-164.28,5
19:32,601627384.0,4320.172785847058,-80.5,7
19:37,719586818.0,16689.7732977389,-47.86,5
19:40,308505160.0,11740.232578167368,-45.49,2
19:41,373163757.0,10032.64370450785,-0.16,2
19:44,785210466.0,1664.109527560572,-48.33,7
19:49,776108637.0,575.2723536574956,-60.57,5
19:49,873701090.0,534.4156720862742,-58.35,7
19:52,842682241.0,4657.731203078933,-7.3,2
19:56,162162212.0,-406.2164566726911,-152.96,5
20:00,705848712.0,22854.12844139954,-10.89,9
20:00,478651121.0,-48.022570401530245,-73.18,5
20:07,749378808.0,4854.035151783603,-17.43,9
20:10,859603181.0,3478.198815563056,-2.58,7
20:23,809499628.0,14511.734563564616,-21.09,7
20:28,106601471.0,8820.234424730459,-50.82,2
20:36,994214354.0,8377.21595208229,-12.44,5
20:54,858989281.0,23405.605568705523,-101.72,5
20:58,901432314.0,3498.735017583814,-24.33,5
21:09,489964679.0,21198.24923144499,-33.88,4
21:21,108931112.0,12600.429681396145,-28.47,9
00:30,973086490.0,8940.239056229362,-8.95,9
00:31,697140785.0,-425.6383832638968,-22.64,9
00:33,382862215.0,-54.85100000000004,-25.19,9
00:37,886921642.0,3007.687928135977,-41.28,2
00:42,480557476.0,9941.179643296766,-39.62,7
00:48,899742927.0,12152.543089731036,-11.96,5
00:49,480557476.0,9924.789643296766,-16.39,9
01:00,779236304.0,155.94759547953248,-25.98,9
01:04,252760664.0,5515.9403028196075,-3.03,2
01:10,613729471.0,7018.85031764784,-18.15,2
01:12,399144202.0,1993.849252991875,-27.94,9
02:00,973086490.0,8936.820411398734,-3.42,5
02:29,305778936.0,10917.47563592614,-49.92,2
02:43,489964679.0,21156.659231444988,-41.59,9
02:46,822135975.0,11387.837629017826,-21.09,2
02:55,572384506.0,8864.306341439067,-45.35,9
02:59,450896297.0,11968.502019554671,-35.13,9
03:04,984783496.0,12545.885715891758,-66.07,7
03:06,985188462.0,475.69024871122457,-33.08,9
03:12,687135796.0,24351.47768382724,-9.99,9
03:20,489964679.0,21122.38730431252,-34.27,5
03:27,113747882.0,10491.566891873044,-18.41,8
03:31,897714622.0,8354.593258138184,-20.34,5
03:34,705848712.0,22829.37844139954,-24.75,9
03:38,887853850.0,9469.458484937277,-18.23,9
03:44,128033695.0,2720.964021285719,-16.29,7
03:44,858989281.0,23387.215568705524,-18.39,9
03:45,785749304.0,7413.310207137297,-7.5,9
03:46,738958551.0,7853.707145853577,-30.78,2
03:55,304455868.0,1399.0171597158298,-27.79,9
03:57,709608057.0,2965.2137723834535,-29.23,9
03:57,842682241.0,4601.173085451118,-56.56,7
03:58,730002588.0,11778.150952794404,-71.6,8
04:11,417850087.0,15042.023996839707,-2.48,7
04:11,213112754.0,6411.786374524264,-4.65,5
04:11,108481285.0,7631.841311753646,-36.24,5
04:12,216285378.0,20847.00638463492,-33.75,9
04:15,331450202.0,6073.5415636962525,-7.23,8
04:21,506618547.0,15825.768397238751,-5.36,7
04:25,950234174.0,900.7107970147232,-41.62,7
04:31,450896297.0,11946.878388105004,-21.62,4
04:32,256002321.0,6252.016637617143,-10.98,9
04:34,871866387.0,-862.5781000000007,-13.34,9
04:35,471897866.0,7497.813247836832,-37.73,7
04:35,627917561.0,2808.4500500000036,-37.64,9
04:38,858989281.0,23367.91173579304,-19.3,2
04:39,836110591.0,5985.567628672961,-35.88,9
04:40,824916823.0,7774.214451084807,-30.12,9
04:40,802697323.0,18647.242847910584,-39.35,9
04:43,282837512.0,11832.564136942958,-31.63,9
04:45,427909748.0,703.423200000012,-32.24,9
04:50,170637730.0,2364.807766923282,-12.9,2
04:52,287480331.0,11075.196227750404,-46.67,5
04:54,473820682.0,10398.477198614317,-8.34,2
04:55,853907490.0,6720.45537377807,-12.25,9
05:05,441274121.0,11013.2522419446,-55.99,7
05:06,874431242.0,7427.65964888355,-22.6,8
05:12,675806859.0,5930.401466988053,-25.77,7
05:13,809499628.0,14426.593504160664,-66.5,7
05:13,221868392.0,4723.771490060974,-8.82,7
05:13,656812046.0,811.9378978684196,-3.06,5
05:15,383833857.0,20884.812342726993,-11.98,2
05:17,519644021.0,2109.2396008107585,-13.12,7
05:17,364357875.0,5850.965281414294,-74.01,7
05:20,766941757.0,8125.185665236811,-36.79,9
05:24,822718326.0,9296.196222410905,-8.45,8
05:26,943329213.0,2115.637683584982,-5.05,5
05:26,853907490.0,6718.370888104227,-2.08,5
05:29,282837512.0,11826.435519149129,-6.13,7
05:29,203466392.0,1624.28866374882,-10.22,8
05:31,532478725.0,4421.505950412732,-29.13,9
05:32,259015404.0,3196.458103099682,-36.58,9
05:37,836110591.0,5977.691494502905,-7.88,7
05:39,949032480.0,4320.948537440915,-32.59,9
05:40,832564361.0,13902.200150154084,-11.83,2
05:41,518474507.0,12655.94066428184,-30.64,9
05:44,290818242.0,6106.788392872879,-4.1,4
05:48,678330503.0,1527.86548439966,-4.16,5
05:49,859603181.0,3457.3431565906353,-20.86,5
05:52,285220959.0,10983.251947108907,-3.3,7
05:57,550169791.0,18287.11859109156,-39.15,8
05:58,887853850.0,9426.856744233724,-42.6,5
05:59,719586818.0,16688.614628411917,-1.16,7
06:02,806358207.0,10493.073480251029,-13.83,5
06:08,788740658.0,3000.1314029896216,-71.53,8
06:11,383625050.0,5362.843116549521,-15.92,7
06:11,183888402.0,15638.67682859945,-34.57,9
06:12,215311171.0,5502.0649297718555,-10.65,5
06:19,520447032.0,7975.642224226775,-9.4,5
06:21,195895574.0,6280.174290803265,-20.0,9
06:22,905860285.0,14947.605756132943,-16.01,5
06:24,609939116.0,5730.3412832444665,-21.06,2
06:25,851649498.0,8896.919719726255,-23.52,4
06:25,549414742.0,6543.440520173808,-19.99,9
06:26,679662108.0,13345.397722582824,-13.69,7
06:27,647936800.0,1288.369536598477,-0.77,7
06:28,930277104.0,9456.864397943236,-46.28,2
06:28,108563213.0,20485.269713824506,-2.39,5
06:34,668329719.0,7117.975933241521,-31.82,5
06:34,873693307.0,7919.992699010037,-14.3,5
06:37,633345190.0,6723.962378268509,-31.93,9
06:38,556992209.0,9773.642246083053,-22.85,9
06:38,315546581.0,23990.035067215475,-4.73,4
06:39,687135796.0,24318.96323701615,-32.51,8
06:40,736340277.0,7459.5099148459085,-22.25,9
06:42,179173981.0,5852.868478861252,-25.59,9
06:42,604288474.0,2756.531812811678,-7.28,2
06:44,815385232.0,8846.097349195661,-21.8,7
06:49,264550521.0,8403.240210083753,-19.91,2
06:52,662610817.0,-1178.855681324928,-32.09,9
06:56,549414742.0,6468.444343141171,-75.0,7
06:59,324224854.0,1162.4414818622067,-2.61,8
07:01,657139925.0,11689.967983706883,-6.42,7
07:02,145387690.0,4815.044389969603,-16.98,2
07:05,781554833.0,2295.8385792775107,-24.94,9
07:07,785749304.0,7412.601269823074,-0.71,2
07:07,131388684.0,19082.396059734703,-30.73,5
07:09,718058208.0,596.8883582323044,-30.25,2
07:09,554792076.0,24169.384197767165,-40.85,2
07:10,146909202.0,4038.931257962152,-48.05,8
07:11,822250278.0,6037.509058800616,-2.06,5
07:15,776431321.0,2808.404269429875,-30.95,7
07:16,414805878.0,12848.25670565718,-37.8,9
07:16,624500124.0,3092.369105487576,-27.04,8
07:21,558119802.0,28440.421536089027,-74.11,7
07:21,706250160.0,9594.993709759576,-13.07,5
07:21,187541224.0,6160.762559221441,-39.48,9
07:23,435984758.0,4653.0376872573015,-28.96,2
07:23,769311479.0,6144.006210192227,-12.19,5
07:24,500043411.0,11881.02069530538,-4.25,7
07:24,829914501.0,1728.383806570974,-5.8,9
07:25,237684254.0,5157.672682663056,-38.91,4
07:31,370521542.0,22769.778142296957,-3.1,5
07:31,532478725.0,4400.422243220536,-21.08,4
07:32,547010927.0,21223.667714330633,-22.89,9
07:34,534204159.0,5035.0301935375965,-32.85,9
07:45,134461671.0,7846.720721704845,-53.27,2
07:48,310375875.0,3280.42447811744,-11.51,5
07:48,758160963.0,7097.368697505388,-10.02,2
07:50,496395938.0,11394.559786237329,-2.39,2
07:52,259015404.0,3182.596100469906,-13.86,5
07:55,421881811.0,4221.70774247659,-4.67,2
07:58,187111705.0,5635.801269974145,-2.69,8
07:59,482513594.0,5446.041960510036,-3.07,2
08:00,704517789.0,15096.575950342374,-0.23,7
08:03,229205098.0,6321.131159697518,-10.54,8
08:03,237493332.0,12199.719284441197,-11.67,4
08:03,547010927.0,21211.936920805492,-11.73,2
08:05,581655972.0,37733.31848951268,-10.11,8
08:05,534204159.0,5021.334336372061,-13.7,5
08:06,678851253.0,2749.4990767496733,-54.2,8
08:10,795847804.0,19897.5396684296,-8.11,2
08:11,336557504.0,1321.8781584030244,-6.35,9
08:12,198946608.0,5262.177768130449,-42.32,5
08:12,407574996.0,3109.867678764652,-6.63,7
08:18,119993184.0,-1991.819402910863,-19.0,9
08:18,752362502.0,8188.068861832424,-68.29,8
08:21,395284483.0,1158.980408642973,-5.95,9
08:23,644751433.0,-1344.2460584655382,-34.51,5
08:23,885259672.0,3395.2522953492467,-5.45,9
08:23,499410772.0,-2757.6268629051624,-20.29,5
08:25,423208402.0,1887.7755500000023,-27.91,5
08:26,310620484.0,445.81326100321866,-65.87,8
08:28,586315521.0,10632.412733537589,-30.73,2
08:28,352291960.0,1691.236703303574,-55.02,5
08:29,322720763.0,6546.295677234292,-40.98,2
08:30,534908754.0,-726.1937500000003,-45.45,5
08:31,709142813.0,791.1797999999994,-96.08,5
08:31,486495235.0,803.2019893887158,-65.97,5
08:31,552980092.0,-122.06528088066254,-45.74,5
08:32,836655156.0,-2780.8864552191567,-52.01,5
08:32,346874167.0,99.55399999999918,-32.86,5
08:32,766692943.0,-1856.2792500000005,-39.59,5
08:36,749378808.0,4834.77495587838,-19.26,4
08:36,993039226.0,-3856.2094999999954,-16.7,5
08:37,824916823.0,7767.081531545527,-7.13,2
08:37,131388684.0,19048.824059734703,-33.57,5
08:38,744211756.0,-3794.2607499999945,-43.74,5
08:39,666952234.0,-512.4644518755131,-137.38,5
08:39,108931112.0,12568.749681396144,-31.68,9
08:40,151968462.0,7306.631723785423,-25.54,8
08:41,600585971.0,184.12324999999953,-156.63,5
08:41,909676212.0,973.8851697400844,-1.14,8
08:41,493855007.0,-2447.661631574393,-26.09,5
08:44,258201793.0,-595.3698000000004,-47.56,5
08:45,737645298.0,-2414.511699999999,-25.78,5
08:47,994214354.0,8358.79273359143,-18.42,7
08:50,833499132.0,2038.8329000000008,-113.93,5
08:53,570269025.0,2191.901783359888,-51.81,5
08:54,511179916.0,7059.999108371867,-8.18,7
08:55,355733816.0,4065.867464054461,-3.08,7
08:55,124102251.0,3407.2481058105823,-9.97,2
08:55,949032480.0,4307.0796154548725,-13.87,2
08:56,475117511.0,7829.93039373982,-24.13,5
08:57,441274121.0,11007.1522419446,-6.1,9
08:57,491392945.0,3366.007500000005,-20.29,5
08:58,558119802.0,28419.421536089027,-21.0,5
08:58,558875206.0,1944.8814500000003,-7.9,9
09:00,540159353.0,9645.720802445558,-5.0,9
09:02,683078800.0,1333.5734472194538,-5.7,9
09:02,214339619.0,-92.5082491316436,-35.71,5
09:05,587225252.0,8812.729935554797,-14.73,8
09:09,117273481.0,7725.625613964115,-5.4,9
09:09,554792076.0,24113.272197767164,-56.11,5
09:11,290818242.0,6100.288392872879,-6.5,9
09:13,618138606.0,893.8798621516972,-5.45,9
09:14,855129444.0,-224.942745437372,-78.32,5
09:15,417850087.0,15035.873996839708,-6.15,9
09:15,699139822.0,2151.932894438895,-6.06,7
09:16,999752672.0,344.1015435333344,-7.3,9
09:16,570269025.0,2153.951783359888,-37.95,1
09:18,601627384.0,4157.072785847057,-163.1,2
09:18,169006407.0,10456.630799452589,-6.05,9
09:19,298000165.0,22299.94688254222,-62.98,2
09:19,690958123.0,17316.93582772021,-5.0,9
09:19,581655972.0,37725.51848951268,-7.8,9
09:21,355733816.0,4058.877464054461,-6.99,7
09:24,586315521.0,10627.362733537588,-5.05,9
09:25,522188082.0,6735.722948624253,-27.9,5
09:25,886921642.0,2991.657928135977,-16.03,7
09:26,653667523.0,4209.322551326438,-2.94,5
09:26,667367404.0,7793.839372890818,-6.45,9
09:26,163470640.0,610.5071999999999,-56.62,5
09:26,913127700.0,444.1161380111165,-199.98,2
09:27,663479159.0,821.4935418277084,-136.99,2
09:30,661295096.0,2794.1912044119345,-65.94,4
09:35,399538448.0,6866.068712652365,-11.49,4
09:38,834383043.0,4640.412290432128,-23.48,4
09:42,754141345.0,-2612.735335115762,-44.11,5
09:42,263882093.0,-1487.3938000000005,-61.21,5
09:43,659415300.0,2323.345790250703,-97.98,2
09:44,601627384.0,3975.0727858470577,-182.0,2
09:45,985188462.0,416.6462487112247,-59.04,4
09:46,180616589.0,1336.275648033954,-104.3,2
09:50,215311171.0,5495.074929771856,-6.99,1
09:50,867679563.0,-109.02944629828416,-43.19,5
09:55,158766229.0,-787.9334858934699,-12.97,5
09:55,448004226.0,2163.9974119306053,-15.98,4
09:57,776431321.0,2773.404269429875,-35.0,2
09:57,970298834.0,2656.2360831395654,-16.77,5
09:58,280098744.0,925.0973778716656,-32.97,4
10:01,722358036.0,-382.8809093729174,-129.6,5
10:02,538003940.0,1510.7900000000077,-39.98,2
10:04,364357875.0,5769.338281414293,-81.63,5
10:05,994947671.0,1242.4157000000002,-184.48,2
10:06,180616589.0,1082.175648033954,-254.1,2
10:10,955035930.0,599.3984791714772,-231.97,2
10:12,663479159.0,786.5035418277084,-34.99,2
10:12,994947671.0,1118.4257000000002,-123.99,2
10:13,366550080.0,22730.041728383596,-77.69,7
10:15,538003940.0,1473.8100000000077,-36.98,4
10:16,137822385.0,3020.877717151475,-5.65,9
10:17,779376323.0,2724.9332158201264,-5.99,6
10:17,285220959.0,10815.95194710891,-167.3,2
10:19,254853117.0,2695.218226756399,-32.99,7
10:23,180616589.0,881.975648033954,-200.2,2
10:24,282837512.0,11820.235519149126,-6.2,9
10:24,475277431.0,-42.42686305638044,-6.0,4
10:25,762896656.0,-522.4375018481413,-16.56,5
10:29,149684419.0,545.9660999999984,-6.35,9
10:30,585625048.0,731.7116190586327,-129.98,2
10:31,722971557.0,-472.7062791569244,-32.75,5
10:33,895750759.0,-794.5037380756659,-120.24,5
10:37,668175891.0,334.52192315849913,-124.5,2
10:39,663479159.0,712.5135418277084,-73.99,2
10:39,647472692.0,21743.045420035665,-86.25,5
10:41,527842638.0,707.6919426329837,-49.99,2
10:42,285220959.0,10525.45194710891,-290.5,2
10:46,904154012.0,801.7874581204323,-94.98,2
10:48,456246119.0,18138.58588468511,-11.0,4
10:49,779946617.0,14604.455032999327,-41.3,2
10:51,479366718.0,1582.5200976323997,-21.98,4
10:54,828750680.0,300.6739952136799,-43.67,5
10:55,475117511.0,7739.94039373982,-89.99,6
11:15,663479159.0,613.0135418277084,-99.5,2
11:15,668175891.0,175.5219231584991,-159.0,2
11:17,738958551.0,7787.377145853577,-66.33,6
11:20,611143859.0,1174.28055000001,-158.3,2
11:30,572384506.0,8755.652341439067,-108.65,5
11:34,663479159.0,469.0135418277084,-144.0,2
11:35,520447032.0,7912.931324226775,-62.71,4
11:37,766941757.0,8111.225798225687,-13.96,5
12:07,994947671.0,975.9457000000002,-142.48,2
12:09,179173981.0,5817.273882639638,-35.59,5
12:10,987656636.0,5565.735921374055,-10.19,8
12:11,903663593.0,345.6517126197981,-115.5,2
12:16,749378808.0,4799.33495587838,-35.44,9
12:24,132400709.0,400.0793351539399,-23.9,9
12:25,663479159.0,397.04354182770845,-71.97,2
12:26,823208989.0,460.76157624971773,-9.98,2
12:28,355940285.0,2175.9729781896835,-141.47,5
12:30,738958551.0,7643.697145853576,-143.68,2
12:32,106601471.0,8802.677113626734,-17.56,2
12:34,663479159.0,294.56354182770843,-102.48,2
12:43,994947671.0,758.4557000000002,-217.49,2
12:44,180616589.0,604.075648033954,-277.9,2
12:47,903663593.0,190.0267126197981,-155.62,2
12:49,322221939.0,3116.947697998701,-39.64,7
12:49,518746136.0,-1183.1997282369166,-23.31,5
12:51,250895529.0,887.7970324692873,-20.37,9
12:52,399144202.0,1937.0440193305203,-56.81,7
12:52,551755686.0,6794.976585195961,-46.48,4
12:52,475117511.0,7606.94039373982,-133.0,2
13:01,727417797.0,4151.401500000008,-31.49,4
13:01,766941757.0,8079.7057982256865,-31.52,2
13:02,941285623.0,-462.3636009332296,-127.24,5
13:06,706361191.0,-31.936701505921857,-16.45,9
13:07,613729471.0,6988.9603176478395,-29.89,9
13:08,663479159.0,124.07354182770842,-170.49,2
13:09,688712152.0,5840.721582591819,-5.7,9
13:09,910730524.0,7333.837611173413,-6.5,9
13:11,120634201.0,4548.047500000004,-17.23,9
13:13,180616589.0,353.47564803395403,-250.6,2
13:14,262767079.0,-1170.8775500000004,-96.44,5
13:18,475117511.0,7571.94039373982,-35.0,2
13:19,989506909.0,-2296.6423707594377,-33.12,5
13:20,866941383.0,1601.252650000005,-154.73,5
13:24,180616589.0,286.97564803395403,-66.5,2
13:24,663479159.0,-27.416458172291584,-151.49,2
13:39,945054126.0,-1073.8719,-21.44,9
13:45,475117511.0,7516.64039373982,-55.3,2
13:54,961077907.0,465.49565000000007,-72.38,5
13:57,978951113.0,-891.5029925904191,-243.99,5
13:58,684284526.0,-2818.2838667457586,-24.95,5
13:58,663479159.0,-122.88645817229158,-95.47,2
13:59,441142605.0,2311.832250000004,-3.49,4
14:01,480198977.0,11141.255297642572,-1.99,4
14:04,994947671.0,584.9557000000002,-173.5,2
14:19,398429109.0,-409.2968999999991,-43.63,5
14:21,475117511.0,7457.84039373982,-58.8,2
14:22,663479159.0,-142.36645817229157,-19.48,2
14:29,522188082.0,6681.702948624253,-54.02,1
14:39,933491926.0,2440.008300000001,-139.97,6
14:43,743630833.0,222.5779132847012,-31.99,2
14:46,899742927.0,12027.553089731036,-124.99,2
14:47,475117511.0,7336.740393739819,-121.1,2
14:48,407574996.0,3060.7376787646517,-49.13,7
14:52,480557476.0,9918.709643296766,-6.08,6
14:54,663479159.0,-174.84645817229156,-32.48,2
15:08,331048953.0,-433.57863202150634,-99.65,5
15:08,663479159.0,-226.83645817229157,-51.99,2
15:10,475117511.0,7280.740393739819,-56.0,2
15:15,285220959.0,10280.45194710891,-245.0,2
15:17,348325817.0,8068.148096104805,-88.37,5
15:36,256002321.0,6208.52678624799,-43.49,2
15:40,475117511.0,7142.84039373982,-137.9,2
15:44,158414827.0,-1644.5321000000015,-68.84,5
15:44,744968736.0,-1562.764626569424,-50.25,5
15:47,588565416.0,6534.077782068405,-41.99,2
15:50,663479159.0,-384.7964581722916,-157.96,2
15:50,901037631.0,837.1693230964066,-35.1,2
15:57,138351025.0,-729.4682500000002,-150.3,5
15:57,657528784.0,-243.98309999999933,-137.8,5
16:00,475117511.0,7087.54039373982,-55.3,2
16:10,663479159.0,-487.77645817229154,-102.98,2
16:17,668175891.0,105.95627315849912,-69.57,5
16:19,155317149.0,166.02439999999928,-41.84,5
16:22,588565416.0,6387.6237820684055,-146.45,5
16:25,345582855.0,-766.9398471794508,-20.07,5
16:34,467207141.0,1476.1704670482638,-84.98,2
16:37,456221621.0,324.64956730262816,-125.97,2
16:38,322221939.0,3101.907697998701,-15.04,1
16:38,285220959.0,10155.85194710891,-124.6,2
16:40,718058208.0,581.8733582323044,-15.01,4
16:44,492215823.0,-120.3768261845569,-35.34,4
16:46,286484726.0,359.13960943561557,-30.99,2
16:47,516051449.0,1545.8305090142912,-85.66,5
16:48,625281433.0,-877.1718073707567,-96.86,5
16:53,663479159.0,-572.2464581722916,-84.47,2
16:56,939972497.0,66.41490860001083,-27.97,4
16:58,628470485.0,156.0380299001231,-118.69,5
17:03,308505160.0,11732.608819018977,-7.62,2
17:07,663479159.0,-679.7364581722916,-107.49,2
17:10,651756497.0,12605.395185211455,-11.26,5
17:14,124102251.0,3366.2581058105825,-40.99,2
17:19,116598243.0,1720.4046729804963,-11.4,7
17:21,834581602.0,226.83589999999936,-52.97,2
17:22,442070890.0,476.34946244437106,-96.98,2
17:24,919185264.0,3701.737527740503,-43.95,1
17:24,909676212.0,886.1751697400842,-87.71,5
17:26,104832000.0,-2773.5173589058445,-51.61,5
17:26,169006407.0,10448.091445847456,-8.54,5
17:27,331450202.0,6043.049563696252,-30.49,5
17:28,663479159.0,-751.1964581722916,-71.46,2
17:28,785210466.0,1642.139527560572,-21.97,1
17:29,550832673.0,2281.181048823173,-32.94,1
17:29,510101371.0,11466.075794330707,-51.38,9
17:31,709151315.0,-977.02678162584,-141.98,5
17:31,873693307.0,7743.378699010038,-133.83,2
17:33,287230540.0,824.4244326671558,-15.97,1
17:33,815385232.0,8836.05734919566,-10.04,7
17:35,475117511.0,6968.54039373982,-119.0,2
17:36,303843160.0,34.168100000001715,-167.3,5
17:40,517190750.0,1626.8960899154124,-22.02,2
17:40,506618547.0,15800.548397238754,-25.22,2
17:42,235881534.0,11162.899479695596,-45.03,2
17:45,683319988.0,6661.6775431691185,-26.09,9
17:45,956717493.0,778.6178776068375,-20.97,1
17:45,987163717.0,5644.840320000006,-32.76,4
17:47,417850087.0,15029.867996839708,-6.01,4
17:48,433917275.0,7246.477896226992,-90.45,5
17:49,315078351.0,5447.12095066468,-28.14,2
17:49,858560423.0,10420.235645306975,-31.49,4
17:51,846550094.0,1622.5868360368745,-256.2,2
17:51,940569402.0,5210.299029112456,-12.95,9
17:52,471897866.0,7432.111247836832,-65.7,5
17:53,361201224.0,4128.733232067893,-30.11,2
17:56,994214354.0,8316.00273359143,-42.79,9
17:58,795847804.0,19875.7996684296,-21.74,9
17:58,204855464.0,-1290.5332386396158,-121.7,5
17:59,815385232.0,8745.757349195661,-90.3,2
17:59,335698481.0,-2004.1279966949403,-24.65,5
17:59,663479159.0,-788.6964581722916,-37.5,2
18:00,245690309.0,7885.170596153668,-50.76,5
18:00,198946608.0,5240.137768130449,-22.04,2
18:02,475117511.0,6919.54039373982,-49.0,2
18:03,252701364.0,-3427.3386726779167,-44.72,5
18:03,771125520.0,300.43784999999946,-84.5,2
18:04,482513594.0,5386.709960510036,-59.33,5
18:06,197779140.0,15.34229999999964,-28.78,9
18:07,601627384.0,3934.922785847057,-40.15,9
18:08,956717493.0,595.1178776068375,-183.5,2
18:08,196289502.0,13369.089318880604,-9.95,9
18:09,844835978.0,8367.4480683951,-55.23,5
18:11,846550094.0,1423.1008360368746,-199.49,2
18:12,713910252.0,-570.5240742714584,-65.36,5
18:15,815385232.0,8620.457349195662,-125.3,2
18:16,683319988.0,6637.942529193571,-23.74,7
18:18,639420537.0,-1619.23395,-17.59,5
18:19,197865285.0,228.99491173122047,-72.1,5
18:20,987163717.0,5604.350320000006,-40.49,9
18:24,475117511.0,6870.54039373982,-49.0,2
18:25,574548998.0,376.2387499999992,-7.49,7
18:25,221868392.0,4702.571490060975,-21.2,9
18:27,873701090.0,494.5478972811088,-39.87,2
18:28,117273481.0,7533.447613964115,-192.18,5
18:28,234952520.0,-1977.153600000001,-34.09,9
18:30,558119802.0,28390.421536089027,-29.0,9
18:31,832564361.0,13867.200750154085,-35.0,7
18:33,912705941.0,16383.194983041472,-44.46,2
18:34,270374623.0,8585.014066122678,-10.78,7
18:34,310375875.0,3249.1344781174403,-31.29,9
18:34,546760202.0,-1754.390527675968,-27.2,5
18:36,220183538.0,429.9791499999995,-134.32,5
18:38,797184978.0,-1606.0874134269804,-78.32,5
18:39,851181128.0,3934.7721580600664,-72.01,2
18:42,373163757.0,10013.703704507849,-18.94,9
18:46,117273481.0,7483.457613964115,-49.99,7
18:51,891716230.0,28.23564807062054,-56.97,7
18:51,176922958.0,-149.79245280235054,-53.51,2
18:53,837876918.0,-2091.7052914654214,-38.65,5
18:53,196289502.0,13326.885682489054,-42.2,7
18:54,930271460.0,-128.34965246422396,-160.28,5
18:55,954263768.0,-351.6213000000002,-29.62,5
18:56,574548998.0,251.05249999999916,-125.19,5
18:57,395284483.0,1097.0103768184697,-61.97,5
18:58,874431242.0,7336.30964888355,-91.35,7
18:59,194023154.0,-2356.0696717847345,-52.21,5
19:02,408057540.0,7269.064106328467,-5.93,8
19:06,235881534.0,11137.202030539804,-25.7,8
19:08,639409800.0,30384.18846602265,-42.01,8
19:11,348460748.0,-111.06040000000084,-38.02,5
19:13,373875019.0,13813.356402803744,-66.86,5
19:17,446720287.0,-879.2765591815944,-88.06,5
19:18,873701090.0,368.8208972811088,-125.73,5
19:20,699313649.0,-2076.160899141906,-38.14,5
19:22,703478110.0,3840.935084266246,-58.27,5
19:27,149684419.0,523.0435499999984,-22.92,5
19:31,868377987.0,2975.429719515681,-85.13,5
19:33,698955014.0,847.8206549409122,-56.74,5
19:34,166019891.0,6928.443413652447,-44.79,5
19:34,575652395.0,-153.95258023817337,-242.07,5
19:40,344522228.0,-2709.7369882083926,-28.54,5
19:42,854895960.0,2339.584609512741,-8.22,5
19:48,534325901.0,5745.134440852096,-58.31,5
19:49,202320275.0,-839.9246500000004,-117.03,5
19:52,163470640.0,596.2571999999999,-14.25,9
20:00,297823329.0,373.17369999999914,-164.07,5
20:02,425730826.0,-12.905590611280331,-54.52,5
20:02,140893085.0,4395.438056365461,-170.39,5
20:04,901432314.0,3482.952427183497,-15.78,2
20:04,750094757.0,-2157.2837000000004,-109.41,5
20:05,633345190.0,6672.718712668254,-51.24,2
20:11,969697937.0,-4305.610265670551,-35.28,5
20:13,940569402.0,5194.358356810535,-15.94,2
20:14,195895574.0,6250.554832803643,-29.62,7
20:17,473820682.0,10299.987198614315,-98.49,5
20:18,496395938.0,11269.497786237327,-125.06,5
20:32,667367404.0,7791.081899611131,-2.76,2
20:34,126929801.0,900.9149190559712,-61.01,5
20:37,246753533.0,249.97989999999876,-51.66,5
20:39,280098744.0,797.3543778716655,-127.74,5
20:42,540159353.0,9627.342211049105,-18.38,2
20:47,956717493.0,486.8425776068375,-108.28,5
20:55,705848712.0,22826.411736653154,-2.97,7
22:18,951817450.0,8588.475185992684,-6.0,9
02:19,628470485.0,132.61802990012308,-23.42,9
02:34,522188082.0,6680.454558924701,-1.25,7
02:42,556992209.0,9761.205675924424,-12.44,8
02:43,414805878.0,12813.16670565718,-35.09,9
02:44,315078351.0,5368.171855211299,-78.95,5
02:49,858989281.0,23356.96173579304,-10.95,9
02:50,779236304.0,120.62759547953247,-35.32,9
02:52,705848712.0,22806.661736653154,-19.75,9
03:03,308897841.0,470.92369999999937,-19.89,9
03:07,496395938.0,11265.445128271956,-4.05,5
03:11,549414742.0,6438.214343141171,-30.23,9
03:12,985188462.0,377.9462487112247,-38.7,9
03:13,851181128.0,3907.4421580600665,-27.33,9
03:23,237493332.0,12191.079284441195,-8.64,9
03:23,873701090.0,329.35194399904134,-39.47,7
03:25,766941757.0,8051.565798225686,-28.14,9
03:29,633345190.0,6644.188712668254,-28.53,9
03:30,551196328.0,3861.644133942312,-3.33,8
03:33,116598243.0,1711.0586607734765,-9.35,2
03:37,705848712.0,22780.63177188876,-26.03,7
03:39,987656636.0,5516.524772993965,-49.21,5
03:59,718058208.0,562.1923573896562,-19.68,5
04:08,897714622.0,8275.582924417524,-79.01,7
04:09,970298834.0,2636.0689691825273,-20.17,8
04:15,858989281.0,23351.207798828134,-5.75,2
04:17,836110591.0,5943.0114945029045,-34.68,9
04:18,779946617.0,14559.465646967052,-44.99,2
04:20,749378808.0,4796.562847669396,-2.77,5
04:25,506618547.0,15798.093130145104,-2.46,7
04:25,290818242.0,6084.107994366532,-16.18,7
04:26,912705941.0,16315.442360197349,-67.75,4
04:26,169006407.0,10427.695299209776,-20.4,4
04:27,802697323.0,18610.792847910583,-36.45,9
04:28,252760664.0,5503.829687240687,-12.11,5
04:37,383625050.0,5357.768984665319,-5.07,7
04:37,146909202.0,3989.13981122455,-49.79,8
04:41,259015404.0,3136.3561004699063,-46.24,9
04:44,414805878.0,12807.869763059232,-5.3,2
04:49,873693307.0,7681.869095942383,-61.51,2
04:55,949032480.0,4268.249615454873,-38.83,9
04:56,905860285.0,14918.932293352922,-28.67,5
04:57,683319988.0,6602.552529193571,-35.39,9
05:06,823208989.0,415.5502300989282,-45.21,7
05:07,124102251.0,3362.067155281491,-4.19,2
05:07,264550521.0,8386.518198701937,-16.72,7
05:10,473820682.0,10294.01612797741,-5.97,7
05:13,421881811.0,4153.353765411216,-68.35,4
05:15,706250160.0,9593.334721729452,-1.66,2
05:16,815385232.0,8616.676437433045,-3.78,4
05:19,550169791.0,18272.875715264337,-14.24,2
05:19,809499628.0,14405.403504160662,-21.19,9
05:21,699139822.0,2125.792894438895,-26.14,9
05:32,324224854.0,1138.1860477650062,-24.26,7
05:33,564744955.0,-197.66504141115803,-12.25,9
05:35,842682241.0,4567.186444982149,-33.99,4
05:37,670102069.0,3134.841126796913,-19.24,9
05:38,489964679.0,21086.44730431252,-35.94,9
05:40,216285378.0,20804.47638463492,-42.53,9
05:40,679662108.0,13300.392996158018,-45.0,5
05:44,287480331.0,11033.519695433964,-41.68,2
05:46,802697323.0,18600.707597825494,-10.09,8
05:48,364357875.0,5762.515577418642,-6.82,2
05:50,809499628.0,14392.245529242857,-13.16,7
05:54,949032480.0,4263.920890803244,-4.33,8
05:54,586315521.0,10623.78775937102,-3.57,7
05:56,108481285.0,7596.237479730672,-35.6,2
05:58,187541224.0,6112.422559221441,-48.34,9
05:59,657139925.0,11675.083200913072,-14.88,4
06:01,450896297.0,11914.288388105004,-32.59,9
06:04,836110591.0,5942.072006671734,-0.94,2
06:05,245690309.0,7809.176750688676,-75.99,7
06:07,558119802.0,28370.191536089027,-20.23,9
06:08,417850087.0,15020.596743752374,-9.27,8
06:10,687135796.0,24316.671742148956,-2.29,7
06:13,647936800.0,1252.795359421526,-35.57,8
06:15,366550080.0,22647.553088646073,-82.49,8
06:17,237684254.0,5155.09699580827,-2.58,5
06:17,940569402.0,5169.618356810535,-24.74,9
06:24,441274121.0,11006.931466286582,-0.22,7
06:27,832564361.0,13860.806891697235,-6.39,2
06:29,633345190.0,6639.069398308449,-5.12,5
06:34,950234174.0,887.291586616276,-13.42,7
06:34,308505160.0,11722.56996077497,-10.04,5
06:38,558119802.0,28316.448124877672,-53.74,7
06:39,960208650.0,14917.995893314148,-21.0,5
06:40,399144202.0,1903.959557901992,-33.08,2
06:44,510101371.0,11428.725794330709,-37.35,9
06:44,519644021.0,2099.027528111115,-10.21,8
06:45,572384506.0,8747.864558716561,-7.79,2
06:45,237493332.0,12176.832765885943,-14.25,5
06:48,200080192.0,8363.433643948018,-67.49,8
06:50,613729471.0,6954.237678676324,-34.72,4
06:51,709608057.0,2925.8337723834534,-39.38,9
06:52,108931112.0,12535.169681396144,-33.58,9
06:52,930277104.0,9434.94554105733,-21.92,2
06:53,113747882.0,10441.1207962458,-50.45,2
06:54,822135975.0,11318.110167094806,-69.73,2
06:54,450896297.0,11902.7141613154,-11.57,7
06:55,256002321.0,6183.37678624799,-25.15,9
06:57,370521542.0,22760.397583324404,-9.38,2
06:57,549414742.0,6419.8972665981255,-18.32,8
07:02,675806859.0,5905.21811091078,-25.18,8
07:04,433917275.0,7237.498398902398,-8.98,2
07:07,183888402.0,15603.59682859945,-35.08,9
07:07,824916823.0,7737.691531545526,-29.39,9
07:08,940569402.0,5164.958773432393,-4.66,8
07:08,581655972.0,37648.31196023062,-77.21,7
07:09,534325901.0,5739.1090595261285,-6.03,4
07:10,480557476.0,9901.895636884688,-16.81,7
07:11,994214354.0,8277.312733591429,-38.69,9
07:12,187111705.0,5609.435406182811,-26.37,2
07:13,901037631.0,831.3693230964067,-5.8,9
07:15,897592348.0,13176.36436078595,-0.05,4
07:15,822250278.0,5971.359446063072,-66.15,2
07:17,887853850.0,9421.92304283568,-4.93,2
07:17,419550103.0,16455.402093773682,-3.89,4
07:21,383833857.0,20854.872086382213,-29.94,5
07:24,853907490.0,6715.429051329467,-2.94,8
07:24,609939116.0,5696.2807450538285,-34.06,2
07:28,678851253.0,2745.189675727105,-4.31,7
07:28,878989510.0,4625.495886141791,-6.64,7
07:29,704517789.0,15065.847018770828,-30.73,7
07:30,532478725.0,4376.092243220536,-24.33,9
07:33,719742742.0,-1592.8425077779634,-33.69,9
07:34,683319988.0,6583.559015850653,-18.99,7
07:38,500043411.0,11880.570758606204,-0.45,7
07:39,851181128.0,3907.166571347064,-0.28,5
07:42,541639148.0,3938.649449468916,-35.39,7
07:43,310375875.0,3234.159043010536,-14.98,8
07:44,203466392.0,1555.3821953292463,-68.91,7
07:54,348325817.0,8040.506919532593,-27.64,5
07:55,865748375.0,4771.095227065268,-2.93,7
07:55,146909202.0,3980.83981122455,-8.3,9
08:02,482513594.0,5367.948622290611,-18.76,5
08:05,948558249.0,8286.369015959808,-5.0,9
08:06,992204045.0,10444.156994434235,-21.73,7
08:10,298000165.0,22282.897015208982,-17.05,5
08:11,336557504.0,1316.5281584030245,-5.35,9
08:14,229205098.0,6318.5714412119905,-2.56,5
08:18,454129843.0,634.8636507917888,-7.3,9
08:18,399538448.0,6860.668712652366,-5.4,9
08:20,668329719.0,7115.115001429684,-2.86,5
08:22,305778936.0,10903.050009553308,-14.43,2
08:22,547010927.0,21210.443772536993,-1.49,7
08:24,775790822.0,-2858.0734192160685,-17.23,5
08:27,454356905.0,2223.8824869796695,-10.58,7
08:29,885259672.0,3387.7522953492467,-7.5,9
08:30,216285378.0,20760.22938463492,-44.25,5
08:30,806358207.0,10485.479984888823,-7.59,7
08:32,672913754.0,9083.115906431352,-7.87,2
08:35,518474507.0,12582.272664281842,-73.67,5
08:35,948069469.0,-832.185900000001,-54.34,5
08:35,703537476.0,1025.185249999999,-53.11,5
08:36,387957305.0,-2459.8161059800796,-15.6,5
08:36,213112754.0,6344.964374524264,-66.82,5
08:38,785749304.0,7348.768322347719,-63.83,7
08:38,699139822.0,2093.812198282753,-31.98,7
08:42,310171581.0,-1988.84370434092,-27.57,5
08:43,795847804.0,19874.47541096226,-1.32,5
08:45,383833857.0,20782.156086382212,-72.72,5
08:47,179173981.0,5812.196810905874,-5.08,5
08:47,857455726.0,-1120.1471141243155,-116.39,5
08:51,576188756.0,-2797.6514999999995,-20.08,5
08:53,986267641.0,5378.8881928135825,-5.95,5
08:53,824916823.0,7674.360662461839,-63.33,8
08:55,195895574.0,6246.060648087464,-4.49,5
08:55,876890798.0,3174.33142069993,-67.37,5
08:56,170637730.0,2360.3238845204573,-4.48,2
08:58,871866387.0,-956.9815000000008,-94.4,5
08:58,197865285.0,223.89491173122047,-5.1,9
09:01,259015404.0,3104.7427908402474,-31.61,8
09:01,425964226.0,2707.3506500000017,-6.6,9
09:03,534204159.0,4998.167806659681,-23.17,5
09:03,290818242.0,6078.807994366532,-5.3,9
09:04,621652856.0,-1089.05603038946,-174.68,5
09:04,690958123.0,17310.93582772021,-6.0,9
09:04,305778936.0,10752.627009553307,-150.42,5
09:07,449387287.0,-262.3623061648984,-135.95,5
09:08,586315521.0,10618.13775937102,-5.65,9
09:08,441274121.0,11000.031466286582,-6.9,9
09:13,683319988.0,6578.159015850653,-5.4,9
09:13,407574996.0,3052.7499162033873,-7.99,5
09:17,618138606.0,887.0798621516973,-6.8,9
09:17,741903302.0,2266.1196979884794,-5.2,9
09:17,851649498.0,8891.119719726255,-5.8,9
09:18,558875206.0,1938.7314500000005,-6.15,9
09:18,851181128.0,3690.425571347064,-216.74,5
09:19,117273481.0,7478.457613964115,-5.0,9
09:19,417850087.0,15014.446743752374,-6.15,9
09:19,169006407.0,10422.445299209776,-5.25,9
09:20,540159353.0,9621.942211049103,-5.4,9
09:20,999752672.0,337.3015435333344,-6.8,9
09:20,322221939.0,3044.0106979987013,-57.9,5
09:21,973388795.0,798.9176761636216,-7.0,7
09:21,506618547.0,15792.643130145105,-5.45,9
09:26,734161378.0,-2510.875169434213,-32.36,5
09:31,145387690.0,4806.529994872689,-8.51,7
09:32,659415300.0,2305.365790250703,-17.98,4
09:34,240643705.0,-225.5349088793845,-151.74,5
09:37,134461671.0,7540.820721704846,-305.9,2
09:41,421881811.0,4137.193765411216,-16.16,4
09:46,414454079.0,439.0668500000018,-4.05,4
09:47,280098744.0,653.8823778716655,-143.47,2
09:48,282837512.0,11781.268071728293,-38.97,5
09:50,279149837.0,698.7830499999989,-29.96,1
09:53,473820682.0,10266.446157977409,-27.57,4
09:55,479456865.0,971.0802314894048,-6.0,4
09:56,259015404.0,3094.3327908402475,-10.41,7
09:57,596171893.0,-475.8182551744889,-5.99,7
10:00,454356905.0,2171.0632869796696,-52.82,4
10:05,285873880.0,9958.868772702204,-207.9,2
10:06,402438092.0,422.9811999999991,-63.61,5
10:08,149684419.0,516.5935499999983,-6.45,9
10:10,472995101.0,1586.6079738883295,-18.97,4
10:11,137822385.0,3013.077717151474,-7.8,9
10:12,647472692.0,21695.97201821781,-47.07,7
10:12,494789005.0,2880.684202396568,-77.74,4
10:12,659415300.0,2300.015790250703,-5.35,9
10:12,280098744.0,571.2823778716655,-82.6,2
10:13,134461671.0,7336.448721704845,-204.37,2
10:16,183888402.0,15591.639575902682,-11.96,5
10:16,673025413.0,2217.6345573766994,-67.91,1
10:26,661295096.0,2769.2212044119347,-24.97,1
10:29,407574996.0,2829.0789162033875,-223.67,5
10:33,192202372.0,-98.53098096092629,-44.98,4
10:39,687135796.0,24106.013742148956,-210.66,2
10:42,285873880.0,9872.082772702204,-86.79,2
10:43,355733816.0,4034.907464054462,-23.97,7
10:52,853907490.0,6709.329051329467,-6.1,6
10:57,570323670.0,3118.2329958823943,-32.04,4
10:59,134461671.0,7192.9627217048455,-143.49,2
11:07,322221939.0,3039.7347757640914,-4.28,2
11:11,570269025.0,2077.961783359888,-75.99,2
11:15,767447966.0,3776.61562551211,-57.2,4
11:18,585625048.0,614.6156190586327,-117.1,5
11:19,310620484.0,425.69326100321865,-20.12,7
11:23,977899503.0,-1233.1171064191474,-31.99,5
11:28,782013626.0,747.4241993116277,-61.98,2
11:29,355733816.0,3999.9174640544616,-34.99,2
11:30,266777719.0,-32.228566219760324,-60.0,2
11:34,322221939.0,2879.1147757640915,-160.62,2
11:35,821971408.0,1823.825721374878,-6.99,7
11:37,277562576.0,350.4137507952724,-29.99,4
11:39,647472692.0,21612.43201821781,-83.54,2
11:44,117308635.0,1057.9590945704883,-10.03,7
11:55,766941757.0,8018.70486601774,-32.86,2
11:55,134461671.0,7063.476721704846,-129.49,2
11:56,266777719.0,-75.35356621976032,-43.12,2
11:59,718058208.0,498.5063573896562,-63.69,2
12:17,266777719.0,-131.22856621976032,-55.88,2
12:18,718058208.0,387.90635738965625,-110.6,2
12:23,280098744.0,506.3123778716655,-64.97,2
12:32,520447032.0,7900.428235085262,-12.5,2
12:35,266777719.0,-160.85356621976032,-29.62,2
12:37,916270283.0,1237.0182499999985,-25.44,9
12:44,280098744.0,417.44037787166553,-88.87,2
12:47,967989787.0,-359.6966173592728,-64.92,5
12:57,519644021.0,2016.717528111115,-82.31,2
13:02,280098744.0,346.05437787166557,-71.39,2
13:03,480557476.0,9896.395636884688,-5.5,9
13:03,534204159.0,4965.9775666596815,-32.19,4
13:06,187111705.0,5604.685406182811,-4.75,9
13:06,493640090.0,-2317.48595,-52.61,5
13:07,982286721.0,-3208.4430240177307,-43.76,5
13:08,407574996.0,2822.5789162033875,-6.5,9
13:10,688712152.0,5835.121582591819,-5.6,9
13:10,637649383.0,304.32519999999835,-23.43,9
13:11,266777719.0,-212.60356621976032,-51.75,2
13:14,586041848.0,476.1216999999991,-64.22,5
13:21,277562576.0,344.4137507952724,-6.0,9
13:22,165691047.0,-553.6865000000009,-82.59,5
13:22,347110339.0,-571.3467925031481,-14.38,9
13:24,910730524.0,7328.537611173413,-5.3,9
13:31,656389634.0,-2778.0718404219865,-41.05,5
13:42,280098744.0,155.6963778716656,-190.36,2
13:43,718058208.0,336.12035738965625,-51.79,2
14:13,280098744.0,61.9523778716656,-93.74,2
14:18,718058208.0,199.66235738965628,-136.46,2
14:43,618514666.0,17940.623905985463,-87.21,5
14:48,687135796.0,23960.41374214896,-145.6,2
14:59,266777719.0,-272.2285662197603,-59.62,2
15:03,421881811.0,4107.163765411216,-30.03,9
15:04,310620484.0,402.3946630427863,-23.3,7
15:19,687135796.0,23884.82774214896,-75.59,2
15:20,687135796.0,23871.82774214896,-13.0,9
15:23,266777719.0,-289.1035662197603,-16.88,2
15:24,647472692.0,21550.36201821781,-62.07,1
15:29,679911053.0,1739.579388208475,-8.49,7
15:38,448004226.0,2045.3946619306053,-118.6,5
15:50,108931112.0,12409.169681396144,-126.0,2
15:56,718058208.0,-18.023642610343728,-217.69,2
16:00,266777719.0,-368.9785662197603,-79.88,2
16:10,709608057.0,2891.381350799976,-34.45,7
16:12,321372947.0,-459.69895078909934,-15.67,5
16:12,678330503.0,1496.5209485355106,-31.34,7
16:13,788740658.0,2968.6314029896216,-31.5,2
16:23,456221621.0,278.01976730262817,-46.63,5
16:25,516051449.0,1459.8805090142912,-49.0,2
16:26,266777719.0,-484.4785662197603,-115.5,2
16:30,939972497.0,19.352858600010833,-47.06,5
16:30,720742759.0,572.6398308830078,-119.98,2
16:30,718058208.0,-80.99564261034372,-62.97,2
16:31,867987292.0,3088.1120966816816,-26.41,2
16:36,912584712.0,255.38261954473307,-39.95,7
16:36,108931112.0,12199.869681396143,-209.3,2
16:42,376271050.0,656.3402468611794,-3.98,4
16:43,788740658.0,2902.1314029896216,-66.5,2
16:46,807714284.0,586.8223607360001,-36.95,5
16:46,687135796.0,23780.12774214896,-91.7,2
16:48,653667523.0,4181.372551326438,-27.95,7
16:54,899742927.0,11963.57462668934,-63.98,7
16:54,516051449.0,1379.3805090142912,-80.5,2
16:56,296972867.0,-755.6224000000008,-60.32,5
16:56,413557825.0,711.3186999999996,-28.0,2
17:04,303843160.0,-294.13189999999827,-328.3,7
17:04,687135796.0,23635.941742148956,-144.19,2
17:05,266777719.0,-506.9785662197603,-22.5,2
17:07,516051449.0,1326.8805090142912,-52.5,2
17:09,581618317.0,-4515.491701873207,-35.05,5
17:12,651756497.0,12593.10848809942,-12.29,7
17:14,687135796.0,23490.34174214896,-145.6,2
17:16,280200287.0,-1207.950453386949,-33.11,5
17:17,672913754.0,9068.625906431353,-14.49,9
17:23,769311479.0,5930.396210192227,-213.61,2
17:23,138609932.0,4082.712003294585,-11.97,4
17:23,858989281.0,23334.567798828135,-16.64,1
17:26,486495235.0,793.2119893887158,-9.99,2
17:26,324224854.0,1109.3460477650062,-28.84,9
17:27,266777719.0,-564.7285662197603,-57.75,2
17:28,690523499.0,627.6541499999996,-11.0,4
17:28,586315521.0,10599.54775937102,-18.59,4
17:29,228136274.0,-660.5506500000008,-60.83,5
17:29,964702094.0,1250.9379228782896,-18.98,2
17:34,516051449.0,1229.5805090142912,-97.3,2
17:36,687135796.0,23285.96974214896,-204.37,2
17:37,788740658.0,2769.8314029896214,-132.3,2
17:39,769311479.0,5894.927827176548,-35.47,5
17:40,586315521.0,10578.32775937102,-21.22,9
17:40,303843160.0,-399.13189999999827,-105.0,4
17:42,558875206.0,1932.7414500000004,-5.99,7
17:42,836110591.0,5921.372006671734,-20.7,7
17:43,454129843.0,615.9776507917888,-18.89,2
17:43,433917275.0,7224.788198902398,-12.71,4
17:44,478412511.0,250.99792019746076,-87.0,2
17:45,516051449.0,1100.0805090142912,-129.5,2
17:48,806358207.0,10450.641064888823,-34.84,4
17:49,994214354.0,8265.022255515114,-12.29,7
17:49,413557825.0,560.6562999999996,-150.66,5
17:51,687135796.0,23279.75974214896,-6.21,7
17:52,984783496.0,12469.638052217308,-76.25,5
17:52,441142605.0,2307.842250000004,-3.99,4
17:52,221868392.0,4692.371490060975,-10.2,2
17:53,518474507.0,12550.32266428184,-31.95,9
17:56,788740658.0,2692.8314029896214,-77.0,2
17:56,424397946.0,1861.371783605399,-148.37,5
17:56,120634201.0,4515.427500000004,-32.62,5
17:58,785749304.0,7310.170322347719,-38.6,5
17:59,667367404.0,7756.081899611131,-35.0,2
17:59,857754342.0,1864.5199228586616,-35.0,2
18:00,698076160.0,5279.434179996693,-53.07,5
18:00,146909202.0,3932.13981122455,-48.7,2
18:00,266777719.0,-583.4785662197603,-18.75,2
18:01,653667523.0,4091.156551326438,-90.22,5
18:03,108931112.0,11954.869681396143,-245.0,2
18:05,143061865.0,6191.356280531831,-24.84,8
18:06,108563213.0,20481.535574276215,-3.73,2
18:10,212560376.0,-571.4848742208978,-25.09,9
18:10,833899961.0,1791.2737728389911,-151.0,4
18:12,128033695.0,2702.6840212857187,-18.28,9
18:14,478412511.0,180.99792019746076,-70.0,2
18:15,454129843.0,528.4916507917889,-87.49,2
18:15,587225252.0,8801.805041058285,-10.92,2
18:16,266777719.0,-644.6035662197603,-61.12,2
18:19,971010829.0,-208.4187435557547,-31.64,9
18:19,122884111.0,-1225.42358307297,-57.69,5
18:21,491392945.0,3336.621500000005,-29.39,5
18:21,667367404.0,7546.081899611131,-210.0,2
18:21,838830098.0,-70.74500791221558,-36.89,5
18:23,516051449.0,1002.7805090142912,-97.3,2
18:26,287480331.0,11011.429695433964,-22.09,9
18:27,409971170.0,1614.3702725559665,-64.27,7
18:28,752362502.0,8142.9205535825695,-45.15,7
18:28,822718326.0,9268.504222410904,-27.69,5
18:29,266777719.0,-736.1035662197603,-91.5,2
18:30,435984758.0,4582.152509608384,-70.89,8
18:30,667367404.0,7522.5003020370195,-23.58,2
18:31,532478725.0,4336.885020905362,-39.21,5
18:37,461029994.0,5769.318375914818,-47.95,5
18:37,742223719.0,316.0946073048027,-75.93,5
18:37,815385232.0,8594.566437433044,-22.11,7
18:39,698076160.0,5217.470375000425,-61.96,5
18:41,518474507.0,12519.316953857273,-31.01,8
18:41,656812046.0,787.9491327469015,-23.99,7
18:41,130154096.0,1076.0792252012682,-1.99,7
18:43,433917275.0,7207.5981989023985,-17.19,9
18:43,822135975.0,11315.070167094806,-3.04,7
18:43,833899961.0,1666.7737728389911,-124.5,7
18:45,224112146.0,-136.05770000000115,-86.88,5
18:46,128033695.0,2700.300536708268,-2.38,8
18:51,656317661.0,-555.2257584585972,-141.53,5
18:52,198051483.0,-1626.5269104088568,-144.72,5
18:53,198946608.0,5194.399768130449,-45.74,5
18:58,851649498.0,8881.667273885225,-9.45,2
18:58,550644516.0,-259.2708500000013,-131.51,5
18:59,675231808.0,14079.301525245,-84.87,2
19:02,441274121.0,10900.057466286582,-99.97,5
19:04,651372390.0,-3247.2257499999987,-17.45,5
19:15,879091637.0,-1113.397476262023,-159.43,5
19:28,399144202.0,1879.989557901992,-23.97,9
19:28,461990622.0,8472.191309192105,-47.82,5
19:29,605116158.0,2269.7855,-15.69,5
19:29,618514666.0,17926.987871547208,-13.64,2
19:34,738958551.0,7638.348369572466,-5.35,7
19:37,128030172.0,-617.4960774498498,-130.19,5
19:41,467207141.0,1350.6251170482635,-125.55,5
19:41,730002588.0,11737.81369022184,-40.34,5
19:43,854513972.0,375.05724999999944,-69.51,5
19:45,815385232.0,8501.410437433044,-93.16,5
19:46,151968462.0,7301.865306125076,-4.77,7
19:52,653640811.0,14672.126106824777,-4.09,8
19:53,736340277.0,7432.811914845908,-26.7,5
19:54,570575024.0,-1112.6201000000003,-147.89,5
19:58,534325901.0,5728.159059526129,-10.95,9
19:59,380228542.0,-1013.8254581844344,-281.18,5
19:59,885259672.0,3374.933626136355,-12.82,5
20:01,859603181.0,3447.535099348747,-9.81,7
20:03,920031185.0,-421.9278705162921,-144.72,5
20:04,760753808.0,-869.7531000000004,-116.47,5
20:07,461990622.0,8467.804716877521,-4.39,7
20:09,290818242.0,6040.6019943665315,-38.21,5
20:09,992204045.0,10387.918994434238,-56.24,5
20:09,279149837.0,575.7650499999988,-123.02,5
20:10,504055745.0,-812.2653386582331,-103.62,5
20:14,305778936.0,10711.827009553308,-40.8,9
20:17,454129843.0,497.5616507917889,-30.93,9
20:18,113747882.0,10420.1907962458,-20.93,9
20:24,270374623.0,8583.375255375866,-1.64,7
20:29,518466565.0,-205.03120000000035,-45.87,5
20:30,198946608.0,5156.664960780315,-37.73,8
20:34,200080192.0,8314.363643948018,-49.07,5
20:36,282837512.0,11743.848071728293,-37.42,9
20:37,279149837.0,536.6150499999989,-39.15,9
20:43,987163717.0,5561.720320000006,-42.63,9
20:52,452974357.0,-2571.941449999996,-28.55,5
20:55,720221651.0,-2245.2088665984347,-54.1,5
20:57,587225252.0,8761.025041058285,-40.78,9
20:58,409370545.0,-281.60322445447986,-57.86,5
20:58,901432314.0,3449.940427183497,-33.01,5
01:35,779946617.0,14537.979910567625,-21.49,2
01:40,639549973.0,5946.655208802453,-36.69,9
01:42,370521542.0,22754.35513774404,-6.04,4
02:37,518474507.0,12478.686953857274,-40.63,9
02:43,873693307.0,7669.829095942383,-12.04,9
03:00,482513594.0,5312.134842174498,-55.81,8
03:18,532478725.0,4310.645020905362,-26.24,9
03:19,196289502.0,13313.385682489054,-13.5,9
03:22,656812046.0,751.5562552951494,-36.39,5
03:22,108931112.0,11917.589681396144,-37.28,9
03:28,832564361.0,13860.653334869934,-0.15,5
03:30,815385232.0,8499.673503284595,-1.74,5
03:30,930277104.0,9431.96026274144,-2.99,2
03:33,520447032.0,7880.229997126281,-20.2,8
03:34,873693307.0,7650.093737018766,-19.74,7
03:40,779236304.0,90.74759547953248,-29.88,9
03:40,940569402.0,5148.018773432394,-16.94,9
03:44,398429109.0,-445.25689999999906,-35.96,9
03:47,887853850.0,9396.333042835678,-25.59,9
03:49,532478725.0,4305.892542310985,-4.75,4
03:55,572384506.0,8709.724558716562,-38.14,9
03:56,766941757.0,7991.854866017739,-26.85,9
03:58,290818242.0,5975.618380425252,-64.98,2
03:58,679662108.0,13295.39085094915,-5.0,5
03:59,967989787.0,887.1133826407272,-23.19,9
04:02,994214354.0,8249.01401487538,-16.01,2
04:05,183888402.0,15547.499575902682,-44.14,9
04:06,471897866.0,7401.279215065695,-30.83,7
04:12,730002588.0,11736.10479570243,-1.71,2
04:19,824916823.0,7651.440662461839,-22.92,9
04:21,386729293.0,26495.529979670773,-6.19,7
04:21,256002321.0,6176.485412149012,-6.89,2
04:21,187541224.0,6070.6225592214405,-41.8,9
04:25,252760664.0,5452.008995096505,-51.82,5
04:29,213112754.0,6337.974374524264,-6.99,9
04:33,324224854.0,1089.280487573477,-20.07,5
04:37,199016328.0,4546.322167419515,-42.05,7
04:41,433917275.0,7190.718198902398,-16.88,9
04:41,951817450.0,8562.782556535847,-25.69,7
04:43,348325817.0,8007.536919532593,-32.97,9
04:45,706250160.0,9588.500018493116,-4.83,5
04:47,950234174.0,870.9566605906225,-16.33,2
04:48,496395938.0,11223.513627237784,-41.93,2
04:50,203466392.0,1524.4513508427888,-30.93,7
04:50,824916823.0,7570.718815297366,-80.72,5
04:51,282837512.0,11689.1763476143,-54.67,2
04:54,500043411.0,11872.704209703696,-7.87,2
04:55,166019891.0,6908.253413652447,-20.19,9
04:57,851649498.0,8831.224152887058,-50.44,8
04:59,395284483.0,1012.7540883964832,-84.26,8
05:01,549414742.0,6383.117266598126,-36.78,9
05:02,624500124.0,3088.6202874610212,-3.75,4
05:04,506618547.0,15782.427011781574,-10.22,7
05:05,749378808.0,4739.910349980243,-56.65,4
05:06,510101371.0,11412.035985378963,-16.69,7
05:08,245690309.0,7799.304797666081,-9.87,8
05:11,264550521.0,8311.302801719052,-75.22,7
05:12,383833857.0,20758.6816669394,-23.47,2
05:12,973086490.0,8925.580411398734,-11.24,9
05:13,613729471.0,6950.080517595851,-4.16,2
05:14,987656636.0,5508.299577812934,-8.23,2
05:17,823208989.0,415.06598598454104,-0.48,2
05:20,195895574.0,6200.484662321982,-45.58,8
05:21,370757362.0,870.3665898126758,-13.83,7
05:24,822135975.0,11288.01164915025,-27.06,2
05:28,494789005.0,2802.898099758021,-77.79,2
05:30,842682241.0,4555.553938698084,-11.63,5
05:32,709608057.0,2855.6813507999764,-35.7,9
05:33,901432314.0,3440.7917755694425,-9.15,5
05:34,433917275.0,7111.073667780232,-79.64,7
05:36,687135796.0,23276.672790503348,-3.09,8
05:37,305778936.0,10698.559334091193,-13.27,7
05:38,489964679.0,21055.65730431252,-30.79,9
05:41,541639148.0,3936.9689973096233,-1.68,7
05:41,518474507.0,12474.279187474278,-4.41,2
05:46,651756497.0,12568.08790011802,-25.02,4
05:48,450896297.0,11874.8741613154,-27.84,9
05:53,366550080.0,22634.912719787095,-12.64,4
05:53,675806859.0,5856.0121071237645,-49.21,7
05:54,383625050.0,5310.580931793257,-47.19,2
05:58,897714622.0,8208.814142243888,-66.77,5
06:00,441274121.0,10867.711424756651,-32.35,2
06:05,221868392.0,4657.681490060975,-34.69,9
06:18,704517789.0,15060.497730760766,-5.35,8
06:20,822250278.0,5959.559686330815,-11.8,8
06:21,547010927.0,21172.478674259914,-37.97,8
06:22,683319988.0,6553.279015850653,-24.88,9
06:22,229205098.0,6293.139377755822,-25.43,8
06:27,806358207.0,10414.2849443624,-36.36,2
06:28,887853850.0,9385.481995514174,-10.85,4
06:32,647472692.0,21527.152914666964,-23.21,7
06:33,940569402.0,5088.924616486906,-59.09,5
06:36,949032480.0,4227.291853178272,-36.63,4
06:39,678851253.0,2742.375131198102,-2.81,8
06:40,853907490.0,6693.429051329467,-15.9,9
06:41,490868147.0,-544.1582208786984,-27.93,9
06:41,905860285.0,14917.25713475675,-1.68,4
06:42,414805878.0,12768.179763059232,-39.69,9
06:43,216285378.0,20727.69938463492,-32.53,9
06:44,522188082.0,6602.567369608694,-77.89,8
06:47,310620484.0,386.1827243920821,-16.21,7
06:48,454356905.0,2137.32328697967,-33.74,9
06:48,718058208.0,-116.20468295467757,-35.21,7
06:49,116598243.0,1673.7554185630222,-37.3,5
06:50,858989281.0,23316.377798828136,-18.19,9
06:50,534204159.0,4954.948592427417,-11.03,7
06:51,802697323.0,18564.7275978255,-35.98,9
06:53,668329719.0,7074.422907269705,-40.69,5
06:56,985188462.0,342.0062487112247,-35.94,9
06:56,769311479.0,5873.487394124549,-21.44,5
07:01,310375875.0,3198.511892793048,-35.65,7
07:02,287480331.0,10967.363088520517,-44.07,4
07:03,450896297.0,11871.984945608812,-2.89,2
07:03,558119802.0,28278.857378535205,-37.59,7
07:04,151968462.0,7249.630278659693,-52.24,2
07:05,187111705.0,5564.844691491639,-39.84,2
07:07,809499628.0,14381.253274127765,-10.99,7
07:09,417850087.0,14980.262942470636,-34.18,8
07:12,912705941.0,16278.267850641729,-37.17,7
07:12,169006407.0,10412.628312501907,-9.82,2
07:16,647936800.0,1211.2852005081158,-41.51,4
07:19,108563213.0,20469.283424196354,-12.25,7
07:20,633345190.0,6603.37939830845,-35.69,9
07:21,873701090.0,322.6178095806276,-6.73,2
07:24,785749304.0,7242.825527359678,-67.34,7
07:25,461029994.0,5764.946420336354,-4.37,8
07:29,166019891.0,6901.43499518993,-6.82,7
07:33,865748375.0,4752.342829318778,-18.75,2
07:38,221868392.0,4636.282291182449,-21.4,2
07:39,604288474.0,2712.269479306584,-44.26,5
07:42,657139925.0,11661.843200913072,-13.24,9
07:45,609939116.0,5692.324372618915,-3.96,2
07:48,143003091.0,19378.80325664359,-73.25,7
07:49,270374623.0,8559.725332936527,-23.65,2
08:03,776431321.0,2758.3690015162983,-15.04,2
08:12,395284483.0,1007.0540883964832,-5.7,9
08:14,473820682.0,10264.896742787882,-1.55,7
08:15,280200287.0,-463.300453386949,-5.35,9
08:17,408057540.0,7261.914106328467,-7.15,9
08:18,297823329.0,366.9736999999992,-6.2,9
08:19,399538448.0,6855.018712652366,-5.65,9
08:20,461990622.0,8467.102313002166,-0.7,2
08:23,933491926.0,2409.236300000001,-30.77,5
08:24,494404688.0,-2418.900765336208,-25.24,5
08:25,690958123.0,17232.668827720212,-78.27,5
08:30,874506295.0,-1661.721756245572,-20.23,5
08:31,851649498.0,8734.176152887057,-97.05,5
08:35,340680761.0,-2770.1255999999985,-56.32,5
08:35,131388684.0,19010.77643929826,-38.05,5
08:37,189335192.0,-1055.2937017578602,-113.04,5
08:37,623156843.0,4594.64672722525,-1.84,2
08:38,719586818.0,16641.6675716465,-9.93,2
08:39,417850087.0,14939.186942470636,-41.08,5
08:41,285115279.0,-2849.1566107892877,-99.07,5
08:41,635679314.0,-2677.99582911952,-27.95,5
08:43,358836279.0,151.62244280758603,-46.04,5
08:43,719742742.0,-1651.6125077779634,-58.77,5
08:44,920830317.0,-274.19362936251844,-126.4,5
08:44,331450202.0,5994.833563696252,-48.22,5
08:53,975200042.0,-2841.887699999998,-45.43,5
08:56,554792076.0,24110.6115097702,-2.66,2
08:59,429235692.0,-1695.632,-294.46,5
08:59,248625662.0,-1896.5769157151472,-93.04,5
09:02,979892433.0,-1640.587300000001,-82.43,5
09:03,237684254.0,5131.6039998924925,-23.49,7
09:03,540159353.0,9616.442211049103,-5.5,9
09:05,613729471.0,6942.980517595851,-7.1,9
09:05,683078800.0,1327.2734472194538,-6.3,9
09:06,853907490.0,6690.38884955513,-3.04,7
09:06,973086490.0,8918.176974271524,-7.4,7
09:07,176922958.0,-177.05045280235055,-27.26,5
09:07,169006407.0,10407.528312501909,-5.1,9
09:08,506618547.0,15776.727011781571,-5.7,9
09:08,314980178.0,2184.6238500000045,-88.79,5
09:09,993039226.0,-3904.2469999999953,-48.04,5
09:09,849096144.0,1575.215858910517,-94.86,5
09:11,570410059.0,698.4366467763098,-170.73,5
09:12,550169791.0,18248.17341592071,-24.7,7
09:13,690958123.0,17225.168827720212,-7.5,9
09:14,851649498.0,8728.476152887057,-5.7,9
09:16,627917561.0,2803.4000500000034,-5.05,9
09:17,618138606.0,881.1798621516973,-5.9,9
09:17,414454079.0,432.97685000000183,-6.09,4
09:18,108931112.0,11780.772581396144,-136.82,4
09:18,967989787.0,836.4958826407272,-50.62,2
09:18,586315521.0,10573.32775937102,-5.0,9
09:19,700138124.0,4453.963300000002,-30.2,5
09:20,299871610.0,582.4031530587667,-74.99,2
09:20,933491926.0,2359.236300000001,-50.0,2
09:22,117273481.0,7471.957613964115,-6.5,9
09:23,781554833.0,2179.5899292775107,-116.25,5
09:24,687135796.0,23248.73279050335,-27.94,4
09:28,909676212.0,866.2051697400842,-19.97,1
09:29,596171893.0,-486.798255174489,-10.98,7
09:31,215404070.0,159.3195891798497,-68.99,2
09:32,856957948.0,8246.243393335359,-37.38,5
09:33,170637730.0,2267.965884520457,-92.36,5
09:34,117308635.0,1008.0000945704884,-49.96,5
09:35,792845450.0,670.9091500000009,-1.5,4
09:35,480557476.0,9832.144280833323,-64.25,2
09:36,348525881.0,-130.10837540506367,-18.97,7
09:36,494789005.0,2775.192099758021,-27.71,5
09:37,578131296.0,761.9267694440439,-11.98,4
09:42,254853117.0,2348.067226756399,-347.15,5
09:43,854895960.0,2172.604609512741,-166.98,2
09:46,163470640.0,514.2771999999999,-81.98,2
09:46,987656636.0,5488.189577812935,-20.11,2
09:47,322221939.0,2874.907629367862,-4.21,2
09:48,767447966.0,3720.77662551211,-55.84,5
09:48,162162212.0,-442.1964566726912,-35.98,2
09:49,967989787.0,826.5058826407272,-9.99,2
09:51,547010927.0,20960.378674259915,-212.1,2
09:52,711045550.0,120.981350000003,-98.43,5
09:59,967989787.0,731.5258826407272,-94.98,2
10:00,254853117.0,2313.037226756399,-35.03,2
10:01,578131296.0,674.9467694440439,-86.98,2
10:06,913127700.0,286.3914380111165,-157.72,5
10:12,967989787.0,623.5333826407273,-107.99,2
10:20,547010927.0,20765.078674259916,-195.3,2
10:22,137822385.0,3007.7777171514745,-5.3,9
10:24,462962606.0,89.9065499999989,-10.98,1
10:26,165045150.0,-429.3239385971443,-137.25,2
10:28,421881811.0,4077.997925411216,-29.17,4
10:30,308505160.0,11654.925318047974,-67.64,5
10:32,987229118.0,3619.6783700417263,-76.57,5
10:35,547010927.0,20730.078674259916,-35.0,2
10:36,475277431.0,-306.32686305638043,-263.9,2
10:40,967989787.0,564.3133826407272,-59.22,2
10:50,547010927.0,20681.078674259916,-49.0,2
10:56,165045150.0,-541.4489385971443,-112.12,2
11:02,699139822.0,2058.173747675063,-35.64,2
11:03,117308635.0,1003.4874750229084,-4.51,2
11:10,475277431.0,-459.6268630563805,-153.3,2
11:12,298007503.0,298.3001036256335,-85.24,2
11:14,967989787.0,490.0708826407272,-74.24,2
11:17,903953091.0,2359.4067623694673,-49.99,4
11:18,364357875.0,5732.255731837835,-30.26,2
11:19,547010927.0,20473.17867425991,-207.9,2
11:25,165045150.0,-707.9489385971443,-166.5,2
11:29,407574996.0,2786.78917988436,-35.79,8
11:38,547010927.0,20333.878674259915,-139.3,2
11:39,967989787.0,431.2108826407272,-58.86,2
11:56,967989787.0,365.22588264072726,-65.98,2
11:57,475277431.0,-719.4598630563805,-259.83,5
12:02,547010927.0,20202.278674259916,-131.6,2
12:06,578131296.0,562.9467694440439,-112.0,7
12:07,237684254.0,5105.423999892492,-26.18,9
12:12,370521542.0,22683.86513774404,-70.49,2
12:15,809499628.0,14358.763274127765,-22.49,9
12:18,639549973.0,5944.681776621,-1.97,5
12:20,165045150.0,-804.6989385971443,-96.75,2
12:21,578131296.0,416.44676944404387,-146.5,4
12:23,967989787.0,301.85838264072726,-63.37,2
12:23,547010927.0,20146.278674259916,-56.0,2
12:24,145387690.0,4792.600396863947,-13.93,7
12:28,264550521.0,8295.262801719051,-16.04,7
12:33,782013626.0,-33.25580068837228,-30.68,9
12:34,215426302.0,-297.02759597430827,-35.41,5
12:43,998405607.0,-918.213999999998,-31.39,5
12:43,967989787.0,274.11588264072725,-27.74,2
12:45,547010927.0,20020.278674259916,-126.0,2
12:47,706301742.0,-2679.428149999999,-41.59,5
12:47,519644021.0,1977.1711559986657,-39.55,7
12:51,165045150.0,-909.3239385971444,-104.62,2
12:55,967989787.0,172.49838264072724,-101.62,2
12:56,916225911.0,-2097.664250000001,-14.84,5
12:58,766941757.0,7990.01791528662,-1.84,2
13:00,518746136.0,-1226.6022282369163,-43.4,5
13:04,687135796.0,23232.762790503348,-15.97,9
13:07,688712152.0,5827.5215825918185,-7.6,9
13:07,480557476.0,9825.994280833324,-6.15,9
13:12,821971408.0,1793.333721374878,-30.49,5
13:13,849096144.0,1569.515858910517,-5.7,9
13:15,421881811.0,4041.916930627331,-36.08,7
13:16,119943495.0,-1498.770862112858,-118.62,5
13:17,726913482.0,-1037.013948526476,-45.05,5
13:17,296770890.0,1619.582010379083,-130.51,5
13:18,277562576.0,339.0137507952724,-5.4,9
13:21,165045150.0,-1070.1989385971442,-160.88,2
13:21,187111705.0,5558.344691491639,-6.5,9
13:32,165045150.0,-1184.1989385971442,-114.0,2
13:49,673025413.0,2149.6575573766995,-67.98,5
13:54,346874167.0,10.078249999999173,-89.48,5
13:55,165045150.0,-1324.4489385971442,-140.25,2
14:29,578131296.0,257.44676944404387,-159.0,7
14:29,919185264.0,3697.552722887972,-4.18,4
14:52,547010927.0,19933.478674259917,-86.8,2
14:57,578131296.0,152.94676944404387,-104.5,4
15:11,547010927.0,19846.67867425992,-86.8,2
15:23,720742759.0,566.6498308830078,-5.99,1
15:26,578131296.0,45.946769444043866,-107.0,4
15:36,547010927.0,19668.17867425992,-178.5,2
15:37,321372947.0,-505.41105078909936,-45.71,5
15:37,298007503.0,231.32010362563344,-66.98,2
15:46,165045150.0,-1486.8239385971442,-162.38,2
15:49,578131296.0,-93.55323055595612,-139.5,4
16:03,678330503.0,1459.15689751324,-37.36,5
16:04,541639148.0,3814.5809973096234,-122.39,5
16:08,492058070.0,635.435968740471,-56.92,1
16:11,165045150.0,-1609.0739385971442,-122.25,2
16:20,956717493.0,451.8425776068375,-35.0,2
16:24,817294757.0,-2668.0283000000004,-17.32,5
16:26,135937041.0,-228.6016982684117,-55.82,5
16:26,345582855.0,-775.3055471794507,-8.37,5
16:28,899742927.0,11928.748495915634,-34.83,8
16:35,868033067.0,-2101.468286451083,-51.42,5
16:37,280268430.0,4492.799732378334,-16.98,4
16:38,413557825.0,549.6762999999996,-10.98,1
16:41,165045150.0,-1649.9489385971442,-40.88,2
16:42,885259672.0,3307.826586136355,-67.11,4
16:42,280200287.0,-529.290453386949,-65.99,2
16:45,583579399.0,453.9022999999991,-25.96,1
16:46,261894284.0,-2650.2762999999977,-49.47,5
16:56,641764023.0,-1368.0288037720045,-47.5,5
16:58,601627384.0,3909.462785847057,-25.46,7
17:01,310375875.0,3107.511892793048,-91.0,2
17:03,494977194.0,1523.0525205975769,-70.1,5
17:04,547010927.0,19514.17867425992,-154.0,2
17:06,705848712.0,22769.63177188876,-11.0,9
17:08,129018172.0,7905.717887752608,-11.98,1
17:08,241459011.0,577.2613132723473,-64.58,5
17:13,198630866.0,-408.6131735612685,-79.96,5
17:14,886921642.0,2957.5259281359768,-34.13,5
17:14,482513594.0,5297.684842174498,-14.45,9
17:15,788740658.0,2682.8414029896217,-9.99,7
17:15,510101371.0,11399.345985378965,-12.69,4
17:15,836110591.0,5887.222006671735,-34.15,9
17:16,183186021.0,-1272.950049999999,-30.8,5
17:18,420109571.0,297.1064189636076,-5.99,4
17:19,128033695.0,2684.1505367082677,-16.15,4
17:20,235881534.0,11090.728237169946,-46.47,7
17:21,851181128.0,3638.540429064725,-51.89,8
17:22,165045150.0,-1715.1989385971442,-65.25,2
17:24,310375875.0,2877.911892793048,-229.6,2
17:24,383625050.0,5233.9309317932575,-76.65,2
17:24,683078800.0,1309.3034472194538,-17.97,7
17:24,886921642.0,2938.272476773328,-19.25,7
17:25,613729471.0,6899.700517595851,-43.28,6
17:25,547010927.0,19381.87867425992,-132.3,2
17:28,795847804.0,19870.814086257556,-3.66,2
17:29,741269136.0,846.9984500000004,-41.95,7
17:30,987163717.0,5502.570320000006,-59.15,2
17:31,984783496.0,12467.549092217308,-2.09,4
17:34,624563756.0,-677.1411712164436,-34.31,5
17:34,399144202.0,1834.318798266628,-45.67,2
17:34,213112754.0,6326.965683530489,-11.01,8
17:35,516051449.0,994.1181249763904,-8.66,2
17:36,802697323.0,18531.3575978255,-33.37,7
17:37,108481285.0,7580.152261726881,-16.09,8
17:37,383625050.0,5226.817481793258,-7.11,4
17:37,308068836.0,517.9395225681922,-34.02,2
17:40,511179916.0,6983.071636362662,-76.93,2
17:41,984783496.0,12458.149092217309,-9.4,9
17:44,229205098.0,6270.699377755823,-22.44,2
17:47,192202372.0,-118.52098096092628,-19.99,4
17:47,709608057.0,2747.1813507999764,-108.5,2
17:50,165045150.0,-1822.448938597144,-107.25,2
17:53,180616589.0,269.769648033954,-17.21,5
17:53,435984758.0,4572.142509608384,-10.01,2
17:54,547010927.0,19319.57867425992,-62.3,2
17:55,237493332.0,12130.786765885943,-46.05,5
17:56,124102251.0,3356.465540001851,-5.6,5
17:57,117308635.0,978.3874750229083,-25.1,2
17:58,730002588.0,11713.984795702429,-22.12,7
17:59,255814263.0,3479.7842967005445,-50.94,1
18:00,836110591.0,5729.772006671735,-157.45,2
18:00,951817450.0,8507.802556535848,-54.98,7
18:05,667367404.0,7505.658849809398,-16.84,4
18:07,308068836.0,407.60552256819216,-110.33,5
18:13,510101371.0,11359.605985378965,-39.74,9
18:18,975345315.0,30425.310799999963,-150.5,2
18:20,993663752.0,24.357042410396566,-27.24,9
18:22,435984758.0,4565.128509608384,-7.01,7
18:22,709608057.0,2492.381350799976,-254.8,2
18:24,388862238.0,645.1858272385228,-112.26,5
18:24,270374623.0,8537.485332936527,-22.24,7
18:24,556992209.0,9746.190675924425,-15.01,7
18:25,851181128.0,3616.2004290647246,-22.34,9
18:25,256002321.0,6151.845412149011,-24.64,9
18:27,984783496.0,12433.937560475282,-24.21,7
18:29,698955014.0,834.8406549409121,-12.98,7
18:29,639420537.0,-1664.64645,-45.41,5
18:30,195895574.0,6182.6346623219815,-17.85,5
18:34,655450953.0,-2556.72987845553,-16.91,5
18:38,605116158.0,2213.7127,-56.07,5
18:38,951817450.0,8484.030556535847,-23.77,5
18:41,647472692.0,21496.01227466696,-31.14,7
18:41,433917275.0,7090.513667780232,-20.56,7
18:43,200080192.0,8289.923366130919,-24.44,7
18:45,834581602.0,170.8658999999994,-55.97,7
18:46,858989281.0,23316.20981637659,-0.17,2
18:49,690958123.0,17219.158827720214,-6.01,7
18:49,450896297.0,11856.470625608812,-15.51,7
18:51,147341222.0,-1583.9019753207956,-79.56,5
18:51,551755686.0,6784.996585195961,-9.98,7
18:53,534097839.0,-4173.901049999999,-26.31,5
18:54,419550103.0,16432.732861454802,-22.67,7
18:56,441274121.0,10847.711424756651,-20.0,9
18:58,901432314.0,3426.6132155694427,-14.18,7
18:59,195895574.0,6159.734662321982,-22.9,9
18:59,673818591.0,962.1067753758412,-26.98,9
19:03,129018172.0,7765.605887752608,-140.11,5
19:03,540159353.0,9588.932211049105,-27.51,5
19:05,690958123.0,17186.614860035374,-32.54,7
19:06,331450202.0,5990.132438882322,-4.7,8
19:10,373875019.0,13798.665333159595,-14.69,7
19:13,949032480.0,4204.801853178272,-22.49,9
19:14,494156462.0,38.216613518239626,-35.22,9
19:15,158766229.0,-802.4371358934699,-14.5,5
19:21,878989510.0,4554.991886141791,-70.5,5
19:22,625658193.0,-1597.1400802437831,-165.46,5
19:22,496674181.0,-625.6025223307225,-51.45,5
19:27,553734946.0,299.62869999999896,-57.02,5
19:28,874431242.0,7333.383052850367,-2.93,5
19:28,836110591.0,5729.728656012286,-0.04,2
19:29,519935524.0,-216.75231026248105,-35.6,5
19:31,633345190.0,6597.216625017934,-6.16,2
19:32,654329190.0,-134.00944905148066,-18.95,5
19:34,146909202.0,3903.877414086925,-28.26,4
19:38,511179916.0,6899.722636362661,-83.35,5
19:48,423208402.0,1827.7659500000025,-60.01,5
19:49,859603181.0,3447.1452307351424,-0.39,8
19:53,285873880.0,9855.418212646462,-16.66,5
20:10,587225252.0,8755.793244129676,-5.23,7
20:10,771125520.0,218.56304999999944,-81.87,5
20:17,758160963.0,7084.669017756401,-12.7,7
20:20,237493332.0,12110.782841913651,-20.0,5
20:21,655730067.0,34.78469999999959,-83.31,5
20:25,954263768.0,-388.5820000000002,-36.96,5
20:26,738958551.0,7627.373161905141,-10.98,2
20:28,986267641.0,5321.600192813583,-57.29,5
20:30,670102069.0,3100.4332353674595,-34.41,2
20:31,719586818.0,16524.3405716465,-117.33,5
20:32,350921975.0,-739.8370289261258,-105.46,5
20:39,120634201.0,4493.9775000000045,-21.45,9
20:39,196289502.0,13266.651543916343,-46.73,2
20:58,151916463.0,187.61655559916872,-63.92,5
21:17,145387690.0,4766.220396863947,-26.38,9
21:26,143003091.0,19347.51325664359,-31.29,9
21:29,549414742.0,6342.613210150887,-40.5,2
00:42,370521542.0,22674.15681164079,-9.71,2
01:49,679662108.0,13286.08022260786,-9.31,2
01:54,823208989.0,362.37273281772013,-52.69,2
01:59,699139822.0,2053.014195223589,-5.16,2
02:17,687135796.0,23196.21233513955,-36.55,5
02:28,858989281.0,23305.00981637659,-11.2,9
02:40,541639148.0,3786.867183637875,-27.71,5
02:49,950234174.0,847.2454979971004,-23.71,2
02:55,256002321.0,6133.445412149012,-18.4,9
02:58,213112754.0,6318.597446700026,-8.37,2
02:59,779946617.0,14516.699303239691,-21.28,2
03:00,874431242.0,7309.66385501731,-23.72,7
03:02,108563213.0,20439.258129104095,-30.03,2
03:09,802697323.0,18492.9275978255,-38.43,9
03:11,151968462.0,7219.745223627132,-29.89,5
03:24,809499628.0,14334.573274127762,-24.19,9
03:25,366550080.0,22627.35086942922,-7.56,2
03:27,145387690.0,4733.830396863947,-32.39,9
03:27,349614277.0,350.85719999999947,-42.6,9
03:33,187541224.0,6029.44255922144,-41.18,9
03:34,216285378.0,20697.62938463492,-30.07,9
03:35,559995067.0,3614.083765071058,-25.19,9
03:37,985188462.0,292.2162487112247,-49.79,9
03:38,169689461.0,711.1360999999991,-35.88,9
03:39,779236304.0,65.90759547953249,-24.84,9
03:40,802697323.0,18458.640065482305,-34.29,2
03:49,668329719.0,7054.81095123241,-19.61,2
03:58,145387690.0,4715.349409998848,-18.48,8
03:58,598793068.0,145.96034999999836,-33.1,9
03:59,324224854.0,1083.552128831578,-5.73,4
04:00,550169791.0,18204.60983197527,-43.56,5
04:00,766941757.0,7966.55791528662,-23.46,9
04:01,809499628.0,14259.851054005112,-74.72,2
04:02,858989281.0,23267.343882912,-37.67,2
04:03,857754342.0,1855.809021891671,-8.71,8
04:04,624500124.0,3072.5378280174664,-16.08,4
04:06,633345190.0,6564.836625017934,-32.38,9
04:07,108481285.0,7576.836048480429,-3.32,2
04:10,912705941.0,16235.450906416609,-42.82,2
04:10,853907490.0,6670.71662394024,-19.67,7
04:11,581655972.0,37611.72453380961,-36.59,7
04:18,383625050.0,5165.675600732985,-61.14,7
04:19,749378808.0,4706.730349980243,-33.18,9
04:19,683319988.0,6523.839015850654,-29.44,9
04:20,925037906.0,1207.7748000000015,-25.2,9
04:21,785749304.0,7227.043317221451,-15.78,7
04:21,842682241.0,4492.3767660474105,-63.18,5
04:21,245690309.0,7792.734329310445,-6.57,8
04:22,489964679.0,21016.97730431252,-38.68,9
04:30,383833857.0,20746.6816669394,-12.0,9
04:32,237493332.0,12091.381388011176,-19.4,5
04:33,308505160.0,11610.562768395548,-44.36,7
04:36,259015404.0,3060.8427908402477,-33.49,9
04:43,949032480.0,4153.5122982229705,-51.29,7
04:44,859603181.0,3431.182078062631,-15.96,2
04:46,930277104.0,9406.591254871768,-25.37,5
04:46,113747882.0,10384.146688558536,-36.04,7
04:50,749378808.0,4702.378525199104,-4.35,7
04:51,795847804.0,19865.67883078172,-5.14,7
04:51,450896297.0,11831.380625608812,-25.09,9
04:56,482513594.0,5292.152705162571,-5.53,8
04:57,586315521.0,10531.382227128335,-41.95,2
04:57,282837512.0,11677.972700711378,-11.2,7
04:58,496395938.0,11212.71343603844,-10.8,8
04:59,195895574.0,6132.53619856374,-27.2,2
05:01,832564361.0,13816.470945111849,-44.18,2
05:02,836110591.0,5697.3886560122855,-32.34,9
05:03,670102069.0,3073.1932353674597,-27.24,9
05:03,237684254.0,5072.901711142822,-32.52,2
05:05,626989363.0,199.3168633173756,-24.18,9
05:06,769311479.0,5830.663455786443,-42.82,2
05:12,256002321.0,6132.063822009661,-1.38,4
05:15,285220959.0,10153.540432422522,-2.31,5
05:15,613729471.0,6895.478436183384,-4.22,5
05:15,559995067.0,3610.137096463157,-3.95,4
05:16,992204045.0,10316.23406742526,-71.68,8
05:17,719586818.0,16500.507457821444,-23.83,2
05:19,679911053.0,1720.1379950335656,-19.44,7
05:24,506618547.0,15770.744546116435,-5.98,7
05:24,407574996.0,2760.698660486348,-26.09,8
05:28,905860285.0,14897.929128854692,-19.33,5
05:28,471897866.0,7389.478168717326,-11.8,7
05:30,441274121.0,10841.721424756654,-5.99,9
05:33,518474507.0,12441.13918747428,-33.14,9
05:37,667367404.0,7489.119106948977,-16.54,2
05:37,709608057.0,2456.1413507999764,-36.24,9
05:38,169006407.0,10378.949040011265,-28.58,7
05:41,305778936.0,10696.554843695723,-2.0,7
05:45,146686559.0,-615.5226111734777,-16.95,9
05:45,128033695.0,1277.632757208152,-6.52,2
05:55,678851253.0,2724.4126783107395,-17.96,2
05:55,124102251.0,3343.887381453728,-12.58,2
05:56,647472692.0,21493.581245551515,-2.43,7
06:03,473820682.0,10235.481763730348,-29.41,7
06:05,609939116.0,5662.5540406084465,-29.77,7
06:07,383833857.0,20745.546746646687,-1.13,7
06:09,601627384.0,3865.0327858470578,-44.43,9
06:10,887853850.0,9383.354267122064,-2.13,7
06:11,441274121.0,10830.895358221676,-10.83,2
06:15,408057540.0,7251.263706908458,-10.65,7
06:16,656812046.0,740.465877523633,-11.09,7
06:19,704517789.0,15044.09458463057,-16.4,7
06:20,187111705.0,5543.325059293028,-15.02,5
06:20,670102069.0,3038.6000642350764,-34.59,2
06:21,417850087.0,14903.858850206443,-35.33,2
06:24,994214354.0,8211.11401487538,-37.9,9
06:27,287480331.0,10965.41085612788,-1.95,7
06:32,489964679.0,21010.859839071432,-6.12,5
06:36,738958551.0,7619.150765262671,-8.22,2
06:42,399144202.0,1807.738798266628,-26.58,9
06:43,532478725.0,4276.312542310985,-29.58,9
06:43,116598243.0,1666.7689371383535,-6.99,7
06:44,587225252.0,8716.363244129676,-39.43,9
06:45,815385232.0,8487.501131892117,-12.17,8
06:50,558119802.0,28247.157378535205,-31.7,9
06:52,392270893.0,10796.43893667416,-0.79,8
06:52,331450202.0,5945.836243187496,-44.3,7
06:53,887156614.0,-1092.1051710407737,-43.09,9
06:59,873693307.0,7648.899365680943,-1.19,8
07:00,549414742.0,6320.873210150888,-21.74,9
07:00,522188082.0,6588.3931200592,-14.17,2
07:00,973086490.0,8902.876974271525,-15.3,9
07:00,639409800.0,30332.082595206884,-52.11,2
07:04,146909202.0,3894.326407765081,-9.55,7
07:09,987656636.0,5474.3167727309265,-13.87,2
07:14,776431321.0,2749.4081107300244,-8.96,5
07:15,587225252.0,8714.85758344597,-1.51,2
07:18,414805878.0,12731.679763059232,-36.5,9
07:20,264550521.0,8225.632601262203,-69.63,2
07:20,198946608.0,5154.309276795803,-2.36,2
07:28,179173981.0,5782.938816454439,-29.26,5
07:33,290818242.0,5929.860761882383,-45.76,2
07:35,322221939.0,2848.147505143366,-26.76,5
07:47,170637730.0,2256.9767315040967,-10.99,5
07:48,532478725.0,4217.896265601884,-58.42,2
07:49,873701090.0,305.8180267437167,-16.8,7
07:51,534325901.0,5687.355916477477,-40.8,7
07:53,752362502.0,8140.029307932669,-2.89,4
07:56,822250278.0,5958.4569278956,-1.1,2
07:56,235881534.0,11018.484505964036,-72.24,7
07:57,758160963.0,7081.786314944662,-2.88,8
07:57,651756497.0,10265.394992614263,-2.69,2
08:10,885259672.0,3302.426586136355,-5.4,9
08:12,657139925.0,11646.262675247115,-15.58,2
08:15,467207141.0,1345.1251170482635,-5.5,9
08:16,554792076.0,24081.813509770203,-28.8,5
08:20,137913631.0,520.0614499999995,-43.89,5
08:21,762700245.0,2340.2797000000023,-5.1,9
08:22,183888402.0,15512.499575902682,-35.0,9
08:22,395284483.0,1001.5540883964832,-5.5,9
08:22,270374623.0,8493.031799712558,-44.45,2
08:23,527842638.0,701.7419426329836,-5.95,9
08:24,948558249.0,8281.369015959808,-5.0,9
08:26,675806859.0,5803.764107123765,-52.25,5
08:27,675806859.0,5801.436542931904,-2.33,7
08:27,146909202.0,3888.1264077650817,-6.2,9
08:28,730002588.0,11701.943088857048,-12.04,2
08:28,175452235.0,-861.2257499999997,-79.55,5
08:29,596463612.0,-1161.8601047251395,-21.88,5
08:32,315546581.0,23917.039067215475,-73.0,5
08:33,454129843.0,492.0616507917889,-5.5,9
08:33,315546581.0,23891.03021449046,-26.01,2
08:34,480557476.0,9801.595373490589,-24.4,5
08:35,534204159.0,4951.261349597032,-3.69,7
08:35,662610817.0,-1306.814981324928,-127.96,5
08:38,799286313.0,-1412.9283128758614,-122.99,5
08:40,857997794.0,267.86066515088726,-27.47,5
08:43,131388684.0,18984.20443929826,-26.57,5
08:43,766941757.0,7902.682455509925,-63.88,7
08:44,143003091.0,19336.355960294353,-11.16,8
08:50,933745726.0,300.98855642932335,-75.08,5
08:55,706250160.0,9586.525830939689,-1.97,5
08:56,518474507.0,12409.147200648276,-31.99,7
08:58,660789920.0,-2337.3308473823727,-60.19,5
08:59,506618547.0,15765.694546116436,-5.05,9
09:00,909669130.0,-262.12711526323335,-51.49,5
09:02,683078800.0,1303.703447219454,-5.6,9
09:03,290818242.0,5922.760761882382,-7.1,9
09:03,999752672.0,331.8015435333344,-5.5,9
09:04,169006407.0,10373.699040011265,-5.25,9
09:04,613729471.0,6889.828436183384,-5.65,9
09:04,540159353.0,9583.582211049104,-5.35,9
09:05,722971557.0,-543.3922791569244,-70.69,5
09:06,690958123.0,17180.114860035374,-6.5,9
09:06,895331556.0,-902.2889000000008,-15.67,5
09:08,851649498.0,8721.326152887057,-7.15,9
09:11,214339619.0,-133.0466491316436,-40.54,5
09:16,117273481.0,7465.957613964115,-6.0,9
09:16,441274121.0,10825.495358221677,-5.4,9
09:17,534583529.0,457.4473880547654,-158.11,5
09:17,779376323.0,2686.4332158201264,-38.5,4
09:17,604288474.0,2674.497479306584,-37.77,5
09:17,558875206.0,1926.6414500000003,-6.1,9
09:17,298007503.0,226.26010362563343,-5.06,7
09:18,683319988.0,6516.689015850654,-7.15,9
09:18,259015404.0,3022.302790840248,-38.54,7
09:19,124102251.0,3273.579381453728,-70.31,5
09:25,225210798.0,312.13177375920884,-44.97,4
09:26,973086490.0,8874.037318891673,-28.84,8
09:27,414454079.0,424.8768500000018,-8.1,4
09:27,667367404.0,7483.769106948976,-5.35,9
09:29,215311171.0,5428.084929771856,-66.99,2
09:30,310620484.0,310.6727243920821,-75.51,2
09:31,776431321.0,2711.4581107300246,-37.95,1
09:31,659008214.0,-3090.255102290424,-38.04,5
09:35,519644021.0,1951.974235640031,-25.2,7
09:38,722358036.0,976.1390906270826,-40.98,2
09:39,127809299.0,1863.0111428980365,-99.99,2
09:43,821971408.0,1780.353721374878,-12.98,7
09:44,355733816.0,3962.9674640544617,-36.95,7
09:46,973086490.0,8823.297318891673,-50.74,2
09:46,644751433.0,-1420.973758465538,-76.73,5
09:48,703537476.0,1012.1852499999992,-13.0,2
09:51,769319491.0,1609.1169999999995,-69.99,2
10:04,812692024.0,3954.20693134288,-13.98,4
10:05,764450279.0,18899.431841391244,-136.49,2
10:08,127809299.0,1710.0211428980365,-152.99,2
10:10,282837512.0,11671.472700711378,-6.5,9
10:13,299871610.0,505.91815305876673,-76.48,2
10:14,339791565.0,-3291.393699999998,-26.85,5
10:15,127809299.0,1654.0411428980365,-55.98,2
10:16,310620484.0,303.7362300441003,-6.94,7
10:22,722358036.0,953.1690906270826,-22.97,1
10:25,585133606.0,3925.048744043089,-34.95,1
10:26,519644021.0,1876.8362356400312,-75.14,5
10:29,764450279.0,18675.445841391243,-223.99,2
10:31,743630833.0,209.5979132847012,-12.98,4
10:31,812692024.0,3909.21693134288,-44.99,2
10:33,299871610.0,481.9256530587667,-23.99,2
10:35,655368335.0,4574.274489920139,-37.04,2
10:38,298000165.0,22264.843780405856,-18.05,2
10:41,403383649.0,1084.3656702776327,-21.98,1
10:41,299871610.0,411.4256530587667,-70.5,2
10:48,588565416.0,6150.323782068405,-237.3,2
11:04,764450279.0,18569.47584139124,-105.97,2
11:08,503575533.0,6067.355100000015,-132.11,2
11:08,639549973.0,5847.401776621,-97.28,2
11:11,299871610.0,313.9481530587667,-97.48,2
11:11,454356905.0,2114.576304724925,-22.75,7
11:16,441142605.0,2298.842250000004,-9.0,4
11:25,588565416.0,6028.523782068405,-121.8,2
11:30,764450279.0,18365.817841391243,-203.66,2
11:30,903663593.0,168.0567126197981,-21.97,7
11:32,769319491.0,1582.1469999999997,-26.97,1
11:38,299871610.0,282.4556530587667,-31.49,2
11:38,792845450.0,640.9191500000009,-29.99,4
11:43,355940285.0,2017.9729781896835,-158.0,2
11:46,503575533.0,6023.315100000015,-44.04,2
11:54,678851253.0,2604.0726783107393,-120.34,6
11:58,299871610.0,170.3381530587667,-112.12,2
11:58,355940285.0,1839.9729781896835,-178.0,2
12:00,639549973.0,5814.331776621,-33.07,4
12:00,688712152.0,5604.921582591818,-222.6,2
12:01,183888402.0,15476.279575902685,-36.22,2
12:05,941285623.0,-496.15360093322965,-33.79,9
12:09,769319491.0,1550.1569999999997,-31.99,2
12:12,299871610.0,82.9631530587667,-87.38,2
12:14,970298834.0,2473.6829691825274,-162.39,2
12:15,480557476.0,9754.709373490588,-46.89,2
12:17,703537476.0,958.1452499999992,-54.04,2
12:20,769319491.0,1520.1669999999997,-29.99,2
12:23,304455868.0,1357.94715971583,-41.07,2
12:24,688712152.0,5306.0215825918185,-298.9,2
12:33,355940285.0,1614.9729781896835,-225.0,2
12:34,766941757.0,7858.012455509925,-44.67,4
12:38,480557476.0,9588.851373490588,-165.86,2
12:38,764450279.0,18274.173841391243,-91.64,2
12:44,643610517.0,-2822.741190729657,-35.72,5
12:47,598586358.0,-3171.6374499999965,-44.67,5
12:48,308897841.0,453.77999999999935,-17.14,5
12:48,348460748.0,-174.66100000000085,-63.6,5
12:49,299871610.0,-34.029346941233314,-116.99,2
12:50,604288474.0,2622.280444247567,-52.22,2
12:52,421881811.0,3979.635719772828,-62.28,5
12:55,688712152.0,5187.0215825918185,-119.0,2
12:56,764450279.0,18058.62984139124,-215.54,2
12:57,588565416.0,5818.523782068405,-210.0,2
13:02,555804115.0,-1609.2135475587029,-31.32,5
13:03,480557476.0,9478.279373490588,-110.57,2
13:05,867679563.0,-133.35514629828418,-24.33,5
13:06,499244466.0,-418.278531283422,-145.87,5
13:06,322221939.0,2842.8475051433657,-5.3,9
13:07,407574996.0,2754.9986604863484,-5.7,9
13:09,749378808.0,4697.328525199104,-5.05,9
13:10,743630833.0,126.8453132847012,-82.75,5
13:12,688712152.0,5023.921582591818,-163.1,2
13:12,773633520.0,271.3633109385115,-101.65,5
13:13,572333122.0,-3328.3100499999973,-36.95,5
13:14,472995101.0,1461.4217238883296,-125.19,5
13:15,480557476.0,9303.307373490588,-174.97,2
13:16,945054126.0,-1124.4219,-50.55,5
13:16,812692024.0,3903.31693134288,-5.9,9
13:16,868014990.0,-3081.3635999999974,-27.21,5
13:22,688712152.0,5018.5215825918185,-5.4,9
13:23,180719578.0,-4014.1552499999966,-49.55,5
13:24,187111705.0,5537.525059293028,-5.8,9
13:25,480557476.0,9297.207373490588,-6.1,9
13:54,134461671.0,7039.500663182866,-23.98,7
13:55,384497904.0,559.7352499999993,-79.94,5
14:03,494789005.0,2774.734985116645,-0.46,7
14:09,973388795.0,788.9176761636216,-10.0,2
14:26,764450279.0,17939.62984139124,-119.0,2
14:40,280098744.0,54.4623778716656,-7.49,4
14:41,299871610.0,-79.02934694123331,-45.0,2
14:42,764450279.0,17792.671841391242,-146.96,2
14:49,764450279.0,17677.18584139124,-115.49,2
14:56,282046994.0,-498.8096499999996,-100.04,5
15:01,764450279.0,17556.813841391242,-120.37,2
15:02,299871610.0,-145.02184694123332,-65.99,2
15:14,776108637.0,567.8823536574956,-7.39,9
15:15,287480331.0,10940.93085612788,-24.48,9
15:23,659415300.0,2280.035790250703,-19.98,2
15:24,679911053.0,1711.1579950335656,-8.98,4
15:47,108481285.0,7276.536048480429,-300.3,2
15:49,678330503.0,1428.80689751324,-30.35,2
15:54,764450279.0,17423.82784139124,-132.99,2
15:57,744968736.0,-1640.356826569424,-77.59,5
16:00,388862238.0,595.2058272385228,-49.98,2
16:02,108481285.0,7237.364048480429,-39.17,2
16:02,310620484.0,127.36423004410032,-176.37,2
16:10,899742927.0,11904.284151276752,-24.46,2
16:15,108481285.0,7173.69204848043,-63.67,2
16:17,421881811.0,3937.151959772828,-42.48,4
16:18,272538745.0,12851.119900000023,-66.97,4
16:20,653667523.0,4065.716551326438,-25.44,9
16:21,173335108.0,4669.949999999999,-31.99,2
16:23,764450279.0,17171.16984139124,-252.66,2
16:24,252760664.0,5404.951560939672,-47.06,7
16:25,628470485.0,109.62802990012308,-22.99,4
16:25,388862238.0,581.7208272385228,-13.48,2
16:30,587225252.0,8665.00758344597,-49.85,2
16:33,536924114.0,-912.883305593096,-85.33,5
16:39,345582855.0,-825.0209471794508,-49.72,5
16:41,829914501.0,1639.826806570974,-88.56,5
16:46,151278285.0,-408.5528000000004,-34.47,5
16:48,129018172.0,7681.605887752608,-84.0,2
16:52,957821152.0,-1525.1940035715495,-125.15,5
16:54,982949451.0,-3310.9441670525093,-28.57,5
16:54,764450279.0,17033.297841391242,-137.87,2
16:57,624500124.0,3039.6639480174663,-32.87,4
16:58,736310094.0,-915.112424027426,-30.68,5
17:01,129018172.0,7356.805887752608,-324.8,2
17:03,564744955.0,-262.52914141115804,-64.86,5
17:08,899692478.0,-1697.8447935240072,-140.69,5
17:12,771125520.0,176.37304999999947,-42.19,9
17:12,391559884.0,-277.01630000000057,-242.35,5
17:12,788740658.0,2669.085062686271,-13.76,2
17:14,475117511.0,6633.35039373982,-1.99,4
17:18,227104649.0,1436.2660543161776,-240.8,2
17:18,764450279.0,16956.32584139124,-76.97,2
17:21,851181128.0,3592.5604290647248,-23.64,9
17:22,824916823.0,7559.421217280177,-11.3,5
17:22,833899961.0,1609.853772838991,-56.92,7
17:23,462962606.0,47.966549999998904,-41.94,5
17:23,897714622.0,8195.344374819568,-13.47,5
17:24,943329213.0,2077.984232500588,-37.65,8
17:24,914806976.0,1149.573250185486,-129.98,2
17:25,106601471.0,8768.916086223111,-33.76,7
17:27,673818591.0,813.1067753758413,-149.0,2
17:27,540159353.0,9503.602211049105,-79.98,4
17:32,795847804.0,19822.22883078172,-43.45,7
17:32,409971170.0,1586.299830339025,-28.07,4
17:33,129018172.0,7174.805887752608,-182.0,2
17:33,887853850.0,9354.294267122064,-29.06,2
17:33,859603181.0,3277.182078062631,-154.0,2
17:35,227104649.0,1352.9660543161776,-83.3,2
17:36,450896297.0,11798.840625608813,-32.54,7
17:36,647936800.0,1164.9911378689246,-46.29,8
17:38,639409800.0,30256.96559520689,-75.12,5
17:39,703478110.0,3814.955084266246,-25.98,4
17:39,151968462.0,7091.625223627132,-128.12,2
17:40,310375875.0,2872.945995365549,-4.97,5
17:40,245690309.0,7784.059949310445,-8.67,4
17:42,310620484.0,-61.62176995589968,-188.99,2
17:43,678330503.0,1418.115081676071,-10.69,2
17:43,914806976.0,1117.613250185486,-31.96,1
17:44,435984758.0,4486.910509608384,-78.22,5
17:45,138609932.0,4067.712003294585,-15.0,4
17:47,581655972.0,37591.73453380961,-19.99,2
17:49,887853850.0,9322.154267122063,-32.14,7
17:52,221868392.0,4633.2322911824485,-3.05,7
17:52,764450279.0,16796.75384139124,-159.57,2
17:53,221868392.0,4605.264266121493,-27.97,7
17:53,229205098.0,6269.654035218247,-1.05,7
17:54,108481285.0,7068.73404848043,-104.96,2
17:55,299871610.0,-188.88934694123333,-43.87,2
17:57,449871732.0,8640.802113265707,-91.97,2
17:59,986267641.0,5299.630192813583,-21.97,4
18:00,596171893.0,-520.7582551744889,-33.96,7
18:01,970298834.0,2281.9249691825275,-191.76,2
18:02,511179916.0,6864.077830877225,-35.64,5
18:03,758160963.0,6970.486314944662,-111.3,2
18:03,551196328.0,3794.276133942312,-67.37,5
18:03,471897866.0,7328.340168717326,-61.14,5
18:05,344219145.0,5763.563902539494,-78.57,5
18:06,345514953.0,816.048199999999,-35.5,9
18:06,699139822.0,2011.3241952235885,-41.69,9
18:08,129018172.0,7000.505887752608,-174.3,2
18:09,949032480.0,4127.2222982229705,-26.29,9
18:10,940569402.0,5073.574616486906,-15.35,9
18:11,673818591.0,604.1067753758413,-209.0,2
18:13,108481285.0,6977.09004848043,-91.64,2
18:15,859603181.0,3181.296078062631,-95.89,2
18:17,624563756.0,-683.1411712164436,-6.0,9
18:19,510101371.0,11322.465985378964,-37.14,9
18:21,758160963.0,6809.486314944662,-161.0,2
18:32,196289502.0,13186.949543916344,-79.7,5
18:37,180616589.0,235.35764803395404,-34.41,5
18:38,975345315.0,30355.058799999963,-70.25,5
18:39,449871732.0,8590.812113265707,-49.99,7
18:39,151968462.0,7027.428223627132,-64.2,5
18:39,859603181.0,3038.524078062631,-142.77,2
18:41,282102606.0,-839.8630375771735,-33.8,9
18:45,556992209.0,9674.594675924423,-71.6,5
18:47,489964679.0,20917.891359071433,-92.97,4
18:51,691843653.0,-2827.208399999995,-8.62,5
18:52,491392945.0,3314.515500000005,-22.11,5
18:54,478651121.0,-174.00682040153026,-125.98,5
18:58,999752672.0,260.4204435333344,-71.38,5
18:59,256002321.0,6104.290582009661,-27.77,7
19:02,667367404.0,7467.799106948976,-15.97,9
19:07,786141370.0,-742.6635000000009,-10.95,9
19:08,406862520.0,198.15972653741048,-231.1,5
19:08,656812046.0,687.1468775236331,-53.32,5
19:11,550169791.0,18189.15983197527,-15.45,9
19:12,196289502.0,13174.28875918142,-12.66,5
19:13,824916823.0,7536.631217280177,-22.79,9
19:13,405945930.0,3315.9652431977293,-19.63,9
19:16,121858569.0,-132.32884999999777,-30.22,9
19:18,527842638.0,635.1887426329836,-66.55,5
19:18,500043411.0,11852.774209703695,-19.93,9
19:24,586315521.0,10507.253227128336,-24.13,5
19:34,547010927.0,19260.02414900253,-59.55,8
19:35,705848712.0,22752.68177188876,-16.95,9
19:38,858560423.0,10332.791645306976,-87.44,5
19:40,623156843.0,4325.82572722525,-268.82,5
19:40,984783496.0,12431.807914557425,-2.13,2
19:42,668329719.0,7021.0989512324095,-33.71,5
19:42,450896297.0,11797.900008171451,-0.94,7
19:43,874431242.0,7286.71385501731,-22.95,9
19:44,873693307.0,7590.407365680943,-58.49,5
19:46,703588001.0,-525.1897500000005,-17.99,9
19:49,785749304.0,7162.181317221451,-64.86,5
19:49,500043411.0,11804.669757567735,-48.1,7
19:50,893134725.0,886.569062973209,-65.25,5
19:50,960208650.0,14863.857893314149,-54.14,5
19:51,736340277.0,7388.599914845908,-44.21,5
19:56,550832673.0,2199.1911344744067,-81.99,8
19:57,832564361.0,13779.678945111847,-36.79,5
20:00,531186970.0,303.7125562436195,-95.65,5
20:00,390747457.0,28.71859999999822,-41.22,5
20:03,887853850.0,9299.014267122066,-23.14,9
20:09,683319988.0,6478.440109623171,-38.25,7
20:10,215311171.0,5421.897426070165,-6.19,2
20:12,435984758.0,4486.559451610489,-0.35,7
20:14,844835978.0,8342.2480683951,-25.2,5
20:15,844835978.0,8336.763359030578,-5.48,4
20:16,310375875.0,2850.70599536555,-22.24,9
20:17,147474476.0,3412.9564967019487,-211.39,5
20:24,416060965.0,684.7960064659198,-10.83,7
20:24,461990622.0,8454.780471331549,-12.32,4
20:28,500043411.0,11705.535757567735,-99.13,5
20:30,121113546.0,-57.32484393013027,-143.32,5
20:31,141521177.0,5890.1519000000135,-57.61,5
20:42,885259672.0,3296.346226888254,-6.08,5
20:50,960208650.0,14850.03098659645,-13.83,2
20:50,581655972.0,37541.40453380961,-50.33,5
20:52,822718326.0,9223.340222410903,-45.16,5
20:56,834581602.0,110.05829999999938,-60.81,5
21:15,853907490.0,6649.476623940241,-21.24,9
21:24,203466392.0,1447.6106428230828,-76.84,2
21:30,454356905.0,2083.1263047249254,-31.45,9
22:09,549414742.0,6314.750317923487,-6.12,5
22:12,994214354.0,8203.761949908469,-7.35,7
00:36,961077907.0,434.65565,-30.84,9
02:04,678851253.0,2598.7807852981737,-5.29,7
02:35,414805878.0,12708.899763059231,-22.78,9
02:38,699139822.0,1980.5957235209837,-30.73,8
02:39,824916823.0,7502.441217280178,-34.19,9
02:44,836110591.0,5672.048656012285,-25.34,9
02:45,880546403.0,-950.7255000000016,-30.3,9
02:46,586315521.0,10472.87352008383,-34.38,7
02:46,264550521.0,8185.594123388469,-40.04,7
02:48,399144202.0,1776.7387982666282,-31.0,9
02:58,259015404.0,2998.282790840248,-24.02,9
03:00,985188462.0,258.3262487112247,-33.89,9
03:00,987163717.0,5460.690320000006,-41.88,9
03:01,769311479.0,5824.881071830292,-5.78,8
03:03,270374623.0,8476.345668528906,-16.69,2
03:04,151968462.0,7002.178223627132,-25.25,9
03:07,887853850.0,9272.074267122063,-26.94,9
03:11,146909202.0,3848.7964077650818,-39.33,9
03:15,609939116.0,5628.231125293007,-34.32,7
03:16,108481285.0,6958.0367246905125,-19.05,4
03:19,752362502.0,8101.372634715361,-38.66,5
03:23,473820682.0,10197.76610841514,-37.72,2
03:26,809499628.0,14238.811054005111,-21.04,9
03:28,489964679.0,20883.501359071433,-34.39,9
03:37,704517789.0,15010.83358609186,-33.26,7
03:37,151968462.0,6980.245335031942,-21.93,5
03:38,633345190.0,6530.406625017934,-34.43,9
03:39,111137699.0,-283.4489499999996,-35.33,9
03:46,305778936.0,10666.910089966272,-29.64,2
03:46,795847804.0,19817.683205777445,-4.55,2
03:50,678330503.0,1408.6699301270542,-9.45,5
03:51,647936800.0,1137.1803583362243,-27.81,5
03:52,187541224.0,5985.59255922144,-43.85,9
03:54,414805878.0,12636.362261722128,-72.54,7
04:02,973086490.0,8810.947318891673,-12.35,9
04:08,675806859.0,5723.768426873562,-77.67,8
04:10,687135796.0,23179.858237822267,-16.35,5
04:12,183888402.0,15436.759575902684,-39.52,9
04:13,480557476.0,9284.20340613684,-13.0,5
04:24,851181128.0,3563.5104290647246,-29.05,9
04:26,887853850.0,9227.72430977033,-44.35,7
04:30,633345190.0,6524.599901091525,-5.81,2
04:31,949032480.0,4088.8322982229706,-38.39,9
04:33,705848712.0,22739.741771888763,-12.94,9
04:37,815385232.0,8441.303919889026,-46.2,5
04:38,550169791.0,18170.73268831294,-18.43,8
04:38,781554833.0,2178.932431943723,-0.66,7
04:51,518474507.0,12373.477200648276,-35.67,9
04:59,639409800.0,30226.91178535473,-30.05,7
05:00,117273481.0,7451.163671905959,-14.79,5
05:02,200080192.0,8272.473366130918,-17.45,9
05:04,705848712.0,22668.099094283367,-71.64,4
05:07,108931112.0,11741.392581396143,-39.38,9
05:09,433917275.0,7058.463667780232,-32.05,9
05:11,216285378.0,20660.259384634923,-37.37,9
05:16,668329719.0,7016.13509746565,-4.96,7
05:18,252760664.0,5401.151478104463,-3.8,7
05:23,749378808.0,4687.739479764444,-9.59,5
05:24,651756497.0,10215.174487675107,-50.22,7
05:25,657528784.0,-279.60309999999936,-35.62,9
05:26,809499628.0,14186.605069852278,-52.21,2
05:28,450896297.0,11757.550008171453,-40.35,9
05:37,824916823.0,7499.856519467915,-2.58,5
05:42,506618547.0,15757.226585962531,-8.47,5
05:42,572384506.0,8674.694558716561,-35.03,9
05:45,736340277.0,7388.161645880329,-0.44,4
05:45,779236304.0,34.66759547953249,-31.24,9
05:45,897714622.0,8194.410421506513,-0.93,7
05:46,308505160.0,11604.068808551265,-6.49,5
05:49,613729471.0,6880.660449222718,-9.17,2
05:52,899742927.0,11867.883106600591,-36.4,7
05:53,187111705.0,5492.376016263132,-45.15,2
05:57,169006407.0,10340.522999200582,-33.18,5
05:59,489964679.0,20869.961233675513,-13.54,4
06:00,940569402.0,5062.5946164869065,-10.98,9
06:00,131388684.0,18944.661565067097,-39.54,5
06:04,324224854.0,1082.3774219342963,-1.17,5
06:12,471897866.0,7325.400160529752,-2.94,2
06:13,399144202.0,1759.8865738011025,-16.85,5
06:18,518474507.0,12352.80865863231,-20.67,7
06:22,709608057.0,2416.341350799976,-39.8,9
06:22,108563213.0,20419.72022099978,-19.54,5
06:23,604288474.0,2618.1373863643203,-4.14,5
06:29,383625050.0,5129.28247058768,-36.39,7
06:32,730002588.0,11679.008889278854,-22.93,7
06:33,237493332.0,12056.898140704308,-34.48,5
06:34,534325901.0,5668.873792058209,-18.48,5
06:36,215311171.0,5394.327820417259,-27.57,4
06:37,912705941.0,16220.539424487695,-14.91,4
06:38,683319988.0,6454.100109623171,-24.34,9
06:38,124102251.0,3272.345211089248,-1.23,8
06:39,511179916.0,6815.70033210595,-48.38,8
06:44,802697323.0,18415.000065482305,-43.64,9
06:44,549414742.0,6280.310317923488,-34.44,9
06:53,134461671.0,7038.795114069955,-0.71,8
06:55,315078351.0,5320.421855211299,-47.75,9
06:57,843537309.0,-990.5197177916318,-20.69,9
06:59,865748375.0,4746.230110031473,-6.11,2
07:01,873701090.0,302.8472676016236,-2.97,2
07:01,256002321.0,6088.750582009661,-15.54,9
07:03,822250278.0,5935.942296672916,-22.51,2
07:05,785749304.0,7157.108279320847,-5.07,2
07:06,766941757.0,7827.022455509925,-30.99,9
07:15,549414742.0,6254.76030735348,-25.55,8
07:16,113747882.0,10318.075047569124,-66.07,7
07:17,482513594.0,5286.035690931853,-6.12,2
07:19,858989281.0,23258.753882378172,-8.59,5
07:19,656812046.0,684.9714564398231,-2.18,8
07:23,441274121.0,10795.25287612965,-30.24,2
07:25,331450202.0,5929.386243187496,-16.45,9
07:26,421881811.0,3926.581552445416,-10.57,7
07:27,940569402.0,5019.098941686218,-43.5,2
07:29,450896297.0,11705.80036770978,-51.75,5
07:31,145387690.0,4691.459409998848,-23.89,9
07:32,383833857.0,20725.80927400338,-19.74,5
07:35,905860285.0,14895.624505908369,-2.3,5
07:36,547010927.0,19198.780341240643,-61.24,7
07:37,719586818.0,16434.34947577668,-66.16,2
07:37,522188082.0,6567.291440326665,-21.1,8
07:41,407574996.0,2747.5902922924984,-7.41,5
07:44,558119802.0,28195.29842423181,-34.69,2
07:44,454356905.0,2049.576304724925,-33.55,9
07:48,287480331.0,10905.23085612788,-35.7,9
07:48,366550080.0,22581.473776263196,-45.88,7
07:49,259015404.0,2935.4381672806726,-62.84,4
07:51,195895574.0,6068.4128657068595,-64.12,7
07:52,679662108.0,13276.183660281768,-9.9,5
07:54,187541224.0,5910.092978340344,-75.5,7
07:57,994214354.0,8163.891949908469,-39.87,9
07:59,116598243.0,1652.996597800543,-13.77,2
08:02,496395938.0,11210.336631773882,-2.38,5
08:13,399538448.0,6849.618712652366,-5.4,9
08:13,853907490.0,6645.069198027201,-4.41,5
08:16,851649498.0,8717.063935748485,-4.26,2
08:17,842682241.0,4482.4685864461935,-9.91,4
08:21,978410962.0,-2690.7108395489736,-13.85,5
08:25,500051919.0,22.094596650590447,-78.16,5
08:29,120634201.0,4460.671500000005,-33.31,5
08:31,823208989.0,348.60645704073266,-13.77,2
08:31,627723633.0,-1613.6213280037628,-64.56,5
08:32,158766229.0,-864.3818858934699,-61.94,5
08:34,235310449.0,592.0891848303087,-111.05,5
08:35,191992682.0,-2495.096460292064,-138.85,5
08:36,816685391.0,-750.8637037084263,-55.79,5
08:36,534908754.0,-745.7447500000003,-19.55,5
08:39,229205098.0,6218.330035218248,-51.32,5
08:40,284905540.0,5930.618294481904,-71.83,8
08:42,891716230.0,-100.38200192937948,-128.62,5
08:43,108931112.0,11730.694392432248,-10.7,8
08:44,500843551.0,139.02139999999972,-104.86,5
08:44,419550103.0,16426.971973131946,-5.76,4
08:46,519933553.0,-797.5364958492715,-13.87,5
08:47,786879739.0,-2119.4432941205573,-50.03,5
08:49,540159353.0,9457.304211049102,-46.3,5
08:49,854895960.0,2155.0643887147025,-17.54,5
08:50,713910252.0,-655.5908742714585,-85.07,5
08:51,237684254.0,5014.817617055793,-58.08,5
08:51,158414827.0,-1709.5026000000014,-64.97,5
08:55,162370388.0,-2194.9954,-44.95,5
08:58,657139925.0,11567.652675247116,-78.61,5
09:01,285428103.0,8054.435950465588,-63.2,5
09:02,930277104.0,9323.956254871768,-82.63,5
09:03,775790822.0,-2890.8934192160687,-32.82,5
09:03,146909202.0,3829.794388784189,-19.0,7
09:03,310620484.0,-103.30580490780166,-41.68,7
09:03,541639148.0,3757.0001323979145,-29.87,8
09:06,492058070.0,578.495968740471,-56.94,5
09:08,691789577.0,-676.9748500000001,-168.04,5
09:09,977899503.0,-1268.2291064191477,-35.11,5
09:10,700138124.0,4379.273300000003,-74.69,5
09:11,503575533.0,5883.560100000015,-139.75,5
09:12,943829984.0,-564.9934908865428,-107.48,5
09:14,335698481.0,-2025.4204966949403,-21.29,5
09:15,409971170.0,1583.9319424468988,-2.37,7
09:16,780463728.0,1104.73757094224,-143.46,5
09:16,314980178.0,2084.6338500000047,-99.99,2
09:16,124102251.0,3262.3552110892483,-9.99,2
09:16,613729471.0,6873.560449222718,-7.1,9
09:16,706250160.0,9578.12506664464,-8.4,4
09:18,559995067.0,3600.5029208479054,-9.63,7
09:18,623156843.0,4243.85572722525,-81.97,4
09:18,950234174.0,735.6514979971005,-111.59,5
09:23,255814263.0,3452.8042967005445,-26.98,4
09:23,534325901.0,5566.783792058209,-102.09,2
09:23,975345315.0,30288.08879999996,-66.97,4
09:24,336557504.0,953.5281584030243,-53.0,2
09:24,344219145.0,5707.573902539494,-55.99,2
09:25,361201224.0,4089.623232067893,-39.11,7
09:25,200080192.0,8241.839734926592,-30.63,7
09:26,133755851.0,-59.995996199907125,-64.97,4
09:26,365608668.0,-45.137886140441154,-144.29,5
09:26,627622066.0,2305.7081856930563,-4.99,7
09:27,250895529.0,772.4660824692872,-115.33,5
09:29,785210466.0,1582.159527560572,-59.98,2
09:29,651756497.0,10097.574487675109,-117.6,7
09:30,819515373.0,1633.4211360637908,-35.95,7
09:30,680773155.0,234.16508333109184,-31.63,5
09:30,170637730.0,2246.302864195986,-10.67,7
09:30,534325901.0,5515.733792058209,-51.05,2
09:31,416060965.0,615.8160064659198,-68.98,2
09:32,435984758.0,4435.4249774853715,-51.13,2
09:33,846550094.0,1223.1208360368746,-199.98,2
09:33,586041848.0,411.1416999999991,-64.98,4
09:36,844835978.0,8300.783359030578,-35.98,4
09:36,849096144.0,1554.535858910517,-14.98,7
09:37,909676212.0,816.2151697400842,-49.99,4
09:37,454129843.0,458.11165079178886,-33.95,1
09:39,108931112.0,11699.001152432247,-31.69,4
09:39,639409800.0,30126.32178535473,-100.59,2
09:40,703478110.0,3688.955084266246,-126.0,2
09:40,802697323.0,18310.530065482304,-104.47,2
09:41,829914501.0,1591.568806570974,-48.26,2
09:44,822135975.0,11176.564966726404,-109.17,2
09:45,489964679.0,20738.36123367551,-131.6,7
09:46,503575533.0,5851.518090000015,-32.04,4
09:46,950234174.0,680.0627505864176,-55.59,8
09:47,416060965.0,586.3160064659198,-29.5,2
09:48,834383043.0,4568.422290432129,-71.99,2
09:48,874431242.0,7205.428498242656,-81.29,5
09:49,771125520.0,169.38304999999946,-6.99,7
09:50,812692024.0,3854.31693134288,-49.0,5
09:50,196289502.0,13138.69875918142,-35.59,2
09:51,581655972.0,37386.42453380961,-154.98,2
09:51,242218612.0,499.2363000000006,-84.98,2
09:51,897592348.0,13143.41436078595,-32.95,1
09:52,835736339.0,2319.363240414559,-32.04,4
09:52,550169791.0,18083.02268831294,-87.71,5
09:53,781554833.0,2044.9324319437228,-134.0,2
09:54,449871732.0,8585.822113265707,-4.99,7
09:55,986267641.0,5280.650192813583,-18.98,2
09:55,795847804.0,19754.973205777445,-62.71,2
09:56,282837512.0,11546.67270071138,-124.8,2
09:56,151968462.0,6948.203325031942,-32.04,4
09:57,355602925.0,1109.3937938274146,-19.98,7
09:57,489964679.0,20699.875233675513,-38.49,4
09:58,802697323.0,18308.889415482303,-1.64,4
09:59,170637730.0,2244.785314195986,-1.52,4
09:59,651756497.0,10000.27448767511,-97.3,4
10:00,570323670.0,3108.222995882394,-10.01,4
10:01,822135975.0,10970.778966726404,-205.79,2
10:02,611143859.0,1050.40855000001,-123.87,2
10:02,511179916.0,6521.00033210595,-294.7,2
10:02,605116158.0,2205.7327,-7.98,4
10:03,482513594.0,5259.505690931854,-26.53,2
10:03,807714284.0,561.8223607360001,-25.0,2
10:03,441274121.0,10716.30287612965,-78.95,2
10:05,829914501.0,1389.968806570974,-201.6,2
10:05,229205098.0,6201.020035218247,-17.31,1
10:05,769311479.0,5811.861071830292,-13.02,1
10:05,420109571.0,253.0767689636076,-44.03,5
10:06,510101371.0,11307.695985378965,-14.77,4
10:07,479456865.0,959.0802314894048,-12.0,4
10:08,414805878.0,12532.286261722127,-104.08,5
10:09,221868392.0,4600.729974250098,-4.53,8
10:09,741269136.0,734.0284500000004,-112.97,2
10:11,610645022.0,-1080.7925626449182,-89.7,5
10:12,480557476.0,9243.18340613684,-41.02,5
10:12,137822385.0,3002.4277171514746,-5.35,9
10:12,690958123.0,17145.084860035375,-35.03,2
10:12,856147482.0,-184.44284859862472,-272.22,5
10:13,806358207.0,10252.5639443624,-161.72,5
10:14,781554833.0,1900.9324319437228,-144.0,2
10:15,873693307.0,7565.037365680943,-25.37,2
10:16,315546581.0,23868.381430587702,-22.65,7
10:16,441274121.0,10670.99208612965,-45.31,4
10:17,511179916.0,6396.40033210595,-124.6,2
10:18,322221939.0,2825.0824140077034,-17.77,2
10:20,558875206.0,1799.0612000000006,-127.58,5
10:22,416060965.0,504.8360064659198,-81.48,2
10:24,297823329.0,333.0136999999992,-33.96,1
10:25,822135975.0,10758.734966726404,-212.04,2
10:25,752362502.0,8075.35263471536,-26.02,7
10:25,534204159.0,4936.534517068909,-14.73,7
10:26,779946617.0,14504.66930323969,-12.03,7
10:28,806358207.0,10233.0319443624,-19.53,4
10:28,824916823.0,7492.216519467915,-7.64,7
10:29,736340277.0,7369.741645880329,-18.42,7
10:30,310375875.0,2811.506034322356,-39.2,2
10:31,930277104.0,9318.96829816721,-4.99,2
10:32,829914501.0,1271.710806570974,-118.26,2
10:34,611143859.0,958.7225500000098,-91.69,2
10:35,672994751.0,-226.95869241586257,-87.98,2
10:37,489964679.0,20586.489233675515,-113.39,2
10:37,203466392.0,1446.2773297111758,-1.33,2
10:41,859603181.0,3028.534078062631,-9.99,1
10:41,286484726.0,341.715176947126,-17.42,5
10:43,511179916.0,6117.10033210595,-279.3,2
10:44,169006407.0,10314.492999200582,-26.03,2
10:45,653640811.0,14666.126106824777,-6.0,1
10:45,108563213.0,20367.690220999782,-52.03,2
10:50,851181128.0,3381.5104290647246,-182.0,2
10:50,270374623.0,8419.635668528907,-56.71,2
10:50,836110591.0,5645.158656012285,-26.89,7
10:51,169006407.0,10263.412999200582,-51.08,2
10:52,287230540.0,740.4444326671558,-83.98,2
10:53,416060965.0,414.8460064659198,-89.99,2
10:53,489964679.0,20487.117233675515,-99.37,2
10:54,873693307.0,7514.047957535136,-50.99,8
10:58,322720763.0,6518.205643301331,-28.09,8
11:02,532478725.0,4165.558565153779,-52.34,7
11:05,690523499.0,622.1541499999996,-5.5,7
11:09,282837512.0,11529.984795218385,-16.69,2
11:10,829914501.0,1201.024806570974,-70.69,2
11:11,949032480.0,4065.6622982229705,-23.17,2
11:13,229205098.0,6179.831405354041,-21.19,2
11:14,331450202.0,5903.16739170931,-26.22,2
11:15,364357875.0,5714.27683967683,-17.98,5
11:15,416060965.0,364.8460064659198,-50.0,2
11:16,489964679.0,20424.117233675515,-63.0,2
11:18,355602925.0,1089.8752195597524,-19.52,7
11:19,639409800.0,30118.243605354728,-8.08,4
11:22,992204045.0,10300.23406742526,-16.0,2
11:23,520447032.0,7816.831045678185,-63.4,5
11:24,534325901.0,5505.319592058208,-10.41,4
11:25,792845450.0,577.9391500000008,-62.98,2
11:25,703537476.0,640.3452499999992,-317.8,2
11:26,829914501.0,1181.044806570974,-19.98,7
11:26,647936800.0,1036.8903583362244,-100.29,2
11:30,117273481.0,7426.193671905959,-24.97,7
11:30,994214354.0,8160.159209908468,-3.73,4
11:32,511179916.0,5877.000332105949,-240.1,2
11:34,832564361.0,13702.31468481971,-77.36,7
11:38,489964679.0,20257.531233675516,-166.59,2
11:40,653640811.0,14577.056106824775,-89.07,2
11:40,187541224.0,5867.132978340344,-42.96,7
11:42,987656636.0,5447.501065252234,-26.82,8
11:42,416060965.0,281.3560064659198,-83.49,2
11:44,482513594.0,5183.2056909318535,-76.3,2
11:47,829914501.0,1006.786806570974,-174.26,2
11:51,874431242.0,7174.928498242656,-30.5,2
11:52,949032480.0,4056.52266290488,-9.14,4
11:54,611143859.0,762.7365500000099,-195.99,2
11:54,287480331.0,10887.38693805221,-17.84,5
11:55,703537476.0,402.3452499999992,-238.0,2
11:57,456246119.0,18038.59588468511,-99.99,2
11:58,832564361.0,13678.99548481971,-23.32,4
11:58,456246119.0,18027.58203452125,-11.01,8
11:58,433917275.0,7032.713667780232,-25.75,2
11:59,416060965.0,156.8560064659198,-124.5,2
12:03,519644021.0,1845.98731559004,-30.85,4
12:03,661295096.0,2711.241204411934,-57.98,2
12:05,844835978.0,8283.254599107628,-17.53,2
12:07,965038148.0,-1133.615014367672,-29.13,9
12:08,532478725.0,4133.878565153779,-31.68,9
12:09,264208990.0,462.13154999999904,-79.97,4
12:10,489964679.0,20077.631233675515,-179.9,2
12:11,282837512.0,11485.594795218383,-44.39,9
12:11,510101371.0,11281.255985378964,-26.44,9
12:12,781554833.0,1761.9324319437228,-139.0,2
12:13,703537476.0,227.34524999999917,-175.0,2
12:13,630468201.0,-768.7415838897017,-30.63,9
12:14,358846516.0,-42.90032747278198,-139.35,5
12:15,901037631.0,799.6693230964066,-31.7,9
12:16,910730524.0,7326.093323088865,-2.44,5
12:17,534908754.0,-788.6347500000003,-42.89,9
12:19,482513594.0,5165.7056909318535,-17.5,2
12:21,416060965.0,146.86600646591978,-9.99,2
12:21,829914501.0,909.514806570974,-97.27,2
12:30,310620484.0,-132.14580490780165,-28.84,9
12:31,482513594.0,5059.319690931853,-106.39,2
12:38,308897841.0,416.4335999999994,-37.35,5
12:40,489964679.0,20060.131233675515,-17.5,2
12:43,215426302.0,-333.41359597430824,-36.39,5
12:46,569687509.0,-2011.8954,-17.08,5
12:48,651756497.0,9819.674487675107,-180.6,7
12:48,248658670.0,-1792.1408499999998,-30.06,5
12:49,603721739.0,-91.35810051681584,-128.39,5
12:49,494156986.0,-424.05655432766497,-60.79,5
12:50,524425303.0,-405.1345000000011,-102.2,5
12:50,388862238.0,569.7808272385228,-11.94,4
12:50,629078930.0,1402.4376723281828,-55.98,2
12:51,874506295.0,-1674.0892562455722,-12.37,5
12:51,943329213.0,2064.954232500588,-13.03,7
12:53,213096759.0,-1486.8531082144395,-47.0,5
12:53,416060965.0,114.40600646591976,-32.46,2
12:55,846550094.0,1181.1508360368746,-41.97,4
12:58,489964679.0,19983.84523367551,-76.29,2
12:58,611143859.0,717.9505500000098,-44.79,2
12:59,703478110.0,3535.655084266246,-153.3,2
13:02,235881534.0,11014.969834136762,-3.51,7
13:02,698076160.0,5171.102375000424,-46.37,5
13:02,854513972.0,357.16724999999946,-17.89,9
13:03,829914501.0,810.856806570974,-98.66,2
13:07,409971170.0,1476.1319424468988,-107.8,2
13:08,456221621.0,214.75166730262816,-63.27,5
13:08,130154096.0,1020.0992252012682,-55.98,2
13:09,407574996.0,2740.0902922924984,-7.5,9
13:09,904154012.0,786.8174581204323,-14.97,7
13:10,380911501.0,-356.6937500000008,-74.13,5
13:12,187111705.0,5487.376016263132,-5.0,9
13:14,433837402.0,-1152.985868464188,-27.99,9
13:17,173335108.0,4663.959999999999,-5.99,4
13:18,993663752.0,-98.61475758960344,-122.97,5
13:19,449871732.0,8566.832113265707,-18.99,9
13:19,460463595.0,-1237.467945418579,-47.94,5
13:19,850290152.0,-2654.3509999999983,-44.29,5
13:20,277562576.0,333.5137507952724,-5.5,9
13:22,340321732.0,597.3228500000029,-257.67,5
13:22,322221939.0,2819.3324140077034,-5.75,9
13:24,416060965.0,94.41600646591978,-19.99,2
13:25,491392945.0,3279.525500000005,-34.99,2
13:26,414454079.0,415.7468500000018,-9.13,4
13:29,494789005.0,2727.5049851166445,-47.23,2
13:30,781554833.0,1614.4324319437228,-147.5,2
13:32,611143859.0,610.8785500000098,-107.07,2
13:32,829914501.0,720.556806570974,-90.3,2
13:34,227104649.0,1340.9640643161777,-12.0,4
13:35,851649498.0,8684.043935748485,-33.02,7
13:36,703537476.0,137.04524999999916,-90.3,2
13:37,706361191.0,-68.42525150592186,-36.49,5
13:39,315078351.0,5250.0718552112985,-70.35,2
13:40,836110591.0,5643.056933675416,-2.1,2
13:44,364396689.0,-866.88425,-130.01,5
13:45,698955014.0,734.8506549409121,-99.99,2
13:46,970298834.0,2240.8649691825276,-41.06,2
13:48,891716230.0,-207.3620019293795,-106.98,2
13:51,829914501.0,495.1708065709741,-225.39,2
13:51,450896297.0,11699.59056770978,-6.21,4
13:52,703537476.0,-96.05475000000084,-233.1,2
13:53,416060965.0,73.93600646591977,-20.48,2
13:57,776108637.0,482.4032536574956,-85.48,5
14:00,703588001.0,-557.6284500000005,-32.44,5
14:04,213112754.0,6255.715112173497,-62.88,2
14:05,489964679.0,19768.259233675515,-215.59,7
14:08,494789005.0,2385.9049851166446,-341.6,2
14:15,703478110.0,3404.055084266246,-131.6,2
14:17,416060965.0,-21.04399353408023,-94.98,2
14:17,859603181.0,3008.874962600798,-19.66,5
14:23,348525881.0,-217.31837540506368,-87.21,5
14:29,413557825.0,519.7162999999996,-29.96,7
14:31,489964679.0,19733.259233675515,-35.0,4
14:33,647936800.0,1018.8703583362244,-18.02,7
14:38,807098817.0,6.610099999999221,-140.91,5
14:40,859603181.0,2938.884962600798,-69.99,2
14:42,829914501.0,258.584806570974,-236.59,2
14:44,572136270.0,-372.02385066642233,-55.27,5
14:44,416060965.0,-47.04399353408023,-26.0,2
14:55,558119802.0,28165.11842423181,-30.18,9
14:59,829914501.0,157.11280657097404,-101.47,2
15:03,489964679.0,19677.973233675515,-55.29,2
15:05,994214354.0,8160.012651639312,-0.15,2
15:07,657139925.0,11534.49664983454,-33.16,7
15:08,511179916.0,5776.200332105949,-100.8,2
15:09,611143859.0,560.4925500000098,-50.39,2
15:17,416060965.0,-153.52399353408023,-106.48,2
15:23,611143859.0,422.6205500000098,-137.87,2
15:24,829914501.0,-22.087193429025945,-179.2,2
15:26,489964679.0,19564.587233675516,-113.39,2
15:30,511179916.0,5585.100332105949,-191.1,2
15:45,807714284.0,539.1192607360001,-22.7,5
15:47,489964679.0,19449.101233675516,-115.49,2
15:49,611143859.0,330.9205500000099,-91.7,2
16:00,998390769.0,-645.9590490594758,-126.5,5
16:03,829914501.0,-195.67319342902593,-173.59,2
16:04,454356905.0,2047.550224724925,-2.03,4
16:06,489964679.0,19351.801233675516,-97.3,2
16:12,611143859.0,138.4345500000099,-192.49,2
16:14,510101371.0,11240.792897991509,-40.46,5
16:19,948558249.0,8265.389015959809,-15.98,7
16:29,128033695.0,1267.522757208152,-10.11,2
16:31,829914501.0,-423.1591934290259,-227.49,2
16:35,741269136.0,650.4109500000004,-83.62,2
16:36,489964679.0,19135.501233675517,-216.3,2
16:36,414805878.0,12530.662301722128,-1.62,4
16:40,551755686.0,6778.006585195962,-6.99,4
16:42,511179916.0,5349.200332105949,-235.9,2
16:46,611143859.0,-75.72344999999007,-214.16,2
16:49,817294757.0,-2701.9583,-33.93,5
17:01,467207141.0,1145.6251170482635,-199.5,2
17:02,613427466.0,5394.398905655876,-61.93,5
17:03,581655972.0,37352.80189246524,-33.62,8
17:10,610450243.0,-1342.5796,-31.82,5
17:10,829914501.0,-443.4311934290259,-20.27,2
17:12,489964679.0,19059.20123367552,-76.3,2
17:14,611143859.0,-282.19544999999005,-206.47,2
17:15,245690309.0,7739.147949310444,-44.91,5
17:16,758885184.0,1150.177182274345,-79.98,2
17:16,467207141.0,1060.6251170482635,-85.0,2
17:17,829914501.0,-551.9171934290259,-108.49,2
17:17,163470640.0,468.30719999999985,-45.97,4
17:17,919185264.0,3673.582722887972,-23.97,1
17:18,511179916.0,5272.900332105949,-76.3,2
17:22,955035930.0,565.4084791714772,-33.99,2
17:24,399144202.0,1722.5365738011023,-37.35,2
17:25,556992209.0,9658.074675924425,-16.52,7
17:26,198946608.0,5112.249276795803,-42.06,2
17:32,511179916.0,5210.600332105949,-62.3,2
17:37,331450202.0,5877.767391709311,-25.4,2
17:39,256002321.0,6024.670582009661,-64.08,2
17:43,611143859.0,-351.48144999999005,-69.29,2
17:47,511179916.0,4918.0003321059485,-292.6,2
17:48,128033695.0,1255.329651737031,-12.19,5
17:49,280268430.0,4437.829732378334,-54.97,4
17:49,809499628.0,14173.165069852275,-13.44,2
17:58,611143859.0,-474.63944999999,-123.16,2
18:00,467207141.0,1023.1251170482636,-37.5,2
18:02,489964679.0,19004.643233675517,-54.56,2
18:04,799861885.0,541.291149999999,-42.83,9
18:15,886921642.0,2884.442476773328,-53.83,5
18:15,467207141.0,864.6251170482637,-158.5,2
18:16,489964679.0,18922.77123367552,-81.87,2
18:19,657139925.0,11516.15664983454,-18.34,9
18:22,135937041.0,-255.4516982684117,-26.85,9
18:23,675806859.0,5393.368426873562,-330.4,2
18:29,489964679.0,18857.699233675517,-65.07,2
18:37,984783496.0,12388.36860750328,-43.44,8
18:39,653640811.0,14434.802106824774,-142.25,5
18:40,819515373.0,1601.9311360637907,-31.49,7
18:40,213112754.0,6239.475112173497,-16.24,9
18:43,984783496.0,12367.11860750328,-21.25,9
18:45,257633312.0,180.1683499999993,-33.0,9
18:45,890567652.0,-295.3814003203994,-50.55,5
18:46,915666111.0,-3776.6895747720378,-14.3,5
18:53,675806859.0,5311.468426873563,-81.9,2
19:04,653640811.0,14409.443373586071,-25.36,5
19:04,489964679.0,18759.013233675516,-98.69,2
19:16,859603181.0,2870.676962600798,-68.21,5
19:21,489964679.0,18665.941233675516,-93.07,2
19:27,886921642.0,2871.972552836364,-12.47,7
19:30,932820758.0,-2343.206566775555,-47.61,5
19:35,587225252.0,8659.937613697204,-5.07,5
19:36,779620857.0,-622.6800963851758,-122.01,5
19:39,203466392.0,1364.3353297111755,-81.94,5
19:40,285220959.0,10141.995517550871,-11.54,5
19:43,331048953.0,-566.4036320215064,-132.82,5
19:49,865748375.0,4696.2921100314725,-49.94,5
20:06,954263768.0,-399.8870000000002,-11.3,5
20:17,535744551.0,338.4702659956264,-57.42,5
20:23,933491926.0,2305.966300000001,-53.27,5
20:49,245690309.0,7723.879918267016,-15.27,5
20:50,683319988.0,6423.671242224481,-30.43,8
20:52,344219145.0,5702.758024138093,-4.82,8
20:54,475117511.0,6612.77039373982,-20.58,5
21:00,370521542.0,22657.511648326567,-16.65,5
21:07,519649533.0,51.80181637066235,-33.14,9
21:08,700138124.0,4357.873300000003,-21.4,9
21:12,127809299.0,1613.6292189472845,-40.41,7
21:22,749378808.0,4660.489479764444,-27.25,9
00:11,433917275.0,7005.893667780232,-26.82,9
00:14,633345190.0,6493.756144560498,-30.84,7
00:14,450896297.0,11664.75056770978,-34.84,9
00:14,824916823.0,7471.476519467915,-20.74,9
00:18,822135975.0,10741.997331450131,-16.74,8
00:19,113747882.0,10288.764688065066,-29.31,7
00:20,633345190.0,6457.366144560498,-36.39,9
00:23,704517789.0,14956.315490316794,-54.52,5
00:24,719586818.0,16434.108773906537,-0.24,5
00:28,858989281.0,23247.177932934137,-11.58,7
00:32,873693307.0,7513.61348959443,-0.43,8
00:36,851181128.0,3355.0604290647248,-26.45,9
00:38,324224854.0,1071.749578697249,-10.63,7
00:39,264208990.0,422.091549999999,-40.04,9
00:41,639409800.0,30115.775681633328,-2.47,2
00:42,709632525.0,-1710.4123500000007,-34.94,9
00:44,940569402.0,5009.708941686217,-9.39,9
00:44,409971170.0,1433.4977143369758,-42.63,2
00:46,169006407.0,10212.368522517694,-51.04,5
00:49,572384506.0,8634.728259958349,-39.97,7
00:51,858989281.0,23224.527932934136,-22.65,9
00:59,473820682.0,10196.195414362155,-1.57,7
01:01,471897866.0,7313.858644039247,-11.54,5
01:01,482513594.0,5027.45941344158,-31.86,5
01:02,656812046.0,626.1137537325187,-58.86,2
01:04,987656636.0,5440.941465575491,-6.56,7
01:06,776431321.0,2663.959934498547,-47.5,8
01:10,235881534.0,10979.3304914067,-35.64,2
01:20,905860285.0,14883.92597463407,-11.7,7
01:31,130154096.0,965.6294105489656,-54.47,7
01:38,887853850.0,9208.48430977033,-19.24,9
01:44,885259672.0,3292.3064176522385,-4.04,2
01:58,519644021.0,1844.1144377557216,-1.87,7
02:00,200080192.0,8239.84323762031,-2.0,5
02:12,992204045.0,10297.38954183284,-2.84,8
02:14,270374623.0,8350.199685264799,-69.44,5
02:21,290818242.0,5839.980923893838,-29.09,2
02:24,897592348.0,13143.317552364351,-0.1,4
02:29,417850087.0,14901.433887421215,-2.42,8
02:32,832564361.0,13674.26190834003,-4.73,5
02:32,145387690.0,4613.947186428372,-77.51,5
02:32,586315521.0,10436.538199428136,-36.34,2
02:34,435984758.0,4425.881936437659,-9.54,2
02:38,506618547.0,15748.156178229146,-9.07,8
02:39,779236304.0,2.7275954795324857,-31.94,9
02:40,705848712.0,22651.859094283365,-16.24,9
02:47,987163717.0,5421.010320000006,-39.68,9
02:47,433917275.0,6971.82800993403,-34.07,4
02:52,730002588.0,11668.791237678222,-10.22,2
02:56,492215823.0,-147.6568261845569,-27.28,9
02:57,624500124.0,3026.8374783587105,-12.83,2
02:57,183888402.0,15399.579575902682,-37.18,9
03:02,824916823.0,7430.124147335621,-41.35,8
03:05,651756497.0,9749.809060131063,-69.87,2
03:09,601627384.0,3856.516266618003,-8.52,5
03:14,264550521.0,8126.089584635123,-59.5,2
03:23,587225252.0,8629.237613697203,-30.7,9
03:24,647936800.0,1012.295885994679,-6.57,4
03:29,802697323.0,18270.349415482306,-38.54,9
03:34,187541224.0,5831.192978340345,-35.94,9
03:34,237493332.0,12021.191953242302,-35.71,2
03:40,549414742.0,6217.17030735348,-37.59,9
03:43,749378808.0,4637.749479764444,-22.74,9
03:44,540159353.0,9444.4825686994,-12.82,5
03:52,668329719.0,7004.702101936312,-11.43,2
03:53,853907490.0,6606.495693408106,-38.57,2
03:58,679662108.0,13254.789266662869,-21.39,7
03:59,897714622.0,8181.866185363208,-12.54,2
04:04,534204159.0,4918.1163758163775,-18.42,5
04:07,108931112.0,11662.631152432246,-36.37,9
04:24,960208650.0,14849.32801353064,-0.7,7
04:29,667367404.0,7410.640677225645,-57.16,2
04:33,842682241.0,4469.205690780411,-13.26,8
04:39,706250160.0,9559.834518358037,-18.29,2
04:47,823208989.0,341.70486690846565,-6.9,8
04:52,785749304.0,7148.170555162122,-8.94,7
04:53,366550080.0,22564.025103617725,-17.45,5
04:57,322221939.0,2818.180939589157,-1.15,2
04:58,683319988.0,6384.021242224481,-39.65,9
05:03,469561218.0,-209.29665000000088,-23.68,9
05:05,146909202.0,3823.16827986486,-6.63,7
05:05,846550094.0,1176.8487405544088,-4.3,2
05:07,213112754.0,6199.297862859345,-40.18,7
05:14,124102251.0,3244.7861559064054,-17.57,7
05:15,480557476.0,9200.12628866996,-43.06,7
05:15,699139822.0,1974.7999232496895,-5.8,2
05:18,815385232.0,8414.943154419025,-26.36,7
05:19,108481285.0,6929.428801019707,-28.61,2
05:23,795847804.0,19750.54155273739,-4.43,5
05:25,308505160.0,11551.644876604309,-52.42,5
05:29,679911053.0,1645.523902313933,-65.63,2
05:39,687135796.0,23162.658237822267,-17.2,9
05:45,421881811.0,3918.35670118339,-8.22,5
05:49,399144202.0,1717.8763145241262,-4.66,7
05:50,310375875.0,2799.0267656968945,-12.48,7
05:50,489964679.0,18638.551233675516,-27.39,9
06:00,259015404.0,2921.458167280673,-13.98,9
06:03,873701090.0,273.29794625080575,-29.55,7
06:04,559995067.0,3573.6891608974524,-26.81,2
06:06,229205098.0,6121.983090478944,-57.85,2
06:06,287480331.0,10842.966417716249,-44.42,7
06:09,985188462.0,225.8962487112247,-32.43,9
06:16,496395938.0,11192.554136755703,-17.78,4
06:25,256002321.0,6000.330582009661,-24.34,9
06:28,809499628.0,14153.935069852278,-19.23,9
06:30,541639148.0,3739.008470010754,-17.99,5
06:30,364357875.0,5651.656672069564,-62.62,8
06:31,859603181.0,2834.373963467678,-36.3,7
06:33,678330503.0,1385.3413319722206,-23.33,7
06:34,709608057.0,2391.1013507999764,-25.24,9
06:36,215311171.0,5375.642613093813,-18.69,5
06:37,698076160.0,5142.222375000424,-28.88,9
06:37,738958551.0,7617.842316185768,-1.31,5
06:42,475117511.0,6589.720883170013,-23.05,8
06:44,108563213.0,20293.237952648433,-74.45,8
06:45,613729471.0,6858.210786145109,-15.35,2
06:47,912705941.0,16219.014334672103,-1.53,5
06:49,874431242.0,7171.147358201773,-3.78,5
06:52,216285378.0,20618.889384634924,-41.37,9
06:52,348325817.0,8002.846866288856,-4.69,7
07:05,609939116.0,5609.079119306718,-19.15,4
07:06,522188082.0,6535.581027153727,-31.71,7
07:07,949032480.0,4040.33266290488,-16.19,9
07:09,516051449.0,947.9902875167438,-46.13,5
07:10,170637730.0,2235.780402594986,-9.0,2
07:13,259015404.0,2909.9656415184513,-11.49,7
07:13,534325901.0,5491.840216119125,-13.48,7
07:14,940569402.0,4997.472917041856,-12.24,5
07:20,973086490.0,8800.457318891673,-10.49,9
07:23,547010927.0,19163.377564591516,-35.4,8
07:23,221868392.0,4558.809974250098,-41.92,9
07:25,518474507.0,12325.56865863231,-27.24,9
07:28,822250278.0,5918.002296672917,-17.94,9
07:31,749378808.0,4601.837080729755,-35.91,7
07:32,806358207.0,10215.1848501946,-17.85,4
07:33,554792076.0,24057.99746394803,-23.82,7
07:34,836110591.0,5616.386933675416,-26.67,9
07:34,766941757.0,7791.202455509925,-35.82,9
07:34,984783496.0,12355.480365742274,-11.64,4
07:36,187111705.0,5411.823588664937,-75.55,8
07:37,116598243.0,1649.3961267556233,-3.6,2
07:39,383625050.0,5112.682626008769,-16.6,7
07:39,383833857.0,20693.666081317795,-32.14,2
07:42,901432314.0,3382.690960656617,-43.92,8
07:46,315546581.0,23865.01250369176,-3.37,8
07:47,550169791.0,18032.11909672375,-50.9,5
07:53,683319988.0,6328.086445638515,-55.93,5
07:54,687135796.0,23124.2621684602,-38.4,7
07:55,675806859.0,5269.35350931174,-42.11,5
07:57,151968462.0,6930.81188874986,-17.39,5
07:58,683078800.0,1255.965641349959,-47.74,4
08:01,558119802.0,28134.21770630986,-30.9,2
08:03,196289502.0,13106.165248056688,-32.38,5
08:05,766941757.0,7767.71501420135,-23.49,7
08:12,698076160.0,5072.521246139087,-69.7,7
08:13,822250278.0,5907.677726818142,-10.32,5
08:16,736340277.0,7334.408787223335,-35.33,5
08:19,203466392.0,1332.8990280495484,-31.44,7
08:30,844835978.0,8281.42627904313,-1.83,2
08:32,779946617.0,14474.340908416274,-30.33,7
08:34,195895574.0,6035.0959104843,-33.32,2
08:34,199016328.0,4541.729578394217,-4.59,2
08:39,752362502.0,8067.576759209936,-7.78,4
08:41,994214354.0,8152.828974430338,-7.18,7
08:47,414805878.0,12504.462301722127,-26.2,9
08:55,769311479.0,5794.7628140840825,-17.1,2
09:09,887853850.0,9183.306158243182,-25.18,4
09:10,494789005.0,2335.0583337245284,-50.85,2
09:13,315078351.0,5248.838100416111,-1.23,2
09:14,116169597.0,64.73694999999967,-42.97,4
09:14,950234174.0,673.4264211652885,-6.64,7
09:15,672913754.0,9062.635906431353,-5.99,7
09:18,461990622.0,8449.337778309038,-5.44,5
09:19,832564361.0,13653.67190834003,-20.59,6
09:21,264550521.0,8120.079584635123,-6.01,7
09:22,703478110.0,3397.0650842662462,-6.99,7
09:25,235881534.0,10899.1904314067,-80.14,4
09:25,435984758.0,4404.819896437659,-21.06,4
09:26,647936800.0,982.215885994679,-30.08,6
09:27,659415300.0,2225.535790250703,-54.5,2
09:28,874431242.0,7169.093018201774,-2.05,4
09:29,187541224.0,5724.8209783403445,-106.37,2
09:30,647472692.0,21483.148098889335,-10.43,7
09:31,856957948.0,8141.257393335359,-104.99,2
09:33,558875206.0,1777.0912000000003,-21.97,7
09:38,891716230.0,-246.70701595870472,-39.35,4
09:39,793781222.0,1847.708878947403,-49.0,7
09:42,226703987.0,2107.065649999999,-43.39,2
09:43,930277104.0,9295.03829816721,-23.93,9
09:43,388862238.0,561.2908272385228,-8.49,4
09:44,518474507.0,12273.58865863231,-51.98,1
09:45,518474507.0,12262.345986247716,-11.24,2
09:46,812692024.0,3829.31693134288,-25.0,6
09:49,280098744.0,44.4723778716656,-9.99,4
09:49,237684254.0,5012.998623585039,-1.82,7
09:51,872286364.0,999.3816541869004,-173.0,2
09:52,478412511.0,149.00792019746075,-31.99,6
09:55,226703987.0,2034.2656499999991,-72.8,2
09:55,187541224.0,5682.834978340345,-41.99,2
09:55,822250278.0,5897.222666818142,-10.46,4
09:58,856957948.0,8055.199393335359,-86.06,2
10:02,108931112.0,11662.564071762125,-0.07,7
10:07,872286364.0,834.8816541869003,-164.5,2
10:08,822135975.0,10701.527331450134,-40.47,7
10:09,833499132.0,2019.8629000000003,-18.97,7
10:09,668692488.0,1440.984353563902,-18.48,4
10:11,414454079.0,207.17485000000184,-208.57,2
10:11,549414742.0,6200.103033715648,-17.07,2
10:13,705848712.0,22646.02680060112,-5.83,8
10:14,815385232.0,8356.553154419025,-58.39,2
10:15,793781222.0,1753.208878947403,-94.5,4
10:15,856957948.0,7944.599393335358,-110.6,2
10:17,821971408.0,1552.853721374878,-227.5,2
10:24,517934629.0,1383.5076787084265,-77.99,2
10:25,220183538.0,413.99914999999953,-15.98,4
10:25,548907062.0,629.0656887682887,-28.0,2
10:25,226703987.0,1897.1076499999992,-137.16,2
10:28,138609932.0,4055.212003294585,-12.5,4
10:28,853907490.0,6586.065693408105,-20.43,2
10:29,298000165.0,22234.491780405857,-30.35,5
10:29,224215364.0,-1615.1125920882787,-40.42,5
10:29,331450202.0,5869.115403870088,-8.65,2
10:29,822135975.0,10698.487331450133,-3.04,4
10:30,948069469.0,-926.004100000001,-93.82,5
10:30,541639148.0,3734.830550010754,-4.18,4
10:30,322221939.0,2725.213939589157,-92.97,5
10:30,762896656.0,-545.7550018481413,-23.32,5
10:31,715068825.0,398.55949999999984,-61.98,6
10:31,564214408.0,-267.0593152742738,-42.65,5
10:32,141521177.0,5874.171900000014,-15.98,2
10:32,624563756.0,-700.8035712164436,-17.66,5
10:33,256045540.0,-3194.553899999999,-38.6,5
10:34,969804197.0,-1794.9362500000009,-30.13,5
10:35,856957948.0,7848.727393335358,-95.87,2
10:36,872286364.0,677.8816541869003,-157.0,2
10:37,127809299.0,1602.0981189472843,-11.53,5
10:37,145553416.0,-2482.74565,-33.86,5
10:39,893134725.0,858.569062973209,-28.0,2
10:39,471897866.0,7241.218644039247,-72.64,4
10:40,730002588.0,11662.702917678222,-6.09,4
10:41,885259672.0,3248.2664176522385,-44.04,2
10:41,570269025.0,2056.4717833598884,-21.49,4
10:44,414454079.0,72.10285000000187,-135.07,2
10:45,987229118.0,3610.78276269448,-8.9,2
10:46,532478725.0,4114.670253767663,-19.21,7
10:47,197865285.0,150.93776173122046,-72.96,5
10:47,588565416.0,5733.543782068406,-84.98,2
10:47,943329213.0,2037.507232500588,-27.45,5
10:48,534325901.0,5472.850216119125,-18.99,9
10:48,769311479.0,5706.940814084082,-87.82,5
10:50,134847904.0,2594.626694386294,-22.0,2
10:52,506618547.0,15564.546178229146,-183.61,2
10:54,872286364.0,482.8816541869003,-195.0,2
10:57,844835978.0,8243.50027904313,-37.93,5
10:57,138609932.0,4003.2220032945847,-51.99,2
10:59,675231808.0,14061.821525245,-17.48,4
10:59,361201224.0,3950.960232067893,-138.66,5
11:00,605116158.0,2160.7527,-44.98,4
11:00,656812046.0,532.3137537325188,-93.8,2
11:01,769311479.0,5700.930814084082,-6.01,7
11:01,215311171.0,5360.662613093814,-14.98,7
11:02,441274121.0,10669.45802960032,-1.53,7
11:04,131388684.0,18904.6495650671,-40.01,5
11:05,846550094.0,812.8987405544087,-33.95,7
11:06,116169597.0,3.8269499999996697,-60.91,7
11:09,672994751.0,-259.90869241586256,-32.95,7
11:10,690523499.0,617.1641499999996,-4.99,7
11:11,284905540.0,5759.370294481904,-171.25,5
11:11,628470485.0,87.62802990012308,-22.0,6
11:13,684284526.0,-2867.911366745758,-49.63,5
11:15,627622066.0,2280.7081856930563,-25.0,2
11:15,581655972.0,37327.11886607101,-25.68,7
11:16,699139822.0,1818.6999232496896,-156.1,2
11:16,905860285.0,14845.60597463407,-38.32,2
11:16,951817450.0,8446.090556535846,-37.94,5
11:16,586315521.0,10426.218199428136,-10.32,7
11:17,973388795.0,631.7776761636217,-157.14,2
11:17,403383649.0,944.4006702776328,-139.97,5
11:17,196289502.0,13075.146748056688,-31.02,4
11:17,479366718.0,1542.5200976323997,-40.0,2
11:18,835736339.0,2191.2432404145593,-128.12,2
11:19,184430449.0,1917.982013885164,-296.1,2
11:20,388862238.0,551.3008272385227,-9.99,7
11:24,828532554.0,985.6925095129466,-31.99,2
11:25,916270283.0,1196.0282499999985,-40.99,2
11:25,290818242.0,5797.588923893838,-42.39,5
11:27,466649401.0,-169.02613427680328,-35.09,5
11:28,601627384.0,3822.846266618003,-33.67,2
11:30,690523499.0,565.9724499999996,-51.19,5
11:31,758160963.0,6739.710314944662,-69.78,5
11:31,604288474.0,2615.0326586655033,-3.1,2
11:33,822135975.0,10669.661331450134,-28.83,5
11:36,514362267.0,-684.0626808929396,-67.09,5
11:36,903953091.0,2309.4167623694675,-49.99,2
11:36,699139822.0,1629.6999232496896,-189.0,2
11:39,851181128.0,3331.677576527184,-23.38,5
11:39,698955014.0,646.2926049409122,-88.56,5
11:39,548907062.0,605.1056887682887,-23.96,1
11:40,656812046.0,227.11375373251877,-305.2,2
11:40,872286364.0,248.88165418690028,-234.0,2
11:41,975345315.0,30263.08879999996,-25.0,2
11:44,184430449.0,1645.6820138851642,-272.3,2
11:45,668329719.0,6898.988101936312,-105.71,5
11:46,668175891.0,22.84457315849913,-83.11,5
11:47,538003940.0,1472.3100000000077,-1.5,4
11:49,264550521.0,8066.869584635123,-53.21,2
11:49,221868392.0,4545.209974966569,-13.6,4
11:51,169006407.0,10196.358522517694,-16.01,1
11:53,489964679.0,18550.711233675516,-87.84,2
11:57,117308635.0,861.3124750229083,-117.07,5
11:57,914806976.0,1091.6332501854858,-25.98,2
11:58,518466565.0,-324.85090000000037,-119.82,5
11:59,134461671.0,7029.840939513799,-8.95,7
11:59,758160963.0,6649.540314944662,-90.17,2
12:00,758160963.0,6626.463195042072,-23.08,2
12:01,856957948.0,7833.757393335358,-14.97,4
12:03,661295096.0,2605.4642044119346,-105.78,5
12:05,821971408.0,1292.453721374878,-260.4,2
12:07,872286364.0,189.88165418690028,-59.0,2
12:08,656812046.0,122.11375373251876,-105.0,2
12:09,718058208.0,-227.4626829546776,-111.26,5
12:09,912705941.0,16197.064334672104,-21.95,9
12:09,742223719.0,291.0946073048027,-25.0,2
12:09,124125096.0,139.84624438780233,-40.9,5
12:10,255814263.0,3414.8142967005447,-37.99,2
12:12,414454079.0,17.530850000001863,-54.57,2
12:15,624500124.0,3006.5674783587106,-20.27,2
12:16,548907062.0,577.1156887682887,-27.99,2
12:28,699139822.0,1379.7999232496895,-249.9,2
12:39,821971408.0,1000.553721374878,-291.9,2
12:41,179173981.0,5782.770015608103,-0.17,7
12:41,321372947.0,-524.5630507890994,-19.15,5
12:46,823208989.0,263.8998669084657,-77.8,5
12:47,842682241.0,4355.133690780411,-114.07,5
12:49,657139925.0,11501.95664983454,-14.2,9
12:49,872286364.0,92.38165418690028,-97.5,2
12:54,255814263.0,3306.9246967005447,-107.89,5
12:57,760704118.0,231.7243127174885,-48.13,5
12:58,548907062.0,558.1356887682887,-18.98,2
13:01,355602925.0,973.2076195597524,-116.67,5
13:01,994214354.0,8114.388974430339,-38.44,9
13:01,699139822.0,1209.6999232496896,-170.1,2
13:02,480557476.0,9193.97628866996,-6.15,9
13:03,836110591.0,5605.393417934549,-10.99,2
13:06,348325817.0,7997.446866288857,-5.4,9
13:07,793781222.0,1624.408878947403,-128.8,4
13:07,987656636.0,5222.541465575491,-218.4,2
13:07,131388684.0,18890.67178993821,-13.98,2
13:10,845648250.0,-120.98440000000052,-130.15,5
13:10,195895574.0,6016.1959104843,-18.9,5
13:10,856957948.0,7727.357393335358,-106.4,2
13:11,736310094.0,-967.807024027426,-52.69,5
13:11,902798190.0,-1162.7226344310266,-68.8,5
13:11,322221939.0,2718.363939589157,-6.85,9
13:13,213930646.0,-1372.4711134725633,-145.93,5
13:14,226703987.0,1806.8076499999993,-90.3,2
13:15,872286364.0,47.88165418690028,-44.5,2
13:18,821971408.0,722.6537213748782,-277.9,2
13:21,277562576.0,328.1637507952724,-5.35,9
13:21,519644021.0,1839.1044377557216,-5.01,4
13:23,407574996.0,2734.7402922924985,-5.35,9
13:24,987656636.0,5083.241465575491,-139.3,2
13:24,310171581.0,-2042.91870434092,-54.07,5
13:30,793781222.0,1565.6088789474031,-58.8,7
13:32,987229118.0,3600.7927626944806,-9.99,2
13:33,226703987.0,1770.4076499999992,-36.4,2
13:34,184430449.0,1461.5820138851643,-184.1,2
13:37,872286364.0,-109.61834581309972,-157.5,2
13:37,867987292.0,3083.2482489150043,-4.86,2
13:38,414454079.0,-132.14914999999814,-118.3,2
13:38,858560423.0,10322.801645306976,-9.99,2
13:38,821971408.0,416.7537213748782,-305.9,2
13:39,152488934.0,887.6641573137307,-39.06,5
13:45,660874296.0,1402.4974499608463,-37.98,2
13:47,992204045.0,10259.00154183284,-38.39,5
13:51,872286364.0,-233.11834581309972,-123.5,2
13:51,310375875.0,2769.8367656968944,-29.19,9
13:52,897592348.0,13080.317552364351,-63.0,2
13:53,987656636.0,4999.241465575491,-84.0,2
13:57,767447966.0,3660.96862551211,-59.81,5
14:00,421881811.0,3879.33870118339,-39.02,5
14:01,786141370.0,-808.6714000000009,-66.01,5
14:01,793781222.0,1427.0088789474032,-138.6,2
14:02,849096144.0,1506.545858910517,-47.99,2
14:04,551196328.0,3737.276133942312,-57.0,2
14:05,344522228.0,-2730.1594882083928,-20.42,5
14:07,990461108.0,-140.73073137938906,-59.83,5
14:09,496395938.0,11170.564136755704,-21.99,7
14:11,699139822.0,982.1999232496896,-227.5,2
14:15,856957948.0,7595.057393335358,-132.3,2
14:16,720742759.0,538.6898308830077,-27.96,1
14:16,987656636.0,4821.441465575491,-177.8,2
14:18,857997794.0,230.5226651508873,-37.34,5
14:19,226703987.0,1721.4076499999992,-49.0,2
14:27,872286364.0,-398.1183458130997,-165.0,2
14:28,793781222.0,1276.5088789474032,-150.5,2
14:39,901037631.0,779.6193230964067,-20.05,2
14:42,699139822.0,732.9999232496896,-249.2,2
14:42,494789005.0,2308.7663337245285,-26.29,5
14:43,226703987.0,1658.4076499999992,-63.0,2
14:45,872286364.0,-582.6183458130997,-184.5,2
14:49,352899149.0,196.9896999999989,-46.94,1
14:52,558119802.0,28104.07770630986,-30.14,9
14:53,625281433.0,-939.5754073707568,-62.4,5
14:53,449871732.0,8550.852113265708,-15.98,2
14:57,793781222.0,1171.5088789474032,-105.0,2
14:58,147474476.0,3406.966496701949,-5.99,7
15:03,166019891.0,6870.902655189931,-30.53,4
15:06,226703987.0,1630.421649999999,-27.99,2
15:07,424397946.0,1848.381783605399,-12.99,2
15:08,170637730.0,2213.7104025949857,-22.07,7
15:11,184430449.0,1192.7820138851644,-268.8,2
15:16,858560423.0,10285.831645306976,-36.97,4
15:19,872286364.0,-717.6183458130997,-135.0,2
15:19,226703987.0,1589.1216499999991,-41.3,2
15:20,849096144.0,1496.555858910517,-9.99,4
15:25,166019891.0,6842.448598763315,-28.45,8
15:29,872286364.0,-931.6183458130996,-214.0,2
15:41,184430449.0,1026.1820138851645,-166.6,2
15:44,656812046.0,52.113753732518774,-70.0,2
15:46,254853117.0,2287.047226756399,-25.99,1
15:53,414454079.0,-263.0211499999981,-130.87,2
15:54,226703987.0,1498.8216499999992,-90.3,2
15:54,517190750.0,1559.8360899154125,-67.06,2
15:54,516051449.0,918.0002875167438,-29.99,4
15:55,165045150.0,-1857.308938597144,-34.86,5
15:58,821971408.0,364.2537213748782,-52.5,2
16:06,916270283.0,1174.0682499999984,-21.96,1
16:07,414454079.0,-442.8791499999981,-179.86,2
16:09,738958551.0,7581.572316185768,-36.27,9
16:14,605116158.0,2008.7727,-151.98,2
16:21,656812046.0,-73.88624626748121,-126.0,2
16:23,987656636.0,4759.0914655754905,-62.35,2
16:24,793781222.0,986.7088789474032,-184.8,2
16:25,399144202.0,1655.6063145241262,-62.27,2
16:27,872286364.0,-1067.6183458130995,-136.0,2
16:27,226703987.0,1353.2216499999993,-145.6,2
16:28,670102069.0,3009.780064235076,-28.82,9
16:28,187541224.0,5518.348978340345,-164.49,2
16:37,656812046.0,-359.4862462674812,-285.6,2
16:51,527842638.0,600.2387426329835,-34.95,1
16:55,226703987.0,1239.1496499999994,-114.07,2
16:56,872286364.0,-1251.1183458130995,-183.5,2
16:56,987656636.0,4672.99146557549,-86.1,2
17:01,793781222.0,827.8088789474033,-158.9,2
17:06,187541224.0,5381.162978340345,-137.19,2
17:07,660874296.0,1366.5174499608463,-35.98,4
17:10,308505160.0,11523.254876604307,-28.39,9
17:14,454356905.0,2005.2602247249251,-42.29,7
17:20,872286364.0,-1388.1183458130995,-137.0,2
17:24,550644516.0,-283.5008500000013,-24.23,9
17:25,678851253.0,2585.964727845319,-12.82,7
17:27,987656636.0,4439.19146557549,-233.8,2
17:28,556992209.0,9577.944625924423,-80.13,4
17:31,399144202.0,1626.7663145241263,-28.84,9
17:31,793781222.0,589.1088789474034,-238.7,2
17:36,613729471.0,6830.050786145109,-28.16,7
17:42,987656636.0,4369.19146557549,-70.0,2
17:46,809499628.0,14122.076960448754,-31.86,5
17:47,386729293.0,26445.53997967077,-49.99,6
17:47,793781222.0,526.8088789474034,-62.3,2
17:50,245690309.0,7696.208906039143,-27.67,2
17:52,187541224.0,5222.276978340345,-158.89,2
18:00,872286364.0,-1542.6183458130995,-154.5,2
18:02,510101371.0,11193.662897991508,-47.13,9
18:03,226703987.0,1064.1636499999995,-174.99,2
18:05,955035930.0,406.7834791714772,-158.62,2
18:09,656812046.0,-456.7862462674812,-97.3,2
18:15,226703987.0,1005.3636499999996,-58.8,2
18:15,187541224.0,5199.2049783403445,-23.07,2
18:20,987656636.0,4047.8914655754897,-321.3,2
18:30,535744551.0,301.2302659956264,-37.24,9
18:33,872286364.0,-1736.1183458130995,-193.5,2
18:41,226703987.0,969.6776499999996,-35.69,2
18:45,128033695.0,1181.5372695837837,-73.79,8
18:50,270374623.0,8343.2096852648,-6.99,9
18:56,408057540.0,7215.973706908458,-35.29,9
18:59,873693307.0,7497.71348959443,-15.9,9
19:13,298007503.0,205.77010362563345,-20.49,9
19:18,226703987.0,886.3776499999996,-83.3,2
19:27,454356905.0,1956.449387972683,-48.81,8
19:30,165098840.0,-844.2206263623731,-32.48,9
19:37,948558249.0,8264.947939359074,-0.44,2
19:38,899742927.0,11831.662365785942,-36.22,4
19:40,226703987.0,802.3776499999996,-84.0,2
20:23,252760664.0,5388.03844881174,-13.11,2
20:24,510101371.0,11145.511413804814,-48.15,5
20:30,547010927.0,19136.687564591517,-26.69,9
20:48,305778936.0,10646.582904336088,-20.33,5
22:52,973086490.0,8789.01678189519,-11.44,5
00:11,196289502.0,13055.166748056688,-19.98,9
00:11,887853850.0,9150.816158243182,-32.49,9
00:23,633345190.0,6454.493891714057,-2.87,2
00:29,802697323.0,18237.8094154823,-32.54,9
00:31,471897866.0,7190.983926132158,-50.23,5
00:32,785749304.0,7134.8305551621215,-13.34,9
00:33,949032480.0,4025.791615848181,-14.54,2
00:33,667367404.0,7362.154874879122,-48.49,2
00:34,586315521.0,10416.60131211441,-9.62,7
00:34,970298834.0,2224.2973064364073,-16.57,5
00:41,822135975.0,10645.55024879435,-24.11,2
00:42,441274121.0,10665.762739960875,-3.7,2
00:43,851649498.0,8628.029990434192,-50.44,7
00:43,556631012.0,228.05892308567823,-37.3,9
00:48,949032480.0,4007.421615848182,-18.37,9
00:51,237493332.0,12020.834800986418,-0.36,2
00:53,950234174.0,668.8738230846212,-4.55,7
00:53,282837512.0,11456.364795218386,-29.23,9
00:54,264550521.0,8065.305522869555,-1.56,7
00:58,705848712.0,22645.047270597195,-0.98,4
01:00,851181128.0,3306.307576527184,-25.37,9
01:00,221868392.0,4529.911915922873,-15.3,4
01:01,651756497.0,9712.706054398952,-37.1,4
01:03,147474476.0,3372.5778651193596,-34.39,2
01:12,647936800.0,929.1198605660676,-53.1,7
01:15,388862238.0,550.479652623988,-0.82,5
01:17,519644021.0,1830.1465686530264,-8.96,5
01:28,824916823.0,7390.944147335621,-39.18,9
01:30,383625050.0,5089.679952238085,-23.0,7
01:35,116598243.0,1646.7436121048936,-2.65,2
01:36,604288474.0,2596.548404339681,-18.48,7
01:38,769311479.0,5673.367769517879,-27.56,7
01:39,836110591.0,5571.19991263595,-34.19,8
01:39,897714622.0,8128.581073316422,-53.29,8
01:45,858989281.0,23211.577932934135,-12.95,9
01:47,108481285.0,6856.539424088997,-72.89,2
01:54,699139822.0,684.1327724774576,-48.87,4
01:55,581655972.0,37261.610183288125,-65.51,5
01:56,785749304.0,7112.646036014639,-22.18,2
01:59,824916823.0,7381.254807357203,-9.69,2
02:02,985188462.0,184.6062487112247,-41.29,9
02:11,704517789.0,14949.938570324352,-6.38,7
02:11,124102251.0,3242.5870562767604,-2.2,2
02:15,117308635.0,825.3738899072963,-35.94,4
02:17,518474507.0,12229.605986247716,-32.74,9
02:20,876890798.0,1713.49142069993,-40.84,9
02:21,541639148.0,3720.9392755326494,-13.89,7
02:22,572384506.0,8600.808259958349,-33.92,9
02:26,409971170.0,1405.457714336976,-28.04,9
02:41,305778936.0,10623.182904336089,-23.4,9
02:46,912705941.0,16161.758402957092,-35.31,2
02:49,705848712.0,22623.647270597194,-21.4,9
02:52,195895574.0,5989.7459104843,-26.45,9
02:52,679662108.0,13227.781435146744,-27.01,7
03:00,836110591.0,5522.1099126359495,-49.09,9
03:02,383833857.0,20689.48008494435,-4.19,7
03:03,795847804.0,19746.365672068587,-4.18,7
03:05,433917275.0,6965.263670223291,-6.56,5
03:06,809499628.0,14098.886960448754,-23.19,9
03:09,421881811.0,3803.7771823647295,-75.56,5
03:14,832564361.0,13636.471908340029,-17.2,9
03:15,176922958.0,-211.79045280235056,-34.74,9
03:16,994214354.0,8076.898974430339,-37.49,9
03:17,221868392.0,4505.331915922873,-24.58,9
03:30,558119802.0,28052.951933997247,-51.13,2
03:33,858989281.0,23199.71729441409,-11.86,2
03:36,532478725.0,4088.650253767663,-26.02,9
03:37,809499628.0,14078.971875692763,-19.92,7
03:39,853907490.0,6573.901269088808,-12.16,7
03:41,668329719.0,6872.561804125582,-26.43,2
03:42,229205098.0,6049.285625182237,-72.7,2
03:51,305778936.0,10597.64085570569,-25.54,4
03:56,308505160.0,11514.847003867491,-8.41,5
03:58,407574996.0,2704.9402922924983,-29.8,9
04:00,113747882.0,10282.157379121682,-6.61,2
04:07,822250278.0,5839.557304750712,-57.67,5
04:07,678851253.0,2526.5397782802083,-59.42,2
04:08,187541224.0,5159.024978340344,-40.18,9
04:13,851181128.0,3268.2751084298775,-38.03,7
04:16,482513594.0,5001.597682269765,-25.86,2
04:20,170233640.0,-1220.5364100501029,-23.65,9
04:20,435984758.0,4372.6006096091905,-32.22,2
04:22,256002321.0,5978.330582009661,-22.0,9
04:25,940569402.0,4987.232917041856,-10.24,9
04:25,670102069.0,2968.090064235076,-41.69,9
04:39,752362502.0,8067.561746352885,-0.02,2
04:39,259015404.0,2874.665641518451,-35.3,9
04:43,823208989.0,218.4714338695314,-45.43,7
04:43,216285378.0,20580.569384634924,-38.32,9
04:47,287480331.0,10813.826417716247,-29.14,9
04:48,874431242.0,7119.009258856455,-50.08,7
04:49,534325901.0,5443.259393689349,-29.59,7
04:50,252760664.0,5381.006508356604,-7.03,2
04:51,407574996.0,2697.4603530225736,-7.48,7
04:54,873693307.0,7440.892094960741,-56.82,8
04:59,905860285.0,14828.941764300682,-16.66,2
05:02,887853850.0,9147.06687060074,-3.75,8
05:05,940569402.0,4954.516229197371,-32.72,4
05:08,706250160.0,9557.739819207289,-2.09,4
05:09,987656636.0,3994.740994237396,-53.15,2
05:12,146909202.0,3762.955374294303,-60.21,2
05:13,169006407.0,10141.51473050026,-54.84,4
05:16,719586818.0,16432.32686709555,-1.78,2
05:22,195895574.0,5969.4088053332,-20.34,2
05:33,532478725.0,4087.088451666552,-1.56,8
05:33,687135796.0,23104.3221684602,-19.94,9
05:34,842682241.0,4331.074910265471,-24.06,5
05:34,259015404.0,2841.336793687055,-33.33,2
05:38,450896297.0,11631.31056770978,-33.44,9
05:43,973086490.0,8763.81678189519,-25.2,9
05:43,213112754.0,6191.554856215735,-7.74,2
05:44,290818242.0,5790.674406103733,-6.91,7
05:48,203466392.0,1286.1416783932568,-46.76,7
05:48,322720763.0,6495.025017131842,-23.18,7
05:49,992204045.0,10230.156890048616,-28.84,2
05:50,943329213.0,1983.0009325461615,-54.51,7
05:55,549414742.0,6162.853033715648,-37.25,9
05:56,145387690.0,4590.6681451689565,-23.28,5
05:59,583579399.0,411.7722999999991,-42.13,9
06:09,601627384.0,3785.366266618003,-37.48,9
06:14,973086490.0,8762.487009489781,-1.33,4
06:15,364357875.0,5585.594389429561,-66.06,5
06:16,287480331.0,10792.897879881,-20.93,2
06:17,108563213.0,20282.74087921275,-10.5,8
06:20,108931112.0,11631.984071762125,-30.58,9
06:21,984783496.0,12298.649970916142,-56.83,7
06:22,187111705.0,5383.717977188893,-28.11,2
06:28,324224854.0,1055.0033546632606,-16.75,5
06:30,613729471.0,6802.24287023843,-27.81,7
06:35,764450279.0,16754.557348495,-42.2,2
06:40,366550080.0,22539.914060891875,-24.11,7
06:40,865748375.0,2795.8518425373636,-20.44,2
06:42,489964679.0,18511.961233675516,-38.75,9
06:46,709608057.0,2347.821350799976,-43.28,9
06:48,409971170.0,1375.49054663056,-29.97,5
06:50,235881534.0,10858.3023709208,-40.89,2
06:55,779236304.0,-39.36240452046751,-42.09,9
06:59,473820682.0,10191.349854014125,-4.85,7
06:59,779946617.0,14470.590523752831,-3.75,2
07:02,899742927.0,11782.390992975012,-49.27,7
07:05,151968462.0,6930.693030287801,-0.12,7
07:06,417850087.0,14867.64101440988,-33.79,7
07:08,408057540.0,7167.617765260709,-48.36,7
07:11,844835978.0,8236.597754161941,-6.9,7
07:13,370521542.0,22651.837640768907,-5.67,5
07:14,506618547.0,15544.900919897736,-19.65,2
07:16,116598243.0,1641.3436121048935,-5.4,9
07:17,738958551.0,7559.162088650688,-22.41,7
07:19,331450202.0,5856.521109633879,-12.59,5
07:19,494789005.0,2281.491429906967,-27.27,2
07:24,749378808.0,4590.286659904391,-11.55,2
07:27,496395938.0,11149.669650978942,-20.89,7
07:28,758160963.0,6596.887640928525,-29.58,2
07:29,143003091.0,19317.71087528838,-18.65,2
07:30,815385232.0,8330.994500216653,-25.56,2
07:33,683319988.0,6287.686445638516,-40.4,9
07:34,709608057.0,2333.648341839399,-14.17,7
07:37,832564361.0,13596.324493451648,-40.15,2
07:40,449871732.0,8539.952523277616,-10.9,2
07:41,399144202.0,1599.5963145241262,-27.17,9
07:41,511179916.0,4916.263602922889,-1.74,5
07:49,730002588.0,11640.858052740845,-21.84,5
07:51,587225252.0,8561.376868842726,-67.86,2
07:55,237684254.0,4995.848464112466,-17.15,5
07:56,570323670.0,3086.530406172035,-21.69,5
07:56,179173981.0,5727.294579030625,-55.48,8
07:57,609939116.0,5607.990073400206,-1.09,8
07:59,108931112.0,11623.293223042456,-8.69,7
07:59,128033695.0,1135.6453026620527,-45.89,7
08:01,183888402.0,15360.799575902682,-38.78,9
08:01,994214354.0,8070.577718223132,-6.32,4
08:08,322221939.0,2713.406574075761,-4.96,5
08:09,885259672.0,3242.3164176522387,-5.95,9
08:09,395284483.0,996.2540883964832,-5.3,9
08:10,215311171.0,5343.438260771758,-17.22,7
08:15,480557476.0,9161.62501599404,-32.35,7
08:17,930277104.0,9251.602898747264,-43.44,5
08:22,252701364.0,-3443.8986726779167,-16.56,5
08:22,482513594.0,4981.297682269765,-20.3,5
08:24,586315521.0,10327.22531211441,-89.38,5
08:25,170233640.0,-1295.5085100501028,-74.97,5
08:25,146686559.0,-642.0960111734777,-26.57,5
08:26,996042490.0,4276.907696170785,-62.4,5
08:26,889916166.0,-176.1165985867733,-78.68,5
08:27,355733816.0,3960.366958092039,-2.6,2
08:27,616924659.0,-339.3104201769146,-24.05,5
08:28,491392945.0,3262.025500000005,-17.5,5
08:29,131388684.0,18889.365012777173,-1.31,2
08:30,890196840.0,-2674.313816675131,-46.78,5
08:30,979135922.0,-1875.6566994095492,-40.99,5
08:32,782013626.0,-70.76180068837229,-37.51,5
08:33,151278285.0,-523.5246500000004,-114.97,5
08:35,783650950.0,-1279.9426434110114,-121.09,5
08:36,493855007.0,-2475.449131574393,-27.79,5
08:36,639549973.0,5793.16320788047,-21.17,7
08:37,954263768.0,-429.81200000000024,-29.93,5
08:39,554792076.0,24005.00746394803,-52.99,5
08:40,679662108.0,13139.056435146744,-88.72,5
08:40,853907490.0,6519.315269088807,-54.59,5
08:40,651372390.0,-3298.210749999999,-50.98,5
08:41,450896297.0,11601.436155892889,-29.87,5
08:41,200080192.0,8235.654940781058,-4.19,7
08:41,298000165.0,22180.549780405858,-53.94,5
08:41,892354433.0,-1667.7199606343386,-25.76,5
08:42,699997811.0,875.4944000000033,-16.94,5
08:43,280200287.0,-579.210453386949,-49.92,5
08:44,762785862.0,699.6357499999996,-112.58,5
08:44,867679563.0,-150.37914629828418,-17.02,5
08:46,331450202.0,5801.053109633879,-55.47,5
08:46,895331556.0,-953.4141000000008,-51.13,5
08:47,336171116.0,-820.5681000000005,-96.28,5
08:47,478986718.0,-1121.4524000000004,-34.82,5
08:50,494404688.0,-2444.8732653362076,-25.97,5
08:52,237493332.0,12000.814800986418,-20.02,5
08:54,291128777.0,-2583.40644052637,-14.31,5
08:54,535804582.0,-1146.958450000001,-129.06,5
08:55,821971408.0,356.5677213748782,-7.69,5
08:56,898104045.0,-1691.233050000002,-93.24,5
08:58,605711527.0,-527.0274861674164,-165.14,5
08:59,456246119.0,17886.18903452125,-141.39,5
08:59,383833857.0,20651.19008494435,-38.29,5
09:00,887156614.0,-1243.8648210407734,-151.76,5
09:00,886921642.0,2826.527874317425,-45.44,5
09:02,455831435.0,-1764.3896048014944,-42.41,5
09:03,558875206.0,1771.3912000000005,-5.7,9
09:04,108563213.0,20217.91387921275,-64.83,5
09:04,534204159.0,4886.829882146301,-31.29,8
09:04,479366718.0,1506.0714476323997,-36.45,5
09:05,138609932.0,3997.522003294585,-5.7,9
09:05,690958123.0,17139.934860035373,-5.15,9
09:08,675806859.0,5229.992788179146,-39.36,5
09:09,749371623.0,-2524.4216535173427,-57.41,5
09:11,792845450.0,444.88315000000085,-133.06,5
09:11,124377686.0,-2490.1923999999985,-18.96,5
09:12,345514953.0,690.343249999999,-125.7,5
09:12,844206657.0,-194.6239448534302,-79.12,5
09:12,812012103.0,-606.1193000000005,-98.28,5
09:13,506618547.0,15539.600919897735,-5.3,9
09:14,106601471.0,8752.916086223111,-16.0,7
09:15,639549973.0,5695.59720788047,-97.57,5
09:15,960208650.0,14812.43101353064,-36.9,5
09:17,851649498.0,8622.429990434191,-5.6,9
09:18,290818242.0,5783.174406103733,-7.5,9
09:19,973388795.0,618.7876761636217,-12.99,7
09:20,117273481.0,7421.193671905959,-5.0,9
09:20,322221939.0,2703.336454075761,-10.07,4
09:21,667367404.0,7357.054874879122,-5.1,9
09:22,659415300.0,2110.005340250703,-115.53,5
09:22,799861885.0,461.37144999999896,-79.92,5
09:22,964702094.0,1223.9779228782895,-26.96,1
09:22,540159353.0,9439.282568699398,-5.2,9
09:24,865748375.0,2782.8518425373636,-13.0,2
09:25,995615876.0,1438.6962396983886,-12.99,2
09:26,117308635.0,804.3238899072963,-21.05,7
09:26,901432314.0,3333.5413363227935,-42.5,5
09:26,259015404.0,2678.656793687055,-162.68,2
09:27,454356905.0,1934.1121079726831,-22.34,4
09:28,298000165.0,22134.579780405857,-45.97,4
09:28,169006407.0,10007.84273050026,-133.67,5
09:29,950234174.0,584.3138230846212,-84.56,2
09:30,246753533.0,237.6241999999988,-12.36,5
09:30,392270893.0,10655.00393667416,-141.44,5
09:30,285220959.0,10119.607044787745,-22.39,2
09:30,214765415.0,-754.3310988501354,-144.7,5
09:31,282837512.0,11439.106785218386,-17.26,4
09:32,960208650.0,14642.29101353064,-170.14,2
09:36,659415300.0,2038.0153402507028,-71.99,2
09:36,551755686.0,6645.006585195962,-133.0,2
09:36,637649383.0,227.99649999999835,-76.33,5
09:36,522188082.0,6500.627256378378,-34.95,5
09:37,298007503.0,188.54010362563344,-17.23,7
09:39,215404070.0,3.9475891798497,-155.37,2
09:40,287480331.0,10746.969199881,-45.93,4
09:43,456246119.0,17764.199034521247,-121.99,6
09:44,550169791.0,17988.474386176815,-43.64,5
09:44,548907062.0,549.1556887682887,-8.98,4
09:47,426474982.0,-3496.09975,-52.87,5
09:47,595800644.0,-1157.6759000000002,-89.48,5
09:48,964702094.0,1148.0681728782895,-75.91,5
09:50,252760664.0,5337.074508356604,-43.93,5
09:51,383833857.0,20632.810084944347,-18.38,1
09:56,551755686.0,6374.806585195962,-270.2,2
09:57,366550080.0,22509.46406089187,-30.45,4
09:58,548907062.0,524.1556887682887,-25.0,2
10:00,448004226.0,2036.4146619306052,-8.98,4
10:01,399144202.0,1593.325105277456,-6.27,4
10:02,120634201.0,4331.871500000005,-128.8,2
10:04,727417797.0,4145.411500000008,-5.99,2
10:06,925037906.0,1144.0248000000015,-63.75,2
10:07,548907062.0,498.17568876828864,-25.98,2
10:08,779946617.0,14425.420523752831,-45.17,2
10:10,550832673.0,2137.6751344744066,-61.52,5
10:10,812692024.0,3644.51693134288,-184.8,2
10:10,215404070.0,-185.02441082015028,-188.97,2
10:11,766941757.0,7710.19165420135,-57.52,4
10:12,522188082.0,6409.424256378377,-91.2,5
10:12,766941757.0,7667.15165420135,-43.04,9
10:12,474951915.0,-2446.2810952340124,-24.8,5
10:18,726913482.0,-1140.374898526476,-103.36,5
10:20,659415300.0,2032.2153402507029,-5.8,9
10:21,767447966.0,3580.83862551211,-80.13,2
10:26,812692024.0,3617.94493134288,-26.57,2
10:27,570323670.0,3052.510406172035,-34.02,2
10:27,933491926.0,2289.986300000001,-15.98,4
10:27,279149837.0,530.6250499999989,-5.99,1
10:28,960208650.0,14479.161013530642,-163.13,2
10:30,527842638.0,524.2687426329835,-75.97,4
10:35,128033695.0,1115.1826626620527,-20.46,4
10:35,162162212.0,-458.1764566726912,-15.98,1
10:37,925037906.0,1040.8998000000015,-103.12,2
10:41,170637730.0,2183.6063995564355,-30.1,8
10:42,933491926.0,2259.036300000001,-30.95,7
10:44,899742927.0,11563.444992975012,-218.95,5
10:45,259015404.0,2423.856793687055,-254.8,2
10:45,405416860.0,1556.045753863785,-62.98,2
10:47,779376323.0,2626.4332158201264,-60.0,2
10:54,657139925.0,11469.08495075099,-32.87,5
10:54,925037906.0,973.3998000000016,-67.5,2
10:54,549414742.0,6153.689053715648,-9.16,4
10:55,549414742.0,6152.763232901846,-0.93,8
10:58,520447032.0,7792.64745525582,-24.18,5
11:00,170637730.0,2168.4710995564355,-15.14,4
11:01,259015404.0,2284.556793687055,-139.3,2
11:01,670102069.0,2955.8900642350764,-12.2,7
11:08,421881811.0,3582.6051823647294,-221.17,2
11:13,828532554.0,954.913101366072,-30.78,7
11:15,215404070.0,-367.02441082015025,-182.0,2
11:24,779376323.0,2501.9332158201264,-124.5,2
11:25,421881811.0,3560.2331823647296,-22.37,2
11:26,120634201.0,4081.271500000005,-250.6,2
11:29,215404070.0,-543.3964108201502,-176.37,2
11:29,925037906.0,921.2748000000016,-52.12,2
11:30,456246119.0,17757.209034521245,-6.99,4
11:31,143003091.0,19245.720875288374,-71.99,2
11:34,551755686.0,6180.906585195962,-193.9,2
11:39,984783496.0,12235.327970916142,-63.32,5
11:41,259015404.0,1998.9567936870549,-285.6,2
11:52,441142605.0,2281.8722500000044,-16.97,7
11:53,779376323.0,2377.4332158201264,-124.5,2
11:58,849096144.0,1418.565858910517,-77.99,2
12:02,737645298.0,-2436.511699999999,-22.0,9
12:03,812692024.0,3416.35893134288,-201.59,2
12:07,421881811.0,3372.64718236473,-187.59,2
12:09,925037906.0,814.7748000000015,-106.5,2
12:11,233981231.0,1539.5627391616956,-79.98,4
12:16,779376323.0,2282.4332158201264,-95.0,2
12:17,553734946.0,199.63869999999895,-99.99,6
12:20,776431321.0,2611.9899344985474,-51.97,4
12:23,521611005.0,-289.19143585104655,-17.54,5
12:24,120634201.0,3899.9715000000047,-181.3,2
12:24,812692024.0,3223.90093134288,-192.46,2
12:25,461029994.0,5685.034420336354,-79.91,5
12:26,402438092.0,406.7811999999991,-16.2,9
12:28,421881811.0,3208.16118236473,-164.49,2
12:31,479456865.0,929.0902314894048,-29.99,2
12:31,145387690.0,4572.328145168956,-18.34,9
12:44,348325817.0,7964.556866288856,-32.89,9
12:44,108812033.0,437.16564999999866,-93.01,5
12:44,907987693.0,-2328.1444999999994,-39.12,5
12:46,441142605.0,2192.6222500000044,-89.25,2
12:47,129018172.0,6918.5258877526085,-81.98,2
12:50,936813994.0,-330.17978916721165,-114.25,5
12:52,823208989.0,149.9514338695314,-68.52,2
12:52,819515373.0,1593.9511360637907,-7.98,4
12:54,444371478.0,376.6065999999988,-47.02,5
13:00,551755686.0,6076.606585195962,-104.3,2
13:01,849096144.0,1413.465858910517,-5.1,9
13:07,310620484.0,-172.53580490780166,-40.39,9
13:08,688712152.0,5011.371582591819,-7.15,9
13:08,834383043.0,4540.585185073416,-27.84,2
13:09,344843570.0,-591.3043175093338,-39.72,5
13:10,532525712.0,-560.5318000000004,-17.32,5
13:14,259015404.0,1751.856793687055,-247.1,2
13:15,256002321.0,5929.330582009661,-49.0,2
13:15,348325817.0,7908.712048852107,-55.84,8
13:19,675806859.0,5194.124788179146,-35.87,5
13:19,480557476.0,9046.18101599404,-115.44,5
13:19,696758548.0,-3188.0428963201375,-60.99,5
13:24,538003940.0,1320.3100000000077,-152.0,2
13:26,401293808.0,-449.2409500000008,-201.53,5
13:31,744211756.0,-3838.9457499999944,-44.69,5
13:32,779376323.0,2202.4332158201264,-80.0,2
13:33,198946608.0,5101.297736086325,-10.95,8
13:33,551755686.0,5965.306585195962,-111.3,2
13:35,441142605.0,2118.7472500000044,-73.88,2
13:39,670102069.0,2923.155565500382,-32.73,2
13:41,259015404.0,1626.556793687055,-125.3,2
13:42,522188082.0,6380.734256378378,-28.69,9
13:42,613427466.0,5387.408905655876,-6.99,7
13:43,538003940.0,1192.8100000000077,-127.5,2
13:44,779376323.0,1946.9332158201264,-255.5,2
13:44,256002321.0,5789.344582009661,-139.99,2
13:45,655450953.0,-2611.4873784555302,-54.76,5
13:47,925037906.0,768.2748000000015,-46.5,2
13:47,120634201.0,3823.671500000005,-76.3,2
13:50,259015404.0,1350.056793687055,-276.5,2
14:00,358836279.0,80.50069280758602,-71.12,5
14:04,538003940.0,1157.8100000000077,-35.0,2
14:05,925037906.0,682.0248000000015,-86.25,2
14:08,120634201.0,3603.871500000004,-219.8,2
14:09,779376323.0,1869.9332158201264,-77.0,2
14:14,421881811.0,3134.01718236473,-74.14,2
14:15,256002321.0,5660.558582009661,-128.79,2
14:16,441142605.0,2019.7472500000044,-99.0,2
14:16,256002321.0,5658.509408612032,-2.05,5
14:19,195895574.0,5900.1228053332,-69.29,2
14:21,259015404.0,1239.456793687055,-110.6,2
14:29,925037906.0,584.5248000000015,-97.5,2
14:33,548907062.0,443.1856887682886,-54.99,2
14:33,256002321.0,5553.523408612032,-104.99,2
14:36,299871610.0,-243.89434694123332,-55.01,5
14:37,180616589.0,223.45764803395403,-11.9,5
14:40,538003940.0,1122.8100000000077,-35.0,2
14:43,779376323.0,1732.9332158201264,-137.0,2
14:46,441142605.0,1915.8722500000044,-103.88,2
14:51,256002321.0,5518.523408612032,-35.0,2
14:53,925037906.0,493.0248000000015,-91.5,2
15:01,441142605.0,1889.9972500000044,-25.88,2
15:12,779376323.0,1633.9332158201264,-99.0,2
15:12,556992209.0,9567.944625924423,-10.0,2
15:14,256002321.0,5440.137408612031,-78.39,2
15:14,535744551.0,264.64026599562635,-36.59,9
15:16,259015404.0,1030.1567936870551,-209.3,2
15:16,399538448.0,6829.638712652367,-19.98,4
15:17,812692024.0,2980.34293134288,-243.56,2
15:21,120634201.0,3323.1715000000045,-280.7,2
15:22,970298834.0,2164.187306436407,-60.11,2
15:31,108481285.0,6803.489424088997,-53.05,2
15:34,256002321.0,5340.051408612031,-100.09,2
15:37,399144202.0,1582.561045277456,-10.76,4
15:43,925037906.0,476.1498000000015,-16.88,2
15:44,742223719.0,144.60175730480267,-146.49,5
15:44,259015404.0,730.5567936870552,-299.6,2
15:49,678330503.0,1341.6195093216909,-43.72,8
15:50,812692024.0,2782.2569313428803,-198.09,2
15:52,441142605.0,1758.1477000000043,-131.85,5
15:54,256002321.0,5307.165408612031,-32.89,2
15:57,925037906.0,398.1498000000015,-78.0,2
16:00,421881811.0,2905.84518236473,-228.17,2
16:06,441142605.0,1740.1577000000043,-17.99,4
16:08,321372947.0,-555.9111507890995,-31.35,5
16:10,259015404.0,570.2567936870553,-160.3,2
16:11,779376323.0,1566.4332158201264,-67.5,2
16:14,925037906.0,316.7748000000015,-81.38,2
16:18,792845450.0,354.89315000000084,-89.99,2
16:21,256002321.0,5251.193408612031,-55.97,2
16:26,632065391.0,-2335.8786499999997,-108.65,5
16:27,925037906.0,257.1498000000015,-59.62,2
16:28,348325817.0,7744.408048852107,-164.3,5
16:31,880546403.0,-1042.8346500000016,-92.11,5
16:36,631111289.0,-962.4515000000006,-26.92,5
16:39,256002321.0,5104.193408612031,-147.0,2
16:46,613427466.0,5332.438905655876,-54.97,4
16:49,310375875.0,2709.938167855349,-59.9,5
16:50,779376323.0,1449.9332158201264,-116.5,2
16:51,345582855.0,-883.9000471794508,-58.88,5
16:53,551755686.0,5798.006585195962,-167.3,7
16:53,256002321.0,4952.293408612031,-151.9,2
16:55,553734946.0,114.70489999999894,-84.93,5
16:58,376271050.0,624.3602468611793,-31.98,4
17:00,964702094.0,1124.9813767276416,-23.09,5
17:02,551755686.0,5638.406585195961,-159.6,7
17:04,785210466.0,1541.235427560572,-40.92,5
17:06,305778936.0,10574.780855705689,-22.86,2
17:07,286484726.0,289.725476947126,-51.99,5
17:09,433917275.0,6930.833670223291,-34.43,9
17:11,124102251.0,3232.6370562767606,-9.95,9
17:12,478412511.0,-126.24222980253928,-275.25,5
17:14,785210466.0,1534.245427560572,-6.99,4
17:14,414805878.0,12504.23581992926,-0.23,8
17:14,500843551.0,95.13139999999972,-43.89,9
17:16,653640811.0,14390.453373586071,-18.99,1
17:16,120634201.0,3261.4035000000044,-61.77,5
17:17,807714284.0,452.2303607360001,-86.89,5
17:20,779376323.0,1312.9332158201264,-137.0,2
17:21,891716230.0,-248.20701595870472,-1.5,4
17:22,310375875.0,2669.471167855349,-40.47,5
17:23,373875019.0,13776.638523365682,-22.03,5
17:25,259015404.0,507.95679368705527,-62.3,2
17:26,633345190.0,6433.543891714057,-20.95,2
17:26,683319988.0,6266.384811613456,-21.3,7
17:28,510101371.0,11103.421413804814,-42.09,9
17:28,235881534.0,10816.6173709208,-41.69,5
17:28,670427480.0,1532.243550000001,-62.98,2
17:29,287230540.0,714.4744326671557,-25.97,2
17:29,348325817.0,7730.968048852107,-13.44,2
17:31,138609932.0,3955.632003294585,-41.89,9
17:33,857754342.0,1773.8390218916709,-81.97,2
17:36,256002321.0,4728.293408612031,-224.0,2
17:41,414805878.0,12472.49581992926,-31.74,9
17:42,548907062.0,373.1956887682886,-69.99,2
17:44,596463612.0,-1176.9951047251395,-15.13,5
17:44,955035930.0,399.7934791714772,-6.99,4
17:45,491392945.0,3256.0355000000054,-5.99,2
17:45,858989281.0,23186.17729441409,-13.54,1
17:45,417850087.0,14712.031014409878,-155.61,5
17:48,667367404.0,7318.727174879122,-38.33,4
17:49,587202562.0,-34.282900582931404,-101.43,5
17:49,259015404.0,257.3567936870553,-250.6,2
17:51,200080192.0,8219.554940781058,-16.1,1
17:53,581618317.0,-4550.261701873207,-34.77,5
17:55,215404070.0,-807.2684108201502,-263.87,2
17:58,256002321.0,4615.621408612032,-112.67,2
18:00,925037906.0,178.3998000000015,-78.75,2
18:00,163470640.0,305.3371999999998,-162.97,2
18:01,554771381.0,-1699.51365,-31.49,9
18:03,668692488.0,1403.754353563902,-37.23,9
18:04,736340277.0,7292.422787223335,-41.99,5
18:04,604334058.0,-145.69470000000055,-133.27,5
18:05,520447032.0,7769.71745525582,-22.93,9
18:10,518474507.0,12171.071917150635,-58.53,5
18:13,487051121.0,205.3143164045101,-8.87,2
18:17,876890798.0,1581.00142069993,-132.49,2
18:17,551755686.0,5426.306585195961,-212.1,2
18:18,785749304.0,7000.646036014639,-112.0,2
18:19,256002321.0,4517.677408612031,-97.94,2
18:19,510101371.0,11092.083223150375,-11.34,2
18:23,442070890.0,459.212412444371,-17.14,5
18:27,517190750.0,1509.0310899154124,-50.8,5
18:29,315546581.0,23849.54702708335,-15.47,5
18:30,551755686.0,5191.806585195961,-234.5,2
18:31,741903302.0,2262.6296979884796,-3.49,7
18:32,130154096.0,810.7376105489657,-154.89,5
18:35,925037906.0,104.5248000000015,-73.88,2
18:37,919185264.0,3601.384722887972,-72.2,5
18:46,241459011.0,539.5159132723472,-37.75,5
18:46,256002321.0,4360.891408612031,-156.79,2
18:46,565175333.0,-3275.458522729827,-12.2,5
18:50,213096759.0,-1590.3201082144396,-103.47,5
18:50,856461967.0,-588.9816464705075,-129.93,5
18:53,762859681.0,-725.789900000001,-24.16,5
18:54,785749304.0,6930.646036014639,-70.0,2
18:56,914806976.0,1046.6632501854858,-44.97,7
18:57,766692943.0,-1904.9617500000004,-48.68,5
18:59,925037906.0,75.2748000000015,-29.25,2
19:10,198630866.0,-537.5101235612685,-128.9,5
19:11,895750759.0,-837.5537380756658,-43.05,9
19:15,901432314.0,3323.6513363227937,-9.89,9
19:19,214339619.0,-169.3290491316436,-36.28,5
19:19,264208990.0,355.099449999999,-66.99,5
19:23,987163717.0,5388.390320000006,-32.62,9
19:26,687135796.0,23079.999235267176,-24.32,2
19:27,291580432.0,-914.5759499999996,-38.88,5
19:28,204855464.0,-1566.7609386396157,-276.23,5
19:28,977899503.0,-1339.7971064191474,-71.57,5
19:30,534097839.0,-4197.361049999999,-23.46,5
19:32,547010927.0,19102.647564591516,-34.04,9
19:32,925037906.0,-3.4751999999984946,-78.75,2
19:39,200080192.0,8126.090940781058,-93.46,5
19:39,624500124.0,2934.3974783587105,-72.17,5
19:41,166019891.0,6835.462598763315,-6.99,5
19:44,280268430.0,4411.744239937472,-26.09,2
19:51,679911053.0,1617.7644078122753,-0.28,2
19:54,493571342.0,-2330.1108809070483,-21.59,5
19:56,534325901.0,5425.059393689349,-18.2,9
19:57,166019891.0,6823.5125987633155,-11.95,9
19:59,555393405.0,-1171.80895,-30.14,9
19:59,256002321.0,4282.981408612031,-77.91,5
20:03,482513594.0,4916.491682269765,-64.81,5
20:05,113747882.0,10248.277379121682,-33.88,9
20:09,925037906.0,-104.3501999999985,-100.88,2
20:18,500043411.0,11704.950717098767,-0.59,5
20:18,627936697.0,498.5705499999998,-151.3,5
20:21,512989907.0,-2234.8144039753665,-48.17,5
20:29,277562576.0,224.4769507952724,-103.69,5
20:40,633345190.0,6397.8438917140575,-35.7,9
20:45,699139822.0,655.8927724774576,-28.24,9
20:48,690958123.0,17034.808860035373,-105.13,5
21:03,277562576.0,200.71869822495512,-23.76,5
00:23,252760664.0,5309.31806556395,-27.76,2
00:24,766941757.0,7643.86165420135,-23.29,9
00:25,399144202.0,1553.831045277456,-28.73,9
00:30,984783496.0,12222.38797091614,-12.94,9
00:56,613729471.0,6771.112147107397,-31.13,7
00:58,738958551.0,7532.372666684379,-26.79,7
01:02,399144202.0,1528.3145356145876,-25.52,8
01:05,284905540.0,5757.825234574976,-1.55,2
01:33,480557476.0,8994.278365489667,-51.9,2
01:54,973086490.0,8748.563287597412,-13.92,7
02:44,873693307.0,7427.59925773825,-13.29,8
02:48,237493332.0,11994.824800986418,-5.99,9
02:57,687135796.0,23068.019235267177,-11.98,9
03:01,550169791.0,17930.29265761902,-58.18,7
03:03,802697323.0,18201.869415482302,-35.94,9
03:06,842682241.0,4322.497629290881,-8.58,5
03:07,609939116.0,5561.737943483722,-46.25,7
03:11,984783496.0,12201.590876085464,-20.8,2
03:19,237493332.0,11967.014759082793,-27.81,2
03:20,315546581.0,23818.41112322529,-31.14,2
03:24,859603181.0,2823.3065630554547,-11.07,7
03:33,366550080.0,22482.07543309985,-27.39,8
03:38,822250278.0,5836.874813823793,-2.68,7
03:39,510101371.0,11056.903223150375,-35.18,9
03:41,169006407.0,9990.201696247534,-17.64,7
03:42,749378808.0,4557.616659904391,-32.67,9
03:47,417850087.0,14683.854428240003,-28.18,8
03:54,985188462.0,152.4162487112247,-32.19,9
03:57,146909202.0,3745.614199296325,-17.34,2
04:02,290818242.0,5768.203945813742,-14.97,5
04:06,769311479.0,5669.725149023853,-3.64,8
04:07,216285378.0,20548.679384634925,-31.89,9
04:09,675806859.0,5152.17697569961,-41.95,4
04:10,370521542.0,22632.097640768905,-19.74,9
04:16,683319988.0,6258.9825696895805,-7.4,8
04:16,128033695.0,1088.0326626620526,-27.15,9
04:19,851181128.0,3245.2851084298777,-22.99,9
04:19,270374623.0,8334.87315970034,-8.34,7
04:20,409971170.0,1375.3035592781348,-0.19,2
04:20,195895574.0,5865.8328053332,-34.29,9
04:29,187541224.0,5128.044978340345,-30.98,9
04:30,897714622.0,8079.275061040033,-49.31,2
04:33,682194230.0,-2079.4083500000006,-24.19,9
04:35,549414742.0,6117.873232901846,-34.89,9
04:39,886921642.0,2740.3305700989804,-86.2,7
04:42,639409800.0,30080.811791343156,-34.96,2
04:42,300095518.0,488.8912283414176,-21.93,9
04:43,719586818.0,16394.558067408558,-37.77,5
04:43,836110591.0,5488.41991263595,-33.69,9
04:43,678330503.0,1280.7540797383665,-60.87,5
04:50,846550094.0,781.0087405544087,-31.89,9
04:50,851181128.0,3240.610967988808,-4.67,2
04:53,905860285.0,14780.969795598548,-47.97,2
04:54,885259672.0,3227.055470435749,-15.26,8
04:54,651756497.0,9676.906465130996,-35.8,5
04:55,489964679.0,18508.007431413473,-3.95,2
04:57,221868392.0,4435.150782577833,-70.18,2
04:57,633345190.0,6357.153891714058,-40.69,9
04:58,601627384.0,3748.2362666180034,-37.13,9
05:01,950234174.0,121.32426347626098,-2.99,7
05:02,912705941.0,16098.755225734269,-63.0,2
05:02,435984758.0,4359.706298647058,-12.89,4
05:03,370521542.0,22589.464656953176,-42.63,7
05:03,383833857.0,20594.784890637828,-38.03,7
05:03,752362502.0,8065.913184774541,-1.65,7
05:04,853907490.0,6502.665269088808,-16.65,9
05:05,473820682.0,10172.68264125263,-18.67,5
05:06,858989281.0,23172.63729441409,-13.54,9
05:25,994214354.0,8040.447718223132,-30.13,9
05:28,718058208.0,1898.2010752320996,-14.34,2
05:30,324224854.0,1052.4683697022276,-2.53,2
05:34,706250160.0,9551.126753269706,-6.61,2
05:36,532478725.0,4055.708451666552,-31.38,9
05:36,588565416.0,5731.735074968009,-1.81,7
05:37,949032480.0,4000.584817987866,-6.84,2
05:38,704517789.0,14915.715193705086,-34.22,7
05:39,450896297.0,11560.186155892889,-41.25,9
05:39,809499628.0,14057.271875692764,-21.7,9
05:44,699139822.0,617.9955135256643,-37.9,7
05:46,679662108.0,13116.230743686114,-22.83,5
05:47,705848712.0,22606.717270597193,-16.93,9
05:56,558119802.0,28045.36549688886,-7.59,5
05:59,259015404.0,227.27846092336827,-30.08,5
05:59,853907490.0,6498.569564075576,-4.1,7
06:00,183888402.0,15323.169575902682,-37.63,9
06:02,482513594.0,4903.945719866937,-12.55,2
06:03,824916823.0,7361.000788791836,-20.25,5
06:04,518474507.0,12134.931917150638,-36.14,9
06:06,203466392.0,1280.0842757766666,-6.06,2
06:10,657139925.0,11447.13495075099,-21.95,9
06:15,245690309.0,7675.516016588898,-20.69,5
06:16,987656636.0,3982.228555356028,-12.51,8
06:17,930277104.0,9245.550375278512,-6.05,2
06:20,256002321.0,4267.051408612031,-15.93,9
06:32,179173981.0,5718.756438642248,-8.54,5
06:32,554792076.0,23966.12036223816,-38.89,2
06:34,187111705.0,5371.668885305671,-12.05,7
06:35,549414742.0,6104.927612351232,-12.95,5
06:38,195895574.0,5858.480888743543,-7.35,5
06:40,709608057.0,2297.2183418393993,-36.43,9
06:41,308505160.0,11512.995924183611,-1.85,5
06:44,534325901.0,5376.310162271843,-48.75,5
06:44,108931112.0,11580.063223042456,-43.23,9
06:45,229205098.0,6043.558248369881,-5.73,4
06:48,647936800.0,924.584501974146,-4.54,2
06:48,653640811.0,14385.469743106509,-4.98,7
06:51,256002321.0,4253.991531168659,-13.06,7
06:51,887853850.0,9114.12687060074,-32.94,9
06:52,541639148.0,3705.307340244041,-15.63,4
06:52,287480331.0,10727.529199881,-19.44,9
06:53,779946617.0,14371.614983034258,-53.81,8
06:55,305778936.0,10559.743055632558,-15.04,7
06:57,117308635.0,785.5729033866536,-18.75,7
06:57,795847804.0,19739.10214553789,-7.26,2
06:58,433917275.0,6887.393670223291,-43.44,9
06:59,940569402.0,4935.466229197371,-19.05,9
07:00,730002588.0,11626.608052740845,-14.25,9
07:00,815385232.0,8323.184273020835,-7.81,7
07:01,450896297.0,11550.653500282231,-9.53,2
07:04,873701090.0,269.0520717854813,-4.25,7
07:07,348325817.0,7663.69065243505,-67.28,5
07:08,532478725.0,4045.4832284447216,-10.23,7
07:09,785749304.0,6917.906196262489,-12.74,7
07:09,806358207.0,10146.92849249056,-68.26,5
07:13,471897866.0,7122.798515148169,-68.19,8
07:16,399538448.0,6816.70652725647,-12.93,2
07:18,581655972.0,37246.762317793466,-14.85,7
07:18,601627384.0,3704.055149325932,-44.18,5
07:19,822135975.0,10583.90883335297,-61.64,5
07:20,416060965.0,-173.64409780359318,-20.12,5
07:21,519644021.0,1826.035007133405,-4.11,5
07:23,287480331.0,10696.647440457202,-30.88,4
07:26,108563213.0,20204.226999822804,-13.69,7
07:26,383625050.0,5055.2042046813685,-34.48,4
07:33,851649498.0,8615.025067881053,-7.4,2
07:34,678851253.0,2521.182540203217,-5.36,5
07:40,858560423.0,10281.985784057644,-3.85,2
07:43,322221939.0,2654.497358706989,-48.84,2
07:44,687135796.0,23049.985205469384,-18.03,7
07:48,145387690.0,4541.678145168957,-30.65,9
07:49,419550103.0,16417.378255696414,-9.59,4
07:52,887853850.0,9094.358678048757,-19.77,2
07:54,364357875.0,5566.870855706063,-18.72,7
07:56,749378808.0,4524.458029848481,-33.16,7
07:57,146909202.0,3740.514199296325,-5.1,9
07:58,885259672.0,3219.9554704357492,-7.1,9
07:59,520447032.0,7764.024105182371,-5.69,7
08:04,395284483.0,989.7540883964832,-6.5,9
08:06,903663593.0,157.54997591603978,-10.51,2
08:08,454129843.0,453.11165079178886,-5.0,9
08:09,331450202.0,5790.80067326376,-10.25,7
08:12,836110591.0,5480.888035180168,-7.53,8
08:15,414805878.0,12433.55581992926,-38.94,9
08:15,809499628.0,14036.498482713892,-20.77,7
08:16,547010927.0,19071.502831787155,-31.14,5
08:18,832564361.0,13531.73488709416,-64.59,7
08:19,145387690.0,4529.876718682265,-11.8,5
08:20,948558249.0,8234.748233470718,-30.2,8
08:22,700138124.0,4348.408123951916,-9.47,7
08:24,874431242.0,7081.902198453733,-37.11,5
08:26,314980178.0,2058.8458500000047,-25.79,5
08:26,995615876.0,1415.1951396983886,-23.5,5
08:27,426466211.0,-2991.52325,-38.66,5
08:27,706361191.0,526.8220984940781,-74.75,5
08:28,234952520.0,-2004.731100000001,-27.58,5
08:29,491392945.0,3225.8235000000054,-30.21,5
08:30,666952234.0,-604.294301875513,-91.83,5
08:30,373163757.0,10013.364796728536,-0.34,8
08:32,637433131.0,-134.7396000000009,-79.83,5
08:34,290751280.0,-337.58930332517434,-43.83,5
08:34,680773155.0,204.79868333109184,-29.37,5
08:34,758160963.0,6568.012160698144,-28.88,5
08:35,196289502.0,13010.396344139814,-44.77,8
08:35,951817450.0,8385.974556535846,-60.12,5
08:35,285220959.0,10097.73808771207,-21.87,8
08:36,737547541.0,-310.27540043222575,-65.23,5
08:37,668329719.0,6863.165716651322,-9.4,7
08:38,366550080.0,22405.98543309985,-76.09,5
08:38,703588001.0,-633.1591500000005,-75.53,5
08:38,298000165.0,22134.462878264178,-0.12,7
08:41,744398361.0,233.03599999999983,-96.37,5
08:43,322720763.0,6361.885017131842,-133.14,5
08:43,915666111.0,-3809.952074772037,-33.26,5
08:43,237684254.0,4938.965211746812,-56.88,5
08:43,713057426.0,-762.1692500000003,-42.28,5
08:46,188263947.0,97.8106500000002,-100.47,5
08:46,282837512.0,11393.390026850935,-45.72,5
08:49,522188082.0,6380.439678942962,-0.29,7
08:49,187111705.0,5289.670885305672,-82.0,5
08:50,558119802.0,28015.33549688886,-30.03,5
08:50,896821055.0,-769.9618263147646,-110.94,5
08:52,317161035.0,-3355.027599999997,-74.78,5
08:54,865748375.0,2634.5288425373637,-148.32,5
08:54,490868147.0,-665.5172208786985,-121.36,5
08:56,128033695.0,1074.309301757387,-13.72,2
08:56,572384506.0,8579.519931776562,-21.29,8
08:58,768271776.0,-834.1517467665793,-121.32,5
08:59,679943657.0,2726.599891111273,-34.33,5
09:00,857455726.0,-1001.9661141243156,-231.82,5
09:02,212560376.0,-625.0138742208978,-53.53,5
09:02,969697937.0,-4345.705265670551,-40.09,5
09:03,999752672.0,254.37044353333437,-6.05,9
09:05,117273481.0,7413.393671905958,-7.8,9
09:09,690958123.0,17028.458860035375,-6.35,9
09:09,558875206.0,1766.3912000000005,-5.0,9
09:10,246753533.0,215.04079999999877,-22.58,5
09:12,618138606.0,876.1798621516973,-5.0,9
09:12,169006407.0,9984.151696247534,-6.05,9
09:15,417850087.0,14678.054428240006,-5.8,9
09:15,305778936.0,10464.571055632558,-95.17,4
09:16,280098744.0,32.9823778716656,-11.49,4
09:16,215404070.0,-885.3254108201502,-78.06,5
09:17,648644594.0,-934.9430000000008,-37.85,5
09:19,197865285.0,145.53776173122046,-5.4,9
09:19,851649498.0,8610.075067881053,-4.95,9
09:20,986774156.0,1315.0609316257676,-5.99,2
09:21,143003091.0,19239.730875288376,-5.99,4
09:21,793781222.0,469.8288789474034,-56.98,4
09:22,667367404.0,7312.627174879121,-6.1,9
09:22,540159353.0,9433.282568699398,-6.0,9
09:24,170637730.0,2143.3237345114144,-25.15,8
09:28,820686957.0,-968.605766311196,-41.08,5
09:28,290818242.0,5762.253945813743,-5.95,9
09:29,549414742.0,6089.541612351231,-15.39,4
09:31,655368335.0,4567.267489920139,-7.01,4
09:35,279149837.0,505.6550499999988,-24.97,1
09:38,461029994.0,5653.554420336354,-31.48,4
09:38,587225252.0,8242.876868842726,-318.5,2
09:40,788740658.0,2646.0950626862714,-22.99,7
09:41,472995101.0,1411.4317238883295,-49.99,4
09:44,152616936.0,266.2830078630648,-54.95,4
09:45,570269025.0,1960.8115333598885,-95.66,5
09:47,134461671.0,7024.840939513799,-5.0,7
09:48,587225252.0,8202.971241747455,-39.91,5
09:49,821971408.0,328.3157213748782,-28.25,5
09:51,137822385.0,2874.4477171514745,-127.98,2
09:56,549414742.0,6013.955612351231,-75.59,7
09:57,108931112.0,11577.424254795786,-2.64,5
09:59,903953091.0,2301.4367623694675,-7.98,4
10:00,762700245.0,339.97970000000237,-160.3,2
10:01,527842638.0,404.2887426329835,-119.98,2
10:01,137822385.0,2867.3477171514746,-7.1,9
10:02,912584712.0,137.08261954473306,-118.3,7
10:07,903953091.0,2295.3867623694673,-6.05,9
10:11,766941757.0,7528.17165420135,-115.69,2
10:17,873701090.0,160.46107178548132,-108.59,5
10:18,962295212.0,-3042.7576499999977,-95.8,5
10:19,448004226.0,1997.9510619306052,-38.46,5
10:20,762700245.0,126.47970000000235,-213.5,2
10:20,287480331.0,10690.497440457202,-6.15,9
10:23,587225252.0,8026.571241747455,-176.4,7
10:24,282837512.0,11387.240026850935,-6.15,9
10:24,930277104.0,9148.670375278514,-96.88,2
10:25,355940285.0,1428.4729781896835,-186.5,2
10:27,899742927.0,11471.518362471545,-80.5,2
10:30,183888402.0,15257.779575902685,-65.39,2
10:31,549414742.0,5947.469612351231,-66.49,2
10:31,986774156.0,1290.0909316257676,-24.97,7
10:35,421881811.0,2905.4545747695624,-0.39,7
10:47,706361191.0,461.8320984940781,-64.99,2
10:50,613427466.0,5239.891905655876,-92.55,5
10:52,305778936.0,10279.085055632557,-185.49,4
10:52,355940285.0,1222.4729781896835,-206.0,2
10:52,155867488.0,-497.2613000000015,-137.32,5
10:55,587225252.0,7699.671241747456,-326.9,4
10:55,198946608.0,5096.297736086325,-5.0,7
10:57,788740658.0,2643.950784975171,-2.14,5
10:58,548907062.0,256.7674887682886,-116.43,5
11:00,899742927.0,11263.618362471543,-207.9,2
11:03,587225252.0,7472.171241747456,-227.5,4
11:06,435313070.0,2590.055446093784,-15.54,2
11:07,657139925.0,11439.797935635765,-7.34,2
11:13,986774156.0,1247.1109316257675,-42.98,2
11:20,534204159.0,4861.838715293711,-24.99,8
11:23,305778936.0,10049.513055632557,-229.57,7
11:26,587225252.0,7269.871241747455,-202.3,7
11:27,762700245.0,49.47970000000237,-77.0,2
11:31,549414742.0,5892.897612351231,-54.57,2
11:48,670102069.0,2919.651668853918,-3.5,8
11:48,129018172.0,6908.535887752609,-9.99,7
11:58,355940285.0,1070.4729781896835,-152.0,2
11:59,899742927.0,11169.818362471544,-93.8,2
12:01,441142605.0,1734.1877000000045,-5.97,4
12:01,549414742.0,5768.297612351231,-124.6,2
12:09,179173981.0,5663.127438642248,-55.63,5
12:12,779946617.0,14074.114983034258,-297.5,2
12:14,575652395.0,2419.057419761827,-66.99,2
12:15,722358036.0,832.7708406270826,-120.4,5
12:17,355940285.0,915.9729781896835,-154.5,2
12:18,781554833.0,1564.4424319437228,-49.99,2
12:22,960208650.0,14464.781013530644,-14.38,9
12:26,106601471.0,8714.190972724557,-38.73,5
12:33,575652395.0,2388.0874197618273,-30.97,4
12:35,549414742.0,5673.13961235123,-95.16,2
12:39,298000165.0,22021.482878264174,-112.98,2
12:47,285115279.0,-2879.456610789288,-30.3,9
12:54,678726554.0,-293.1642476516103,-88.94,5
12:57,933745726.0,263.2685564293233,-37.72,9
12:59,604288474.0,2547.464404339681,-49.08,5
13:00,549414742.0,5533.153612351231,-139.99,2
13:00,762700245.0,-193.4202999999976,-242.9,2
13:01,259015404.0,160.63846092336826,-36.64,9
13:04,960208650.0,14448.884454695772,-15.9,7
13:05,910730524.0,7321.393323088865,-4.7,9
13:08,586041848.0,365.1716999999991,-45.97,2
13:12,779236304.0,-73.7424045204675,-34.38,9
13:15,189757473.0,-2025.3011500000007,-13.48,5
13:17,655730067.0,-7.708800000000416,-42.49,5
13:19,383833857.0,20551.874890637828,-42.91,1
13:20,688712152.0,5005.971582591819,-5.4,9
13:25,912584712.0,-75.01738045526693,-212.1,7
13:26,903468956.0,-406.1806000000006,-96.24,5
13:28,868014990.0,-3095.688599999997,-14.33,5
13:28,812839908.0,-1713.4748500000003,-20.45,5
13:29,460463595.0,-1273.8079454185788,-36.34,9
13:30,941285623.0,-540.8416009332296,-44.69,5
13:33,127809299.0,1583.1855189472844,-18.91,5
13:35,280130290.0,-139.43010000000038,-126.14,5
13:36,305778936.0,9871.727055632557,-177.79,2
13:36,583558311.0,-1201.6302152486678,-110.4,5
13:37,762700245.0,-266.9202999999976,-73.5,2
13:42,586041848.0,360.18169999999907,-4.99,1
13:45,912584712.0,-137.3173804552669,-62.3,7
13:47,407574996.0,2692.7177227215866,-4.74,5
13:52,355940285.0,719.4729781896835,-196.5,2
13:54,899742927.0,10908.718362471544,-261.1,2
14:02,305778936.0,9607.841055632556,-263.89,2
14:06,262767079.0,-1227.8348000000003,-56.96,5
14:09,706361191.0,413.8420984940781,-47.99,2
14:11,762700245.0,-546.2202999999976,-279.3,2
14:11,890830949.0,496.5639999999981,-39.64,5
14:12,987656636.0,3927.918555356028,-54.31,2
14:15,899742927.0,10593.718362471544,-315.0,2
14:18,741903302.0,2229.705458740785,-32.92,7
14:22,912584712.0,-418.7173804552669,-281.4,4
14:25,762700245.0,-758.3202999999976,-212.1,2
14:28,909676212.0,764.7251697400842,-51.49,4
14:30,593191200.0,975.0470499999992,-35.0,2
14:39,587225252.0,7109.571241747455,-160.3,2
15:01,355940285.0,641.9729781896835,-77.5,2
15:08,587225252.0,6907.271241747455,-202.3,2
15:12,912584712.0,-536.3173804552669,-117.6,7
15:25,901037631.0,749.5393230964066,-30.08,2
15:26,388862238.0,498.499652623988,-51.98,2
15:29,912584712.0,-718.3173804552669,-182.0,4
15:31,116598243.0,1614.965547224781,-26.38,5
15:34,407574996.0,2657.6277227215865,-35.09,1
15:35,355940285.0,577.9729781896835,-64.0,2
15:40,587225252.0,6735.771241747455,-171.5,2
15:40,865748375.0,2615.4157686589147,-19.11,8
15:41,492058070.0,540.995968740471,-37.5,7
15:43,355940285.0,483.97297818968354,-94.0,2
15:44,480198977.0,11087.537297642572,-53.72,5
15:48,899742927.0,10448.118362471543,-145.6,2
15:51,173335108.0,2302.4879999999994,-171.47,2
15:54,556992209.0,9543.954625924423,-23.99,4
15:54,355940285.0,295.97297818968354,-188.0,2
16:01,769319491.0,1465.1769999999997,-54.99,2
16:03,587225252.0,6506.171241747455,-229.6,2
16:05,173335108.0,2017.5879999999993,-284.9,2
16:07,720742759.0,328.17743088300773,-210.51,5
16:16,762700245.0,-1078.9202999999975,-320.6,2
16:20,899742927.0,10274.518362471545,-173.6,2
16:21,822250278.0,5832.169013823794,-4.71,4
16:25,286484726.0,241.735476947126,-47.99,2
16:32,605116158.0,1968.7796,-39.99,5
16:32,183186021.0,-1297.3925499999991,-24.44,5
16:32,762700245.0,-1274.2202999999977,-195.3,2
16:33,224112146.0,1131.0222999999987,-52.92,7
16:37,587225252.0,6297.571241747454,-208.6,7
16:39,223207876.0,-161.44889999999992,-61.07,5
16:41,305778936.0,9467.869055632556,-139.97,4
16:41,173335108.0,1967.201999999999,-50.39,2
16:56,355940285.0,103.97297818968354,-192.0,2
16:57,587225252.0,5988.871241747454,-308.7,7
16:58,233981231.0,1525.6838151909706,-13.88,7
16:59,252760664.0,5289.30806556395,-20.01,2
17:01,358846516.0,-78.63032747278199,-35.73,9
17:01,224112146.0,1071.0222999999987,-60.0,2
17:04,762700245.0,-1356.8202999999974,-82.6,2
17:04,867987292.0,2932.8462489150043,-150.4,5
17:05,624500124.0,2933.7255882170175,-0.67,5
17:06,949032480.0,3976.1048179878658,-24.48,9
17:06,124102251.0,3192.7011607449413,-39.94,4
17:07,296972867.0,-799.8715000000008,-44.25,5
17:11,108481285.0,6796.039203548879,-7.45,2
17:13,939972497.0,-72.12714139998917,-91.48,2
17:13,500043411.0,11696.223232940569,-8.73,5
17:14,173335108.0,1743.9019999999994,-223.3,2
17:14,629078930.0,1391.281290657553,-11.16,7
17:18,305778936.0,9317.397055632557,-150.47,4
17:19,151968462.0,6899.194886313415,-31.5,8
17:23,287230540.0,708.4844326671557,-5.99,1
17:24,587225252.0,5804.071241747454,-184.8,7
17:24,558119802.0,27971.64549688886,-43.69,9
17:24,482513594.0,4829.345719866937,-74.6,2
17:26,280268430.0,4381.754239937472,-29.99,4
17:26,173335108.0,1561.2439999999997,-182.66,2
17:26,383625050.0,5001.674204681369,-53.53,2
17:29,897592348.0,12960.337552364352,-119.98,2
17:29,690523499.0,560.4724499999996,-5.5,4
17:30,939972497.0,-182.12714139998917,-110.0,2
17:31,489964679.0,18475.142101413472,-32.87,4
17:32,138609932.0,3946.632003294585,-9.0,4
17:33,506618547.0,15477.463714463587,-62.14,2
17:33,221868392.0,4412.650782577833,-22.5,7
17:35,310375875.0,2661.2924892280935,-8.18,7
17:35,162162212.0,-481.6576066726912,-23.48,5
17:36,213112754.0,6088.164856215734,-103.39,2
17:36,417850087.0,14623.866268240006,-54.19,4
17:38,331450202.0,5714.500673263759,-76.3,2
17:38,322221939.0,2644.4673587069888,-10.03,1
17:39,518474507.0,12082.864133003162,-52.07,2
17:39,704517789.0,14885.395193705086,-30.32,2
17:40,679911053.0,1560.4204078122752,-57.34,2
17:40,683078800.0,1045.975641349959,-9.99,7
17:41,120634201.0,3221.4035000000044,-40.0,4
17:41,897592348.0,12950.347552364352,-9.99,2
17:41,815385232.0,8272.834273020835,-50.35,2
17:41,859603181.0,2802.3465630554547,-20.96,7
17:42,117273481.0,7378.393671905958,-35.0,2
17:43,752362502.0,8055.903184774541,-10.01,7
17:43,113747882.0,10232.997379121682,-15.28,4
17:44,305778936.0,9235.525055632555,-81.87,4
17:44,690958123.0,17008.448860035376,-20.01,2
17:44,795847804.0,19696.62214553789,-42.48,2
17:45,762700245.0,-1641.0202999999974,-284.2,2
17:46,618514666.0,17910.497871547206,-16.49,4
17:47,736340277.0,7267.862787223335,-24.56,1
17:49,373163757.0,10001.354796728536,-12.01,4
17:50,200080192.0,8062.610940781058,-63.48,2
17:50,587225252.0,5651.471241747454,-152.6,7
17:52,147474476.0,3344.6178651193595,-27.96,7
17:52,506618547.0,15464.363714463589,-13.1,7
17:54,672913754.0,9040.665906431354,-21.97,7
17:54,670427480.0,1433.4312000000011,-98.81,5
17:55,408057540.0,6651.79776526071,-65.82,2
17:55,939972497.0,-279.6071413999892,-97.48,2
17:55,462962606.0,14.0165499999989,-33.95,7
17:55,117273481.0,7163.493671905959,-214.9,2
17:56,992204045.0,10208.367609246354,-21.79,7
17:56,699997811.0,1075.5244000000032,-19.97,7
17:57,549414742.0,5430.99561235123,-102.16,4
17:57,479456865.0,733.4006814894049,-195.69,5
17:57,822135975.0,10574.78883335297,-9.12,4
17:58,229205098.0,5890.578248369881,-152.98,2
17:59,679911053.0,1438.6204078122753,-121.8,2
17:59,706250160.0,9534.006753269705,-17.12,7
18:00,698076160.0,5028.380274086104,-44.14,5
18:02,492215823.0,-373.0288261845569,-225.37,5
18:04,331450202.0,5679.500673263759,-35.0,2
18:04,194023154.0,-2384.6496717847344,-28.58,9
18:05,158414827.0,-1729.0026000000014,-19.5,9
18:06,366477356.0,-299.4116,-166.08,5
18:08,627917561.0,2725.4300500000036,-77.97,2
18:11,224112146.0,974.9430999999988,-96.08,5
18:12,310620484.0,-190.61580490780165,-18.08,9
18:14,117273481.0,7128.493671905959,-35.0,2
18:17,587225252.0,5347.671241747454,-303.8,4
18:17,496395938.0,11140.648638235796,-9.02,5
18:18,939972497.0,-314.5971413999892,-34.99,2
18:21,824916823.0,7349.780788791836,-11.22,7
18:21,762700245.0,-1869.9202999999975,-228.9,2
18:24,196289502.0,12985.656344139814,-24.74,9
18:24,627917561.0,2629.445050000003,-95.98,2
18:27,940569402.0,4921.912941311341,-13.55,2
18:29,331450202.0,5490.500673263759,-189.0,2
18:29,549414742.0,5394.60961235123,-36.39,7
18:30,633345190.0,6354.726707333776,-2.43,7
18:31,624563756.0,-754.3360712164437,-53.53,5
18:31,336557504.0,822.9953084030244,-130.53,5
18:34,448279144.0,726.1923499999996,-21.59,9
18:35,433917275.0,6842.073670223292,-45.32,7
18:35,308068836.0,379.30552256819215,-28.3,9
18:38,237493332.0,11911.896759082792,-55.12,5
18:39,939972497.0,-344.0971413999892,-29.5,2
18:40,948069469.0,-944.504100000001,-18.5,9
18:40,989506909.0,-2318.587370759438,-21.95,5
18:42,801500539.0,-2980.8136999999992,-37.83,9
18:42,441274121.0,10647.089296426751,-18.67,7
18:43,175452235.0,457.5672500000003,-81.21,5
18:43,235881534.0,10792.253934022769,-24.36,7
18:43,604870380.0,-1802.671552900553,-16.18,5
18:45,469561218.0,-243.17175000000088,-33.88,5
18:48,151916463.0,80.62155559916872,-107.0,5
18:49,433917275.0,6840.284365938135,-1.79,8
18:52,855129444.0,-328.243845437372,-103.3,5
18:54,518378868.0,-1378.7918000000002,-58.01,5
18:54,270374623.0,8284.795159700341,-50.08,5
18:55,838415080.0,-3305.801499999999,-46.24,5
18:55,143061865.0,6159.866280531831,-31.49,7
18:57,675398089.0,-781.5158407746509,-101.96,5
18:58,534325901.0,5369.0202222718435,-7.29,7
19:00,627723633.0,-1662.6783780037626,-49.06,5
19:01,549414742.0,5349.82361235123,-44.79,2
19:01,657528784.0,-337.9410999999993,-58.34,5
19:02,999752672.0,220.89434353333436,-33.48,5
19:02,667367404.0,7311.572282388522,-1.05,2
19:03,245690309.0,7648.538016588898,-26.98,5
19:08,683319988.0,6233.80256968958,-25.18,9
19:08,228136274.0,-738.4953000000008,-77.94,5
19:10,954263768.0,-478.19740000000024,-48.39,5
19:12,352291960.0,1634.0400533035738,-57.2,5
19:14,668692488.0,1181.690903563902,-222.06,5
19:16,973086490.0,8719.779287597412,-28.78,5
19:16,516051449.0,812.9582875167438,-105.04,5
19:16,893134725.0,799.2776629732091,-59.29,5
19:24,183888402.0,15182.972988022942,-74.81,8
19:25,987390838.0,-2779.7962412103793,-43.17,5
19:26,691012931.0,-1702.087250000001,-18.43,5
19:27,549414742.0,5258.12361235123,-91.7,2
19:35,872286364.0,-1792.1179958130997,-56.0,5
19:43,681955876.0,-1339.1581000000003,-36.64,5
19:49,409971170.0,1232.8605592781348,-142.44,5
19:50,943329213.0,1963.629141151104,-19.37,2
19:53,822718326.0,9175.922222410903,-47.42,5
19:54,581655972.0,37172.74431779347,-74.02,5
19:55,489964679.0,18441.60210141347,-33.54,9
19:58,478986718.0,-1151.8695000000002,-30.42,5
20:01,992204045.0,10148.349609246354,-60.02,5
20:02,654329190.0,-235.40209905148063,-78.74,5
20:05,213112754.0,6020.216098030841,-67.95,8
20:16,187541224.0,4336.924978340345,-141.12,5
20:28,290818242.0,5733.161945813743,-29.09,5
20:40,788740658.0,2544.767784975171,-99.18,5
20:43,815993333.0,421.4601690614072,-22.24,5
20:52,586315521.0,10307.268627626338,-19.96,8
20:56,901432314.0,3320.371720218267,-3.28,5
20:57,673025413.0,2102.8695573766995,-46.79,5
20:59,618514666.0,17873.201871547208,-37.3,5
02:18,749378808.0,4494.168029848481,-30.29,9
02:38,785749304.0,6904.96619626249,-12.94,9
02:43,510101371.0,11026.663223150375,-30.24,9
02:49,749378808.0,4464.1052119579,-30.06,8
02:55,216285378.0,20512.73938463493,-35.94,9
03:02,124102251.0,3161.7522727613673,-30.95,2
03:16,795847804.0,19696.284314778324,-0.34,2
03:22,558119802.0,27970.28795596397,-1.36,5
03:39,287480331.0,10669.809196285853,-20.69,7
03:41,383625050.0,4995.287677892262,-6.39,2
03:44,414805878.0,12396.38581992926,-37.17,9
03:53,600585971.0,148.23324999999954,-35.89,9
03:55,482513594.0,4813.253928418656,-16.09,2
03:56,985188462.0,127.44624871122473,-24.97,9
04:00,237684254.0,4927.976687812464,-10.99,5
04:03,322221939.0,2612.3567552210557,-32.11,5
04:06,510101371.0,10951.211581425228,-75.45,8
04:07,675806859.0,5110.230616516206,-41.95,7
04:07,489964679.0,18417.92210141347,-23.68,9
04:09,670102069.0,2882.1216688539184,-37.53,9
04:18,604288474.0,2546.8888863352154,-0.58,5
04:20,518474507.0,12047.034133003162,-35.83,9
04:20,264550521.0,8021.46805245691,-5.29,4
04:28,308505160.0,11486.10263791827,-26.89,2
04:29,314980178.0,2021.3258500000047,-37.52,9
04:34,235881534.0,10791.335146890657,-0.92,5
04:34,836110591.0,5442.938035180168,-37.95,9
04:37,547010927.0,19049.662831787155,-21.84,9
04:37,259015404.0,131.00846092336826,-29.63,9
04:49,865748375.0,2595.657537770845,-19.76,8
04:50,973086490.0,8689.271814434354,-30.51,2
04:51,853907490.0,6486.607895503769,-11.96,7
04:54,785749304.0,6848.686650778421,-56.28,4
04:55,639409800.0,30057.03311808029,-23.78,4
04:55,245690309.0,7645.067347554489,-3.47,5
04:55,383833857.0,20537.219921607222,-14.65,4
04:58,256002321.0,4238.241531168659,-15.75,9
05:01,183888402.0,15152.452988022942,-30.52,9
05:02,145387690.0,4505.936718682266,-23.94,9
05:07,480557476.0,8964.502967136785,-29.78,5
05:08,683319988.0,6198.50256968958,-35.3,9
05:09,897714622.0,7392.233225954359,-17.04,7
05:10,166019891.0,6822.969663701389,-0.54,8
05:13,613729471.0,6685.452337695271,-85.66,7
05:14,842682241.0,4305.710017585488,-16.79,5
05:30,572384506.0,8537.879121642765,-41.64,7
05:35,633345190.0,6316.676707333776,-38.05,9
05:38,678851253.0,2499.010880193968,-22.17,2
05:40,987656636.0,3909.2920913937455,-18.63,5
05:41,448004226.0,1966.4391108628547,-31.51,7
05:41,522188082.0,6356.78276208336,-23.66,7
05:45,461990622.0,8439.285954123841,-10.05,5
05:48,145387690.0,4489.122284447898,-16.81,2
05:53,315546581.0,23810.38063196945,-8.03,2
05:54,506618547.0,15404.635169619303,-59.73,5
05:54,108481285.0,6748.9954614096205,-47.04,8
05:55,930277104.0,9114.840375278514,-33.83,9
05:56,718058208.0,1870.2110752320996,-27.99,9
05:58,519644021.0,1807.1881219532895,-18.85,2
05:59,769311479.0,5636.721851866892,-33.0,7
06:01,270374623.0,8282.690457215587,-2.1,2
06:05,494789005.0,2276.784157625591,-4.71,2
06:06,187111705.0,5268.271632442684,-21.4,5
06:07,713641917.0,753.8618669368817,-22.49,4
06:07,550169791.0,17928.467608838,-1.83,7
06:08,994214354.0,8011.057718223132,-29.39,9
06:08,108563213.0,20181.497594899956,-22.73,2
06:12,809499628.0,14020.158482713892,-16.34,9
06:13,282837512.0,11352.395522667026,-34.84,7
06:16,221868392.0,4403.213692001048,-9.44,7
06:19,886921642.0,2691.4337053600107,-48.9,5
06:21,859603181.0,2788.7104261228337,-13.64,7
06:22,322720763.0,6314.9634263579765,-46.92,2
06:23,256002321.0,4230.987099864441,-7.25,7
06:24,549414742.0,5223.58361235123,-34.54,9
06:26,949032480.0,3955.904817987866,-20.2,9
06:27,718058208.0,1868.7628062376684,-1.45,4
06:27,709608057.0,2265.088341839399,-32.13,9
06:28,806358207.0,10098.30615813075,-48.62,7
06:29,187541224.0,4312.184978340345,-24.74,9
06:30,930277104.0,9112.917827493364,-1.92,7
06:31,417850087.0,14615.26707819848,-8.6,7
06:33,511179916.0,4911.683493409269,-4.58,8
06:34,779236304.0,-91.4724045204675,-17.73,9
06:35,887853850.0,9073.468678048755,-20.89,9
06:37,867987292.0,2930.4941847592177,-2.35,5
06:38,532478725.0,4023.743228444722,-21.74,9
06:41,874431242.0,7024.033435963845,-57.87,5
06:43,146909202.0,3680.399007351264,-60.12,2
06:44,873693307.0,7404.1544597953725,-23.44,7
06:45,679662108.0,13108.618930441757,-7.61,8
06:46,601627384.0,3703.195353250784,-0.86,4
06:47,116598243.0,1571.3862192916208,-43.58,5
06:49,719586818.0,16373.708278820002,-20.85,2
06:53,120634201.0,3211.1735000000044,-10.23,9
06:55,766941757.0,7489.24165420135,-38.93,9
06:57,471897866.0,7114.598552839216,-8.2,5
06:58,113747882.0,10230.237882591731,-2.76,7
06:58,252760664.0,5256.331698281546,-32.98,7
06:59,456246119.0,17743.785998213352,-13.42,5
06:59,822135975.0,10568.017733965382,-6.77,5
07:04,169006407.0,9934.51782628224,-49.63,8
07:05,549414742.0,5219.930927002842,-3.65,5
07:06,195895574.0,5839.587520630788,-18.89,2
07:09,284905540.0,5756.1175171802215,-1.71,5
07:11,450896297.0,11548.839802794835,-1.81,2
07:16,131388684.0,18825.215911757143,-64.15,2
07:18,873701090.0,154.85467925205376,-5.61,2
07:19,905860285.0,14776.49348977836,-4.48,2
07:20,992204045.0,10108.9293503364,-39.42,7
07:20,475117511.0,6580.733371528801,-8.99,2
07:21,496395938.0,11101.85122728808,-38.8,2
07:21,454356905.0,1926.706874334255,-7.41,5
07:25,851181128.0,3207.420967988808,-33.19,9
07:25,473820682.0,10163.411700060622,-9.27,7
07:28,534325901.0,5304.614564929259,-64.41,8
07:28,738958551.0,7470.6992751995185,-61.67,7
07:30,618138606.0,854.8910472714346,-21.29,7
07:31,364357875.0,5562.775042982747,-4.1,2
07:32,203466392.0,1269.443030464229,-10.64,5
07:34,815385232.0,8208.279307308163,-64.55,2
07:35,489964679.0,18403.30733763244,-14.61,7
07:39,331450202.0,5482.865804526333,-7.63,5
07:44,587225252.0,5332.259655172631,-15.41,7
07:46,822250278.0,5808.853959971367,-23.32,2
07:46,143003091.0,19179.18086946493,-60.55,8
07:47,290818242.0,5730.623386564848,-2.54,7
07:49,887853850.0,9062.854541839442,-10.61,5
07:49,858989281.0,23098.03191606454,-74.61,8
07:50,779946617.0,14035.287960999489,-38.83,7
07:51,310375875.0,2636.8229729417826,-24.47,7
07:52,667367404.0,7289.5761715115295,-22.0,4
08:00,758160963.0,6542.6139775921465,-25.4,5
08:02,324224854.0,1028.9587178979136,-23.51,7
08:02,885259672.0,3214.2554704357494,-5.7,9
08:03,836110591.0,5436.277048322092,-6.66,2
08:04,832564361.0,13516.706859029397,-15.03,4
08:05,399538448.0,6811.30652725647,-5.4,9
08:06,395284483.0,983.8540883964832,-5.9,9
08:07,527842638.0,397.18874263298346,-7.1,9
08:07,518474507.0,12033.398431472762,-13.64,2
08:08,547010927.0,19046.133483681944,-3.53,7
08:19,143061865.0,6121.968280531831,-37.9,5
08:22,948558249.0,8228.798233470718,-5.95,9
08:24,366550080.0,22392.24020686854,-13.75,2
08:25,229205098.0,5870.354200207081,-20.22,8
08:26,851649498.0,8554.483473108972,-55.59,5
08:29,950234174.0,119.95297245823788,-1.37,5
08:29,425730826.0,-50.06059061128033,-37.16,5
08:29,280098744.0,-66.09562212833438,-99.08,5
08:30,683319988.0,6183.711506030103,-14.79,8
08:30,706250160.0,9532.255767531942,-1.75,4
08:31,644751433.0,-1508.993158465538,-88.02,5
08:33,308897841.0,393.74379999999934,-22.69,5
08:33,361955473.0,-1068.9358047559156,-37.07,5
08:34,706301742.0,-2695.013149999999,-15.59,5
08:35,905860285.0,14694.90848977836,-81.59,5
08:35,699997811.0,1023.3352000000032,-52.19,5
08:35,117273481.0,7104.879548378271,-23.61,7
08:36,421881811.0,2893.7945321502775,-11.66,5
08:36,949032480.0,3942.058730330355,-13.85,7
08:37,119943495.0,-1622.780062112858,-124.01,5
08:37,986267641.0,5271.739578054611,-8.91,7
08:37,874506295.0,-1698.741756245572,-24.65,5
08:38,298000165.0,22011.081276797453,-10.4,5
08:38,494789005.0,2258.8781576255915,-17.91,5
08:41,656317661.0,-693.2199084585972,-137.99,5
08:41,534325901.0,5289.0885649292595,-15.53,5
08:41,609939116.0,5532.081924512534,-29.66,8
08:41,554792076.0,23924.44236223816,-41.68,5
08:41,687135796.0,23042.022586615807,-7.96,5
08:41,215426302.0,-364.3255959743082,-30.91,5
08:42,390747457.0,-73.3323000000018,-102.05,5
08:43,534204159.0,4852.546068785819,-9.29,2
08:43,166019891.0,6774.025663701389,-48.94,5
08:43,818552503.0,-669.7932500000012,-213.56,5
08:45,473820682.0,10129.811700060622,-33.6,5
08:46,851181128.0,3200.2233247274207,-7.2,8
08:46,987229118.0,3502.4287626944806,-98.36,5
08:47,370521542.0,22574.881363436263,-14.58,7
08:47,245198540.0,-680.3886011982205,-27.54,5
08:49,586315521.0,10299.474256525646,-7.79,7
09:02,117273481.0,7099.629548378271,-5.25,9
09:02,290818242.0,5724.823386564848,-5.8,9
09:02,586315521.0,10293.774256525645,-5.7,9
09:03,690523499.0,420.0244499999996,-140.45,5
09:04,581655972.0,37155.2243678759,-5.25,9
09:05,690958123.0,17001.348860035378,-7.1,9
09:06,540159353.0,9425.782568699398,-7.5,9
09:07,229205098.0,5773.278200207081,-97.08,5
09:07,455831435.0,-1818.0146048014944,-53.62,5
09:10,259015404.0,118.70918430266047,-12.3,2
09:10,441274121.0,10642.389296426752,-4.7,9
09:11,691843653.0,-2834.925899999995,-7.72,5
09:14,999752672.0,213.39434353333436,-7.5,9
09:15,866941383.0,1520.3155000000047,-80.94,5
09:16,910730524.0,7286.829760689112,-34.56,8
09:17,819515373.0,1268.5151360637908,-65.44,5
09:17,473820682.0,10078.614620060622,-51.2,4
09:19,920830317.0,-526.1222293625185,-251.93,5
09:19,169006407.0,9929.06782628224,-5.45,9
09:20,220183538.0,324.50344999999953,-89.5,5
09:20,138351025.0,-761.5279000000003,-32.06,5
09:20,417850087.0,14609.26707819848,-6.0,9
09:21,373163757.0,9827.411796728537,-173.94,5
09:21,618138606.0,849.1910472714345,-5.7,9
09:22,812692024.0,2684.0609313428804,-98.2,5
09:22,147341222.0,-1631.1635253207955,-47.26,5
09:23,672913754.0,8916.030906431353,-124.64,5
09:23,828750680.0,259.6567952136799,-41.02,5
09:24,769319491.0,1453.1969999999994,-11.98,1
09:25,667367404.0,7281.776171511529,-7.8,9
09:25,741903302.0,2224.0054587407853,-5.7,9
09:28,706361191.0,349.3420984940781,-64.5,2
09:32,479456865.0,717.4206814894048,-15.98,4
09:33,679943657.0,2694.449891111273,-32.15,2
09:34,700138124.0,4210.2881239519165,-138.12,2
09:35,403383649.0,914.4106702776328,-29.99,1
09:37,657139925.0,11405.743399929786,-34.05,5
09:39,127809299.0,1520.2055189472844,-62.98,2
09:39,248142083.0,-626.4825652974832,-143.75,5
09:41,187111705.0,5239.191632442684,-29.08,7
09:41,179173981.0,5632.094759240012,-31.03,5
09:42,718058208.0,1828.8028062376684,-39.96,4
09:45,143383029.0,-660.9411693476613,-260.65,5
09:48,282837512.0,11323.195522667023,-29.2,9
09:53,699139822.0,599.8797504654622,-18.12,7
09:54,264550521.0,8006.42805245691,-15.04,7
10:00,687135796.0,22992.26258661581,-49.76,2
10:04,345514953.0,590.353249999999,-99.99,2
10:05,661295096.0,2519.494204411935,-85.97,4
10:06,175452235.0,397.2672500000003,-60.3,2
10:06,779376323.0,1235.9332158201264,-77.0,4
10:13,604288474.0,2492.7296163352153,-54.16,4
10:13,809499628.0,14002.164595645589,-17.99,5
10:15,137822385.0,2861.647717151475,-5.7,9
10:19,709151315.0,-1080.01078162584,-102.98,5
10:28,494789005.0,2243.7428576255916,-15.14,4
10:29,277562576.0,198.7286982249551,-1.99,4
10:33,986774156.0,983.2109316257676,-263.9,2
10:33,572384506.0,8424.269121642765,-113.61,2
10:39,225210798.0,215.78377375920883,-96.35,5
10:41,421881811.0,2831.0745321502777,-62.72,2
10:42,711045550.0,408.01135000000295,-162.97,2
10:44,165691047.0,-609.6396000000009,-55.95,5
10:49,679662108.0,13024.218930441755,-84.4,2
10:56,364357875.0,5501.885042982747,-60.89,2
11:08,679662108.0,13019.148930441756,-5.07,1
11:08,687135796.0,22980.85258661581,-11.41,4
11:08,456246119.0,17686.805998213353,-56.98,4
11:10,910730524.0,7083.871760689112,-202.96,2
11:19,575652395.0,2238.1074197618273,-149.98,2
11:47,687135796.0,22949.78258661581,-31.07,7
12:02,165045150.0,-1900.148938597144,-42.84,9
12:02,866941383.0,1500.3255000000047,-19.99,4
12:05,679662108.0,12995.778930441757,-23.37,2
12:14,706361191.0,209.84209849407807,-139.5,2
12:19,903663593.0,119.59997591603978,-37.95,7
12:20,986774156.0,799.8109316257676,-183.4,2
12:21,605711527.0,-547.9274861674164,-20.9,9
12:22,679943657.0,2689.1498911112726,-5.3,9
12:33,909676212.0,740.7651697400842,-23.96,7
12:34,116169597.0,-103.14305000000031,-106.97,4
12:34,225210798.0,183.81377375920883,-31.97,4
12:34,857997794.0,210.0226651508873,-20.5,9
12:39,767447966.0,3570.80860551211,-10.03,4
12:41,910730524.0,6802.485760689113,-281.39,2
12:41,496865819.0,-1119.5234318426824,-9.38,5
12:44,603375739.0,-363.63093697673304,-114.14,5
12:45,706361191.0,99.84209849407809,-110.0,2
12:45,384497904.0,502.3590499999992,-57.38,5
12:46,146686559.0,-698.7939111734777,-56.7,5
12:49,192202372.0,-215.26798096092625,-96.75,5
12:52,891513205.0,579.9584796590692,-66.15,5
12:53,879091637.0,-1152.077476262023,-38.68,9
12:55,910730524.0,6683.485760689113,-119.0,2
12:56,986774156.0,680.1669316257676,-119.64,2
12:57,189335192.0,-1203.2429017578602,-147.95,5
12:57,355733816.0,3945.386958092039,-14.98,7
12:59,572333122.0,-3363.305049999997,-34.99,5
13:01,537487133.0,-1077.3716500000005,-76.31,5
13:01,449387287.0,-376.8333061648984,-114.47,5
13:03,910730524.0,6675.985760689113,-7.5,9
13:04,979892433.0,-1672.613700000001,-32.03,5
13:08,407574996.0,2650.3277227215863,-7.3,9
13:10,706361191.0,10.342098494078073,-89.5,2
13:16,277562576.0,190.9286982249551,-7.8,9
13:20,187111705.0,5232.0916324426835,-7.1,9
13:20,849096144.0,1407.865858910517,-5.6,9
13:21,688712152.0,4999.07158259182,-6.9,9
13:21,229502829.0,-3226.6414241862485,-71.36,5
13:21,656389634.0,-2837.119340421986,-59.05,5
13:23,982286721.0,-3245.8380240177307,-37.39,5
13:30,687135796.0,22942.39258661581,-7.39,9
13:34,595800644.0,-1181.8559000000002,-24.18,9
13:46,706361191.0,-37.15790150592193,-47.5,2
13:48,779946617.0,13950.909960999486,-84.38,5
14:05,706361191.0,-146.15790150592193,-109.0,2
14:17,252419513.0,-1826.642235813416,-19.51,5
15:11,706361191.0,-276.1579015059219,-130.0,2
15:15,409971170.0,1228.800706837984,-4.06,2
15:19,679911053.0,1437.7868804576249,-0.83,7
15:28,352899149.0,135.0050499999989,-61.98,5
15:49,706361191.0,-388.1579015059219,-112.0,2
16:09,478651121.0,-216.83682040153025,-42.83,9
16:15,885259672.0,3203.3209023138993,-10.93,8
16:21,551755686.0,5156.754655850647,-35.05,8
16:25,373875019.0,13679.91252336568,-96.73,5
16:27,532478725.0,4007.893228444722,-15.85,1
16:29,376271050.0,580.9302468611793,-43.43,9
16:30,516051449.0,800.9782875167438,-11.98,7
16:40,899742927.0,10263.59941098111,-10.92,7
16:41,698076160.0,4933.754274086104,-94.63,5
16:59,628470485.0,-202.98497009987693,-200.61,5
17:03,624500124.0,2932.212109905179,-1.51,5
17:06,858989281.0,23079.13191606454,-18.9,9
17:12,873693307.0,7388.214459795373,-15.94,9
17:12,386729293.0,26410.52693651494,-35.01,2
17:13,684988568.0,-873.3139234272014,-17.93,9
17:13,399144202.0,1490.2245356145877,-38.09,9
17:15,454129843.0,373.12165079178885,-79.99,2
17:19,558119802.0,27949.55795596397,-20.73,9
17:19,704517789.0,14813.796001452243,-71.6,2
17:20,802697323.0,18163.4694154823,-38.4,9
17:21,510101371.0,10932.091581425226,-19.12,4
17:22,554792076.0,23898.303614703087,-26.14,2
17:23,450896297.0,11515.949802794836,-32.89,9
17:24,705848712.0,22412.817270597192,-193.9,2
17:24,433917275.0,6745.544365938135,-94.74,2
17:24,414805878.0,12394.88643698188,-1.5,2
17:28,647936800.0,910.6175114510712,-13.97,5
17:28,769311479.0,5607.671851866892,-29.05,7
17:28,835736339.0,770.2532404145593,-20.99,1
17:30,421881811.0,2812.150132150278,-18.92,4
17:30,315546581.0,23798.360631969448,-12.02,4
17:30,868377987.0,2895.529969515681,-79.9,5
17:31,423208402.0,1796.7759500000025,-30.99,2
17:32,633345190.0,6274.328577333777,-42.35,4
17:32,237493332.0,11772.726759082792,-139.17,2
17:33,730002588.0,11621.11334971498,-5.49,5
17:34,494156462.0,4.226613518239624,-33.99,2
17:34,433917275.0,6674.2471463750935,-71.3,2
17:36,586315521.0,10275.194256525643,-18.58,7
17:37,224112146.0,901.9630999999988,-72.98,2
17:37,540159353.0,9389.396568699398,-36.39,5
17:37,822135975.0,10516.819733965382,-51.2,5
17:39,874431242.0,6947.740435963845,-76.29,5
17:39,104832000.0,-2822.4698589058444,-48.95,5
17:40,878989510.0,4470.081886141791,-84.91,5
17:41,868377987.0,2852.489969515681,-43.04,9
17:44,532478725.0,3820.993228444722,-186.9,7
17:44,713910252.0,-743.2511742714585,-87.66,5
17:44,857754342.0,1772.3390218916709,-1.5,4
17:44,435313070.0,2540.0654460937844,-49.99,2
17:45,386729293.0,26392.35493651494,-18.17,2
17:46,287230540.0,662.1585989370005,-46.33,2
17:46,859603181.0,2723.211426122834,-65.5,5
17:46,639549973.0,5685.577207880469,-10.02,2
17:46,340295966.0,-1717.6644500000002,-46.93,5
17:48,901432314.0,3318.357720218267,-2.01,4
17:49,416060965.0,-193.6340978035932,-19.99,2
17:50,310375875.0,2610.5029729417824,-26.32,9
17:51,678851253.0,2385.624880193968,-113.39,2
17:51,365608668.0,-51.10788614044115,-5.97,4
17:53,838830098.0,-199.2828579122156,-128.54,5
17:55,143061865.0,6109.988280531831,-11.98,7
17:55,315546581.0,23706.19063196945,-92.17,2
17:56,752362502.0,7910.303184774541,-145.6,2
17:59,930271460.0,-157.83575246422396,-29.49,5
17:59,873693307.0,7359.734459795373,-28.48,2
18:00,851181128.0,3164.2133247274205,-36.01,2
18:01,492215823.0,-405.2088261845569,-32.18,9
18:02,138609932.0,3735.260003294585,-211.37,2
18:03,213112754.0,6005.2125227475535,-15.0,2
18:04,627622066.0,2147.7181856930565,-132.99,2
18:05,128033695.0,1057.9148015491155,-16.39,7
18:08,719586818.0,16317.911278820002,-55.8,5
18:08,386729293.0,26322.38293651494,-69.97,2
18:08,166019891.0,6344.225663701389,-429.8,2
18:15,532478725.0,3585.0932284447217,-235.9,4
18:17,305778936.0,9202.975055632558,-32.55,9
18:18,198051483.0,-1657.2169104088568,-30.69,9
18:18,854513972.0,312.69869999999946,-44.47,5
18:19,423208402.0,1744.7959500000024,-51.98,7
18:19,678851253.0,2282.066880193968,-103.56,2
18:28,383625050.0,4890.497677892262,-104.79,5
18:29,287480331.0,10645.269196285852,-24.54,9
18:30,752362502.0,7715.00318477454,-195.3,2
18:33,587225252.0,5295.709655172631,-36.55,9
18:33,166019891.0,6288.225663701389,-56.0,2
18:36,601627384.0,3673.005353250784,-30.19,9
18:37,678851253.0,2193.1948801939684,-88.87,2
18:37,912705941.0,16058.302088042394,-40.45,2
18:41,520239952.0,-1878.302476654763,-215.42,5
18:43,854895960.0,2064.8623887147023,-90.2,5
18:45,196289502.0,12969.716344139812,-15.94,9
18:45,435984758.0,4328.098465247493,-31.61,7
18:45,815385232.0,8141.384297308163,-66.9,7
18:49,441142605.0,1699.7477000000044,-34.44,9
18:49,916270283.0,1084.7342499999984,-89.33,5
18:50,143061865.0,6029.432280531832,-80.56,5
18:51,331684336.0,-1600.8474699513215,-113.81,5
18:52,374994043.0,-2095.5605500000006,-12.58,5
18:53,532478725.0,3573.426062892556,-11.67,2
18:55,639420537.0,-1717.46895,-52.82,5
18:57,423208402.0,1731.8284500000025,-12.97,5
18:57,678851253.0,2047.6088801939684,-145.59,2
18:57,795847804.0,19671.546314778323,-24.74,5
18:58,122884111.0,-1267.0860830729698,-41.66,5
18:58,984783496.0,12177.931316085464,-23.66,7
18:58,116598243.0,1515.1482192916208,-56.24,5
18:59,245690309.0,7643.530627554489,-1.54,4
19:02,642015139.0,-264.00366253436175,-18.81,5
19:03,155317149.0,121.95484999999928,-44.07,5
19:04,675231808.0,14025.533525245,-36.29,5
19:10,248658670.0,-1835.1383499999995,-43.0,5
19:12,659008214.0,-3143.610102290424,-53.36,5
19:13,564744955.0,-364.7263414111581,-102.2,5
19:14,279149837.0,428.5850499999988,-77.07,5
19:16,534908754.0,-837.4723500000002,-48.84,5
19:17,773633520.0,166.7255609385115,-104.64,5
19:23,585596026.0,-371.4647611887467,-112.32,5
19:24,213112754.0,5989.562522747554,-15.65,9
19:25,940569402.0,4902.464258029346,-19.45,5
19:26,924045955.0,-135.6199873413354,-71.79,5
19:28,832564361.0,13475.182859029395,-41.52,5
19:31,285873880.0,9689.644212646464,-165.77,5
19:32,939972497.0,-388.1467413999892,-44.05,5
19:33,678330503.0,1226.9154888060564,-53.84,7
19:33,876890798.0,1538.38822069993,-42.61,5
19:34,565175333.0,-3321.996022729827,-46.54,5
19:37,678851253.0,1947.5088801939685,-100.1,2
19:38,802697323.0,18109.6256603726,-53.84,7
19:42,399144202.0,1486.548980909375,-3.68,5
19:46,871866387.0,-1049.4564000000007,-92.47,5
19:48,625281433.0,-977.2210573707569,-37.65,5
19:49,441274121.0,10598.048255531708,-44.34,2
19:49,138609932.0,3563.585003294585,-171.67,5
19:50,472213568.0,-573.9825942060532,-19.0,9
19:54,435984758.0,4219.164465247492,-108.93,5
19:55,690523499.0,391.1544499999996,-28.87,9
19:56,668329719.0,6862.198411164397,-0.97,8
19:58,135937041.0,-399.0118982684117,-143.56,5
20:01,653667523.0,3947.171551326438,-118.55,5
20:07,548549094.0,-503.1136299265087,-280.0,3
20:13,121858569.0,-208.4388499999978,-76.11,5
20:14,471897866.0,7053.768552839216,-60.83,5
20:20,824916823.0,7341.920275217511,-7.86,8
20:20,213112754.0,5906.220522747554,-83.34,5
20:25,815385232.0,8102.940297308162,-38.44,5
20:29,709608057.0,2238.9532327768916,-26.14,7
20:29,195895574.0,5804.087520630788,-35.5,9
20:30,297823329.0,288.58504999999917,-44.43,5
20:36,651756497.0,9672.734165604188,-4.17,5
20:39,180616589.0,161.67564803395402,-61.78,5
20:49,163470640.0,231.2029999999998,-74.13,5
21:14,407574996.0,2601.58339303957,-48.74,7
02:37,687135796.0,22935.14258661581,-7.25,9
02:37,216285378.0,20474.46938463493,-38.27,9
02:46,547010927.0,19029.548720960654,-16.58,5
02:46,532478725.0,3548.8360628925557,-24.59,9
02:55,973086490.0,8678.291814434355,-10.98,9
02:55,601627384.0,3627.375353250783,-45.63,9
02:59,324224854.0,1013.544696816258,-15.41,7
03:01,667367404.0,7262.886827084737,-18.89,8
03:02,779946617.0,13941.351805611212,-9.56,7
03:03,890567652.0,-320.5714003203994,-25.19,9
03:08,687135796.0,22908.48990500153,-26.65,5
03:11,984783496.0,12159.701316085466,-18.23,9
03:13,383833857.0,20526.269921607225,-10.95,9
03:16,419550103.0,16414.013299003756,-3.36,2
03:16,785749304.0,6847.3311091805845,-1.36,2
03:29,370521542.0,22571.89091504366,-2.99,5
03:37,832564361.0,13472.2916127647,-2.89,7
03:38,809499628.0,13984.4846121218,-17.68,5
03:42,994214354.0,7966.837718223132,-44.22,9
03:42,623156843.0,4240.816503011673,-3.04,7
03:49,874431242.0,6877.046204412019,-70.69,5
03:49,633345190.0,6250.108577333776,-24.22,9
03:52,809499628.0,13969.0346121218,-15.45,9
03:54,822135975.0,10454.03993034296,-62.78,7
03:55,912705941.0,16053.012252768129,-5.29,5
03:55,124102251.0,3116.764026819974,-13.07,7
03:58,675806859.0,5100.773172786457,-9.46,5
04:02,259015404.0,85.28918430266049,-33.42,9
04:04,383833857.0,20502.628929336235,-23.64,2
04:06,348325817.0,7653.635058611751,-10.06,5
04:06,450896297.0,11482.759802794835,-33.19,9
04:09,482513594.0,4797.013928418656,-16.24,9
04:16,987163717.0,5344.460320000006,-43.93,9
04:18,709608057.0,2199.483232776892,-39.47,9
04:21,108481285.0,6722.2648382686975,-26.73,2
04:21,145387690.0,4464.102284447898,-25.02,9
04:24,520418719.0,716.3718000000027,-34.34,9
04:25,851649498.0,8536.939712896874,-17.54,7
04:25,305778936.0,9199.118571991205,-3.86,2
04:25,113747882.0,10226.50875804523,-3.73,2
04:26,290818242.0,5721.290053475354,-3.53,7
04:26,970298834.0,2158.8406294254796,-5.35,5
04:29,213112754.0,5889.110176739384,-17.11,2
04:29,795847804.0,19632.379776866608,-39.17,2
04:31,678330503.0,1152.4525547237386,-74.46,7
04:32,128033695.0,1056.0230802399772,-1.89,7
04:36,815385232.0,8068.069733418064,-34.87,7
04:40,482513594.0,4773.321304580202,-23.69,2
04:44,187111705.0,5220.816615563184,-11.28,2
04:46,887853850.0,9031.864541839444,-30.99,9
04:46,414805878.0,12359.24643698188,-35.64,9
04:47,705848712.0,22397.57727059719,-15.24,9
04:47,779236304.0,-126.0724045204675,-34.6,9
04:48,853907490.0,6480.607895503769,-6.0,9
04:50,581655972.0,37152.96542210547,-2.26,8
04:54,131388684.0,18777.681037159226,-47.53,8
04:55,572384506.0,8392.809121642766,-31.46,9
04:58,252760664.0,5213.161478888177,-43.17,7
05:00,480557476.0,8925.96446157024,-38.54,5
05:02,690958123.0,16971.210237473402,-30.14,5
05:04,522188082.0,6340.003003558685,-16.78,8
05:07,145387690.0,4405.62329838635,-58.48,2
05:09,873693307.0,7348.233684786781,-11.5,5
05:11,534204159.0,4801.2553476502735,-51.29,2
05:12,471897866.0,7032.858086664936,-20.91,2
05:12,885259672.0,3200.032995782147,-3.29,2
05:12,532478725.0,3548.701760539114,-0.13,7
05:28,657139925.0,11383.553399929786,-22.19,9
05:31,264550521.0,7988.99270261834,-17.44,2
05:33,510101371.0,10900.301581425225,-31.79,9
05:34,842682241.0,4269.535862170375,-36.17,7
05:35,399144202.0,1458.6189809093746,-27.93,9
05:36,992204045.0,10061.515246147052,-47.41,7
05:37,166019891.0,6286.282794116672,-1.94,4
05:43,229205098.0,5732.215626887264,-41.06,5
05:45,134461671.0,4377.217504060892,-7.62,7
05:45,985188462.0,89.2062487112247,-38.24,9
05:46,183888402.0,15117.882988022942,-34.57,9
05:47,405945930.0,3305.527606568139,-10.44,5
05:51,824916823.0,7313.460275217511,-28.46,9
05:53,549414742.0,5203.490927002842,-16.44,9
05:54,853907490.0,6478.3295164570145,-2.28,8
05:54,647936800.0,847.0568771256567,-63.56,7
05:58,822250278.0,5794.558491491465,-14.3,2
06:00,678851253.0,1913.8422696296632,-33.67,7
06:02,308505160.0,11466.047051584272,-20.06,8
06:02,749378808.0,4460.0806345551955,-4.02,4
06:05,414805878.0,12333.135223601766,-26.11,2
06:05,237684254.0,4880.871533046512,-47.11,7
06:06,399144202.0,1454.751349998984,-3.87,4
06:06,766941757.0,7443.95165420135,-45.29,9
06:10,859603181.0,2663.0892060077313,-60.12,7
06:17,752362502.0,7680.853522525843,-34.15,5
06:19,719586818.0,16290.492604336398,-27.42,8
06:23,706250160.0,9467.729999376445,-64.53,7
06:24,950234174.0,113.7880599724933,-6.16,8
06:25,143061865.0,6010.017325779381,-19.41,8
06:27,586315521.0,10231.466686361116,-43.73,2
06:27,169006407.0,9909.96809295512,-19.1,2
06:28,235881534.0,10748.449780775753,-42.89,2
06:29,769311479.0,5586.098048368055,-21.57,8
06:32,905860285.0,14644.807493693164,-50.1,8
06:35,106601471.0,8677.600972724556,-36.59,9
06:36,510101371.0,10859.897461945551,-40.4,2
06:38,435984758.0,4201.3239848212215,-17.84,8
06:38,310375875.0,2608.127791537166,-2.38,2
06:39,383625050.0,4883.369104492976,-7.13,4
06:40,670102069.0,2852.4503643305143,-29.67,2
06:44,949032480.0,3916.768730330355,-25.29,9
06:45,496395938.0,11029.309233454427,-72.54,8
06:45,683319988.0,6148.971506030103,-34.74,9
06:47,108931112.0,11540.044254795786,-37.38,9
06:48,203466392.0,1269.4361179303178,-0.01,2
06:52,836110591.0,5401.597048322092,-34.68,9
06:53,679662108.0,12948.949331152638,-46.83,2
06:53,322221939.0,2590.7703161476893,-21.59,7
06:54,899742927.0,10246.514280111693,-17.09,7
06:54,609939116.0,5491.847687652909,-40.23,2
06:56,237493332.0,11763.326759082793,-9.4,9
06:57,699139822.0,533.9798560217073,-65.9,5
07:01,758160963.0,6524.017878495358,-18.6,5
07:03,558119802.0,27932.60795596397,-16.95,9
07:06,858989281.0,23036.46600627719,-42.67,7
07:07,802697323.0,18067.1356603726,-42.49,9
07:09,897714622.0,7337.4982502290195,-54.73,2
07:09,550169791.0,17894.252010063363,-34.22,7
07:09,366550080.0,22366.754025304785,-25.49,5
07:10,519644021.0,1773.233845355498,-33.95,5
07:12,473820682.0,10068.650747674268,-9.96,4
07:20,601627384.0,3604.660541012522,-22.71,7
07:21,518474507.0,11995.728431472762,-37.67,9
07:23,198946608.0,5040.429530362756,-55.87,7
07:27,237493332.0,11738.08563522911,-25.24,7
07:31,256002321.0,4211.737099864441,-19.25,9
07:33,987656636.0,3885.142397425409,-24.15,7
07:36,613729471.0,6621.413179655966,-64.04,7
07:38,587225252.0,5293.753343042866,-1.96,5
07:39,187541224.0,1633.964978340345,-38.22,9
07:42,254853117.0,2249.086979926949,-37.96,2
07:47,940569402.0,4888.77690380272,-13.69,7
07:51,844835978.0,8186.007472839476,-50.59,7
07:51,743630833.0,87.9153132847012,-38.93,9
07:52,454356905.0,1898.3268743342549,-28.38,9
08:00,930277104.0,9071.292371973825,-41.63,2
08:01,836110591.0,5387.413683902695,-14.18,2
08:02,806358207.0,10065.769746054431,-32.54,2
08:03,454129843.0,366.2216507917889,-6.9,9
08:04,399538448.0,6806.25652725647,-5.05,9
08:07,558119802.0,27899.813135206212,-32.79,2
08:10,700138124.0,4204.569035139732,-5.72,5
08:11,395284483.0,978.2040883964834,-5.65,9
08:11,489964679.0,18379.11733763244,-24.19,9
08:11,331450202.0,5473.437778210352,-9.43,7
08:11,403383649.0,900.2924660994441,-14.12,2
08:13,549414742.0,5194.354528444559,-9.14,5
08:15,170637730.0,2074.397062232191,-52.13,4
08:17,554792076.0,23892.117450626218,-6.19,2
08:18,718058208.0,1826.7649511479665,-2.04,7
08:22,885259672.0,3193.982995782146,-6.05,9
08:25,184430449.0,955.8183638851644,-70.36,5
08:25,668329719.0,6846.076217859555,-16.12,2
08:26,851181128.0,3143.9749147901534,-20.24,5
08:30,346874167.0,-68.46490000000082,-78.54,5
08:33,680773155.0,195.50198333109185,-9.3,5
08:34,500043411.0,11676.105232940568,-20.12,5
08:34,409370545.0,-308.41572445447986,-26.81,5
08:35,131388684.0,18743.955037159227,-33.73,5
08:36,851649498.0,8508.827712896875,-28.11,5
08:37,902798190.0,-1314.8256344310266,-152.1,5
08:37,506618547.0,15357.90008207159,-41.39,8
08:41,754141345.0,-2651.480335115762,-38.74,5
08:42,704517789.0,14789.59111493269,-24.2,2
08:44,621181115.0,-614.0542495707712,-89.4,5
08:44,518746136.0,-1256.2497282369166,-29.65,5
08:45,215832575.0,-1684.0669637442195,-47.8,5
08:47,585133606.0,3805.009594043089,-120.04,5
08:49,973086490.0,8638.287877348877,-40.0,2
08:50,298007503.0,116.99310362563348,-71.55,5
08:50,593378953.0,-633.000349999995,-214.24,5
08:51,933491926.0,2170.3183000000013,-88.72,5
08:52,727417797.0,4066.514500000008,-78.9,5
08:53,398429109.0,-530.1249499999991,-44.67,5
08:53,143606916.0,-255.01259597081028,-235.11,5
08:55,197865285.0,-11.562238268779543,-7.1,9
08:55,596463612.0,-1233.0426047251394,-56.05,5
08:56,108563213.0,20108.29159489996,-73.21,5
08:56,285220959.0,10049.29108771207,-48.45,5
08:58,711045550.0,340.05535000000293,-67.96,5
08:58,572136270.0,-451.62435066642234,-79.6,5
08:58,141521177.0,5839.801900000014,-34.37,5
08:59,519933553.0,-830.1239958492715,-32.59,5
09:01,690958123.0,16965.110237473404,-6.1,9
09:01,975345315.0,30209.10479999996,-53.98,5
09:04,405416860.0,1347.967253863785,-208.08,5
09:05,586315521.0,10225.816686361117,-5.65,9
09:11,117273481.0,7091.82954837827,-7.8,9
09:13,613729471.0,6615.713179655966,-5.7,9
09:15,246753533.0,190.47569999999877,-24.57,5
09:15,999752672.0,207.6943435333344,-5.7,9
09:15,627917561.0,2623.7950500000034,-5.65,9
09:18,179173981.0,5626.476041854779,-5.62,5
09:18,169006407.0,9903.76809295512,-6.2,9
09:18,335698481.0,-2070.59299669494,-45.17,5
09:20,217540156.0,-3164.3698199999953,-31.76,5
09:20,417850087.0,14603.46707819848,-5.8,9
09:21,555393405.0,-1257.2548000000002,-85.45,5
09:21,412823730.0,-567.6342741495102,-129.97,5
09:21,506618547.0,15352.90008207159,-5.0,9
09:22,683078800.0,1039.925641349959,-6.05,9
09:22,540159353.0,9383.5965686994,-5.8,9
09:25,282837512.0,11305.805522667026,-17.39,1
09:25,588565416.0,5627.449074968009,-104.29,5
09:27,769319491.0,1400.8019999999997,-52.39,5
09:30,541639148.0,3684.346060244041,-20.96,4
09:31,792845450.0,314.9231500000009,-39.97,4
09:33,215311171.0,5332.458260771758,-10.98,7
09:34,909676212.0,638.2011697400842,-102.56,5
09:37,824218857.0,-3289.346160845429,-55.92,5
09:48,657139925.0,11376.845839386777,-6.71,5
09:49,973388795.0,576.7576761636217,-42.03,2
09:50,133755851.0,-99.97599619990712,-39.98,4
09:50,618514666.0,17832.211871547206,-40.99,2
09:57,548907062.0,32.781488768288625,-223.99,2
09:58,480198977.0,11028.567297642572,-58.97,4
09:59,593191200.0,864.4043499999991,-110.64,5
10:03,287480331.0,10636.255390467037,-9.01,5
10:07,137822385.0,2855.9977171514747,-5.65,9
10:10,903953091.0,2230.4067623694673,-64.98,2
10:13,853907490.0,6124.843516457015,-353.49,2
10:27,973086490.0,8579.427877348877,-58.86,2
10:33,688712152.0,4849.08158259182,-149.99,2
10:34,996042490.0,4226.917696170785,-49.99,4
10:41,421881811.0,2781.3667311811405,-30.78,5
10:42,950234174.0,-22.01194002750668,-135.8,2
10:42,776431321.0,2598.1735003631525,-13.82,7
10:46,727417797.0,4015.034500000008,-51.48,4
10:50,647472692.0,21428.122722223703,-55.03,4
10:50,618514666.0,17831.306820035985,-0.91,7
10:54,456246119.0,17478.205998213354,-208.6,7
10:55,853907490.0,5886.157516457015,-238.69,2
10:55,480557476.0,8884.27446157024,-41.69,7
11:06,456246119.0,17409.619998213355,-68.59,4
11:07,348525881.0,-252.2683754050637,-34.95,7
11:10,867679563.0,-223.48924629828417,-73.11,5
11:12,779946617.0,13907.23180561121,-34.12,2
11:12,679662108.0,12796.377331152638,-152.57,2
11:13,766941757.0,7410.351654201349,-33.6,7
11:16,950234174.0,-190.01194002750668,-168.0,2
11:27,779376323.0,1231.5628624894407,-4.37,2
11:33,364357875.0,5449.861742832131,-52.02,5
11:39,779376323.0,1181.5728624894407,-49.99,6
11:40,604288474.0,2448.676473961436,-44.05,5
11:43,973086490.0,8569.287877348877,-10.14,2
11:43,679943657.0,2622.0128911112724,-67.14,5
11:46,679662108.0,12763.50533115264,-32.87,2
11:50,149684419.0,325.6217999999983,-77.92,5
11:55,853907490.0,5639.785516457015,-246.37,2
12:03,386277162.0,-279.13000000000045,-39.14,9
12:06,661295096.0,2387.5142044119348,-131.98,2
12:11,586041848.0,358.19169999999906,-1.99,4
12:18,853907490.0,5355.585516457015,-284.2,2
12:21,655450953.0,-2648.62737845553,-37.14,9
12:28,519644021.0,1713.003845355498,-60.23,2
12:28,564214408.0,-287.8073152742738,-20.75,5
12:30,520447032.0,7743.275121641315,-20.75,2
12:33,469561218.0,-270.56175000000087,-27.39,9
12:35,950234174.0,-397.91194002750666,-207.9,2
12:35,298000165.0,21652.68127679745,-358.4,2
12:36,298007503.0,87.37310362563346,-29.62,9
12:39,456246119.0,17292.033998213356,-117.59,4
12:44,344522228.0,-2750.7619882083927,-20.6,5
12:48,298000165.0,21568.68127679745,-84.0,2
12:48,950234174.0,-460.2119400275066,-62.3,2
12:48,688328251.0,-1095.3841253548271,-28.07,5
12:48,202320275.0,-976.6819000000004,-136.76,5
12:53,348325817.0,7647.195288611752,-6.44,4
12:54,797184978.0,-1622.3399134269805,-16.25,5
12:57,753525749.0,-2234.7684,-53.81,5
12:59,504055745.0,-853.6150386582331,-41.35,5
13:00,287480331.0,10590.275390467035,-45.98,2
13:00,380911501.0,-394.1598500000008,-37.47,5
13:01,456246119.0,17232.561998213354,-59.47,7
13:04,967989787.0,88.42908264072723,-84.07,5
13:04,173317688.0,-2147.3787348842857,-46.25,5
13:04,259015404.0,80.58918430266048,-4.7,9
13:05,187111705.0,5214.916615563185,-5.9,9
13:05,402438092.0,304.4243999999991,-102.36,5
13:06,679662108.0,12686.53333115264,-76.97,2
13:07,910730524.0,6669.635760689112,-6.35,9
13:08,348325817.0,7642.095288611751,-5.1,9
13:09,322221939.0,2585.470316147689,-5.3,9
13:18,679662108.0,12559.86133115264,-126.67,2
13:21,424927189.0,-402.5685172558946,-137.71,5
13:22,715068825.0,321.9019999999998,-76.66,5
13:33,679662108.0,12440.875331152638,-118.99,2
13:50,280268430.0,4377.774239937473,-3.98,4
13:52,662610817.0,-1607.202131324928,-300.39,5
13:57,137913631.0,389.36899999999946,-107.77,5
13:57,679662108.0,12329.57533115264,-111.3,2
14:01,462962606.0,-36.930950000001104,-50.95,5
14:15,679662108.0,12284.089331152638,-45.49,2
14:23,950234174.0,-652.0119400275066,-191.8,2
14:29,541639148.0,3675.776548742472,-8.57,5
14:30,993039226.0,-3954.9394999999954,-50.69,5
14:38,941285623.0,-686.7286009332297,-145.89,5
15:09,116598243.0,1510.2039661363133,-4.94,2
15:32,678330503.0,1124.1125547237386,-28.34,2
15:43,639549973.0,5680.916644807803,-4.66,7
15:50,321372947.0,-583.8012507890994,-27.89,5
15:52,108481285.0,6692.274838268698,-29.99,7
15:56,548907062.0,-36.476511231711385,-69.26,2
15:58,316793091.0,317.50431005495113,-86.98,2
16:01,241459011.0,516.3259132723472,-23.19,9
16:17,421881811.0,2728.7567311811404,-52.61,2
16:26,995615876.0,1284.7051396983886,-130.49,2
16:28,548907062.0,-172.96251123171135,-136.49,2
16:29,829914501.0,-582.325193429026,-30.41,5
16:31,744968736.0,-1672.326826569424,-31.97,5
16:32,310375875.0,2522.7916615371664,-85.34,4
16:34,376271050.0,533.9602468611793,-46.97,4
16:37,413557825.0,508.7362999999996,-10.98,1
16:40,886921642.0,2689.9941236096483,-1.44,2
16:42,948558249.0,8131.498233470717,-97.3,2
16:43,467207141.0,809.5830670482637,-55.04,5
16:59,370521542.0,22565.76091504366,-6.13,7
16:59,628470485.0,-226.95497009987693,-23.97,4
17:02,158414827.0,-1739.3500000000015,-10.35,5
17:07,995615876.0,1236.2251396983886,-48.48,2
17:08,587225252.0,5170.777343042866,-122.98,5
17:12,948558249.0,7966.998233470717,-164.5,2
17:13,892354433.0,-1745.7499606343383,-78.03,5
17:15,995615876.0,1140.7551396983886,-95.47,2
17:16,413557825.0,423.7562999999995,-84.98,2
17:16,128033695.0,1040.6710402399772,-15.35,4
17:17,940569402.0,4874.32690380272,-14.45,9
17:20,151968462.0,6833.845739029141,-65.35,2
17:20,229205098.0,5714.895626887264,-17.32,7
17:22,272538745.0,12704.819900000024,-146.3,2
17:22,166019891.0,6246.892794116672,-39.39,4
17:24,679662108.0,12116.817331152635,-167.27,2
17:24,696333897.0,259.5525999999992,-51.41,5
17:24,196289502.0,12954.476344139814,-15.24,4
17:24,331450202.0,5439.725778210352,-33.71,5
17:24,647472692.0,21405.2114822237,-22.91,4
17:26,868377987.0,2702.509969515681,-149.98,2
17:26,227104649.0,1334.9640643161777,-6.0,7
17:27,128033695.0,798.5130402399772,-242.16,2
17:31,534325901.0,5270.409854915727,-18.68,8
17:32,651756497.0,9671.079256921796,-1.65,2
17:32,887853850.0,9014.843250384143,-17.02,5
17:34,213112754.0,5805.810176739384,-83.3,2
17:34,417850087.0,14527.758789393296,-75.71,5
17:35,336557504.0,626.4953084030244,-196.5,2
17:36,138609932.0,3543.635003294585,-19.95,4
17:38,683319988.0,6052.841506030103,-96.13,2
17:39,519935524.0,-259.80981026248105,-43.06,5
17:39,534325901.0,5257.409854915727,-13.0,9
17:40,948558249.0,7689.798233470718,-277.2,2
17:40,627622066.0,2137.7281856930567,-9.99,2
17:41,876890798.0,1528.39822069993,-9.99,7
17:41,486495235.0,705.2219893887158,-87.99,2
17:41,690958123.0,16932.110237473404,-33.0,4
17:41,581655972.0,37122.01542210547,-30.95,7
17:42,641764023.0,-1386.6138037720043,-18.59,5
17:43,130154096.0,758.7576105489657,-51.98,4
17:44,414805878.0,12290.435223601766,-42.7,2
17:46,220183538.0,286.12344999999954,-38.38,9
17:47,709608057.0,2178.205322776892,-21.28,4
17:47,703478110.0,3386.085084266246,-10.98,7
17:47,550832673.0,2116.705134474407,-20.97,4
17:49,272538745.0,12506.019900000025,-198.8,2
17:49,331450202.0,5423.465778210351,-16.26,7
17:50,315546581.0,23680.30633856117,-25.88,5
17:51,613427466.0,5232.901905655876,-6.99,7
17:51,897714622.0,7212.198250229019,-125.3,2
17:51,873693307.0,7315.207684786781,-33.03,5
17:52,466649401.0,-221.2552342768033,-52.23,5
17:52,126929801.0,859.9249190559711,-40.99,2
17:53,995615876.0,1082.7751396983886,-57.98,2
17:54,868377987.0,2676.529969515681,-25.98,2
17:55,336557504.0,551.4953084030244,-75.0,2
17:56,690958123.0,16901.120237473402,-30.99,7
17:57,486495235.0,623.2319893887158,-81.99,2
17:59,540159353.0,9211.6165686994,-171.98,2
18:01,679662108.0,11994.331331152636,-122.49,2
18:03,213112754.0,5721.810176739384,-84.0,2
18:03,675398089.0,-800.9958407746509,-19.48,9
18:08,200080192.0,8046.710940781059,-15.9,9
18:08,155317149.0,90.91484999999928,-31.04,9
18:09,108563213.0,20096.68062052623,-11.61,7
18:09,224112146.0,816.9630999999987,-85.0,2
18:09,340680761.0,-2793.8255999999983,-23.7,9
18:10,993238248.0,-750.0824873928839,-30.39,9
18:10,272538745.0,12411.519900000025,-94.5,2
18:12,995615876.0,999.2951396983884,-83.48,2
18:13,441274121.0,10542.254537956438,-55.79,8
18:14,858989281.0,23017.01600627719,-19.45,9
18:16,785749304.0,6831.511109180585,-15.82,5
18:20,214339619.0,-195.62314913164357,-26.29,5
18:23,305778936.0,9170.868571991205,-28.25,9
18:24,984783496.0,12106.707214877384,-52.99,5
18:25,690523499.0,385.1644499999996,-5.99,7
18:28,213112754.0,5533.5101767393835,-188.3,2
18:33,630468201.0,-805.5892338897017,-36.85,5
18:36,824916823.0,7277.503606904605,-35.96,2
18:39,200080192.0,8038.205180574086,-8.51,4
18:39,124102251.0,3008.5020268199737,-108.26,5
18:39,252760664.0,5186.183478888177,-26.98,5
18:41,844835978.0,8137.9174728394755,-48.09,5
18:42,618138606.0,772.0643472714345,-77.13,5
18:43,851649498.0,8493.187712896875,-15.64,9
18:44,455052690.0,-770.9942600513724,-120.56,5
18:47,500043411.0,11585.375232940569,-90.73,7
18:49,348460748.0,-229.08460000000088,-54.42,5
18:52,478986718.0,-1201.1726000000003,-49.3,5
18:52,511179916.0,4860.29649340927,-51.39,5
18:53,738958551.0,7431.411720154626,-39.29,2
18:54,461990622.0,8415.356617810192,-23.93,2
18:56,858560423.0,10257.005784057645,-24.98,7
19:01,851181128.0,3112.5349147901534,-31.44,9
19:02,949032480.0,3910.1252395743977,-6.64,5
19:04,651756497.0,9527.586256921795,-143.49,5
19:05,448004226.0,1873.611760862855,-92.83,5
19:08,433917275.0,6647.887146375094,-26.36,9
19:12,392270893.0,10637.420441412827,-17.58,4
19:13,982949451.0,-3344.1991670525094,-33.26,5
19:13,216286013.0,-181.0714933460599,-140.31,5
19:13,310375875.0,2390.1556615371665,-132.64,5
19:14,817294757.0,-2717.1758000000004,-15.22,5
19:15,587225252.0,5133.907343042866,-36.87,9
19:16,720221651.0,-2286.5788665984346,-41.37,5
19:19,858560423.0,10167.503784057644,-89.5,5
19:20,474301748.0,-1514.9690056839693,-30.28,5
19:20,189757473.0,-2062.4636500000006,-37.16,5
19:21,408057540.0,6590.729765260709,-61.07,5
19:29,344219145.0,5653.954024138093,-48.8,5
19:29,386729293.0,26276.571561990622,-45.81,7
19:30,195895574.0,5778.204869964275,-25.88,7
19:41,736340277.0,7252.632787223335,-15.23,9
19:42,308068836.0,250.91152256819217,-128.39,5
19:45,639409800.0,30017.15899913342,-39.87,8
19:46,245690309.0,7635.438627554489,-8.09,5
19:48,433917275.0,6615.136229381198,-32.75,7
19:49,293191074.0,86.79814999999925,-21.65,9
19:51,454129843.0,267.74845079178885,-98.47,5
19:55,245690309.0,7635.202453831277,-0.24,5
20:00,270374623.0,8229.590381426413,-53.1,7
20:00,450896297.0,11449.68790117366,-33.07,2
20:01,494156462.0,-91.8924864817604,-96.12,5
20:02,489964679.0,18375.758362463977,-3.36,2
20:04,290818242.0,5643.394053475355,-77.9,5
20:15,226703987.0,670.8871999999996,-131.49,5
20:23,999752672.0,61.420943533334395,-146.27,5
20:23,960208650.0,14435.780352581414,-13.1,4
20:28,511179916.0,4847.3512160971495,-12.95,5
20:28,886921642.0,2654.350123609649,-35.64,5
20:29,736340277.0,7220.054787223335,-32.58,5
20:32,472213568.0,-616.0770942060533,-42.09,5
20:38,785210466.0,1495.223227560572,-39.02,5
20:43,698955014.0,361.8389549409122,-34.45,5
20:44,221868392.0,4377.933692001048,-25.28,9
20:53,203466392.0,1201.7321179303178,-67.7,5
20:55,480198977.0,10906.431297642572,-122.14,5
21:50,749378808.0,4425.060634555195,-35.02,9
21:51,730002588.0,11552.70513669414,-68.41,5
22:03,943329213.0,1939.768088533404,-23.86,5
01:13,370521542.0,22518.13700405479,-47.62,7
01:30,985188462.0,59.6762487112247,-29.53,9
01:52,718058208.0,1776.7853406988568,-49.98,7
02:00,547010927.0,18999.378720960656,-30.17,9
02:20,541639148.0,3648.578312551167,-27.2,2
02:31,547010927.0,18996.271805952183,-3.11,5
02:40,549414742.0,5166.914528444559,-27.44,9
02:44,254853117.0,2227.106979926949,-21.98,9
02:54,647936800.0,831.637578193005,-15.42,2
02:55,388862238.0,476.609652623988,-21.89,9
03:01,518474507.0,11967.568431472762,-28.16,9
03:08,417850087.0,14488.177280890306,-39.58,8
03:09,758160963.0,6456.899342693732,-67.12,5
03:10,433917275.0,6583.286229381198,-31.85,9
03:10,399144202.0,1410.1591483949005,-44.59,2
03:11,116598243.0,1487.2412995064276,-22.96,4
03:17,496395938.0,10971.231031073032,-58.08,2
03:22,190874125.0,313.24301421356733,-34.36,9
03:25,704517789.0,14766.085872223151,-23.51,8
03:34,196289502.0,12943.486344139814,-10.99,9
03:35,905860285.0,14607.337493693163,-37.47,9
03:35,679911053.0,1430.7547042653305,-7.03,2
03:44,549414742.0,5161.816752512646,-5.1,8
03:48,679662108.0,11972.621768802508,-21.71,2
03:50,145387690.0,4378.4332983863505,-27.19,9
03:51,822135975.0,10445.033389995264,-9.01,5
03:56,802697323.0,18026.895660372596,-40.24,9
03:59,973086490.0,8562.297877348878,-6.99,9
04:03,769311479.0,5585.996911470361,-0.1,5
04:03,143003091.0,19129.155683347515,-50.03,2
04:04,264550521.0,7981.661213864712,-7.33,5
04:06,905860285.0,14601.743118388662,-5.59,5
04:10,461029994.0,5649.406299682366,-4.15,7
04:11,647472692.0,21352.051493662388,-53.16,4
04:11,749378808.0,4399.3706345551955,-25.69,9
04:14,986267641.0,5230.839578054612,-40.9,9
04:16,586315521.0,10193.511343521846,-32.31,8
04:22,675806859.0,5097.108573279218,-3.66,8
04:25,853907490.0,5324.141827351629,-31.44,8
04:34,994214354.0,7933.837718223132,-33.0,9
04:35,887853850.0,8978.063250384143,-36.78,9
04:36,290818242.0,5635.5350851981675,-7.86,7
04:37,851181128.0,3091.3949147901535,-21.14,9
04:37,949032480.0,3888.935239574397,-21.19,9
04:39,187111705.0,5149.923411155859,-64.99,5
04:40,449871732.0,8484.674646956108,-55.28,2
04:40,534325901.0,5214.580618544497,-42.83,7
04:42,421881811.0,2683.049850499844,-45.71,2
04:43,195895574.0,5747.984869964274,-30.22,9
04:52,179173981.0,5591.836041854779,-34.64,9
04:52,187541224.0,1605.8249783403448,-28.14,9
04:54,408057540.0,6585.751440779667,-4.98,2
04:56,705848712.0,22385.32727059719,-12.25,9
05:07,324224854.0,990.7818630429596,-22.76,8
05:07,836110591.0,5342.243683902695,-45.17,9
05:10,169006407.0,9875.069232557136,-28.7,2
05:13,383625050.0,4881.835275549856,-1.53,2
05:14,366550080.0,22301.195238697917,-65.56,8
05:19,108481285.0,6627.101862366104,-65.17,2
05:19,473820682.0,10060.086693220224,-8.56,5
05:20,873701090.0,153.0714770908828,-1.78,2
05:22,842682241.0,4228.734985356743,-40.8,5
05:22,215311171.0,5260.777627514071,-71.68,5
05:23,187541224.0,1605.7075003365426,-0.12,8
05:23,815385232.0,8028.870767674709,-39.2,7
05:23,887853850.0,8963.753774843637,-14.31,5
05:23,216285378.0,20439.799384634927,-34.67,9
05:26,108931112.0,11499.254254795786,-40.79,9
05:26,604288474.0,2441.326333022642,-7.35,8
05:27,749378808.0,4388.968685800222,-10.4,2
05:28,108563213.0,20058.878775640325,-37.8,7
05:30,873693307.0,7273.318985254219,-41.89,8
05:30,221868392.0,4341.803692001048,-36.13,9
05:31,940569402.0,4866.82690380272,-7.5,9
05:37,581655972.0,37107.263058822755,-14.75,8
05:37,613729471.0,6533.811155036056,-81.9,8
05:39,575652395.0,2210.7574197618274,-27.35,9
05:41,822250278.0,5769.331852042497,-25.23,4
05:42,329840194.0,262.0867301431478,-40.18,9
05:42,703478110.0,3346.4779543289696,-39.61,8
05:45,675231808.0,13987.740481391347,-37.79,4
05:48,134461671.0,4349.001934338759,-28.22,7
05:49,651756497.0,9517.272708555383,-10.31,2
05:53,859603181.0,2649.0548473817216,-14.03,2
05:55,973086490.0,8557.010659532441,-5.29,4
06:03,213112754.0,5513.770292191612,-19.74,7
06:05,287480331.0,10576.763364752958,-13.51,7
06:07,510101371.0,10814.217461945553,-45.68,9
06:07,532478725.0,3512.111760539113,-36.59,9
06:11,730002588.0,11541.92404903778,-10.78,5
06:11,912705941.0,16050.427771634771,-2.58,5
06:13,678851253.0,1904.1679188771027,-9.67,4
06:19,409971170.0,1225.3525681727806,-3.45,7
06:21,705848712.0,22364.20005360539,-21.13,7
06:25,687135796.0,22908.459287719594,-0.03,5
06:29,414805878.0,12255.765223601766,-34.67,9
06:30,126929801.0,802.1147750358759,-57.81,5
06:31,370757362.0,846.6365898126758,-23.73,9
06:31,672913754.0,8912.340918423384,-3.69,7
06:32,489964679.0,18364.133318919143,-11.63,7
06:37,305778936.0,9138.426595301193,-32.44,7
06:37,994214354.0,7915.208710004385,-18.63,5
06:37,198946608.0,5015.004036407809,-25.43,7
06:40,824916823.0,7249.173606904605,-28.33,9
06:40,706250160.0,9448.426650725509,-19.3,2
06:41,500043411.0,11550.79354569228,-34.58,4
06:42,252760664.0,5177.1370146590725,-9.05,7
06:43,435984758.0,4179.672009584085,-21.65,7
06:44,517934629.0,1346.8276787084264,-36.68,9
06:46,229205098.0,5704.039472779955,-10.86,7
06:46,151968462.0,6831.374988109668,-2.47,7
06:46,480557476.0,8876.945890014827,-7.33,8
06:46,482513594.0,4759.937059404656,-13.38,4
06:47,987656636.0,3864.123332781271,-21.02,2
06:52,285220959.0,10048.724064420108,-0.57,5
06:53,322221939.0,2582.0874682382932,-3.38,7
06:54,419550103.0,16338.007117202911,-76.01,5
06:57,644751433.0,-1533.033158465538,-24.04,9
06:59,256002321.0,4173.579183539503,-38.16,2
06:59,806358207.0,10065.30578498537,-0.46,7
06:59,405416860.0,1304.3379669583708,-43.63,8
07:04,885259672.0,3193.817103378018,-0.17,7
07:06,441274121.0,10525.8819859397,-16.37,8
07:08,461990622.0,8377.668621187504,-37.69,2
07:08,522188082.0,6312.689909266812,-27.31,4
07:11,554792076.0,23844.09714106204,-48.02,7
07:12,235881534.0,10707.714324268942,-40.74,2
07:14,897714622.0,7175.477822778204,-36.72,5
07:17,315078351.0,5229.390901514788,-19.45,7
07:18,308505160.0,11461.754038086712,-4.29,8
07:19,282837512.0,11280.405522667026,-25.4,9
07:20,609939116.0,5479.795467813513,-12.05,7
07:21,719586818.0,16222.4915348781,-68.0,5
07:26,128033695.0,736.1161552776014,-62.4,2
07:26,949032480.0,3840.3992635557065,-48.54,4
07:26,113747882.0,10215.180011830931,-11.33,4
07:27,930277104.0,9039.252371973824,-32.04,9
07:30,170637730.0,2050.845890409551,-23.55,4
07:34,510101371.0,10805.51132114884,-8.71,8
07:42,832564361.0,13444.56041222498,-27.73,5
07:42,259015404.0,40.24918430266049,-40.34,9
07:42,865748375.0,2534.2282289707873,-61.43,5
07:43,550169791.0,17846.04072314976,-48.21,2
07:44,899742927.0,10189.3167758694,-57.2,8
07:50,282837512.0,11264.964210939208,-15.44,7
07:50,844835978.0,8136.946549188451,-0.97,5
07:54,699139822.0,525.1831498212756,-8.8,7
07:57,166019891.0,6224.846124321367,-22.05,2
07:58,454129843.0,263.04845079178887,-4.7,9
08:01,540159353.0,9196.616192358631,-15.0,7
08:01,203466392.0,1144.600083902456,-57.13,5
08:03,668329719.0,6843.833687195373,-2.24,7
08:05,688712152.0,4840.8058244374415,-8.28,8
08:05,885259672.0,3188.767103378018,-5.05,9
08:06,655368335.0,4501.691910070222,-65.58,5
08:08,527842638.0,392.18874263298346,-5.0,9
08:10,639549973.0,5664.7684614393465,-16.15,5
08:13,195895574.0,5745.044594748721,-2.94,4
08:14,558119802.0,27852.86669087125,-46.95,2
08:15,395284483.0,972.5040883964832,-5.7,9
08:17,183888402.0,15081.392988022944,-36.49,9
08:18,945054126.0,-1147.0019,-22.58,5
08:18,399538448.0,6799.75652725647,-6.5,9
08:19,111137699.0,-335.09949999999964,-51.65,5
08:22,971129830.0,-1436.0631499999995,-13.71,5
08:25,344219145.0,5645.0372354396095,-8.92,2
08:25,383833857.0,20466.41092933623,-36.22,5
08:25,631744379.0,-2009.3787594910675,-14.47,5
08:25,868014990.0,-3116.201099999997,-20.51,5
08:26,383833857.0,20400.71242928453,-65.7,7
08:27,607629901.0,-3746.108319908144,-5.62,5
08:28,775790822.0,-2919.6634192160686,-28.77,5
08:29,215426302.0,-416.2235959743082,-51.9,5
08:33,837876918.0,-2104.0802914654214,-12.38,5
08:34,799453072.0,-479.06740000000104,-91.45,5
08:35,540159353.0,9136.752192358632,-59.86,5
08:35,500843551.0,-10.084900000000305,-105.22,5
08:35,387957305.0,-2516.9586059800795,-57.14,5
08:41,491392945.0,3186.2455000000054,-39.58,5
08:42,680773155.0,173.90278333109185,-21.6,5
08:49,520447032.0,7707.539686279123,-35.74,5
08:50,990461108.0,-183.78283137938905,-43.05,5
08:52,683319988.0,6032.50820021475,-20.33,5
08:53,767447966.0,3509.3416055121097,-61.47,5
08:53,833899961.0,1591.8987728389911,-17.96,5
08:55,315546581.0,23665.14706299309,-15.16,2
08:56,673025413.0,2084.4315573766994,-18.44,5
08:57,237684254.0,4811.817667221036,-69.05,2
09:00,506618547.0,15347.20008207159,-5.7,9
09:03,425964226.0,2703.0006500000018,-4.35,9
09:03,138609932.0,3537.4350032945854,-6.2,9
09:03,558875206.0,1761.4412000000004,-4.95,9
09:03,741903302.0,2218.3054587407855,-5.7,9
09:05,683078800.0,1034.425641349959,-5.5,9
09:06,444371478.0,322.22289999999884,-54.38,5
09:08,993663752.0,-260.62870758960344,-162.01,5
09:08,534325901.0,5187.322618544497,-27.26,5
09:08,586315521.0,10187.461343521849,-6.05,9
09:09,169006407.0,9869.019232557135,-6.05,9
09:09,165098840.0,-885.583126362373,-41.36,5
09:10,117273481.0,7086.429548378271,-5.4,9
09:11,540159353.0,9131.052192358631,-5.7,9
09:14,290818242.0,5630.235085198167,-5.3,9
09:15,581655972.0,37099.96305882275,-7.3,9
09:17,613729471.0,6527.761155036056,-6.05,9
09:17,699139822.0,480.0631498212756,-45.12,2
09:18,264550521.0,7971.591093864712,-10.07,4
09:19,975345315.0,30202.20479999996,-6.9,9
09:20,621652856.0,-1295.86403038946,-206.81,5
09:20,760704118.0,166.16231271748848,-65.56,5
09:21,779946617.0,13882.161805611211,-25.07,4
09:21,816685391.0,-805.0745037084263,-54.21,5
09:22,308505160.0,11456.254038086712,-5.5,9
09:23,270374623.0,8219.9191383693,-9.67,4
09:24,225210798.0,173.82377375920882,-9.99,4
09:25,919185264.0,3595.3947228879724,-5.99,7
09:34,853907490.0,5265.831827351629,-58.31,2
09:38,743630833.0,45.9353132847012,-41.98,2
09:46,441142605.0,1631.7677000000044,-67.98,2
09:47,324046160.0,-924.3643332130708,-151.3,5
09:48,960208650.0,14393.74687327087,-42.03,5
09:48,414454079.0,-706.2821499999981,-263.4,5
09:49,856957948.0,7533.590393335358,-61.47,5
09:49,609939116.0,5366.245467813513,-113.55,2
09:51,865748375.0,2512.2482289707873,-21.98,1
09:53,494789005.0,2199.5588576255914,-44.18,5
09:55,668175891.0,9.877073158499131,-12.97,5
09:57,355733816.0,3912.4369580920393,-32.95,7
10:01,779946617.0,13841.648053912057,-40.51,2
10:03,137822385.0,2850.4977171514747,-5.5,9
10:04,572384506.0,8337.337021642767,-55.47,4
10:05,145387690.0,4377.157200377741,-1.28,2
10:11,943329213.0,1911.698088533404,-28.07,7
10:23,282046994.0,-587.8076499999996,-89.0,5
10:28,554792076.0,23638.32514106204,-205.77,2
10:35,639549973.0,5441.468461439346,-223.3,2
10:45,554792076.0,23472.43914106204,-165.89,2
10:50,280268430.0,4189.474239937473,-188.3,2
10:58,647472692.0,21305.284493662388,-46.77,5
11:01,956717493.0,439.8625776068375,-11.98,1
11:09,108931112.0,11414.413154795786,-84.84,4
11:10,639549973.0,5414.168461439346,-27.3,2
11:12,391688371.0,572.5092995685231,-13.0,4
11:16,322221939.0,2485.3404682382934,-96.75,5
11:21,519644021.0,1695.7167100225563,-17.29,2
11:24,956717493.0,391.86287760683746,-48.0,5
11:26,280268430.0,4134.874239937472,-54.6,2
11:32,849096144.0,1397.875858910517,-9.99,7
11:37,970298834.0,2131.8306294254794,-27.01,7
11:39,639549973.0,5227.2684614393465,-186.9,2
11:42,280268430.0,4103.374239937472,-31.5,2
11:46,287480331.0,10493.225084752958,-83.54,4
11:49,538003940.0,1095.8500000000076,-26.96,7
11:50,519644021.0,1589.3937100225564,-106.32,5
11:53,541639148.0,3615.818312551167,-32.76,2
12:04,601627384.0,3567.880541012522,-36.78,1
12:07,639549973.0,5088.668461439346,-138.6,2
12:10,348325817.0,7603.487906428214,-38.61,5
12:13,656389634.0,-2862.5993404219867,-25.48,9
12:18,743630833.0,-10.974686715298796,-56.91,1
12:19,280268430.0,4076.074239937472,-27.3,2
12:26,601627384.0,3526.230541012522,-41.65,9
12:26,235663459.0,-203.59557018798483,-28.68,9
12:28,952921898.0,-332.9345777080187,-20.9,9
12:32,519644021.0,1539.2037100225564,-50.19,2
12:34,585133606.0,3799.019594043089,-5.99,4
12:34,866941383.0,1485.345500000005,-14.98,7
12:36,639549973.0,5053.668461439346,-35.0,2
12:40,364357875.0,5442.092228134393,-7.77,7
12:40,985188462.0,31.20278871122476,-28.47,4
12:48,585133606.0,3717.019594043089,-82.0,2
12:48,407574996.0,2540.169627401122,-61.41,7
12:48,965038148.0,-1157.8175143676722,-24.2,5
12:49,843174694.0,-4394.895999999998,-46.24,5
12:50,391688371.0,487.7322995685232,-84.78,5
12:51,519644021.0,1530.1737100225564,-9.03,4
12:56,903953091.0,2187.500038995662,-42.91,7
13:04,722358036.0,826.7208406270827,-6.05,9
13:05,262767079.0,-1376.1032000000002,-148.27,5
13:05,277562576.0,184.1286982249551,-6.8,9
13:05,187111705.0,5142.323411155859,-7.6,9
13:09,407574996.0,2535.169627401122,-5.0,9
13:10,555804115.0,-1618.0085475587027,-8.79,5
13:12,259015404.0,34.549184302660485,-5.7,9
13:15,322221939.0,2479.3404682382934,-6.0,9
13:16,849096144.0,1390.375858910517,-7.5,9
13:19,688712152.0,4833.005824437441,-7.8,9
13:34,804317849.0,-3560.1191330205206,-71.0,5
13:36,331048953.0,-720.9636320215063,-154.56,5
13:44,904154012.0,764.8474581204323,-21.97,7
13:52,585133606.0,3583.039594043089,-133.98,2
13:54,270374623.0,8210.799138369299,-9.12,4
13:54,403765849.0,-2247.285499999999,-45.09,5
14:06,469561218.0,-342.66105000000084,-72.1,5
14:14,503575533.0,5468.518090000015,-13.0,2
15:01,280268430.0,3964.074239937472,-112.0,2
15:22,903953091.0,2040.8360389956624,-146.66,5
15:25,280268430.0,3855.574239937472,-108.5,2
15:48,280268430.0,3730.974239937472,-124.6,2
15:56,964913066.0,-2128.8797000000004,-21.67,5
15:57,348525881.0,-272.2483754050637,-19.98,2
16:16,709608057.0,2145.605322776892,-32.6,9
16:19,158414827.0,-1768.6200000000017,-29.27,5
16:21,345582855.0,-895.2050471794507,-11.3,5
16:24,280268430.0,3571.3742399374723,-159.6,2
16:34,914806976.0,886.6732501854858,-159.99,6
16:36,296972867.0,-882.4113000000008,-82.54,5
16:37,534097839.0,-4219.688549999999,-22.33,5
16:38,886921642.0,2641.3201236096484,-13.03,2
16:38,183186021.0,-1319.8025499999992,-22.41,5
16:40,117308635.0,700.2429033866536,-85.33,2
16:40,785210466.0,1473.253227560572,-21.97,1
16:41,678330503.0,1115.5585412504738,-8.55,7
16:44,399144202.0,1366.5791483949006,-43.58,2
16:46,532478725.0,3510.9972257827944,-1.11,5
16:48,280268430.0,3394.2742399374724,-177.1,2
16:51,456221621.0,108.20536730262816,-106.55,5
16:53,413557825.0,290.80949999999956,-132.95,5
16:55,736310094.0,-1005.419424027426,-37.61,5
16:56,441142605.0,1431.7877000000044,-199.98,2
16:58,280268430.0,3254.2742399374724,-140.0,2
17:00,670102069.0,2793.675915482087,-58.77,5
17:03,868033067.0,-2122.198286451083,-20.73,5
17:04,126929801.0,740.017775035876,-62.1,5
17:08,471897866.0,6988.300683243279,-44.56,8
17:09,433917275.0,6576.71780751114,-6.57,7
17:10,752362502.0,7670.672726376221,-10.18,7
17:14,610450243.0,-1364.1596,-21.58,5
17:15,885259672.0,3147.2055833780178,-41.56,4
17:16,984783496.0,12090.767214877384,-15.94,9
17:17,766812921.0,-587.4731000000007,-177.08,5
17:19,785749304.0,6828.58461147053,-2.93,7
17:21,421881811.0,2672.818530499844,-10.23,4
17:23,699997811.0,980.7952000000032,-42.54,9
17:23,836110591.0,5336.023683902695,-6.22,4
17:23,833499132.0,1984.9129000000005,-34.95,7
17:24,618138606.0,744.0643472714345,-28.0,2
17:24,199016328.0,4506.779578394217,-34.95,7
17:25,280268430.0,3105.1742399374725,-149.1,2
17:26,858989281.0,23011.54707157904,-5.47,2
17:27,180616589.0,137.70564803395402,-23.97,7
17:28,822718326.0,9170.932222410904,-4.99,1
17:28,237493332.0,11729.652543225597,-8.43,7
17:31,117273481.0,7080.439548378271,-5.99,7
17:31,310375875.0,2387.537550047287,-2.62,5
17:32,331450202.0,5321.675778210351,-101.79,2
17:32,858989281.0,22994.30707157904,-17.24,9
17:33,683319988.0,5991.2782002147505,-41.23,9
17:34,449871732.0,8474.694646956108,-9.98,1
17:34,506618547.0,15333.161897313428,-14.04,5
17:36,639409800.0,29996.47766839149,-20.68,2
17:37,771125520.0,153.40304999999947,-15.98,7
17:37,405945930.0,3199.5376065681394,-105.99,2
17:39,795847804.0,19598.979776866607,-33.4,4
17:39,667367404.0,7259.775454483476,-3.11,2
17:39,851649498.0,8480.446507501378,-12.74,7
17:41,169006407.0,9843.999232557137,-25.02,1
17:45,399144202.0,1335.6491483949003,-30.93,9
17:45,834581602.0,74.56724999999938,-35.49,5
17:45,241459011.0,478.7002132723472,-37.63,5
17:46,336557504.0,527.5683950194864,-23.93,2
17:47,315546581.0,23619.99694299309,-45.15,4
17:47,489964679.0,18333.403318919143,-30.73,9
17:48,113747882.0,10187.570011830932,-27.61,7
17:48,134847904.0,2460.8220443862933,-133.8,5
17:48,285428103.0,7974.445950465588,-79.99,2
17:51,429556122.0,4697.571750000003,-50.04,2
17:51,280268430.0,2829.3742399374723,-275.8,2
17:53,957821152.0,-1614.1710035715498,-88.98,5
17:53,106601471.0,8661.766376068972,-15.83,2
17:54,522188082.0,6270.609909266812,-42.08,7
17:57,450896297.0,11303.38790117366,-146.3,2
17:57,423208402.0,1594.0833000000025,-60.0,2
18:01,450896297.0,11266.94790117366,-36.44,9
18:02,280268430.0,2822.3742399374723,-7.0,2
18:02,842682241.0,4187.684985356743,-41.05,9
18:06,522188082.0,6263.595909266812,-7.01,7
18:09,713057426.0,-793.7692500000003,-31.6,9
18:11,761272540.0,-171.2887500000011,-17.23,9
18:11,256002321.0,4159.329183539503,-14.25,9
18:12,949032480.0,3778.0992635557063,-62.3,2
18:16,709608057.0,2118.3410071497096,-27.26,7
18:17,419550103.0,16296.931117202914,-41.08,5
18:17,701070224.0,403.0989500000001,-152.26,5
18:19,809499628.0,13947.6946121218,-21.34,9
18:19,558119802.0,27820.43669087125,-32.43,9
18:29,423208402.0,1382.5833000000025,-211.5,2
18:32,987163717.0,5308.120320000005,-36.34,9
18:35,395284483.0,959.9843402113084,-12.52,5
18:36,170637730.0,2019.9618904095512,-30.88,5
18:39,690523499.0,382.1644499999996,-3.0,7
18:40,874431242.0,6819.353862650171,-57.69,5
18:42,479366718.0,1484.5814476323997,-21.49,7
18:44,535744551.0,186.71556599562635,-77.92,5
18:45,598586358.0,-3195.8924499999966,-24.26,5
18:50,690958123.0,16894.1132374734,-7.01,7
18:51,802697323.0,17997.109777746766,-29.79,5
18:52,128033695.0,704.0761552776014,-32.04,9
18:52,475117511.0,6520.763371528801,-59.97,7
18:53,124102251.0,3000.1686788986153,-8.33,4
18:53,180719578.0,-4028.607749999997,-14.45,5
18:56,822135975.0,10431.733389995265,-13.3,5
18:57,266777719.0,-785.7010662197603,-49.6,5
18:58,117273481.0,7067.459548378271,-12.98,7
18:59,180616589.0,92.72564803395404,-44.98,7
19:02,954263768.0,-489.48910000000024,-11.29,5
19:02,719742742.0,-1675.6725077779631,-24.06,5
19:03,709632525.0,-1778.0773500000007,-67.66,5
19:04,610645022.0,-1142.6774626449185,-61.88,5
19:12,475117511.0,6461.774371528802,-58.99,5
19:16,556992209.0,9481.458625924426,-62.5,5
19:24,331450202.0,5302.745778210351,-18.93,9
19:27,703537476.0,-143.07375000000084,-47.02,5
19:32,779816907.0,-2767.9285829229125,-54.7,5
19:36,670102069.0,2756.345915482087,-37.33,9
19:38,475117511.0,6445.266811260567,-16.51,7
19:38,795847804.0,19579.76909987743,-19.21,7
19:38,633345190.0,6224.184224907902,-25.92,7
19:40,305778936.0,9126.436595301191,-11.99,9
19:42,496395938.0,10923.519031073032,-47.71,5
19:49,245690309.0,7628.970611155318,-6.23,7
19:53,675806859.0,4951.956573279218,-145.15,5
20:02,473820682.0,9991.794693220225,-68.29,5
20:05,550169791.0,17777.06272314976,-68.98,5
20:10,348525881.0,-306.1333754050637,-33.88,5
20:15,441274121.0,10464.0859859397,-61.8,5
20:20,703478110.0,3207.62595432897,-138.85,5
20:22,788740658.0,2538.0409787741332,-6.73,5
20:26,824916823.0,7243.903953279963,-5.27,2
20:30,285428103.0,7879.441950465588,-95.0,5
20:31,532525712.0,-595.8418000000004,-35.31,5
20:39,886921642.0,2623.533956040891,-17.79,2
20:39,986267641.0,5178.171578054612,-52.67,5
20:48,450896297.0,11200.86974835657,-66.08,2
20:54,196289502.0,12926.804618986016,-16.68,5
20:58,245690309.0,7617.084611155317,-11.89,5
00:33,678851253.0,4123.620974492226,-73.55,7
01:52,270374623.0,11318.518469968054,-18.28,2
02:30,489964679.0,18301.66331891914,-31.74,9
02:36,670102069.0,4409.895915482087,-31.45,9
02:46,198946608.0,4963.864291762158,-51.14,2
02:49,550169791.0,22551.85420265314,-4.21,7
02:51,581618317.0,-3420.711701873207,-22.95,9
02:54,108931112.0,15217.033154795789,-36.38,9
03:00,183888402.0,15052.612988022942,-28.78,9
03:03,195895574.0,7747.844594748721,-18.2,9
03:03,822250278.0,5764.839467435352,-4.49,7
03:09,832564361.0,13396.657008512646,-47.9,7
03:09,489964679.0,18285.349598831304,-16.31,2
03:16,749378808.0,4363.028685800223,-25.94,9
03:23,699139822.0,445.2131498212756,-34.85,9
03:24,348325817.0,11753.517906428217,-16.97,9
03:28,416060965.0,1159.0159021964068,-21.35,9
03:33,706250160.0,12987.410417515368,-3.02,5
03:37,809499628.0,17670.5046121218,-27.19,9
03:45,506618547.0,20511.413569052304,-23.75,2
03:47,113747882.0,12625.390011830932,-37.18,9
03:47,749378808.0,4305.2464542551625,-57.78,4
03:52,886921642.0,2564.9195075128496,-58.61,2
03:55,348325817.0,11728.92713558439,-24.59,2
04:01,613729471.0,9857.867285846523,-2.89,8
04:02,237493332.0,15450.887394494952,-27.77,5
04:03,873701090.0,150.01951383490808,-3.05,7
04:04,779236304.0,1521.5875954795326,-27.34,9
04:08,670102069.0,4409.3289650147935,-0.57,5
04:17,216285378.0,20407.53938463493,-32.26,9
04:17,170637730.0,2003.6933586109776,-16.27,5
04:17,518474507.0,15677.77843147276,-38.79,9
04:17,633345190.0,6208.843318842051,-15.34,2
04:20,510101371.0,13547.57132114884,-37.94,9
04:22,815385232.0,11023.990758505715,-3.88,5
04:24,912705941.0,16047.669255925028,-2.76,2
04:30,785749304.0,9685.584611470533,-13.0,9
04:31,433917275.0,6544.77780751114,-31.94,9
04:34,203466392.0,1079.9469218971783,-64.65,5
04:35,766941757.0,9052.42165420135,-32.93,9
04:36,905860285.0,14561.243984576678,-40.5,2
04:38,549414742.0,5132.276752512646,-29.54,9
04:38,558119802.0,33635.67669276109,-17.76,5
04:39,698076160.0,4913.133235659583,-20.62,2
04:39,287480331.0,12043.835084752958,-45.39,9
04:41,256002321.0,7478.139183539503,-14.19,9
04:46,836110591.0,5297.933683902695,-38.09,9
04:48,604288474.0,2430.667263636418,-10.66,4
04:49,899742927.0,10185.962032495449,-3.35,8
04:52,985188462.0,826.2727887112248,-34.93,9
04:53,322221939.0,2463.813287740697,-15.53,5
04:55,145387690.0,4944.267200377741,-22.89,9
04:55,450896297.0,14360.91616376906,-2.95,2
05:00,802697323.0,21505.219777746766,-33.89,9
05:01,541639148.0,3581.030835257946,-34.79,2
05:01,699139822.0,374.6696774548511,-70.54,7
05:03,940569402.0,4815.941681983107,-50.89,2
05:08,675806859.0,7730.991020259421,-0.97,7
05:08,897714622.0,9940.45227145535,-44.03,5
05:10,752362502.0,12036.78510309608,-8.89,2
05:10,169006407.0,9842.373327852552,-1.63,2
05:12,256002321.0,7465.66460129638,-12.47,8
05:13,229205098.0,5694.045652088711,-9.99,2
05:13,785749304.0,9657.15317507463,-28.43,5
05:14,853907490.0,8700.148570287314,-50.68,4
05:21,370521542.0,27275.463737280603,-21.67,7
05:21,482513594.0,7471.319929764905,-78.62,2
05:23,519644021.0,1518.6342350494704,-11.54,2
05:28,252760664.0,5134.863681868011,-42.27,8
05:28,949032480.0,3752.219263555706,-25.88,9
05:29,851181128.0,3060.1049147901535,-31.29,9
05:30,480557476.0,12478.33020286968,-54.62,5
05:33,802697323.0,15891.588488615063,-13.63,7
05:35,532478725.0,3482.8172257827946,-28.18,9
05:36,213112754.0,5507.797957744279,-5.97,2
05:38,679662108.0,16749.77942639385,-1.84,7
05:40,549414742.0,5126.972669225654,-5.3,5
05:41,145387690.0,4895.123420460424,-49.14,5
05:43,572384506.0,9983.507021642768,-36.83,9
05:45,179173981.0,7378.486041854779,-38.35,9
05:53,730002588.0,15461.615384652558,-37.31,5
05:54,586315521.0,10186.831803488092,-0.63,2
05:54,409971170.0,2917.915885563993,-13.44,7
05:55,435984758.0,6402.058724527369,-27.61,2
05:55,842682241.0,6914.029982160804,-53.66,5
05:57,690958123.0,20335.712345706943,-17.4,5
05:58,874431242.0,10556.348625778077,-12.01,2
05:58,587225252.0,7895.267343042866,-38.64,9
05:59,196289502.0,16301.738131613432,-1.07,8
06:00,851181128.0,3040.592276484335,-19.51,5
06:01,719586818.0,20105.33442480164,-19.16,2
06:01,705848712.0,22356.70005360539,-7.5,9
06:03,679911053.0,1424.1899627290325,-6.56,5
06:06,532478725.0,3464.180229165134,-18.64,5
06:07,647472692.0,26047.029868365124,-37.25,7
06:10,282837512.0,14156.074210939209,-26.89,9
06:11,305778936.0,12042.30851129507,-2.13,4
06:11,441274121.0,13848.186183444504,-74.9,7
06:12,116598243.0,1451.6577760988898,-35.58,2
06:22,581655972.0,37096.81587491664,-3.15,7
06:26,494789005.0,2199.5135196375304,-0.05,2
06:27,131388684.0,18731.5347691678,-12.42,7
06:27,718058208.0,3265.8596255765037,-10.93,2
06:28,809499628.0,17650.184900003504,-20.32,7
06:31,949032480.0,3743.435399610855,-8.78,2
06:32,187541224.0,1562.2875003365425,-43.42,9
06:37,709608057.0,2082.2510071497095,-36.09,9
06:42,128033695.0,670.0846293297715,-33.99,8
06:43,887853850.0,8930.313774843637,-33.44,9
06:43,383833857.0,25139.604663311256,-40.11,8
06:47,383625050.0,4803.634314767871,-78.2,5
06:49,867679563.0,-233.47924629828415,-9.99,9
06:51,930277104.0,11615.856948827352,-2.77,2
06:51,108481285.0,8182.884879696248,-28.22,4
06:52,687135796.0,27679.959287719594,-7.5,9
06:55,713641917.0,682.4685278491199,-71.39,2
06:57,547010927.0,23334.081805952184,-37.19,9
06:59,973086490.0,8540.960659532442,-16.05,9
07:04,461990622.0,11911.767901532185,-7.9,2
07:05,195895574.0,7717.831025060882,-30.01,2
07:06,290818242.0,8226.674048927673,-3.56,2
07:08,657139925.0,14842.955839386776,-18.89,9
07:08,700138124.0,7116.531637293152,-6.04,5
07:14,407574996.0,2509.215478801186,-25.95,7
07:16,873693307.0,11225.606071054011,-4.71,5
07:20,705848712.0,22307.449842274615,-49.25,5
07:23,259015404.0,0.4691843026604871,-34.08,9
07:26,824916823.0,10128.70244944959,-32.2,5
07:31,310375875.0,4061.0168128518826,-1.52,7
07:33,678330503.0,1768.859729722992,-6.7,7
07:36,324224854.0,3795.270713579428,-15.51,2
07:37,473820682.0,13117.6864062966,-0.11,7
07:40,709608057.0,2070.9290388538084,-11.32,2
07:41,315546581.0,27568.67577594755,-40.32,5
07:42,992204045.0,13433.443424610585,-61.07,5
07:43,687135796.0,27669.881857977933,-10.08,2
07:48,108563213.0,23745.72071056487,-62.16,5
07:51,364357875.0,6275.0138135274065,-7.08,7
07:51,287480331.0,12020.820404170609,-23.01,5
07:55,520447032.0,7684.294149007072,-23.25,5
07:57,235881534.0,13255.855492628334,-51.86,7
08:01,647936800.0,824.7012128922266,-6.94,5
08:03,264550521.0,8964.283845442202,-17.31,2
08:04,683319988.0,8252.898200214751,-32.38,9
08:07,887853850.0,8924.533376421386,-5.78,5
08:08,146909202.0,3678.9880996756287,-1.41,2
08:09,859603181.0,2627.255666544273,-21.8,7
08:10,399538448.0,6793.60652725647,-6.15,9
08:12,769311479.0,8338.050620664428,-30.95,2
08:14,218795010.0,1117.9964499999996,-2.85,9
08:18,187111705.0,8447.634319615468,-28.02,2
08:18,405945930.0,4821.33760656814,-3.2,9
08:18,948558249.0,7683.698233470717,-6.1,9
08:19,639409800.0,35589.28849052425,-33.19,2
08:21,433917275.0,6518.579599305829,-26.2,5
08:21,564214408.0,-315.1521152742738,-27.34,5
08:22,482513594.0,7444.327929764905,-26.99,5
08:24,534908754.0,-866.5395000000002,-29.07,5
08:26,417850087.0,17610.594369679042,-2.58,7
08:26,973086490.0,8501.682676624656,-39.28,5
08:28,494404688.0,-2482.2532653362077,-37.38,5
08:30,860360312.0,-324.23759111731965,-81.52,5
08:30,822718326.0,12440.974222410903,-62.96,5
08:34,849096144.0,1310.2398589105171,-80.14,5
08:34,785749304.0,9626.98317507463,-30.17,5
08:35,609939116.0,6217.659646369859,-8.59,8
08:36,858989281.0,22990.96408933392,-3.34,5
08:36,345582855.0,-923.7468471794508,-28.54,5
08:38,822135975.0,10414.423431481791,-17.31,5
08:39,374994043.0,-2118.923050000001,-23.36,5
08:40,979892433.0,-61.28160000000102,-68.67,5
08:41,776108637.0,2117.2847536574955,-59.12,5
08:42,113747882.0,12574.55575231247,-50.83,2
08:43,270374623.0,11206.182469968056,-112.34,5
08:43,657528784.0,-376.9590999999993,-39.02,5
08:46,558875206.0,4763.210050000001,-123.23,5
08:46,355733816.0,5742.473234880616,-9.96,7
08:46,414805878.0,12212.435223601766,-43.33,9
08:47,691843653.0,-2851.1783999999952,-16.25,5
08:49,807098817.0,-127.73320000000078,-134.34,5
08:50,308897841.0,2347.366699999999,-46.38,5
08:54,851649498.0,8441.259213657391,-39.19,2
08:54,667367404.0,10367.77603163486,-18.0,2
08:54,147341222.0,-1297.7763253207954,-106.61,5
08:56,829914501.0,-738.6491934290259,-156.32,5
08:57,263882093.0,-1537.7263000000005,-50.33,5
08:59,624500124.0,2844.3496698667977,-87.86,7
09:00,626989363.0,60.42496331737556,-138.89,5
09:00,683319988.0,8234.71431327215,-18.18,5
09:01,430910686.0,1565.5533000000005,-180.84,5
09:02,274818272.0,90.60777856713152,-55.38,5
09:03,422955974.0,-398.51721500095,-42.85,5
09:04,166019891.0,9105.05273699807,-36.79,8
09:05,613729471.0,9850.717285846526,-7.15,9
09:06,821971408.0,288.8917213748782,-39.42,5
09:07,668329719.0,9555.831793180148,-68.0,2
09:08,550832673.0,4667.487134474407,-50.22,5
09:09,383833857.0,25133.804663311257,-5.8,9
09:10,758160963.0,9156.039342693732,-90.86,5
09:11,124102251.0,2968.317478036822,-31.85,2
09:11,414454079.0,867.6278500000019,-76.09,2
09:14,101531259.0,1311.7867999999996,-57.97,4
09:16,698955014.0,321.85895494091216,-39.98,4
09:17,760753808.0,1015.2768999999996,-14.97,7
09:17,799286313.0,9.081687124138632,-47.99,2
09:17,895331556.0,654.5958999999992,-66.99,2
09:17,886837068.0,1716.7880999999995,-30.97,4
09:17,287230540.0,2947.1685989370008,-6.99,7
09:18,796709231.0,1010.3900778962976,-19.98,1
09:18,933745726.0,397.2985564293233,-15.97,7
09:18,508518911.0,394.37475027901047,-19.99,2
09:18,520418719.0,3623.381800000003,-9.99,1
09:18,131388684.0,18672.6367691678,-58.9,5
09:18,425730826.0,1847.9594093887197,-11.98,2
09:19,843537309.0,86.02028220836817,-25.96,7
09:19,446720287.0,242.7434408184056,-47.98,2
09:19,880546403.0,563.7953499999983,-139.97,2
09:19,121858569.0,2591.5711500000025,-9.99,2
09:19,730002588.0,15265.909384652556,-195.71,5
09:19,818552503.0,1140.716749999999,-31.99,6
09:19,298007503.0,1787.2131036256335,-12.16,7
09:20,221356538.0,1591.2617999999998,-147.72,5
09:20,688328251.0,180.62587464517287,-5.99,2
09:21,155317149.0,681.9648499999993,-28.95,7
09:21,108812033.0,1257.1756499999983,-9.99,2
09:22,482513594.0,7413.6779297649055,-30.65,2
09:22,500043411.0,11505.503545692278,-45.29,5
09:22,663479159.0,4801.323541827709,-9.98,7
09:22,385685918.0,1133.5199408415524,-149.97,2
09:22,762859681.0,764.220099999999,-59.99,2
09:22,405945930.0,4801.35760656814,-19.98,7
09:23,703588001.0,1249.8608499999996,-74.98,2
09:23,444371478.0,757.2428999999988,-74.98,2
09:23,698076160.0,4871.6532356595835,-41.48,4
09:23,409370545.0,1595.57427554552,-6.01,7
09:24,136770968.0,298.1223999999997,-40.99,2
09:24,757115616.0,2357.7700000000027,-37.99,2
09:24,897592348.0,12933.83798632199,-16.51,5
09:24,354894456.0,732.4199999999996,-59.99,2
09:25,799453072.0,713.9525999999989,-61.98,2
09:25,593378953.0,1740.349650000005,-129.98,2
09:25,709935470.0,849.0557376997724,-47.98,2
09:25,430910686.0,1548.5833000000005,-16.97,7
09:25,678851253.0,4007.343974492226,-116.28,5
09:26,101531259.0,1280.7967999999996,-30.99,2
09:26,572136270.0,1256.3456493335775,-30.95,1
09:26,535804582.0,283.051549999999,-9.99,2
09:26,918772878.0,220.9604827546788,-44.1,2
09:26,641764023.0,-195.5938037720043,-63.98,2
09:26,402438092.0,1973.434399999999,-5.99,2
09:27,923322792.0,320.6756682463624,-31.99,2
09:27,929044080.0,868.9838915056284,-32.96,7
09:27,642015139.0,199.02633746563825,-16.97,1
09:27,822250278.0,5743.919117435352,-20.92,4
09:28,310740977.0,306.52652650733484,-37.07,7
09:29,762785862.0,1656.6657499999994,-212.97,2
09:29,257633312.0,437.6983499999992,-14.97,7
09:29,936813994.0,1169.8702108327882,-39.95,1
09:29,155867488.0,467.7486999999985,-124.99,2
09:29,349614277.0,2396.9071999999996,-36.95,7
09:29,886837068.0,1660.8780999999994,-55.91,7
09:30,639409800.0,35572.10601052425,-17.18,4
09:30,108812033.0,1227.1856499999983,-29.99,2
09:30,500843551.0,2039.9250999999997,-99.99,2
09:30,500051919.0,360.10459665059045,-31.99,2
09:31,285220959.0,12876.2617587097,-41.46,5
09:31,651756497.0,13889.686370810994,-2.59,7
09:31,466649401.0,1704.7747657231969,-23.97,4
09:31,519649533.0,1205.8218163706624,-130.98,2
09:31,834383043.0,4529.095185073416,-11.49,4
09:31,124125096.0,-4.6915056121976875,-144.54,5
09:32,224112146.0,713.9730999999987,-102.99,2
09:32,524425303.0,1247.895499999999,-21.97,1
09:32,856147482.0,555.5671514013752,-9.99,2
09:32,555804115.0,-125.49854755870274,-49.99,2
09:32,466649401.0,1693.0824613978916,-11.69,4
09:32,221356538.0,1534.3417999999997,-56.92,7
09:33,903468956.0,1248.8193999999994,-28.0,2
09:33,444371478.0,747.2528999999988,-9.99,2
09:33,473820682.0,13028.8144062966,-88.87,2
09:33,414454079.0,860.0178500000019,-7.61,4
09:33,887853850.0,8908.953376421387,-15.58,7
09:34,223207876.0,1326.3811,-92.17,2
09:34,655730067.0,341.3511999999996,-40.94,7
09:34,385685918.0,1023.5399408415524,-109.98,2
09:34,895331556.0,619.6458999999992,-34.95,1
09:34,494156986.0,1323.175545672335,-95.27,5
09:35,779236304.0,1486.1375954795326,-35.45,2
09:35,656317661.0,257.8000915414028,-63.98,2
09:35,698076160.0,4826.723235659583,-44.93,7
09:35,760753808.0,962.2768999999996,-53.0,2
09:35,799453072.0,600.9725999999989,-112.98,2
09:37,795847804.0,22971.283099877433,-150.49,2
09:37,624500124.0,2832.514769866798,-11.83,4
09:37,131388684.0,18643.9667691678,-28.67,2
09:37,435984758.0,6392.048724527369,-10.01,1
09:38,726913482.0,392.14510147352394,-37.48,4
09:38,370757362.0,824.6365898126758,-22.0,2
09:39,471897866.0,6955.960683243279,-32.34,2
09:39,854513972.0,2177.7086999999997,-9.99,2
09:39,554792076.0,27762.823141062043,-84.62,5
09:40,553734946.0,2049.724899999999,-14.98,7
09:40,132400709.0,726.0993351539398,-43.98,2
09:40,254853117.0,2223.141604308447,-3.97,2
09:41,366477356.0,1856.6084,-66.98,2
09:42,535804582.0,271.561549999999,-11.49,4
09:43,799286313.0,-24.90831287586137,-33.99,2
09:43,197050303.0,458.1494325634951,-46.98,2
09:43,340321732.0,2555.352850000003,-65.97,2
09:44,147474476.0,3306.6278651193597,-37.99,2
09:44,336171116.0,672.4554499999996,-176.98,5
09:44,642015139.0,127.03633746563824,-71.99,2
09:44,414805878.0,12051.435223601766,-161.0,2
09:45,799861885.0,1215.391449999999,-105.98,2
09:45,895331556.0,569.6558999999992,-49.99,4
09:45,296972867.0,760.5986999999992,-31.99,2
09:46,188263947.0,2464.820650000001,-27.99,2
09:46,548907062.0,-184.94251123171136,-11.98,4
09:47,989506909.0,-2368.6198707594376,-50.03,5
09:47,859264768.0,1293.2450837819383,-54.0,4
09:47,776108637.0,2104.2947536574957,-12.99,2
09:47,856957948.0,9524.60039333536,-29.99,4
09:47,761272540.0,566.7212499999989,-1.99,4
09:47,258201793.0,-38.3598000000004,-12.99,2
09:47,187541224.0,1544.8975003365424,-17.39,7
09:47,555804115.0,-161.43854755870274,-35.94,1
09:48,454356905.0,1859.839765222882,-38.49,5
09:49,760753808.0,932.2868999999996,-29.99,2
09:49,524425303.0,1197.905499999999,-49.99,2
09:49,310740977.0,276.5465265073348,-29.98,2
09:50,155317149.0,593.9948499999992,-87.97,2
09:51,762859681.0,748.250099999999,-15.97,7
09:51,656317661.0,243.82009154140283,-13.98,1
09:51,824916823.0,10118.52244944959,-10.18,7
09:51,494156986.0,1313.185545672335,-9.99,6
09:51,216286013.0,334.94850665394006,-153.98,6
09:52,703537476.0,1071.906249999999,-35.02,2
09:52,752362502.0,12029.78510309608,-7.0,7
09:53,555393405.0,-79.10480000000015,-134.85,4
09:53,652048867.0,1019.2351499999992,-59.98,4
09:53,158414827.0,30.38999999999852,-19.99,2
09:53,211493028.0,1228.9299999999994,-99.99,6
09:53,701070224.0,224.59895000000012,-178.5,2
09:53,639409800.0,35564.07601052425,-8.03,4
09:54,155867488.0,445.7486999999985,-22.0,2
09:54,823208989.0,1033.5714338695311,-56.38,7
09:54,370521542.0,27152.2777372806,-123.19,2
09:54,237684254.0,6475.3896513230175,-11.43,5
09:55,414454079.0,831.5978500000019,-28.42,2
09:55,776108637.0,2046.3147536574957,-57.98,2
09:55,838830098.0,1082.7271420877844,-4.99,1
09:57,851181128.0,2991.2322764843348,-49.36,2
09:57,828750680.0,1074.65679521368,-25.0,2
09:57,930277104.0,11455.584948827352,-160.27,2
09:57,508518911.0,364.38475027901046,-29.99,4
09:57,297823329.0,1892.024399999999,-71.56,5
09:58,706361191.0,496.85209849407806,-54.99,2
09:58,822135975.0,10254.137431481791,-160.29,2
09:58,117308635.0,629.9729033866536,-70.27,2
09:58,641764023.0,-243.57380377200428,-47.98,2
09:58,688328251.0,141.67587464517288,-38.95,1
09:59,570323670.0,4462.4803961720345,-20.03,4
09:59,250957494.0,1114.1204999999989,-19.99,4
09:59,473820682.0,12986.8424062966,-41.97,2
09:59,366477356.0,1805.6884,-50.92,7
10:00,681955876.0,-22.12810000000033,-22.97,1
10:00,895750759.0,-62.53373807566581,-184.98,2
10:00,806358207.0,10034.44578498537,-30.86,2
10:00,280990953.0,860.0528499999987,-9.99,2
10:00,987163717.0,7548.008480000006,-52.11,4
10:00,254018059.0,103.58875,-40.99,2
10:00,138351025.0,128.49209999999974,-234.98,2
10:02,868377987.0,1779.539969515681,-56.99,2
10:02,574548998.0,1533.062499999999,-47.99,2
10:02,897714622.0,9896.07227145535,-44.38,2
10:03,211493028.0,1178.9399999999994,-49.99,6
10:03,779946617.0,18187.89233198069,-28.76,8
10:04,762785862.0,1631.6657499999994,-25.0,2
10:04,158414827.0,-204.59000000000148,-234.98,2
10:04,703537476.0,1061.906249999999,-10.0,2
10:05,279149837.0,1917.5950499999988,-54.99,2
10:05,137822385.0,2844.0977171514746,-6.4,9
10:06,761272540.0,453.7512499999989,-112.97,2
10:06,155867488.0,444.2486999999985,-1.5,4
10:06,518466565.0,1258.1590999999996,-12.99,2
10:07,799286313.0,-152.88831287586137,-127.98,2
10:07,824916823.0,10085.93244944959,-32.59,7
10:07,806358207.0,9880.11578498537,-154.33,2
10:07,478986718.0,692.8473999999997,-147.98,2
10:07,382862215.0,354.1689999999999,-10.98,7
10:07,519649533.0,1177.8718163706624,-27.95,1
10:08,780463728.0,3471.7375709422395,-22.0,2
10:08,280990953.0,847.0628499999987,-12.99,2
10:09,779236304.0,1425.3875954795326,-60.75,2
10:09,726913482.0,334.1651014735239,-57.98,2
10:09,701070224.0,55.09895000000011,-169.5,2
10:09,491392945.0,6247.025500000005,-26.97,7
10:10,315078351.0,8522.532551514787,-37.86,4
10:10,655730067.0,261.3811999999996,-79.97,1
10:10,398429109.0,2184.945050000001,-57.93,7
10:10,688328251.0,110.19587464517288,-31.48,4
10:11,918772878.0,200.9104827546788,-20.05,2
10:11,370757362.0,788.6865898126757,-35.95,7
10:11,851181128.0,2975.822276484335,-15.41,1
10:12,675231808.0,17175.750481391347,-49.99,4
10:12,880546403.0,557.8053499999983,-5.99,1
10:12,130154096.0,2601.767610548966,-4.99,7
10:12,108812033.0,1095.2056499999985,-131.98,2
10:12,257633312.0,434.2083499999992,-3.49,7
10:13,155317149.0,588.0048499999992,-5.99,2
10:14,151968462.0,6830.894966925092,-0.48,5
10:14,518466565.0,1201.1590999999996,-57.0,2
10:14,414805878.0,11893.935223601766,-157.5,2
10:14,310740977.0,150.57652650733482,-125.97,2
10:15,936813994.0,1117.8802108327882,-51.99,2
10:15,822135975.0,10186.251431481793,-67.89,2
10:15,762785862.0,1592.6957499999994,-38.97,2
10:15,836110591.0,5181.713683902694,-116.22,2
10:16,293609137.0,188.85049257449805,-6.0,4
10:16,704517789.0,14715.545872223152,-50.54,2
10:17,637649383.0,1983.0064999999984,-54.99,2
10:17,799861885.0,1205.401449999999,-9.99,7
10:18,497772347.0,1785.0620499999982,-21.98,4
10:18,138351025.0,88.57209999999974,-39.92,4
10:18,478986718.0,554.8773999999996,-137.97,2
10:19,786141370.0,-898.1272000000008,-89.46,5
10:19,211493028.0,1118.9599999999994,-59.98,6
10:20,280130290.0,203.5998999999996,-76.97,7
10:21,923322792.0,285.72566824636243,-34.95,7
10:21,108812033.0,1043.2156499999985,-51.99,2
10:22,473820682.0,12861.5424062966,-125.3,2
10:22,823208989.0,982.7783138695314,-50.79,4
10:22,761272540.0,393.8412499999989,-59.91,1
10:22,197050303.0,386.1594325634951,-71.99,2
10:22,688328251.0,86.22587464517288,-23.97,4
10:23,395284483.0,2445.6123402113085,-169.37,2
10:23,223207876.0,1288.3211,-38.06,2
10:23,930277104.0,11376.512948827352,-79.07,2
10:23,297823329.0,1842.034399999999,-49.99,2
10:23,143061865.0,8509.027325779381,-9.99,2
10:24,519649533.0,1087.9018163706623,-89.97,2
10:24,895750759.0,-161.5137380756658,-98.98,2
10:24,414805878.0,11781.935223601766,-112.0,2
10:24,366477356.0,1727.7084,-77.98,2
10:25,370521542.0,26917.0917372806,-235.19,2
10:25,296972867.0,693.6186999999992,-66.98,2
10:26,949032480.0,3719.1753996108546,-24.26,7
10:27,637649383.0,1923.0164999999984,-59.99,2
10:28,250957494.0,1008.1404999999988,-105.98,2
10:29,449387287.0,530.1866938351016,-12.98,7
10:29,155867488.0,294.2686999999985,-149.98,2
10:30,552980092.0,520.0047191193376,-27.93,4
10:31,970298834.0,2080.137449425479,-51.69,4
10:32,478986718.0,519.9273999999996,-34.95,1
10:32,519649533.0,962.9118163706625,-124.99,2
10:32,945054126.0,495.0381,-32.96,7
10:33,555393405.0,-121.08480000000014,-41.98,2
10:34,245198540.0,919.6413988017796,-4.99,1
10:34,631111289.0,668.5484999999994,-9.0,4
10:35,923322792.0,153.74566824636244,-131.98,2
10:35,880546403.0,512.8153499999983,-44.99,2
10:36,815993333.0,1540.4701690614072,-30.99,1
10:36,124102251.0,2903.337478036822,-64.98,2
10:36,473820682.0,12787.356406296602,-74.19,2
10:37,108812033.0,1013.2656499999983,-29.95,7
10:37,250957494.0,861.1504999999988,-146.99,2
10:38,280130290.0,153.6098999999996,-49.99,2
10:39,776108637.0,1881.3347536574956,-164.98,2
10:39,308068836.0,45.111522568192186,-205.8,2
10:40,681955876.0,-94.09810000000031,-71.97,4
10:40,421881811.0,4821.711618076135,-1.11,2
10:40,913801979.0,279.1027799144939,-97.42,5
10:41,895750759.0,-172.4937380756658,-10.98,7
10:44,414805878.0,11648.935223601766,-133.0,2
10:44,293609137.0,168.87049257449806,-19.98,2
10:45,834581602.0,1581.5672499999991,-25.0,2
10:46,179173981.0,7331.856842381841,-46.63,4
10:46,796709231.0,973.4100778962976,-36.98,4
10:47,851649498.0,8409.209213657392,-32.05,2
10:47,552980092.0,464.0347191193375,-55.97,2
10:48,221356538.0,1432.3717999999997,-101.97,2
10:48,930277104.0,11141.312948827352,-235.2,2
10:48,815993333.0,1493.8936390614072,-46.58,4
10:48,897592348.0,12866.46998632199,-67.37,5
10:49,500051919.0,330.15459665059046,-29.95,7
10:49,945054126.0,400.0581,-94.98,2
10:50,799861885.0,1185.411449999999,-19.99,2
10:50,709935470.0,814.0657376997724,-34.99,2
10:51,155867488.0,282.28869999999847,-11.98,1
10:51,604334058.0,1449.3252999999995,-59.98,4
10:54,858560423.0,10134.553784057643,-32.95,7
10:54,519649533.0,932.9218163706624,-29.99,4
10:55,524425303.0,1159.925499999999,-37.98,2
10:56,627723633.0,-1702.2990780037626,-39.62,5
10:57,448004226.0,1738.621760862855,-134.99,2
10:58,136770968.0,278.1323999999997,-19.99,2
10:58,108812033.0,992.2856499999984,-20.98,4
10:58,990894155.0,892.3964586788416,-5.99,2
10:58,280990953.0,776.0928499999986,-70.97,4
10:59,574548998.0,1513.0724999999993,-19.99,4
10:59,701070224.0,-23.901049999999884,-79.0,2
10:59,651756497.0,13859.326370810992,-30.36,4
11:00,296972867.0,545.6386999999992,-147.98,2
11:00,395284483.0,2196.4263402113083,-249.19,2
11:00,473820682.0,12669.056406296602,-118.3,2
11:01,184430449.0,2775.838363885164,-129.98,2
11:02,402438092.0,1904.444399999999,-68.99,2
11:02,856147482.0,519.5871514013752,-35.98,2
11:02,605116158.0,1941.8072,-26.97,5
11:02,637649383.0,1873.0764999999983,-49.94,1
11:02,690958123.0,20277.374345706943,-58.34,5
11:03,992204045.0,13361.331384610585,-72.11,4
11:03,310620484.0,448.3241950921983,-11.06,7
11:04,446720287.0,222.7534408184056,-19.99,2
11:04,308068836.0,-184.4884774318078,-229.6,2
11:04,945054126.0,387.0681,-12.99,2
11:04,293609137.0,153.90049257449806,-14.97,1
11:05,450896297.0,14324.29616376906,-36.62,2
11:06,657139925.0,14774.425839386777,-68.53,2
11:07,333054026.0,90.28989402319,-56.21,2
11:08,500051919.0,182.17459665059047,-147.98,2
11:08,704517789.0,14694.809066463024,-20.74,2
11:08,975345315.0,36028.214799999965,-6.99,4
11:08,496395938.0,10880.335633900286,-43.18,7
11:09,158766229.0,-926.36653589347,-61.98,5
11:10,631111289.0,658.5584999999994,-9.99,7
11:11,152616936.0,1461.2930078630648,-54.99,2
11:12,822135975.0,9895.765431481792,-290.49,2
11:12,667367404.0,10304.67603163486,-63.1,2
11:12,796709231.0,816.4200778962975,-156.99,2
11:13,216286013.0,280.96850665394004,-53.98,2
11:13,598793068.0,1815.9703499999985,-4.99,7
11:13,849096144.0,1306.749858910517,-3.49,4
11:14,726913482.0,271.1751014735239,-62.99,2
11:16,524425303.0,1114.945499999999,-44.98,4
11:16,828750680.0,999.68679521368,-74.97,2
11:17,552980092.0,436.0347191193375,-28.0,2
11:18,546296727.0,187.32452730261855,-27.96,7
11:19,293609137.0,87.92049257449806,-65.98,2
11:19,815993333.0,1437.8336390614072,-56.06,2
11:19,637649383.0,1823.0864999999983,-49.99,2
11:19,929044080.0,749.0138915056284,-119.97,2
11:20,414805878.0,11414.435223601766,-234.5,2
11:20,500843551.0,1979.9350999999997,-59.99,2
11:21,701070224.0,-220.90104999999988,-197.0,2
11:22,806358207.0,9850.325784985367,-29.79,1
11:22,683078800.0,2892.455641349959,-17.97,7
11:23,880546403.0,490.81534999999826,-22.0,2
11:23,298000165.0,21552.71127679745,-15.97,4
11:25,221868392.0,6493.258626752437,-28.55,7
11:25,828750680.0,964.68679521368,-35.0,2
11:27,822135975.0,9672.479431481792,-223.29,2
11:28,254018059.0,83.59875000000001,-19.99,4
11:28,500843551.0,1931.9450999999997,-47.99,2
11:28,409971170.0,2902.258845563993,-15.66,4
11:29,472995101.0,1315.7515238883295,-95.68,5
11:29,349614277.0,2338.9271999999996,-57.98,2
11:29,854513972.0,2154.7387,-22.97,7
11:30,598793068.0,1774.0003499999984,-41.97,4
11:30,449387287.0,505.1866938351015,-25.0,6
11:30,836110591.0,5176.966398686183,-4.75,8
11:31,929044080.0,736.0238915056284,-12.99,2
11:34,792845450.0,1571.323150000001,-243.6,2
11:34,497772347.0,1763.0620499999982,-22.0,4
11:35,743630833.0,-95.9746867152988,-85.0,2
11:35,414805878.0,11338.135223601766,-76.3,2
11:37,494156986.0,1275.195545672335,-37.99,2
11:38,903953091.0,3661.8660389956626,-84.97,4
11:38,450896297.0,14263.29616376906,-61.0,1
11:38,990461108.0,552.2271686206111,-82.99,2
11:39,310740977.0,-29.39347349266518,-179.97,2
11:40,822135975.0,9504.493431481793,-167.99,2
11:40,990894155.0,820.4164586788415,-71.98,2
11:41,382862215.0,272.1889999999999,-81.98,2
11:42,986774156.0,3315.176931625768,-4.99,7
11:46,585133606.0,5833.059594043089,-69.98,4
11:46,624563756.0,1031.7039287835564,-34.96,1
11:48,771125520.0,89.42304999999948,-63.98,2
11:48,535804582.0,239.57154999999895,-31.99,2
11:48,757115616.0,2337.7900000000027,-19.98,1
11:49,633345190.0,6093.343318842051,-115.5,4
11:49,221868392.0,6487.118626752436,-6.14,4
11:52,923322792.0,143.75566824636243,-9.99,2
11:52,743630833.0,-202.4746867152988,-106.5,2
11:53,352899149.0,1313.0150499999988,-5.99,2
11:53,815993333.0,1363.7836390614073,-74.05,2
11:53,355602925.0,945.2476195597524,-27.96,7
11:53,473820682.0,12510.870406296604,-158.19,2
11:54,918772878.0,160.8104827546788,-40.1,2
11:54,134847904.0,4881.832044386294,-47.99,2
11:55,285428103.0,7789.141950465588,-90.3,2
11:56,690523499.0,2125.17445,-3.99,7
11:56,631111289.0,598.5884999999994,-59.97,2
11:58,581655972.0,37036.83587491664,-59.98,2
11:59,795847804.0,22958.56561513749,-12.72,5
11:59,310620484.0,435.2441950921984,-13.08,2
12:01,246753533.0,1831.4856999999988,-64.99,2
12:02,923322792.0,137.76566824636242,-5.99,2
12:04,449387287.0,449.19669383510154,-55.99,2
12:04,223207876.0,1278.3111,-10.01,2
12:04,736310094.0,-1029.649424027426,-24.23,9
12:04,675231808.0,17106.303481391347,-69.45,5
12:05,843537309.0,26.040282208368176,-59.98,2
12:05,382862215.0,231.1989999999999,-40.99,2
12:05,450896297.0,14236.20616376906,-27.09,9
12:05,340321732.0,2455.362850000003,-99.99,2
12:05,535804582.0,198.58154999999897,-40.99,2
12:06,478986718.0,471.9573999999995,-47.97,2
12:06,138609932.0,3529.4750032945853,-7.96,4
12:06,492058070.0,776.9959687404707,-98.0,2
12:07,520447032.0,7671.624149007072,-12.67,4
12:07,873693307.0,11208.636071054014,-16.97,9
12:10,859264768.0,1257.2950837819385,-35.95,7
12:11,858989281.0,22980.54408933392,-10.42,7
12:12,285428103.0,7671.541950465587,-117.6,2
12:12,492215823.0,2597.191173815443,-32.6,7
12:12,552980092.0,408.0347191193375,-28.0,2
12:13,395284483.0,2096.354340211308,-100.07,2
12:14,449387287.0,318.2166938351015,-130.98,2
12:15,843537309.0,-123.94971779163184,-149.99,2
12:15,895750759.0,-182.4837380756658,-9.99,2
12:16,652048867.0,939.265149999999,-79.97,2
12:17,683078800.0,2849.330641349959,-43.12,2
12:17,143606916.0,-282.9525959708103,-27.94,9
12:19,792845450.0,1285.7231500000012,-285.6,2
12:19,743630833.0,-334.4746867152988,-132.0,2
12:20,896821055.0,930.0581736852354,-11.98,1
12:23,624563756.0,977.7139287835564,-53.99,2
12:24,524425303.0,1031.9754999999989,-82.97,2
12:25,859264768.0,1227.3050837819385,-29.99,2
12:27,538003940.0,1060.8600000000076,-34.99,2
12:27,435984758.0,6384.032724527369,-8.02,4
12:28,538003940.0,1027.3400000000076,-33.52,9
12:29,828750680.0,963.18679521368,-1.5,4
12:30,473820682.0,12460.484406296602,-50.39,2
12:32,583579399.0,1723.3062999999993,-53.47,5
12:33,524425303.0,1024.4754999999989,-7.5,9
12:33,792845450.0,1079.9231500000012,-205.8,2
12:34,151968462.0,6800.844946925093,-30.05,4
12:34,683078800.0,2785.580641349959,-63.75,2
12:34,308068836.0,-379.0884774318078,-194.6,2
12:35,386729293.0,31177.601561990625,-74.97,6
12:35,352899149.0,1284.0550499999988,-28.96,1
12:37,760753808.0,862.3068999999996,-69.98,2
12:37,828532554.0,820.4131013660719,-134.5,2
12:37,187541224.0,1323.0395003365425,-221.86,2
12:37,510101371.0,13505.10132114884,-42.47,4
12:38,366550080.0,22296.37826520387,-4.82,7
12:39,386277162.0,1596.8899999999994,-15.98,2
12:41,213112754.0,5495.547957744279,-12.25,9
12:42,652048867.0,864.295149999999,-74.97,2
12:43,382862215.0,105.2289999999999,-125.97,2
12:43,256045540.0,-3220.2563999999993,-25.7,5
12:45,828750680.0,931.19679521368,-31.99,2
12:45,280990953.0,716.0928499999986,-60.0,2
12:47,843537309.0,-261.9297177916318,-137.98,2
12:48,140893085.0,4187.538056365462,-207.9,5
12:49,534204159.0,6744.1712931767825,-57.08,2
12:49,321372947.0,-628.8483507890994,-45.05,5
12:49,310620484.0,412.3041950921984,-22.94,9
12:51,213096759.0,-1714.7241082144396,-124.4,5
12:52,473820682.0,12414.298406296602,-46.19,2
12:53,828532554.0,587.4131013660719,-233.0,2
12:57,187541224.0,1117.2535003365424,-205.79,2
12:57,382862215.0,75.2389999999999,-29.99,4
12:58,478986718.0,470.4573999999995,-1.5,4
12:59,395284483.0,1988.5823402113083,-107.77,2
12:59,918772878.0,110.6704827546788,-50.14,2
12:59,642015139.0,67.47133746563826,-59.56,5
12:59,601627384.0,5122.0637936043495,-0.17,2
13:00,143383029.0,-140.93116934766135,-9.99,7
13:01,136770968.0,265.15239999999966,-12.98,4
13:02,246753533.0,1799.4956999999988,-31.99,2
13:04,828750680.0,898.2467952136799,-32.95,1
13:04,822135975.0,9424.021431481791,-80.47,2
13:04,518466565.0,1098.4764499999997,-102.68,5
13:05,842682241.0,6855.040982160805,-58.99,5
13:06,683078800.0,2714.705641349959,-70.88,2
13:06,518474507.0,15641.368134426217,-36.41,2
13:07,322221939.0,2457.313287740697,-6.5,9
13:08,308068836.0,-572.9884774318077,-193.9,2
13:09,949032480.0,3537.5653996108545,-181.61,2
13:09,245690309.0,7604.078611155317,-13.01,5
13:10,407574996.0,2503.715478801186,-5.5,9
13:10,918772878.0,80.59048275467879,-30.08,2
13:11,625281433.0,-1016.2632073707568,-39.04,5
13:11,473820682.0,12331.012406296602,-83.29,2
13:12,497772347.0,1753.0720499999982,-9.99,2
13:12,395284483.0,1835.3103402113084,-153.27,2
13:13,258201793.0,-76.3498000000004,-37.99,2
13:13,480557476.0,12472.68020286968,-5.65,9
13:13,749378808.0,4299.546454255163,-5.7,9
13:13,187111705.0,8442.634319615468,-5.0,9
13:13,940569402.0,4742.371681983107,-73.57,5
13:14,252701364.0,-3476.0586726779165,-32.16,5
13:14,891716230.0,189.81298404129527,-21.98,4
13:18,896821055.0,773.0781736852354,-156.98,2
13:18,987656636.0,6527.063942708182,-7.06,7
13:19,165045150.0,-1938.466438597144,-38.32,5
13:22,179173981.0,7262.277592381841,-69.58,4
13:23,500843551.0,1913.9750999999997,-17.97,4
13:23,184430449.0,2746.878363885164,-28.96,7
13:29,961077907.0,276.19280000000003,-158.46,5
13:32,296972867.0,522.4486999999991,-23.19,9
13:33,454356905.0,1663.867765222882,-195.97,2
13:34,413557825.0,845.8494999999996,-24.96,1
13:36,822135975.0,9378.53543148179,-45.49,2
13:36,280990953.0,687.1328499999986,-28.96,1
13:36,473820682.0,12261.012406296602,-70.0,2
13:38,701070224.0,-269.9010499999999,-49.0,2
13:38,833499132.0,3820.05525,-32.86,5
13:39,631111289.0,498.5984999999994,-99.99,2
13:39,737537711.0,-1748.2994663984643,-30.02,5
13:40,637649383.0,1723.0964999999983,-99.99,2
13:41,494156986.0,1269.205545672335,-5.99,2
13:43,508518911.0,324.4347502790105,-39.95,1
13:44,546296727.0,177.33452730261857,-9.99,2
13:48,655730067.0,251.39119999999957,-9.99,2
13:48,815385232.0,10931.408758505717,-92.58,5
13:49,246753533.0,1768.5256999999988,-30.97,4
13:49,767447966.0,3423.0293255121096,-86.31,4
13:51,280990953.0,587.1428499999986,-99.99,2
13:54,799453072.0,562.9925999999989,-37.98,2
13:55,473820682.0,12185.440406296602,-75.57,2
13:55,308068836.0,-680.7884774318077,-107.8,2
13:58,546296727.0,151.35452730261858,-25.98,4
13:59,859264768.0,1155.3250837819385,-71.98,2
13:59,214339619.0,-300.97244913164354,-105.35,5
14:00,701070224.0,-312.4010499999999,-42.5,2
14:00,643610517.0,-2858.186190729657,-35.45,5
14:00,851649498.0,8359.285213657391,-49.92,5
14:01,134847904.0,4864.852044386294,-16.98,4
14:02,508518911.0,296.4347502790105,-28.0,2
14:02,822135975.0,9111.86343148179,-266.67,2
14:05,454356905.0,1530.1957652228818,-133.67,2
14:07,414805878.0,11111.335223601767,-226.8,2
14:07,828532554.0,482.41310136607194,-105.0,2
14:08,395284483.0,1725.4243402113084,-109.89,2
14:08,688328251.0,80.23587464517288,-5.99,2
14:11,340680761.0,-2821.9955999999984,-28.17,5
14:11,308068836.0,-812.3884774318077,-131.6,2
14:12,511179916.0,7072.157710253574,-52.19,7
14:16,880546403.0,426.83534999999824,-63.98,2
14:17,828750680.0,831.2567952136799,-66.99,2
14:17,994214354.0,7903.966128387068,-11.24,5
14:17,828532554.0,388.41310136607194,-94.0,2
14:22,624563756.0,915.1108287835564,-62.6,5
14:24,395284483.0,1648.4243402113084,-77.0,2
14:26,880546403.0,298.8553499999982,-127.98,2
14:26,487051121.0,166.9105664045101,-38.4,5
14:27,822135975.0,9021.56343148179,-90.3,2
14:30,308068836.0,-1112.6884774318078,-300.3,2
14:32,994214354.0,7873.942848387069,-30.02,4
14:33,408057540.0,2608.121440779667,-47.63,1
14:34,331450202.0,8349.467744103456,-41.03,2
14:35,454356905.0,1313.251765222882,-216.94,2
14:39,828532554.0,170.91310136607194,-217.5,2
14:45,534204159.0,6433.476293176783,-310.69,5
14:48,706361191.0,410.36884849407807,-86.48,5
14:55,143003091.0,21983.0468886239,-57.97,4
15:00,395284483.0,1502.8243402113085,-145.6,2
15:06,535804582.0,143.59154999999896,-54.99,2
15:16,535804582.0,64.60154999999897,-78.99,2
15:19,448004226.0,1681.7117608628546,-56.91,7
15:20,538003940.0,1021.3500000000076,-5.99,4
15:24,358836279.0,10.994892807585998,-69.51,5
15:31,187541224.0,1027.6675003365424,-89.59,2
15:45,903663593.0,112.09705585954086,-7.5,4
15:56,395284483.0,1264.8523402113085,-237.97,2
15:57,187541224.0,917.0675003365424,-110.6,2
16:02,762859681.0,704.6975999999989,-43.55,5
16:10,333054026.0,74.24989402319,-16.04,7
16:13,245690309.0,7596.843768308777,-7.23,4
16:15,395284483.0,1035.9523402113086,-228.9,2
16:23,696333897.0,1626.072599999999,-15.98,4
16:25,762859681.0,686.7575999999989,-17.94,4
16:27,899742927.0,10101.982032495447,-83.98,2
16:30,779620857.0,596.3399036148242,-35.98,2
16:31,187541224.0,872.2815003365424,-44.79,2
16:33,943329213.0,1812.452088533404,-99.25,5
16:33,901432314.0,3263.239720218267,-55.12,5
16:35,228136274.0,786.5246999999991,-17.48,4
16:39,738958551.0,9691.152602113818,-13.26,7
16:45,901432314.0,3226.029720218267,-37.21,7
16:46,151916463.0,1745.6215555991687,-10.0,2
16:46,280200287.0,-673.620453386949,-94.41,5
16:47,228136274.0,711.5346999999991,-74.99,2
16:47,444428189.0,2327.9293500000026,-101.97,2
16:49,527842638.0,2037.1987426329836,-29.99,4
16:50,395284483.0,985.5943402113088,-50.36,2
16:51,151278285.0,434.4853499999997,-31.99,2
17:01,197865285.0,-71.56223826877954,-60.0,2
17:03,395284483.0,938.0083402113088,-47.59,2
17:04,187541224.0,747.7235003365424,-124.56,2
17:04,228136274.0,661.6346999999992,-49.9,4
17:06,198946608.0,4951.864291762158,-12.0,7
17:10,522188082.0,6260.441361858891,-3.15,2
17:12,308505160.0,15186.349769487942,-19.9,7
17:20,322720763.0,6287.893192702044,-27.07,8
17:21,233981231.0,3353.193815190971,-14.99,4
17:22,627936697.0,2161.61055,-30.96,1
17:23,556992209.0,12795.940125924426,-18.52,4
17:25,899692478.0,-1836.7366935240073,-138.89,5
17:26,261894284.0,-2669.161299999998,-18.88,5
17:29,137913631.0,2289.379,-51.99,2
17:31,187541224.0,622.4375003365424,-125.29,2
17:31,280268430.0,5065.384239937473,-49.99,4
17:33,627936697.0,2061.64055,-99.97,4
17:36,613729471.0,9825.517285846525,-25.2,2
17:37,137913631.0,2233.399,-55.98,2
17:37,564744955.0,1280.283658588842,-29.99,2
17:43,444428189.0,2303.959350000003,-23.97,7
17:43,373875019.0,16265.932523365682,-15.98,1
17:43,454356905.0,1110.979765222882,-202.27,2
17:44,627936697.0,2036.64055,-25.0,2
17:49,403902116.0,1595.6837499999992,-22.0,2
17:49,293191074.0,1337.8181499999992,-61.98,2
17:52,736340277.0,7181.154787223335,-38.9,7
17:53,828532554.0,-5.586898633928058,-176.5,2
17:56,435313070.0,2537.5203086224637,-2.55,2
17:57,187541224.0,506.25150033654234,-116.19,2
17:59,521611005.0,-339.7846358510466,-50.59,5
18:03,395284483.0,748.3363402113087,-189.67,2
18:03,807098817.0,-164.63320000000078,-36.9,9
18:06,828532554.0,-90.58689863392806,-85.0,2
18:15,454356905.0,943.721765222882,-167.26,2
18:16,187541224.0,474.76550033654235,-31.49,2
18:26,316793091.0,1641.014310054951,-51.49,7
18:33,706250160.0,12956.020417515369,-31.39,9
18:35,478651121.0,-269.88387040153026,-53.05,5
18:38,285873880.0,9675.35324812084,-14.29,7
19:01,518474507.0,15512.785134426214,-128.58,5
19:06,550169791.0,22544.864202653134,-6.99,9
19:07,738958551.0,9657.172602113818,-33.98,9
19:09,618514666.0,21557.828820035986,-23.48,5
19:11,146909202.0,3651.308099675629,-27.68,9
19:13,845648250.0,350.83684999999946,-128.18,5
19:19,654329190.0,-257.94559905148066,-22.54,5
19:37,120634201.0,5797.583500000004,-14.59,9
19:43,370521542.0,26905.1417372806,-11.95,9
19:44,583558311.0,-1266.0372152486675,-64.41,5
19:45,948069469.0,678.197999999999,-83.3,5
19:58,865748375.0,2511.3095024712698,-0.94,5
20:23,609939116.0,6043.506646369859,-174.15,5
20:38,344843570.0,-625.8343175093338,-34.53,5
20:39,170637730.0,1916.9633586109776,-86.73,5
20:41,587225252.0,7820.607264155328,-74.66,7
20:50,558119802.0,33608.486692761086,-27.19,9
21:05,554792076.0,27739.860465441077,-22.96,2
21:08,653640811.0,14377.065087902438,-8.4,2
21:13,593378953.0,1695.3096500000051,-45.04,9
21:54,414805878.0,11055.360118594232,-55.98,5
00:00,461990622.0,10595.767901532185,-1316.0,0
00:00,652048867.0,289.295149999999,-575.0,0
00:00,633345190.0,7839.343318842051,-1334.0,0
00:00,588565416.0,7820.449074968008,-501.0,0
00:00,977899503.0,-199.79710641914744,-469.0,0
00:00,987229118.0,4838.428762694481,-489.0,0
00:00,452974357.0,-2880.941449999996,-1322.0,0
00:00,564214408.0,8.84788472572609,-1351.0,0
00:00,514362267.0,596.9373191070604,-829.0,0
00:00,986774156.0,4051.176931625768,-939.0,0
00:00,920830317.0,10.877770637481262,-1361.0,0
00:00,197865285.0,802.4377617312202,-1276.0,0
00:00,499244466.0,-69.17853128342222,-621.0,0
00:00,610450243.0,-770.1596,-1081.0,0
00:00,909676212.0,1758.201169740084,-780.0,0
00:00,141521177.0,7749.801900000013,-1090.0,0
00:00,474301748.0,-2067.969005683969,-553.0,0
00:00,812839908.0,-1564.9748500000003,-1004.0,0
00:00,296972867.0,-703.5513000000009,-1226.0,0
00:00,246753533.0,1092.5256999999988,-676.0,0
00:00,257633312.0,-151.7916500000008,-586.0,0
00:00,886837068.0,858.8780999999994,-802.0,0
00:00,892354433.0,-1023.7499606343384,-1324.0,0
00:00,822135975.0,11513.31343148179,-596.0,0
00:00,477216513.0,-546.6414499999994,-1351.0,0
00:00,554792076.0,27223.860465441077,-516.0,0
00:00,261894284.0,-3227.161299999998,-558.0,0
00:00,104832000.0,-2678.4698589058444,-861.0,0
00:00,750094757.0,-1703.2837000000004,-1226.0,0
00:00,390747457.0,574.2676999999981,-1269.0,0
00:00,817294757.0,-2473.6758000000004,-1359.0,0
00:00,598793068.0,1111.0003499999984,-663.0,0
00:00,535804582.0,-1099.398450000001,-1164.0,0
00:00,684988568.0,-325.3139234272014,-457.0,0
00:00,170637730.0,3304.9633586109776,-633.0,0
00:00,982949451.0,-3479.1991670525094,-1130.0,0
00:00,520447032.0,9474.624149007072,-891.0,0
00:00,851181128.0,5297.822276484335,-448.0,0
00:00,221868392.0,5893.118626752436,-594.0,0
00:00,876890798.0,3153.39822069993,-575.0,0
00:00,661295096.0,3416.5142044119348,-646.0,0
00:00,534583529.0,1504.4473880547653,-628.0,0
00:00,370521542.0,26099.1417372806,-806.0,0
00:00,585133606.0,4951.059594043089,-882.0,0
00:00,366550080.0,25827.37826520387,-636.0,0
00:00,570269025.0,3472.8115333598885,-488.0,0
00:00,472995101.0,2432.0815238883297,-887.0,0
00:00,245198540.0,71.64139880177947,-848.0,0
00:00,522188082.0,8500.441361858891,-540.0,0
00:00,370757362.0,1819.6865898126755,-644.0,0
00:00,648644594.0,124.0569999999991,-452.0,0
00:00,187111705.0,7055.6343196154685,-1387.0,0
00:00,270374623.0,10665.182469968056,-541.0,0
00:00,435313070.0,3435.5203086224637,-1148.0,0
00:00,713057426.0,-1440.7692500000005,-647.0,0
00:00,744968736.0,-1382.326826569424,-1294.0,0
00:00,497809732.0,433.2928695525952,-1327.0,0
00:00,430910686.0,1072.5833000000005,-476.0,0
00:00,422955974.0,354.98278499904995,-1089.0,0
00:00,979135922.0,-206.6566994095492,-551.0,0
00:00,724537117.0,-1006.0454000000004,-1176.0,0
00:00,165691047.0,577.8603999999991,-655.0,0
00:00,336557504.0,1692.228395019486,-967.0,0
00:00,766692943.0,-1851.9617500000004,-952.0,0
00:00,706250160.0,11958.020417515369,-998.0,0
00:00,979892433.0,-1270.281600000001,-1209.0,0
00:00,303843160.0,647.8681000000017,-778.0,0
00:00,822718326.0,11241.974222410903,-1199.0,0
00:00,843537309.0,-928.9297177916318,-667.0,0
00:00,949032480.0,5184.565399610854,-645.0,0
00:00,818552503.0,475.7167499999989,-665.0,0
00:00,286484726.0,1171.735476947126,-745.0,0
00:00,516051449.0,1971.978287516744,-504.0,0
00:00,218795010.0,603.9964499999996,-514.0,0
00:00,380228542.0,205.67454181556548,-623.0,0
00:00,556992209.0,11804.940125924426,-991.0,0
00:00,833499132.0,2983.0552500000003,-837.0,0
00:00,785749304.0,8839.98317507463,-787.0,0
00:00,504055745.0,250.38496134176697,-608.0,0
00:00,550832673.0,3681.487134474407,-986.0,0
00:00,500043411.0,13904.503545692278,-839.0,0
00:00,679662108.0,16201.779426393849,-548.0,0
00:00,235663459.0,491.4044298120152,-901.0,0
00:00,843174694.0,-4738.895999999998,-1300.0,0
00:00,324224854.0,3327.270713579428,-468.0,0
00:00,672994751.0,225.09130758413744,-520.0,0
00:00,853907490.0,7590.148570287314,-1110.0,0
00:00,903663593.0,1037.397055859541,-578.0,0
00:00,357651163.0,-509.3200000000006,-1008.0,0
00:00,939972497.0,313.8532586000108,-557.0,0
00:00,903468956.0,619.8193999999994,-629.0,0
00:00,971129830.0,-2005.0631499999995,-569.0,0
00:00,990894155.0,199.4164586788415,-621.0,0
00:00,816685391.0,-514.0745037084263,-1384.0,0
00:00,564744955.0,708.283658588842,-572.0,0
00:00,133755851.0,929.0240038000928,-1109.0,0
00:00,675806859.0,7082.991020259421,-648.0,0
00:00,544961962.0,2377.0743230056087,-553.0,0
00:00,252760664.0,7302.46368186801,-749.0,0
00:00,131388684.0,22297.9667691678,-721.0,0
00:00,534097839.0,-4910.688549999999,-691.0,0
00:00,842682241.0,6343.040982160805,-512.0,0
00:00,680773155.0,1133.9027833310918,-746.0,0
00:00,631111289.0,-452.4015000000006,-951.0,0
00:00,776431321.0,3596.173500363153,-502.0,0
00:00,472213568.0,-46.07709420605329,-600.0,0
00:00,137913631.0,1757.399,-476.0,0
00:00,668692488.0,2518.690903563902,-543.0,0
00:00,834581602.0,866.5672499999991,-715.0,0
00:00,240643705.0,734.4650911206154,-998.0,0
00:00,874431242.0,10104.348625778077,-452.0,0
00:00,752362502.0,10923.78510309608,-1106.0,0
00:00,925659248.0,-408.9501392295712,-1270.0,0
00:00,496395938.0,13160.995633900286,-561.0,0
00:00,807714284.0,1315.730360736,-679.0,0
00:00,699997811.0,2082.795200000003,-1340.0,0
00:00,147474476.0,4708.62786511936,-473.0,0
00:00,500843551.0,1244.9750999999997,-669.0,0
00:00,859603181.0,4399.255666544273,-700.0,0
00:00,896821055.0,-115.92182631476464,-889.0,0
00:00,322221939.0,4348.313287740697,-803.0,0
00:00,915666111.0,-4108.852074772038,-1269.0,0
00:00,551196328.0,4995.276133942312,-567.0,0
00:00,117273481.0,9546.459548378272,-897.0,0
00:00,641764023.0,-1113.5738037720043,-870.0,0
00:00,955035930.0,1653.793479171477,-1347.0,0
00:00,866941383.0,3238.675500000005,-750.0,0
00:00,321372947.0,-196.8483507890994,-1262.0,0
00:00,151968462.0,9400.844946925092,-776.0,0
00:00,403383649.0,2109.292466099444,-471.0,0
00:00,134847904.0,4349.852044386294,-515.0,0
00:00,610645022.0,-486.67746264491825,-988.0,0
00:00,996042490.0,5975.917696170785,-501.0,0
00:00,479366718.0,2260.581447632399,-997.0,0
00:00,986267641.0,7656.171578054611,-1272.0,0
00:00,851649498.0,10685.285213657393,-673.0,0
00:00,449871732.0,10639.694646956108,-705.0,0
00:00,971010829.0,429.58125644424535,-815.0,0
00:00,237493332.0,14865.887394494952,-585.0,0
00:00,768271776.0,-296.15174676657944,-632.0,0
00:00,673025413.0,4495.4315573767,-889.0,0
00:00,509627909.0,244.684649999999,-961.0,0
00:00,373163757.0,12040.411796728537,-554.0,0
00:00,858560423.0,12259.553784057643,-745.0,0
00:00,494789005.0,3453.4335196375305,-485.0,0
00:00,656317661.0,-248.17990845859717,-492.0,0
00:00,398429109.0,1152.9450500000012,-1032.0,0
00:00,957821152.0,-1180.1710035715498,-951.0,0
00:00,143061865.0,7808.027325779381,-701.0,0
00:00,478651121.0,65.1161295984698,-1340.0,0
00:00,142791593.0,115.5319499999996,-475.0,0
00:00,690523499.0,1547.17445,-578.0,0
00:00,386277162.0,529.8899999999994,-1067.0,0
00:00,487051121.0,1019.91056640451,-759.0,0
00:00,758885184.0,1969.177182274345,-561.0,0
00:00,137822385.0,3970.097717151475,-957.0,0
00:00,951817450.0,10079.974556535846,-1014.0,0
00:00,672913754.0,10947.340918423384,-745.0,0
00:00,491392945.0,5009.025500000005,-1238.0,0
00:00,208381936.0,-782.525578221745,-544.0,0
00:00,461029994.0,7561.406299682367,-861.0,0
00:00,350921975.0,-22.33702892612564,-665.0,0
00:00,124102251.0,4343.9374780368225,-476.0,0
00:00,948069469.0,-560.802000000001,-1239.0,0
00:00,950234174.0,1341.9880599724934,-596.0,0
00:00,200080192.0,10017.205180574085,-821.0,0
00:00,895331556.0,-258.3441000000008,-828.0,0
00:00,429556122.0,6458.571750000003,-503.0,0
00:00,865748375.0,4109.309502471269,-485.0,0
00:00,376271050.0,1467.5602468611792,-813.0,0
00:00,348325817.0,10519.92713558439,-1209.0,0
00:00,604334058.0,947.3252999999996,-502.0,0
00:00,442070890.0,1096.3124124443711,-1351.0,0
00:00,835829467.0,-1537.0947499999988,-491.0,0
00:00,984783496.0,14781.767214877384,-642.0,0
00:00,558119802.0,32574.48669276109,-1034.0,0
00:00,503575533.0,8253.518090000016,-965.0,0
00:00,169006407.0,12192.373327852552,-520.0,0
00:00,576188756.0,-3394.6514999999995,-597.0,0
00:00,229205098.0,7739.045652088711,-464.0,0
00:00,675231808.0,16528.303481391347,-578.0,0
00:00,722358036.0,1197.720840627083,-1304.0,0
00:00,129018172.0,9043.135887752607,-782.0,0
00:00,331684336.0,-1420.8474699513215,-990.0,0
00:00,183186021.0,-2128.802549999999,-809.0,0
00:00,471897866.0,8928.96068324328,-499.0,0
00:00,625281433.0,-347.26320737075673,-700.0,0
00:00,605116158.0,2972.9071999999996,-589.0,0
00:00,467207141.0,1776.5830670482635,-693.0,0
00:00,987163717.0,7029.008480000006,-519.0,0
00:00,366477356.0,607.7084,-1120.0,0
00:00,943829984.0,515.0065091134572,-595.0,0
00:00,873693307.0,10241.636071054014,-967.0,0
00:00,287230540.0,1564.1685989370008,-1383.0,0
00:00,424927189.0,-7.568517255894676,-890.0,0
00:00,824916823.0,9290.93244944959,-795.0,0
00:00,766812921.0,241.5268999999994,-846.0,0
00:00,308897841.0,1128.3666999999991,-1219.0,0
00:00,565175333.0,-3511.996022729827,-1204.0,0
00:00,559995067.0,4075.439160897453,-1266.0,0
00:00,683078800.0,2096.705641349959,-618.0,0
00:00,644751433.0,-1285.033158465538,-952.0,0
00:00,462962606.0,-1085.930950000001,-1049.0,0
00:00,709632525.0,-1471.0773500000007,-1043.0,0
00:00,489964679.0,22355.149598831304,-613.0,0
00:00,448279144.0,1274.1923499999994,-496.0,0
00:00,687135796.0,27154.881857977933,-515.0,0
00:00,703478110.0,4923.62595432897,-1201.0,0
00:00,361201224.0,3394.9602320678932,-665.0,0
00:00,596463612.0,-2245.0426047251394,-1012.0,0
00:00,654329190.0,261.0544009485193,-1144.0,0
00:00,492058070.0,-579.0040312595293,-1356.0,0
00:00,433917275.0,8686.57959930583,-912.0,0
00:00,203466392.0,3249.6069218971784,-672.0,0
00:00,586315521.0,12503.831803488092,-653.0,0
00:00,121858569.0,1815.5711500000025,-776.0,0
00:00,524425303.0,107.47549999999887,-917.0,0
00:00,999752672.0,1437.4209435333346,-652.0,0
00:00,194745206.0,901.3603720912432,-508.0,0
00:00,475277431.0,273.5401369436195,-632.0,0
00:00,340295966.0,-1353.6644500000002,-850.0,0
00:00,930271460.0,436.1642475357762,-1116.0,0
00:00,734161378.0,-2538.875169434213,-1043.0,0
00:00,361955473.0,-169.93580475591557,-711.0,0
00:00,297823329.0,1165.034399999999,-677.0,0
00:00,519933553.0,-167.62399584927152,-880.0,0
00:00,613729471.0,9347.517285846525,-478.0,0
00:00,138351025.0,-481.42790000000025,-570.0,0
00:00,388862238.0,1399.609652623988,-446.0,0
00:00,741903302.0,3332.305458740786,-684.0,0
00:00,130522384.0,-347.8038156208604,-847.0,0
00:00,496674181.0,-1189.6025223307224,-564.0,0
00:00,151278285.0,-574.5146500000003,-1009.0,0
00:00,760753808.0,-208.6931000000004,-1071.0,0
00:00,162162212.0,-201.65760667269112,-1395.0,0
00:00,119993184.0,-1932.819402910863,-1223.0,0
00:00,101531259.0,421.7967999999996,-859.0,0
00:00,705848712.0,26257.249842274618,-1343.0,0
00:00,478986718.0,-807.5426000000004,-1278.0,0
00:00,838415080.0,-3233.801499999999,-928.0,0
00:00,919185264.0,5412.394722887972,-683.0,0
00:00,108931112.0,14281.033154795789,-936.0,0
00:00,480557476.0,11525.68020286968,-947.0,0
00:00,444428189.0,1385.9593500000028,-918.0,0
00:00,550644516.0,-8.400850000001356,-1065.0,0
00:00,630691258.0,417.61654487484134,-617.0,0
00:00,737547541.0,819.7245995677742,-545.0,0
00:00,386729293.0,30527.601561990625,-650.0,0
00:00,696333897.0,1098.072599999999,-528.0,0
00:00,331450202.0,7718.467744103456,-631.0,0
00:00,624563756.0,93.11082878355636,-822.0,0
00:00,730002588.0,14092.909384652556,-1173.0,0
00:00,585596026.0,250.5352388112533,-938.0,0
00:00,809499628.0,17005.184900003504,-645.0,0
00:00,555804115.0,-1202.4385475587028,-1041.0,0
00:00,534908754.0,-733.5395000000002,-1143.0,0
00:00,403902116.0,735.6837499999992,-860.0,0
00:00,506618547.0,17818.413569052304,-1143.0,0
00:00,316793091.0,1166.014310054951,-475.0,0
00:00,860360312.0,361.26240888268035,-477.0,0
00:00,308068836.0,505.31152256819223,-854.0,0
00:00,627936697.0,1306.64055,-730.0,0
00:00,898104045.0,-1305.133050000002,-584.0,0
00:00,835736339.0,2085.143240414559,-500.0,0
00:00,815385232.0,10388.408758505717,-543.0,0
00:00,454129843.0,1783.048450791789,-790.0,0
00:00,435984758.0,5690.032724527369,-694.0,0
00:00,673818591.0,1365.1067753758412,-469.0,0
00:00,626989363.0,1091.5249633173753,-577.0,0
00:00,531186970.0,-449.2874437563805,-753.0,0
00:00,713910252.0,193.7488257285413,-1213.0,0
00:00,567499591.0,-1129.0653000000004,-1000.0,0
00:00,183546640.0,506.150697347734,-883.0,0
00:00,424397946.0,3887.3817836053986,-1041.0,0
00:00,878989510.0,6160.081886141791,-782.0,0
00:00,298000165.0,25244.71127679745,-475.0,0
00:00,416060965.0,701.0159021964068,-458.0,0
00:00,158414827.0,-1500.5900000000015,-1296.0,0
00:00,607629901.0,-3964.108319908144,-1193.0,0
00:00,871866387.0,-43.45640000000071,-706.0,0
00:00,215832575.0,-1306.0669637442195,-877.0,0
00:00,314980178.0,3726.095850000005,-1285.0,0
00:00,494156986.0,269.2055456723349,-1000.0,0
00:00,769319491.0,536.8019999999995,-864.0,0
00:00,885259672.0,4368.705583378018,-621.0,0
00:00,887853850.0,11217.613376421386,-533.0,0
00:00,535744551.0,1464.7155659956263,-472.0,0
00:00,659415300.0,3511.215340250703,-1331.0,0
00:00,250895529.0,2467.4660824692874,-525.0,0
00:00,414805878.0,13678.110118594232,-465.0,0
00:00,264208990.0,467.0994499999988,-1266.0,0
00:00,233981231.0,2495.193815190971,-858.0,0
00:00,285428103.0,9721.641950465588,-598.0,0
00:00,736340277.0,8901.154787223335,-752.0,0
00:00,315078351.0,7563.532551514787,-959.0,0
00:00,499410772.0,-2643.6268629051624,-1168.0,0
00:00,779946617.0,16887.89233198069,-1300.0,0
00:00,204855464.0,-936.1609386396158,-646.0,0
00:00,241459011.0,1367.8002132723473,-731.0,0
00:00,670427480.0,2563.431200000001,-1247.0,0
00:00,570575024.0,-827.6201000000005,-730.0,0
00:00,657139925.0,13905.425839386777,-869.0,0
00:00,651372390.0,-3367.710749999999,-1222.0,0
00:00,480198977.0,13093.431297642572,-731.0,0
00:00,520418719.0,3035.381800000003,-588.0,0
00:00,781554833.0,2274.442431943723,-985.0,0
00:00,521611005.0,8.71536414895354,-1194.0,0
00:00,308505160.0,14577.349769487942,-609.0,0
00:00,741269136.0,412.4109500000004,-1268.0,0
00:00,668329719.0,9060.831793180148,-495.0,0
00:00,486495235.0,2142.2319893887156,-631.0,0
00:00,855129444.0,35.856154562628035,-846.0,0
00:00,340321732.0,1994.3628500000032,-461.0,0
00:00,383625050.0,6521.734314767871,-930.0,0
00:00,355733816.0,5078.473234880616,-664.0,0
00:00,581618317.0,-4624.711701873207,-1204.0,0
00:00,785210466.0,2620.253227560572,-678.0,0
00:00,889916166.0,185.8834014132267,-613.0,0
00:00,184430449.0,2054.878363885164,-692.0,0
00:00,135937041.0,316.98810173158836,-517.0,0
00:00,886921642.0,4019.91950751285,-591.0,0
00:00,196289502.0,15789.738131613432,-512.0,0
00:00,711045550.0,4514.155350000003,-1376.0,0
00:00,540159353.0,11334.94219235863,-921.0,0
00:00,592961759.0,-1476.7348000000004,-1194.0,0
00:00,479456865.0,1975.500681489405,-635.0,0
00:00,291580432.0,-218.5759499999997,-1156.0,0
00:00,647936800.0,883.3612128922264,-1393.0,0
00:00,779620857.0,-17.660096385175848,-614.0,0
00:00,812692024.0,4037.56093134288,-489.0,0
00:00,176922958.0,1156.2095471976495,-653.0,0
00:00,913127700.0,1608.3914380111164,-621.0,0
00:00,293191074.0,541.8181499999992,-796.0,0
00:00,581655972.0,42249.83587491664,-620.0,0
00:00,215426302.0,834.2764040256918,-592.0,0
00:00,450896297.0,13751.20616376906,-485.0,0
00:00,558875206.0,3407.2100500000006,-1356.0,0
00:00,994947671.0,1182.9557000000004,-590.0,0
00:00,574548998.0,851.0724999999993,-662.0,0
00:00,857754342.0,2822.08902189167,-1268.0,0
00:00,214339619.0,630.6275508683564,-985.0,0
00:00,225210798.0,1167.3237737592087,-849.0,0
00:00,111137699.0,9.90050000000042,-660.0,0
00:00,940569402.0,6718.371681983107,-1149.0,0
00:00,256045540.0,-3304.1563999999994,-1294.0,0
00:00,854895960.0,3660.8623887147023,-1006.0,0
00:00,226703987.0,1945.8871999999997,-1017.0,0
00:00,154246234.0,264.37489210210424,-702.0,0
00:00,466649401.0,989.0824613978916,-704.0,0
00:00,880546403.0,-982.1446500000018,-1281.0,0
00:00,189335192.0,-750.7429017578602,-650.0,0
00:00,255814263.0,4310.924696700545,-795.0,0
00:00,743630833.0,415.52531328470127,-925.0,0
00:00,703588001.0,245.86084999999957,-1004.0,0
00:00,688712152.0,6321.005824437441,-887.0,0
00:00,627917561.0,3615.7950500000034,-856.0,0
00:00,130154096.0,1605.767610548966,-996.0,0
00:00,482513594.0,6763.6779297649055,-650.0,0
00:00,655368335.0,5444.691910070222,-682.0,0
00:00,290751280.0,673.4106966748257,-614.0,0
00:00,859264768.0,586.3250837819385,-569.0,0
00:00,964702094.0,2211.481376727642,-456.0,0
00:00,700138124.0,6222.531637293152,-894.0,0
00:00,534325901.0,7178.322618544497,-609.0,0
00:00,758160963.0,8581.039342693732,-575.0,0
00:00,134461671.0,5959.001934338759,-530.0,0
00:00,199016328.0,6443.779578394217,-863.0,0
00:00,183888402.0,18372.612988022946,-847.0,0
00:00,656812046.0,917.2137537325189,-926.0,0
00:00,786141370.0,-192.1272000000008,-1237.0,0
00:00,998390769.0,-33.959049059475774,-1013.0,0
00:00,846550094.0,1903.0087405544089,-1170.0,0
00:00,833899961.0,2731.898772838991,-530.0,0
00:00,277562576.0,1003.1286982249552,-856.0,0
00:00,352899149.0,814.0550499999988,-470.0,0
00:00,604288474.0,3601.9672636364176,-912.0,0
00:00,213112754.0,7230.547957744278,-1135.0,0
00:00,166019891.0,8199.05273699807,-906.0,0
00:00,345582855.0,79.7531528205493,-539.0,0
00:00,688328251.0,-854.7641253548271,-935.0,0
00:00,138969884.0,991.5882999999994,-619.0,0
00:00,660874296.0,2605.5174499608465,-611.0,0
00:00,868377987.0,2979.539969515681,-650.0,0
00:00,172084472.0,-1264.4307215957183,-1296.0,0
00:00,867679563.0,190.52075370171588,-1201.0,0
00:00,872286364.0,-1071.1179958130997,-991.0,0
00:00,623156843.0,6090.816503011673,-1068.0,0
00:00,844206657.0,173.3760551465698,-1307.0,0
00:00,925037906.0,1141.6498000000015,-587.0,0
00:00,285220959.0,11758.2617587097,-1118.0,0
00:00,146686559.0,-324.7939111734777,-1301.0,0
00:00,760704118.0,1610.4623127174889,-639.0,0
00:00,844835978.0,9972.046549188452,-813.0,0
00:00,930277104.0,10669.312948827352,-472.0,0
00:00,995615876.0,2095.2951396983885,-637.0,0
00:00,639549973.0,7627.668461439345,-711.0,0
00:00,284905540.0,8004.117517180221,-446.0,0
00:00,744398361.0,965.0359999999998,-608.0,0
00:00,637649383.0,1093.0964999999983,-630.0,0
00:00,405416860.0,2264.837966958371,-882.0,0
00:00,975345315.0,35256.214799999965,-772.0,0
00:00,553734946.0,1230.7248999999988,-819.0,0
00:00,455831435.0,-1521.9146048014943,-674.0,0
00:00,667367404.0,9819.67603163486,-485.0,0
00:00,441274121.0,13328.186183444504,-520.0,0
00:00,822250278.0,7636.919117435351,-801.0,0
00:00,345514953.0,1945.3532499999992,-1247.0,0
00:00,832564361.0,16338.657008512644,-600.0,0
00:00,799286313.0,-928.8883128758614,-776.0,0
00:00,152488934.0,1879.7641573137307,-826.0,0
00:00,637433131.0,589.2603999999992,-982.0,0
00:00,642924505.0,613.1422201835262,-460.0,0
00:00,344219145.0,7697.0372354396095,-728.0,0
00:00,596328017.0,-2169.7403499999996,-1090.0,0
00:00,736310094.0,-598.649424027426,-856.0,0
00:00,663479159.0,5507.323541827709,-1044.0,0
00:00,163470640.0,1401.203,-1094.0,0
00:00,994214354.0,10278.942848387069,-594.0,0
00:00,698955014.0,1600.608954940912,-539.0,0
00:00,336171116.0,-412.5445500000004,-1085.0,0
00:00,173335108.0,722.2439999999995,-839.0,0
00:00,402438092.0,1130.444399999999,-774.0,0
00:00,266777719.0,928.2989337802396,-806.0,0
00:00,796709231.0,-131.57992210370253,-948.0,0
00:00,973086490.0,10819.682676624656,-850.0,0
00:00,256002321.0,6537.66460129638,-928.0,0
00:00,769311479.0,7428.050620664428,-910.0,0
00:00,901432314.0,4600.529720218266,-468.0,0
00:00,691012931.0,-1573.087250000001,-1335.0,0
00:00,754141345.0,-2669.480335115762,-1181.0,0
00:00,776108637.0,1315.3347536574956,-566.0,0
00:00,122884111.0,-2240.08608307297,-973.0,0
00:00,854513972.0,1583.7387,-571.0,0
00:00,656781737.0,-5435.969999999996,-917.0,0
00:00,819515373.0,2798.515136063791,-491.0,0
00:00,945054126.0,-199.9319,-587.0,0
00:00,290818242.0,7595.674048927673,-631.0,0
00:00,572136270.0,422.34564933357774,-834.0,0
00:00,593378953.0,763.3096500000051,-932.0,0
00:00,873701090.0,1232.019513834908,-462.0,0
00:00,383833857.0,24463.804663311257,-670.0,0
00:00,455052690.0,-84.99426005137241,-594.0,0
00:00,280200287.0,-1138.620453386949,-465.0,0
00:00,956717493.0,1650.8628776068376,-1241.0,0
00:00,992204045.0,12853.331384610585,-508.0,0
00:00,627622066.0,3458.7281856930567,-989.0,0
00:00,120634201.0,4858.583500000004,-939.0,0
00:00,691789577.0,-348.97485000000006,-883.0,0
00:00,473820682.0,11728.440406296602,-457.0,0
00:00,913801979.0,696.102779914494,-641.0,0
00:00,799453072.0,-31.0074000000011,-594.0,0
00:00,456221621.0,1119.2053673026282,-664.0,0
00:00,618514666.0,21062.828820035986,-495.0,0
00:00,519649533.0,33.92181637066233,-899.0,0
00:00,198051483.0,-1128.7169104088568,-624.0,0
00:00,722971557.0,221.60772084307564,-910.0,0
00:00,954263768.0,-1.489100000000235,-1057.0,0
00:00,821971408.0,1499.8917213748782,-464.0,0
00:00,897714622.0,8939.07227145535,-957.0,0
00:00,349614277.0,1677.9271999999996,-661.0,0
00:00,385685918.0,545.5399408415524,-478.0,0
00:00,639420537.0,-1396.46895,-684.0,0
00:00,188263947.0,1154.8206500000006,-1310.0,0
00:00,425964226.0,3884.0006500000018,-799.0,0
00:00,426466211.0,-3029.4232500000003,-1248.0,0
00:00,681955876.0,-1098.0981000000004,-1004.0,0
00:00,245690309.0,9825.843768308776,-479.0,0
00:00,780463728.0,2963.7375709422395,-508.0,0
00:00,228136274.0,-364.3653000000008,-1026.0,0
00:00,478412511.0,989.7577701974608,-559.0,0
00:00,719586818.0,19553.33442480164,-552.0,0
00:00,555393405.0,-795.0848000000001,-674.0,0
00:00,220183538.0,1247.1234499999996,-1269.0,0
00:00,624500124.0,4003.514769866798,-654.0,0
00:00,180616589.0,1089.725648033954,-736.0,0
00:00,742223719.0,1249.6017573048027,-479.0,0
00:00,490790931.0,719.1823499999987,-701.0,0
00:00,517190750.0,3610.131089915412,-547.0,0
00:00,709608057.0,3517.9290388538084,-553.0,0
00:00,365608668.0,1112.8921138595588,-669.0,0
00:00,858989281.0,27274.34408933392,-999.0,0
00:00,169689461.0,1819.1360999999993,-585.0,0
00:00,647472692.0,25180.029868365124,-867.0,0
00:00,550169791.0,21380.864202653134,-1164.0,0
00:00,639409800.0,34687.07601052425,-877.0,0
00:00,828532554.0,539.4131013660719,-995.0,0
00:00,834383043.0,5767.095185073416,-783.0,0
00:00,587202562.0,831.7170994170688,-1214.0,0
00:00,893134725.0,1803.2776629732089,-1296.0,0
00:00,629078930.0,2233.2812906575527,-531.0,0
00:00,713641917.0,1518.46852784912,-451.0,0
00:00,358846516.0,974.369672527218,-1257.0,0
00:00,282102606.0,-9.8630375771736,-812.0,0
00:00,162370388.0,-2225.9954,-1286.0,0
00:00,618138606.0,1834.0643472714344,-570.0,0
00:00,338022396.0,943.4008893757392,-881.0,0
00:00,354894456.0,-20.580000000000386,-753.0,0
23:59,461990622.0,10579.777901532185,-15.99,1
23:59,461990622.0,10571.787901532183,-7.99,7
23:59,461990622.0,10564.787901532183,-7.0,1
23:59,461990622.0,10557.787901532183,-7.0,1
23:59,461990622.0,10538.797901532183,-18.99,6
23:59,652048867.0,281.305149999999,-7.99,7
23:59,652048867.0,181.305149999999,-100.0,6
23:59,652048867.0,162.315149999999,-18.99,6
23:59,633345190.0,7823.3533188420515,-15.99,1
23:59,633345190.0,7815.363318842052,-7.99,7
23:59,633345190.0,7796.373318842052,-18.99,6
23:59,633345190.0,7790.383318842052,-5.99,1
23:59,588565416.0,7807.459074968008,-12.99,1
23:59,588565416.0,7800.459074968008,-7.0,1
23:59,588565416.0,7794.469074968008,-5.99,1
23:59,588565416.0,7694.469074968008,-100.0,6
23:59,588565416.0,7675.479074968009,-18.99,6
23:59,588565416.0,7659.489074968009,-15.99,1
23:59,977899503.0,-215.78710641914745,-15.99,1
23:59,977899503.0,-222.78710641914745,-7.0,1
23:59,977899503.0,-241.77710641914743,-18.99,6
23:59,987229118.0,4822.438762694481,-15.99,1
23:59,987229118.0,4803.448762694481,-18.99,6
23:59,987229118.0,4790.458762694481,-12.99,1
23:59,720221651.0,-2294.5688665984344,-7.99,1
23:59,720221651.0,-2310.558866598434,-15.99,1
23:59,762700245.0,-210.9102999999975,-15.99,1
23:59,762700245.0,-223.90029999999751,-12.99,1
23:59,762700245.0,-230.90029999999751,-7.0,1
23:59,762700245.0,-249.89029999999752,-18.99,6
23:59,452974357.0,-2896.931449999996,-15.99,1
23:59,452974357.0,-2915.9214499999957,-18.99,6
23:59,452974357.0,-2930.9114499999955,-14.99,1
23:59,452974357.0,-2943.9014499999953,-12.99,1
23:59,452974357.0,-2956.891449999995,-12.99,1
23:59,452974357.0,-3056.891449999995,-100.0,6
23:59,282046994.0,56.20235000000037,-5.99,1
23:59,282046994.0,50.21235000000037,-5.99,1
23:59,282046994.0,44.22235000000037,-5.99,1
23:59,282046994.0,31.23235000000037,-12.99,1
23:59,282046994.0,15.242350000000366,-15.99,1
23:59,282046994.0,-3.747649999999632,-18.99,6
23:59,282046994.0,-103.74764999999964,-100.0,6
23:59,973388795.0,1670.7676761636217,-15.99,1
23:59,973388795.0,1662.7776761636217,-7.99,1
23:59,973388795.0,1643.7876761636217,-18.99,6
23:59,973388795.0,1628.7976761636216,-14.99,1
23:59,973388795.0,1613.8076761636216,-14.99,1
23:59,973388795.0,1606.8076761636216,-7.0,1
23:59,973388795.0,1600.8176761636216,-5.99,1
23:59,564214408.0,-10.142115274273907,-18.99,6
23:59,564214408.0,-18.132115274273907,-7.99,7
23:59,564214408.0,-25.132115274273907,-7.0,1
23:59,564214408.0,-32.13211527427391,-7.0,1
23:59,514362267.0,581.9473191070604,-14.99,1
23:59,514362267.0,573.9573191070604,-7.99,1
23:59,514362267.0,557.9673191070603,-15.99,1
23:59,364357875.0,8101.523813527407,-15.99,1
23:59,364357875.0,8093.533813527407,-7.99,7
23:59,364357875.0,8086.533813527407,-7.0,1
23:59,364357875.0,8080.543813527407,-5.99,1
23:59,364357875.0,8061.553813527407,-18.99,6
23:59,721393911.0,-397.94654253571656,-15.99,1
23:59,721393911.0,-404.94654253571656,-7.0,1
23:59,721393911.0,-417.93654253571657,-12.99,1
23:59,721393911.0,-430.9265425357166,-12.99,1
23:59,721393911.0,-443.9165425357166,-12.99,1
23:59,721393911.0,-462.9065425357166,-18.99,6
23:59,419550103.0,18929.041117202913,-15.99,1
23:59,419550103.0,18921.05111720291,-7.99,1
23:59,419550103.0,18906.06111720291,-14.99,1
23:59,227104649.0,3001.9740643161776,-7.99,1
23:59,227104649.0,2982.984064316178,-18.99,6
23:59,412823730.0,196.37572585048977,-15.99,1
23:59,412823730.0,188.3857258504897,-7.99,1
23:59,412823730.0,88.38572585048973,-100.0,6
23:59,986774156.0,3951.176931625768,-100.0,6
23:59,337771621.0,-2619.62765,-12.99,1
23:59,337771621.0,-2638.6176499999997,-18.99,6
23:59,337771621.0,-2654.6076499999995,-15.99,1
23:59,337771621.0,-2662.5976499999992,-7.99,1
23:59,337771621.0,-2762.5976499999992,-100.0,6
23:59,596171893.0,402.2417448255111,-7.0,1
23:59,596171893.0,396.2517448255111,-5.99,1
23:59,596171893.0,377.2617448255111,-18.99,6
23:59,920830317.0,3.8777706374812624,-7.0,1
23:59,920830317.0,-11.112229362518738,-14.99,1
23:59,920830317.0,-27.102229362518734,-15.99,1
23:59,920830317.0,-35.09222936251874,-7.99,7
23:59,920830317.0,-54.08222936251873,-18.99,6
23:59,603721739.0,1735.1518994831845,-15.99,1
23:59,603721739.0,1729.1618994831842,-5.99,1
23:59,603721739.0,1629.1618994831842,-100.0,6
23:59,603721739.0,1610.1718994831842,-18.99,6
23:59,197865285.0,786.4477617312202,-15.99,1
23:59,197865285.0,778.4577617312202,-7.99,1
23:59,499244466.0,-85.16853128342221,-15.99,1
23:59,499244466.0,-100.1585312834222,-14.99,1
23:59,499244466.0,-115.1485312834222,-14.99,1
23:59,499244466.0,-121.1385312834222,-5.99,1
23:59,499244466.0,-127.1285312834222,-5.99,1
23:59,499244466.0,-146.1185312834222,-18.99,6
23:59,856957948.0,9508.61039333536,-15.99,1
23:59,856957948.0,9489.62039333536,-18.99,6
23:59,856957948.0,9482.62039333536,-7.0,1
23:59,856957948.0,9475.62039333536,-7.0,1
23:59,856957948.0,9468.62039333536,-7.0,1
23:59,856957948.0,9462.63039333536,-5.99,1
23:59,610450243.0,-778.1496,-7.99,1
23:59,610450243.0,-791.1396,-12.99,1
23:59,610450243.0,-806.1296,-14.99,1
23:59,610450243.0,-819.1196,-12.99,1
23:59,610450243.0,-838.1096,-18.99,6
23:59,909676212.0,1750.211169740084,-7.99,7
23:59,909676212.0,1731.221169740084,-18.99,6
23:59,909676212.0,1631.221169740084,-100.0,6
23:59,909676212.0,1624.221169740084,-7.0,1
23:59,909676212.0,1611.231169740084,-12.99,1
23:59,909676212.0,1598.241169740084,-12.99,1
23:59,695607232.0,487.07049461056,-15.99,1
23:59,695607232.0,479.08049461056,-7.99,7
23:59,695607232.0,466.09049461056,-12.99,1
23:59,695607232.0,453.10049461056,-12.99,1
23:59,695607232.0,438.1104946105599,-14.99,1
23:59,695607232.0,432.12049461055994,-5.99,1
23:59,587225252.0,7801.617264155328,-18.99,6
23:59,141521177.0,7730.811900000013,-18.99,6
23:59,474301748.0,-2083.959005683969,-15.99,1
23:59,474301748.0,-2091.9490056839686,-7.99,1
23:59,474301748.0,-2098.9490056839686,-7.0,1
23:59,474301748.0,-2111.9390056839684,-12.99,1
23:59,474301748.0,-2117.929005683968,-5.99,1
23:59,474301748.0,-2136.919005683968,-18.99,6
23:59,812839908.0,-1570.9648500000003,-5.99,1
23:59,812839908.0,-1586.9548500000003,-15.99,1
23:59,812839908.0,-1594.9448500000003,-7.99,7
23:59,812839908.0,-1613.9348500000003,-18.99,6
23:59,296972867.0,-722.5413000000009,-18.99,6
23:59,246753533.0,1076.5356999999988,-15.99,1
23:59,246753533.0,1068.5456999999988,-7.99,1
23:59,246753533.0,1062.5556999999988,-5.99,1
23:59,246753533.0,1049.5656999999987,-12.99,1
23:59,246753533.0,949.5656999999989,-100.0,6
23:59,257633312.0,-167.7816500000008,-15.99,1
23:59,257633312.0,-175.77165000000082,-7.99,1
23:59,257633312.0,-194.76165000000083,-18.99,6
23:59,257633312.0,-207.75165000000084,-12.99,1
23:59,585625048.0,2273.6256190586328,-15.99,1
23:59,585625048.0,2265.635619058633,-7.99,7
23:59,585625048.0,2246.645619058633,-18.99,6
23:59,585625048.0,2233.6556190586334,-12.99,1
23:59,585625048.0,2227.6656190586336,-5.99,1
23:59,585625048.0,2214.675619058634,-12.99,1
23:59,585625048.0,2208.685619058634,-5.99,1
23:59,274818272.0,643.6177785671316,-18.99,6
23:59,274818272.0,627.6277785671316,-15.99,1
23:59,274818272.0,620.6277785671316,-7.0,1
23:59,274818272.0,607.6377785671316,-12.99,1
23:59,274818272.0,592.6477785671316,-14.99,1
23:59,274818272.0,492.6477785671316,-100.0,6
23:59,234952520.0,-2020.7211000000011,-15.99,1
23:59,518378868.0,-1271.7818000000002,-12.99,1
23:59,518378868.0,-1284.7718000000002,-12.99,1
23:59,518378868.0,-1292.7618000000002,-7.99,7
23:59,518378868.0,-1311.7518000000002,-18.99,6
23:59,856147482.0,503.5971514013752,-15.99,1
23:59,856147482.0,490.6071514013752,-12.99,1
23:59,856147482.0,475.6171514013752,-14.99,1
23:59,856147482.0,456.6271514013752,-18.99,6
23:59,829914501.0,951.360806570974,-15.99,1
23:59,886837068.0,839.8880999999994,-18.99,6
23:59,886837068.0,823.8980999999994,-15.99,1
23:59,886837068.0,815.9080999999994,-7.99,7
23:59,886837068.0,715.9080999999994,-100.0,6
23:59,892354433.0,-1039.7399606343386,-15.99,1
23:59,892354433.0,-1047.7299606343386,-7.99,7
23:59,822135975.0,11497.323431481793,-15.99,1
23:59,822135975.0,11489.333431481791,-7.99,1
23:59,822135975.0,11470.343431481791,-18.99,6
23:59,127809299.0,2085.2155189472846,-14.99,1
23:59,127809299.0,2072.225518947285,-12.99,1
23:59,127809299.0,2059.235518947285,-12.99,1
23:59,127809299.0,2043.245518947285,-15.99,1
23:59,127809299.0,2024.255518947285,-18.99,6
23:59,477216513.0,-565.6314499999994,-18.99,6
23:59,344843570.0,-1.8243175093338009,-15.99,1
23:59,554792076.0,27217.870465441076,-5.99,1
23:59,554792076.0,27210.870465441076,-7.0,1
23:59,554792076.0,27203.870465441076,-7.0,1
23:59,554792076.0,27196.870465441076,-7.0,1
23:59,554792076.0,27180.88046544107,-15.99,1
23:59,546760202.0,-1773.380527675968,-18.99,6
23:59,546760202.0,-1789.370527675968,-15.99,1
23:59,845648250.0,331.84684999999945,-18.99,6
23:59,845648250.0,315.85684999999944,-15.99,1
23:59,261894284.0,-3243.1512999999977,-15.99,1
23:59,261894284.0,-3262.1412999999975,-18.99,6
23:59,261894284.0,-3362.1412999999975,-100.0,6
23:59,261894284.0,-3368.1312999999973,-5.99,1
23:59,261894284.0,-3383.121299999997,-14.99,1
23:59,261894284.0,-3390.121299999997,-7.0,1
23:59,395284483.0,735.3463402113086,-12.99,1
23:59,395284483.0,729.3563402113086,-5.99,1
23:59,395284483.0,723.3663402113086,-5.99,1
23:59,395284483.0,708.3763402113086,-14.99,1
23:59,395284483.0,700.3863402113086,-7.99,1
23:59,104832000.0,-2694.459858905844,-15.99,1
23:59,104832000.0,-2794.459858905844,-100.0,6
23:59,104832000.0,-2807.449858905844,-12.99,1
23:59,104832000.0,-2820.4398589058437,-12.99,1
23:59,173317688.0,-2163.3687348842855,-15.99,1
23:59,173317688.0,-2171.3587348842852,-7.99,7
23:59,173317688.0,-2186.348734884285,-14.99,1
23:59,173317688.0,-2193.348734884285,-7.0,1
23:59,173317688.0,-2206.338734884285,-12.99,1
23:59,173317688.0,-2213.338734884285,-7.0,1
23:59,146909202.0,6192.318099675629,-15.99,1
23:59,146909202.0,6185.318099675629,-7.0,1
23:59,146909202.0,6166.328099675629,-18.99,6
23:59,750094757.0,-1722.2737000000004,-18.99,6
23:59,750094757.0,-1738.2637000000004,-15.99,1
23:59,750094757.0,-1838.2637000000004,-100.0,6
23:59,409370545.0,1582.58427554552,-12.99,1
23:59,409370545.0,1575.58427554552,-7.0,1
23:59,409370545.0,1569.59427554552,-5.99,1
23:59,390747457.0,558.277699999998,-15.99,1
23:59,390747457.0,550.287699999998,-7.99,7
23:59,390747457.0,531.297699999998,-18.99,6
23:59,817294757.0,-2492.6658,-18.99,6
23:59,598793068.0,1103.0103499999984,-7.99,7
23:59,598793068.0,1095.0203499999984,-7.99,1
23:59,598793068.0,1088.0203499999984,-7.0,1
23:59,598793068.0,1069.0303499999984,-18.99,6
23:59,113747882.0,12561.56575231247,-12.99,1
23:59,113747882.0,12546.57575231247,-14.99,1
23:59,113747882.0,12533.58575231247,-12.99,1
23:59,113747882.0,12518.59575231247,-14.99,1
23:59,113747882.0,12510.605752312473,-7.99,1
23:59,113747882.0,12502.615752312471,-7.99,7
23:59,113747882.0,12483.625752312471,-18.99,6
23:59,583558311.0,-515.0272152486677,-18.99,6
23:59,535804582.0,-1115.388450000001,-15.99,1
23:59,535804582.0,-1215.388450000001,-100.0,6
23:59,535804582.0,-1234.378450000001,-18.99,6
23:59,684988568.0,-341.3039234272014,-15.99,1
23:59,684988568.0,-349.29392342720143,-7.99,7
23:59,684988568.0,-364.28392342720144,-14.99,1
23:59,684988568.0,-371.28392342720144,-7.0,1
23:59,684988568.0,-390.27392342720145,-18.99,6
23:59,788740658.0,4198.050978774134,-14.99,1
23:59,788740658.0,4192.060978774134,-5.99,1
23:59,788740658.0,4185.060978774134,-7.0,1
23:59,788740658.0,4172.070978774134,-12.99,1
23:59,170637730.0,3288.973358610978,-15.99,1
23:59,170637730.0,3280.983358610978,-7.99,1
23:59,849096144.0,2923.7598589105173,-7.99,1
23:59,849096144.0,2907.7698589105175,-15.99,1
23:59,849096144.0,2888.7798589105178,-18.99,6
23:59,849096144.0,2875.789858910518,-12.99,1
23:59,849096144.0,2775.789858910518,-100.0,6
23:59,982949451.0,-3495.189167052509,-15.99,1
23:59,982949451.0,-3503.179167052509,-7.99,1
23:59,982949451.0,-3522.169167052509,-18.99,6
23:59,520447032.0,9467.624149007072,-7.0,1
23:59,520447032.0,9460.624149007072,-7.0,1
23:59,520447032.0,9447.634149007072,-12.99,1
23:59,520447032.0,9431.644149007072,-15.99,1
23:59,520447032.0,9412.654149007072,-18.99,6
23:59,851181128.0,5284.832276484335,-12.99,1
23:59,851181128.0,5271.842276484335,-12.99,1
23:59,851181128.0,5255.852276484336,-15.99,1
23:59,851181128.0,5247.862276484336,-7.99,7
23:59,851181128.0,5228.872276484336,-18.99,6
23:59,221868392.0,5878.1286267524365,-14.99,1
23:59,221868392.0,5862.138626752437,-15.99,1
23:59,221868392.0,5843.148626752437,-18.99,6
23:59,876890798.0,3134.40822069993,-18.99,6
23:59,876890798.0,3118.4182206999303,-15.99,1
23:59,876890798.0,3110.4282206999305,-7.99,1
23:59,876890798.0,3097.4382206999308,-12.99,1
23:59,876890798.0,2997.4382206999308,-100.0,6
23:59,661295096.0,3408.524204411935,-7.99,1
23:59,661295096.0,3400.534204411935,-7.99,7
23:59,661295096.0,3385.5442044119354,-14.99,1
23:59,661295096.0,3366.5542044119356,-18.99,6
23:59,418717120.0,-1849.3006465372296,-100.0,6
23:59,418717120.0,-1864.2906465372296,-14.99,1
23:59,418717120.0,-1872.2806465372296,-7.99,1
23:59,534583529.0,1480.4673880547653,-7.99,7
23:59,190874125.0,297.2530142135673,-15.99,1
23:59,190874125.0,291.2630142135673,-5.99,1
23:59,190874125.0,284.2630142135673,-7.0,1
23:59,190874125.0,265.2730142135673,-18.99,6
23:59,370521542.0,26091.151737280597,-7.99,1
23:59,370521542.0,26075.161737280596,-15.99,1
23:59,370521542.0,26069.17173728059,-5.99,1
23:59,370521542.0,26063.181737280593,-5.99,1
23:59,370521542.0,26044.19173728059,-18.99,6
23:59,585133606.0,4935.06959404309,-15.99,1
23:59,585133606.0,4927.07959404309,-7.99,7
23:59,585133606.0,4908.08959404309,-18.99,6
23:59,585133606.0,4895.09959404309,-12.99,1
23:59,585133606.0,4880.1095940430905,-14.99,1
23:59,423208402.0,1363.5933000000025,-18.99,6
23:59,423208402.0,1357.6033000000025,-5.99,1
23:59,423208402.0,1351.6133000000025,-5.99,1
23:59,423208402.0,1343.6233000000025,-7.99,1
23:59,423208402.0,1327.6333000000025,-15.99,1
23:59,366550080.0,25819.38826520387,-7.99,7
23:59,366550080.0,25803.39826520387,-15.99,1
23:59,570269025.0,3457.8215333598887,-14.99,1
23:59,570269025.0,3438.831533359889,-18.99,6
23:59,570269025.0,3422.841533359889,-15.99,1
23:59,570269025.0,3322.841533359889,-100.0,6
23:59,472995101.0,2416.09152388833,-15.99,1
23:59,472995101.0,2408.10152388833,-7.99,1
23:59,472995101.0,2393.1115238883303,-14.99,1
23:59,472995101.0,2386.1115238883303,-7.0,1
23:59,472995101.0,2380.1215238883306,-5.99,1
23:59,472995101.0,2374.131523888331,-5.99,1
23:59,245198540.0,63.65139880177947,-7.99,7
23:59,245198540.0,-36.34860119822053,-100.0,6
23:59,612304466.0,-1960.8932500000003,-14.99,1
23:59,612304466.0,-1966.8832500000003,-5.99,1
23:59,612304466.0,-1985.8732500000008,-18.99,6
23:59,612304466.0,-1993.8632500000008,-7.99,1
23:59,612304466.0,-2009.8532500000008,-15.99,1
23:59,522188082.0,8492.451361858892,-7.99,1
23:59,522188082.0,8476.461361858892,-15.99,1
23:59,522188082.0,8457.471361858892,-18.99,6
23:59,370757362.0,1806.6965898126757,-12.99,1
23:59,370757362.0,1790.7065898126757,-15.99,1
23:59,370757362.0,1771.7165898126757,-18.99,6
23:59,671824917.0,-732.6532000000003,-18.99,6
23:59,671824917.0,-832.6532000000003,-100.0,6
23:59,671824917.0,-838.6432000000003,-5.99,1
23:59,671824917.0,-845.6432000000003,-7.0,1
23:59,671824917.0,-851.6332000000003,-5.99,1
23:59,671824917.0,-857.6232000000003,-5.99,1
23:59,648644594.0,118.06699999999913,-5.99,1
23:59,648644594.0,103.07699999999912,-14.99,1
23:59,648644594.0,90.08699999999912,-12.99,1
23:59,648644594.0,75.09699999999913,-14.99,1
23:59,648644594.0,59.106999999999125,-15.99,1
23:59,648644594.0,-40.893000000000875,-100.0,6
23:59,187111705.0,7039.644319615469,-15.99,1
23:59,358836279.0,745.004892807586,-5.99,1
23:59,358836279.0,738.004892807586,-7.0,1
23:59,358836279.0,723.014892807586,-14.99,1
23:59,358836279.0,716.014892807586,-7.0,1
23:59,358836279.0,697.024892807586,-18.99,6
23:59,270374623.0,10657.192469968057,-7.99,1
23:59,270374623.0,10642.202469968057,-14.99,1
23:59,270374623.0,10635.202469968057,-7.0,1
23:59,270374623.0,10535.202469968057,-100.0,6
23:59,270374623.0,10516.212469968055,-18.99,6
23:59,435313070.0,3335.5203086224637,-100.0,6
23:59,435313070.0,3319.530308622464,-15.99,1
23:59,444371478.0,731.2628999999988,-15.99,1
23:59,444371478.0,712.2728999999988,-18.99,6
23:59,224524792.0,-2113.2806824308486,-18.99,6
23:59,224524792.0,-2129.2706824308484,-15.99,1
23:59,905860285.0,18928.253984576677,-7.99,1
23:59,630468201.0,-508.57923388970175,-18.99,6
23:59,630468201.0,-524.5692338897018,-15.99,1
23:59,713057426.0,-1459.7592500000003,-18.99,6
23:59,713057426.0,-1467.7492500000003,-7.99,1
23:59,713057426.0,-1567.7492500000003,-100.0,6
23:59,713057426.0,-1580.7392500000003,-12.99,1
23:59,713057426.0,-1586.7292500000003,-5.99,1
23:59,918160369.0,-819.9536500000004,-7.99,7
23:59,918160369.0,-832.9436500000004,-12.99,1
23:59,918160369.0,-838.9336500000004,-5.99,1
23:59,918160369.0,-857.9236500000004,-18.99,6
23:59,293609137.0,81.93049257449806,-5.99,1
23:59,293609137.0,74.93049257449806,-7.0,1
23:59,293609137.0,67.93049257449806,-7.0,1
23:59,293609137.0,52.94049257449806,-14.99,1
23:59,293609137.0,36.95049257449806,-15.99,1
23:59,293609137.0,28.960492574498055,-7.99,7
23:59,293609137.0,9.970492574498056,-18.99,6
23:59,678726554.0,550.8457523483896,-15.99,1
23:59,678726554.0,542.8557523483896,-7.99,1
23:59,678726554.0,523.8657523483896,-18.99,6
23:59,678726554.0,517.8757523483896,-5.99,1
23:59,678726554.0,511.8857523483896,-5.99,1
23:59,678726554.0,498.8957523483896,-12.99,1
23:59,744968736.0,-1482.326826569424,-100.0,6
23:59,744968736.0,-1498.316826569424,-15.99,1
23:59,497809732.0,417.3028695525952,-15.99,1
23:59,497809732.0,398.3128695525952,-18.99,6
23:59,430910686.0,1056.5933000000005,-15.99,1
23:59,430910686.0,1048.6033000000004,-7.99,7
23:59,215311171.0,6796.787627514072,-7.99,1
23:59,215311171.0,6780.797627514072,-15.99,1
23:59,215311171.0,6774.807627514072,-5.99,1
23:59,215311171.0,6759.817627514072,-14.99,1
23:59,215311171.0,6740.827627514072,-18.99,6
23:59,215311171.0,6640.827627514072,-100.0,6
23:59,422955974.0,341.99278499904995,-12.99,1
23:59,422955974.0,334.99278499904995,-7.0,1
23:59,422955974.0,327.00278499904994,-7.99,1
23:59,422955974.0,308.0127849990499,-18.99,6
23:59,229502829.0,-3242.6314241862483,-15.99,1
23:59,229502829.0,-3250.621424186248,-7.99,1
23:59,229502829.0,-3269.611424186248,-18.99,6
23:59,229502829.0,-3275.6014241862476,-5.99,1
23:59,229502829.0,-3290.5914241862474,-14.99,1
23:59,229502829.0,-3297.5914241862474,-7.0,1
23:59,229502829.0,-3304.5914241862474,-7.0,1
23:59,979135922.0,-222.64669940954923,-15.99,1
23:59,979135922.0,-230.63669940954924,-7.99,1
23:59,391688371.0,2015.242299568523,-14.99,1
23:59,391688371.0,2009.252299568523,-5.99,1
23:59,391688371.0,1993.262299568523,-15.99,1
23:59,391688371.0,1985.272299568523,-7.99,1
23:59,391688371.0,1966.282299568523,-18.99,6
23:59,374994043.0,-2134.913050000001,-15.99,1
23:59,374994043.0,-2153.9030500000003,-18.99,6
23:59,108481285.0,8814.894879696249,-7.99,1
23:59,108481285.0,8806.904879696249,-7.99,7
23:59,108481285.0,8787.914879696249,-18.99,6
23:59,724537117.0,-1022.0354000000004,-15.99,1
23:59,724537117.0,-1041.0254000000004,-18.99,6
23:59,724537117.0,-1047.0154000000005,-5.99,1
23:59,724537117.0,-1054.0154000000005,-7.0,1
23:59,165691047.0,571.8703999999991,-5.99,1
23:59,165691047.0,563.8803999999991,-7.99,1
23:59,165691047.0,547.8903999999991,-15.99,1
23:59,336557504.0,1676.238395019486,-15.99,1
23:59,315546581.0,27552.68577594755,-15.99,1
23:59,315546581.0,27544.695775947548,-7.99,1
23:59,315546581.0,27525.705775947543,-18.99,6
23:59,315546581.0,27512.715775947545,-12.99,1
23:59,315546581.0,27497.725775947543,-14.99,1
23:59,315546581.0,27484.73577594754,-12.99,1
23:59,315546581.0,27471.74577594754,-12.99,1
23:59,965038148.0,-555.8075143676722,-7.99,1
23:59,965038148.0,-574.7975143676722,-18.99,6
23:59,706250160.0,11942.030417515369,-15.99,1
23:59,706250160.0,11934.040417515367,-7.99,7
23:59,979892433.0,-1276.271600000001,-5.99,1
23:59,979892433.0,-1289.261600000001,-12.99,1
23:59,979892433.0,-1304.251600000001,-14.99,1
23:59,979892433.0,-1319.241600000001,-14.99,1
23:59,979892433.0,-1338.231600000001,-18.99,6
23:59,912705941.0,18511.679255925028,-7.99,1
23:59,303843160.0,634.8781000000017,-12.99,1
23:59,303843160.0,618.8881000000017,-15.99,1
23:59,303843160.0,599.8981000000017,-18.99,6
23:59,352291960.0,3576.050053303574,-7.99,1
23:59,904154012.0,1418.8574581204325,-15.99,1
23:59,904154012.0,1403.8674581204325,-14.99,1
23:59,904154012.0,1388.8774581204325,-14.99,1
23:59,904154012.0,1373.8874581204325,-14.99,1
23:59,904154012.0,1360.8974581204322,-12.99,1
23:59,822718326.0,11225.984222410903,-15.99,1
23:59,822718326.0,11217.994222410904,-7.99,1
23:59,822718326.0,11210.994222410904,-7.0,1
23:59,317161035.0,-3371.017599999997,-15.99,1
23:59,317161035.0,-3386.0075999999967,-14.99,1
23:59,317161035.0,-3393.0075999999967,-7.0,1
23:59,317161035.0,-3411.9975999999965,-18.99,6
23:59,187541224.0,2766.775500336543,-7.99,1
23:59,355940285.0,966.3129781896836,-7.99,7
23:59,355940285.0,958.3229781896836,-7.99,1
23:59,355940285.0,951.3229781896836,-7.0,1
23:59,538003940.0,2265.360000000008,-5.99,1
23:59,538003940.0,2257.370000000008,-7.99,7
23:59,538003940.0,2241.3800000000083,-15.99,1
23:59,538003940.0,2141.3800000000083,-100.0,6
23:59,538003940.0,2122.3900000000085,-18.99,6
23:59,843537309.0,-934.9197177916318,-5.99,1
23:59,843537309.0,-947.9097177916318,-12.99,1
23:59,843537309.0,-953.8997177916318,-5.99,1
23:59,843537309.0,-969.8897177916318,-15.99,1
23:59,843537309.0,-988.8797177916318,-18.99,6
23:59,224112146.0,697.9830999999987,-15.99,1
23:59,224112146.0,678.9930999999987,-18.99,6
23:59,224112146.0,671.9930999999987,-7.0,1
23:59,224112146.0,657.0030999999987,-14.99,1
23:59,932820758.0,-2358.196566775555,-14.99,1
23:59,932820758.0,-2364.186566775554,-5.99,1
23:59,932820758.0,-2371.186566775554,-7.0,1
23:59,932820758.0,-2387.1765667755544,-15.99,1
23:59,932820758.0,-2395.166566775554,-7.99,1
23:59,949032480.0,5177.565399610854,-7.0,1
23:59,949032480.0,5171.575399610854,-5.99,1
23:59,949032480.0,5165.585399610854,-5.99,1
23:59,949032480.0,5158.585399610854,-7.0,1
23:59,949032480.0,5139.595399610855,-18.99,6
23:59,949032480.0,5123.605399610855,-15.99,1
23:59,598586358.0,-3214.8824499999964,-18.99,6
23:59,598586358.0,-3230.872449999996,-15.99,1
23:59,598586358.0,-3238.862449999996,-7.99,1
23:59,818552503.0,375.7167499999989,-100.0,6
23:59,818552503.0,367.7267499999989,-7.99,1
23:59,818552503.0,359.7367499999989,-7.99,7
23:59,286484726.0,1152.745476947126,-18.99,6
23:59,516051449.0,1952.988287516744,-18.99,6
23:59,516051449.0,1944.998287516744,-7.99,1
23:59,516051449.0,1929.008287516744,-15.99,1
23:59,218795010.0,596.0064499999996,-7.99,7
23:59,218795010.0,581.0164499999996,-14.99,1
23:59,218795010.0,575.0264499999996,-5.99,1
23:59,454356905.0,3310.731765222882,-7.99,1
23:59,715068825.0,305.9119999999998,-15.99,1
23:59,715068825.0,205.9119999999998,-100.0,6
23:59,380228542.0,189.68454181556547,-15.99,1
23:59,380228542.0,181.69454181556543,-7.99,1
23:59,380228542.0,166.70454181556545,-14.99,1
23:59,380228542.0,153.71454181556544,-12.99,1
23:59,380228542.0,138.72454181556543,-14.99,1
23:59,380228542.0,132.73454181556542,-5.99,1
23:59,380228542.0,113.74454181556544,-18.99,6
23:59,556992209.0,11788.950125924426,-15.99,1
23:59,556992209.0,11780.960125924426,-7.99,1
23:59,556992209.0,11761.970125924428,-18.99,6
23:59,833499132.0,2967.065250000001,-15.99,1
23:59,833499132.0,2959.075250000001,-7.99,7
23:59,833499132.0,2952.075250000001,-7.0,1
23:59,833499132.0,2939.085250000001,-12.99,1
23:59,833499132.0,2933.095250000001,-5.99,1
23:59,833499132.0,2926.095250000001,-7.0,1
23:59,938992364.0,760.1486537313996,-18.99,6
23:59,938992364.0,660.1486537313996,-100.0,6
23:59,938992364.0,652.1586537313996,-7.99,1
23:59,938992364.0,639.1686537313996,-12.99,1
23:59,938992364.0,624.1786537313995,-14.99,1
23:59,785749304.0,8831.993175074631,-7.99,1
23:59,785749304.0,8816.003175074631,-15.99,1
23:59,785749304.0,8810.013175074631,-5.99,1
23:59,785749304.0,8804.023175074632,-5.99,1
23:59,504055745.0,242.39496134176693,-7.99,7
23:59,504055745.0,226.40496134176692,-15.99,1
23:59,504055745.0,220.4149613417669,-5.99,1
23:59,504055745.0,213.4149613417669,-7.0,1
23:59,504055745.0,200.4249613417669,-12.99,1
23:59,504055745.0,185.4349613417669,-14.99,1
23:59,504055745.0,85.4349613417669,-100.0,6
23:59,399538448.0,8461.60652725647,-7.0,1
23:59,399538448.0,8454.60652725647,-7.0,1
23:59,399538448.0,8447.60652725647,-7.0,1
23:59,399538448.0,8432.61652725647,-14.99,1
23:59,399538448.0,8413.62652725647,-18.99,6
23:59,399538448.0,8405.63652725647,-7.99,1
23:59,399538448.0,8397.646527256471,-7.99,7
23:59,550832673.0,3662.497134474407,-18.99,6
23:59,550832673.0,3646.5071344744074,-15.99,1
23:59,550832673.0,3546.5071344744074,-100.0,6
23:59,151916463.0,1726.631555599169,-18.99,6
23:59,500043411.0,13896.513545692278,-7.99,7
23:59,500043411.0,13880.523545692278,-15.99,1
23:59,500043411.0,13861.533545692278,-18.99,6
23:59,500043411.0,13761.533545692278,-100.0,6
23:59,679662108.0,16185.789426393849,-15.99,1
23:59,679662108.0,16166.799426393847,-18.99,6
23:59,235663459.0,475.4144298120152,-15.99,1
23:59,235663459.0,469.4244298120152,-5.99,1
23:59,235663459.0,463.4344298120152,-5.99,1
23:59,235663459.0,456.4344298120152,-7.0,1
23:59,235663459.0,441.4444298120152,-14.99,1
23:59,843174694.0,-4757.885999999998,-18.99,6
23:59,890196840.0,-2693.3038166751307,-18.99,6
23:59,890196840.0,-2709.2938166751305,-15.99,1
23:59,890196840.0,-2809.2938166751305,-100.0,6
23:59,508518911.0,281.44475027901046,-14.99,1
23:59,508518911.0,274.44475027901046,-7.0,1
23:59,508518911.0,258.45475027901045,-15.99,1
23:59,508518911.0,239.46475027901045,-18.99,6
23:59,508518911.0,139.46475027901045,-100.0,6
23:59,324224854.0,3311.2807135794283,-15.99,1
23:59,158766229.0,-504.35653589346987,-7.99,1
23:59,158766229.0,-520.3465358934699,-15.99,1
23:59,158766229.0,-535.3365358934699,-14.99,1
23:59,158766229.0,-541.3265358934699,-5.99,1
23:59,158766229.0,-556.3165358934699,-14.99,1
23:59,158766229.0,-569.3065358934699,-12.99,1
23:59,672994751.0,217.10130758413743,-7.99,1
23:59,672994751.0,209.11130758413745,-7.99,7
23:59,672994751.0,194.1213075841374,-14.99,1
23:59,672994751.0,179.1313075841374,-14.99,1
23:59,672994751.0,160.1413075841374,-18.99,6
23:59,853907490.0,7490.148570287314,-100.0,6
23:59,853907490.0,7474.158570287314,-15.99,1
23:59,903663593.0,1022.4070558595412,-14.99,1
23:59,903663593.0,1007.417055859541,-14.99,1
23:59,903663593.0,1000.417055859541,-7.0,1
23:59,903663593.0,987.427055859541,-12.99,1
23:59,903663593.0,968.437055859541,-18.99,6
23:59,357651163.0,-525.3100000000006,-15.99,1
23:59,357651163.0,-533.3000000000006,-7.99,1
23:59,357651163.0,-546.2900000000006,-12.99,1
23:59,357651163.0,-565.2800000000007,-18.99,6
23:59,939972497.0,291.8732586000108,-5.99,1
23:59,939972497.0,285.8832586000108,-5.99,1
23:59,939972497.0,272.89325860001077,-12.99,1
23:59,939972497.0,172.89325860001077,-100.0,6
23:59,939972497.0,153.90325860001076,-18.99,6
23:59,548907062.0,498.05748876828864,-7.0,1
23:59,548907062.0,491.05748876828864,-7.0,1
23:59,548907062.0,478.0674887682886,-12.99,1
23:59,548907062.0,462.0774887682886,-15.99,1
23:59,548907062.0,443.0874887682886,-18.99,6
23:59,548907062.0,343.0874887682886,-100.0,6
23:59,786927378.0,-1319.6702796373163,-7.99,1
23:59,786927378.0,-1335.6602796373163,-15.99,1
23:59,786927378.0,-1354.6502796373163,-18.99,6
23:59,786927378.0,-1454.6502796373163,-100.0,6
23:59,786927378.0,-1467.6402796373163,-12.99,1
23:59,903468956.0,603.8293999999994,-15.99,1
23:59,903468956.0,595.8393999999994,-7.99,7
23:59,971129830.0,-2020.0531499999995,-14.99,1
23:59,971129830.0,-2033.0431499999995,-12.99,1
23:59,971129830.0,-2048.03315,-14.99,1
23:59,971129830.0,-2067.0231499999995,-18.99,6
23:59,971129830.0,-2083.0131499999993,-15.99,1
23:59,971129830.0,-2091.003149999999,-7.99,7
23:59,990894155.0,183.42645867884153,-15.99,1
23:59,990894155.0,175.43645867884152,-7.99,1
23:59,990894155.0,156.4464586788415,-18.99,6
23:59,149684419.0,1629.6317999999983,-15.99,1
23:59,149684419.0,1616.6417999999985,-12.99,1
23:59,149684419.0,1601.6517999999985,-14.99,1
23:59,149684419.0,1594.6517999999985,-7.0,1
23:59,149684419.0,1579.6617999999985,-14.99,1
23:59,887156614.0,-808.8548210407735,-18.99,6
23:59,887156614.0,-816.8448210407735,-7.99,7
23:59,887156614.0,-832.8348210407735,-15.99,1
23:59,887156614.0,-838.8248210407735,-5.99,1
23:59,887156614.0,-844.8148210407735,-5.99,1
23:59,887156614.0,-850.8048210407735,-5.99,1
23:59,816685391.0,-533.0645037084263,-18.99,6
23:59,816685391.0,-541.0545037084263,-7.99,1
23:59,564744955.0,608.283658588842,-100.0,6
23:59,564744955.0,592.2936585888419,-15.99,1
23:59,564744955.0,584.3036585888419,-7.99,7
23:59,635679314.0,-2685.9858291195196,-7.99,7
23:59,635679314.0,-2693.9758291195194,-7.99,1
23:59,635679314.0,-2793.9758291195194,-100.0,6
23:59,635679314.0,-2800.9758291195194,-7.0,1
23:59,635679314.0,-2807.9758291195194,-7.0,1
23:59,635679314.0,-2822.965829119519,-14.99,1
23:59,635679314.0,-2835.955829119519,-12.99,1
23:59,133755851.0,921.0340038000928,-7.99,1
23:59,133755851.0,905.0440038000928,-15.99,1
23:59,711140907.0,1308.4705999999994,-15.99,1
23:59,711140907.0,1289.4805999999994,-18.99,6
23:59,392270893.0,12621.430441412827,-15.99,1
23:59,675806859.0,7067.001020259421,-15.99,1
23:59,675806859.0,7059.0110202594215,-7.99,7
23:59,194023154.0,-2400.639671784734,-15.99,1
23:59,194023154.0,-2408.629671784734,-7.99,1
23:59,544961962.0,2371.084323005609,-5.99,1
23:59,544961962.0,2352.094323005609,-18.99,6
23:59,252760664.0,7286.47368186801,-15.99,1
23:59,252760664.0,7278.483681868011,-7.99,7
23:59,252760664.0,7259.493681868011,-18.99,6
23:59,252760664.0,7159.493681868011,-100.0,6
23:59,131388684.0,22281.9767691678,-15.99,1
23:59,131388684.0,22273.986769167797,-7.99,1
23:59,131388684.0,22254.996769167796,-18.99,6
23:59,131388684.0,22154.996769167796,-100.0,6
23:59,285873880.0,11617.36324812084,-7.99,1
23:59,285873880.0,11611.37324812084,-5.99,1
23:59,285873880.0,11596.38324812084,-14.99,1
23:59,534097839.0,-4926.678549999999,-15.99,1
23:59,534097839.0,-4934.6685499999985,-7.99,7
23:59,534097839.0,-4947.658549999998,-12.99,1
23:59,534097839.0,-4966.648549999998,-18.99,6
23:59,780859359.0,-605.5300000000002,-18.99,6
23:59,780859359.0,-613.5200000000002,-7.99,7
23:59,780859359.0,-713.5200000000002,-100.0,6
23:59,442079728.0,1128.655119219314,-18.99,6
23:59,373875019.0,16246.942523365682,-18.99,6
23:59,373875019.0,16230.952523365682,-15.99,1
23:59,373875019.0,16222.962523365684,-7.99,1
23:59,891716230.0,821.8229840412953,-15.99,1
23:59,891716230.0,814.8229840412953,-7.0,1
23:59,891716230.0,795.8329840412953,-18.99,6
23:59,427909748.0,2309.433200000012,-18.99,6
23:59,427909748.0,2301.4432000000124,-7.99,1
23:59,427909748.0,2293.4532000000127,-7.99,7
23:59,427909748.0,2286.4532000000127,-7.0,1
23:59,842682241.0,6327.050982160805,-15.99,1
23:59,842682241.0,6319.060982160805,-7.99,7
23:59,842682241.0,6313.070982160805,-5.99,1
23:59,680773155.0,1033.9027833310918,-100.0,6
23:59,680773155.0,1017.9127833310918,-15.99,1
23:59,680773155.0,1009.9227833310918,-7.99,7
23:59,680773155.0,990.9327833310916,-18.99,6
23:59,699139822.0,1954.6796774548511,-15.99,1
23:59,699139822.0,1935.689677454851,-18.99,6
23:59,631111289.0,-460.39150000000063,-7.99,1
23:59,631111289.0,-479.38150000000064,-18.99,6
23:59,631111289.0,-579.3815000000006,-100.0,6
23:59,551755686.0,6825.764655850648,-15.99,1
23:59,551755686.0,6810.774655850648,-14.99,1
23:59,551755686.0,6803.774655850648,-7.0,1
23:59,551755686.0,6784.784655850648,-18.99,6
23:59,776431321.0,3588.183500363153,-7.99,7
23:59,776431321.0,3569.193500363154,-18.99,6
23:59,776431321.0,3563.2035003631536,-5.99,1
23:59,916270283.0,2365.744249999999,-18.99,6
23:59,916270283.0,2357.754249999999,-7.99,7
23:59,993039226.0,-3970.929499999995,-15.99,1
23:59,993039226.0,-3978.919499999995,-7.99,1
23:59,993039226.0,-3991.909499999995,-12.99,1
23:59,993039226.0,-3997.8994999999945,-5.99,1
23:59,993039226.0,-4003.8894999999943,-5.99,1
23:59,993039226.0,-4009.879499999994,-5.99,1
23:59,993039226.0,-4028.869499999994,-18.99,6
23:59,779816907.0,-2775.9185829229123,-7.99,7
23:59,779816907.0,-2783.908582922912,-7.99,1
23:59,779816907.0,-2790.908582922912,-7.0,1
23:59,779816907.0,-2796.898582922912,-5.99,1
23:59,779816907.0,-2815.8885829229116,-18.99,6
23:59,806358207.0,12635.33578498537,-14.99,1
23:59,806358207.0,12628.33578498537,-7.0,1
23:59,806358207.0,12612.34578498537,-15.99,1
23:59,806358207.0,12593.35578498537,-18.99,6
23:59,490868147.0,-4.5072208786984795,-18.99,6
23:59,490868147.0,-11.50722087869848,-7.0,1
23:59,490868147.0,-27.49722087869848,-15.99,1
23:59,490868147.0,-35.48722087869848,-7.99,1
23:59,195895574.0,7701.841025060882,-15.99,1
23:59,195895574.0,7693.851025060882,-7.99,7
23:59,195895574.0,7686.851025060882,-7.0,1
23:59,195895574.0,7667.861025060883,-18.99,6
23:59,355602925.0,1759.2576195597524,-15.99,1
23:59,355602925.0,1751.2676195597523,-7.99,1
23:59,355602925.0,1732.2776195597523,-18.99,6
23:59,779376323.0,3008.082862489441,-15.99,1
23:59,779376323.0,2908.082862489441,-100.0,6
23:59,472213568.0,-54.06709420605329,-7.99,1
23:59,472213568.0,-70.05709420605329,-15.99,1
23:59,472213568.0,-85.04709420605329,-14.99,1
23:59,472213568.0,-100.03709420605328,-14.99,1
23:59,472213568.0,-107.03709420605328,-7.0,1
23:59,472213568.0,-114.03709420605328,-7.0,1
23:59,472213568.0,-214.03709420605327,-100.0,6
23:59,137913631.0,1741.409,-15.99,1
23:59,137913631.0,1722.419,-18.99,6
23:59,518466565.0,1083.4864499999996,-14.99,1
23:59,518466565.0,1076.4864499999996,-7.0,1
23:59,518466565.0,976.4864499999996,-100.0,6
23:59,696758548.0,-3203.0328963201373,-14.99,1
23:59,696758548.0,-3218.022896320137,-14.99,1
23:59,696758548.0,-3231.012896320137,-12.99,1
23:59,696758548.0,-3244.0028963201366,-12.99,1
23:59,426474982.0,-3512.0897499999996,-15.99,1
23:59,520239952.0,-1261.292476654763,-7.99,1
23:59,520239952.0,-1269.282476654763,-7.99,7
23:59,520239952.0,-1288.272476654763,-18.99,6
23:59,782058249.0,-1271.4413733101617,-12.99,1
23:59,782058249.0,-1278.4413733101617,-7.0,1
23:59,782058249.0,-1294.4313733101617,-15.99,1
23:59,492215823.0,2581.2011738154433,-15.99,1
23:59,492215823.0,2562.2111738154435,-18.99,6
23:59,492215823.0,2556.221173815444,-5.99,1
23:59,413557825.0,745.8494999999996,-100.0,6
23:59,283027736.0,246.0042439701729,-12.99,1
23:59,283027736.0,233.01424397017288,-12.99,1
23:59,283027736.0,226.01424397017288,-7.0,1
23:59,283027736.0,219.01424397017288,-7.0,1
23:59,283027736.0,203.02424397017285,-15.99,1
23:59,283027736.0,103.02424397017283,-100.0,6
23:59,668692488.0,2511.690903563902,-7.0,1
23:59,668692488.0,2505.700903563902,-5.99,1
23:59,668692488.0,2498.700903563902,-7.0,1
23:59,668692488.0,2483.7109035639023,-14.99,1
23:59,668692488.0,2467.7209035639025,-15.99,1
23:59,668692488.0,2448.7309035639028,-18.99,6
23:59,834581602.0,851.5772499999991,-14.99,1
23:59,834581602.0,845.5872499999991,-5.99,1
23:59,834581602.0,811.6072499999991,-18.99,6
23:59,834581602.0,795.6172499999991,-15.99,1
23:59,834581602.0,787.6272499999991,-7.99,1
23:59,834581602.0,687.6272499999991,-100.0,6
23:59,975200042.0,-2849.8776999999977,-7.99,7
23:59,975200042.0,-2856.8776999999977,-7.0,1
23:59,975200042.0,-2862.8676999999975,-5.99,1
23:59,975200042.0,-2875.8576999999973,-12.99,1
23:59,975200042.0,-2894.847699999997,-18.99,6
23:59,216286013.0,180.96850665394004,-100.0,6
23:59,216286013.0,164.97850665394003,-15.99,1
23:59,216286013.0,156.98850665394002,-7.99,7
23:59,240643705.0,719.4750911206154,-14.99,1
23:59,240643705.0,713.4850911206154,-5.99,1
23:59,240643705.0,697.4950911206154,-15.99,1
23:59,240643705.0,689.5050911206154,-7.99,7
23:59,240643705.0,670.5150911206154,-18.99,6
23:59,240643705.0,570.5150911206154,-100.0,6
23:59,874431242.0,10096.358625778075,-7.99,7
23:59,874431242.0,10090.368625778076,-5.99,1
23:59,874431242.0,10083.368625778076,-7.0,1
23:59,874431242.0,10068.378625778076,-14.99,1
23:59,874431242.0,10055.388625778076,-12.99,1
23:59,874431242.0,10036.398625778076,-18.99,6
23:59,456246119.0,19906.87199821335,-18.99,6
23:59,456246119.0,19898.88199821335,-7.99,7
23:59,456246119.0,19798.88199821335,-100.0,6
23:59,752362502.0,10910.79510309608,-12.99,1
23:59,752362502.0,10895.80510309608,-14.99,1
23:59,752362502.0,10882.81510309608,-12.99,1
23:59,752362502.0,10866.82510309608,-15.99,1
23:59,925659248.0,-427.9401392295712,-18.99,6
23:59,925659248.0,-443.9301392295712,-15.99,1
23:59,925659248.0,-451.9201392295712,-7.99,1
23:59,820686957.0,-652.5957663111959,-18.99,6
23:59,820686957.0,-660.5857663111959,-7.99,1
23:59,820686957.0,-668.5757663111959,-7.99,7
23:59,406772240.0,-1116.8253500000003,-18.99,6
23:59,406772240.0,-1124.8153500000003,-7.99,1
23:59,406772240.0,-1140.8053500000003,-15.99,1
23:59,406772240.0,-1155.7953500000003,-14.99,1
23:59,496395938.0,13145.005633900286,-15.99,1
23:59,496395938.0,13126.015633900286,-18.99,6
23:59,807714284.0,1309.740360736,-5.99,1
23:59,807714284.0,1303.750360736,-5.99,1
23:59,807714284.0,1290.760360736,-12.99,1
23:59,807714284.0,1271.770360736,-18.99,6
23:59,699997811.0,2066.8052000000034,-15.99,1
23:59,699997811.0,2058.8152000000036,-7.99,1
23:59,699997811.0,2039.8252000000036,-18.99,6
23:59,147474476.0,4700.63786511936,-7.99,7
23:59,147474476.0,4681.64786511936,-18.99,6
23:59,147474476.0,4675.65786511936,-5.99,1
23:59,147474476.0,4662.667865119361,-12.99,1
23:59,216285378.0,23775.549384634927,-7.99,7
23:59,216285378.0,23768.549384634927,-7.0,1
23:59,216285378.0,23753.55938463493,-14.99,1
23:59,216285378.0,23740.569384634924,-12.99,1
23:59,216285378.0,23734.57938463492,-5.99,1
23:59,216285378.0,23715.58938463492,-18.99,6
23:59,469330905.0,345.4500680292156,-7.0,1
23:59,469330905.0,330.46006802921556,-14.99,1
23:59,469330905.0,311.47006802921555,-18.99,6
23:59,469330905.0,303.48006802921554,-7.99,7
23:59,709935470.0,799.0757376997724,-14.99,1
23:59,709935470.0,780.0857376997724,-18.99,6
23:59,679943657.0,5524.022891111273,-15.99,1
23:59,679943657.0,5505.032891111273,-18.99,6
23:59,679943657.0,5498.032891111273,-7.0,1
23:59,679943657.0,5491.032891111273,-7.0,1
23:59,679943657.0,5484.032891111273,-7.0,1
23:59,679943657.0,5469.042891111273,-14.99,1
23:59,690941877.0,-35.85503848250811,-7.99,1
23:59,690941877.0,-42.85503848250811,-7.0,1
23:59,500843551.0,1144.9750999999997,-100.0,6
23:59,500843551.0,1128.9850999999996,-15.99,1
23:59,500843551.0,1109.9950999999996,-18.99,6
23:59,872874909.0,-2123.761897899587,-7.99,1
23:59,651756497.0,13851.336370810994,-7.99,7
23:59,651756497.0,13835.346370810994,-15.99,1
23:59,651756497.0,13822.356370810994,-12.99,1
23:59,651756497.0,13816.366370810994,-5.99,1
23:59,651756497.0,13809.366370810994,-7.0,1
23:59,651756497.0,13790.376370810996,-18.99,6
23:59,859603181.0,4393.265666544273,-5.99,1
23:59,896821055.0,-123.91182631476464,-7.99,1
23:59,217540156.0,-3180.359819999995,-15.99,1
23:59,217540156.0,-3280.359819999995,-100.0,6
23:59,217540156.0,-3286.349819999995,-5.99,1
23:59,217540156.0,-3299.3398199999947,-12.99,1
23:59,217540156.0,-3306.3398199999947,-7.0,1
23:59,217540156.0,-3325.3298199999945,-18.99,6
23:59,929044080.0,728.0338915056284,-7.99,1
23:59,929044080.0,709.0438915056284,-18.99,6
23:59,929044080.0,696.0538915056284,-12.99,1
23:59,929044080.0,683.0638915056284,-12.99,1
23:59,929044080.0,670.0738915056284,-12.99,1
23:59,322221939.0,4332.323287740697,-15.99,1
23:59,322221939.0,4324.333287740697,-7.99,7
23:59,322221939.0,4311.343287740698,-12.99,1
23:59,322221939.0,4304.343287740698,-7.0,1
23:59,322221939.0,4289.353287740698,-14.99,1
23:59,322221939.0,4282.353287740698,-7.0,1
23:59,322221939.0,4263.363287740698,-18.99,6
23:59,310375875.0,4625.026812851883,-15.99,1
23:59,310375875.0,4610.036812851883,-14.99,1
23:59,310375875.0,4597.046812851883,-12.99,1
23:59,310375875.0,4582.0568128518835,-14.99,1
23:59,310375875.0,4563.066812851884,-18.99,6
23:59,910730524.0,8328.645760689113,-15.99,1
23:59,910730524.0,8320.655760689113,-7.99,1
23:59,910730524.0,8301.665760689113,-18.99,6
23:59,910730524.0,8294.665760689113,-7.0,1
23:59,910730524.0,8288.675760689113,-5.99,1
23:59,910730524.0,8281.675760689113,-7.0,1
23:59,551196328.0,4976.2861339423125,-18.99,6
23:59,551196328.0,4968.296133942313,-7.99,7
23:59,551196328.0,4952.306133942313,-15.99,1
23:59,551196328.0,4945.306133942313,-7.0,1
23:59,551196328.0,4932.316133942313,-12.99,1
23:59,551196328.0,4917.326133942313,-14.99,1
23:59,551196328.0,4910.326133942313,-7.0,1
23:59,117273481.0,9538.469548378273,-7.99,7
23:59,117273481.0,9530.479548378273,-7.99,1
23:59,641764023.0,-1121.5638037720043,-7.99,1
23:59,955035930.0,1637.803479171477,-15.99,1
23:59,955035930.0,1537.803479171477,-100.0,6
23:59,541639148.0,5158.040835257946,-18.99,6
23:59,541639148.0,5145.050835257946,-12.99,1
23:59,541639148.0,5138.050835257946,-7.0,1
23:59,541639148.0,5122.060835257947,-15.99,1
23:59,907987693.0,-2347.134499999999,-18.99,6
23:59,907987693.0,-2363.124499999999,-15.99,1
23:59,907987693.0,-2371.1144999999988,-7.99,7
23:59,866941383.0,3222.685500000005,-15.99,1
23:59,866941383.0,3203.6955000000053,-18.99,6
23:59,866941383.0,3190.7055000000055,-12.99,1
23:59,866941383.0,3175.7155000000057,-14.99,1
23:59,321372947.0,-215.83835078909945,-18.99,6
23:59,321372947.0,-228.82835078909943,-12.99,1
23:59,321372947.0,-235.82835078909943,-7.0,1
23:59,321372947.0,-242.82835078909943,-7.0,1
23:59,321372947.0,-248.81835078909944,-5.99,1
23:59,151968462.0,9381.854946925092,-18.99,6
23:59,151968462.0,9368.864946925092,-12.99,1
23:59,151968462.0,9355.874946925092,-12.99,1
23:59,151968462.0,9348.874946925092,-7.0,1
23:59,993663752.0,401.38129241039655,-7.99,1
23:59,993663752.0,393.39129241039655,-7.99,7
23:59,993663752.0,380.40129241039654,-12.99,1
23:59,993663752.0,367.4112924103965,-12.99,1
23:59,993663752.0,354.4212924103965,-12.99,1
23:59,993663752.0,347.4212924103965,-7.0,1
23:59,403383649.0,2093.302466099444,-15.99,1
23:59,403383649.0,2086.302466099444,-7.0,1
23:59,403383649.0,2071.3124660994445,-14.99,1
23:59,134847904.0,4333.862044386295,-15.99,1
23:59,134847904.0,4325.872044386295,-7.99,7
23:59,134847904.0,4312.882044386295,-12.99,1
23:59,134847904.0,4299.892044386295,-12.99,1
23:59,134847904.0,4280.9020443862955,-18.99,6
23:59,134847904.0,4180.9020443862955,-100.0,6
23:59,610645022.0,-502.66746264491826,-15.99,1
23:59,610645022.0,-515.6574626449183,-12.99,1
23:59,610645022.0,-521.6474626449183,-5.99,1
23:59,610645022.0,-527.6374626449183,-5.99,1
23:59,610645022.0,-546.6274626449183,-18.99,6
23:59,383345285.0,-1049.5923735880765,-18.99,6
23:59,383345285.0,-1062.5823735880765,-12.99,1
23:59,383345285.0,-1075.5723735880763,-12.99,1
23:59,996042490.0,5959.927696170786,-15.99,1
23:59,996042490.0,5952.927696170786,-7.0,1
23:59,996042490.0,5937.937696170786,-14.99,1
23:59,996042490.0,5930.937696170786,-7.0,1
23:59,996042490.0,5923.937696170786,-7.0,1
23:59,996042490.0,5904.947696170786,-18.99,6
23:59,479366718.0,2252.5914476323996,-7.99,7
23:59,479366718.0,2152.5914476323996,-100.0,6
23:59,479366718.0,2146.6014476324,-5.99,1
23:59,479366718.0,2131.6114476324,-14.99,1
23:59,479366718.0,2125.6214476324003,-5.99,1
23:59,479366718.0,2106.6314476324005,-18.99,6
23:59,986267641.0,7640.181578054611,-15.99,1
23:59,986267641.0,7632.191578054611,-7.99,7
23:59,986267641.0,7613.201578054612,-18.99,6
23:59,986267641.0,7600.211578054612,-12.99,1
23:59,986267641.0,7585.221578054612,-14.99,1
23:59,871200314.0,242.86132424263835,-15.99,1
23:59,871200314.0,234.87132424263837,-7.99,7
23:59,871200314.0,215.88132424263836,-18.99,6
23:59,871200314.0,200.89132424263835,-14.99,1
23:59,871200314.0,193.89132424263835,-7.0,1
23:59,871200314.0,93.89132424263836,-100.0,6
23:59,851649498.0,10679.295213657391,-5.99,1
23:59,851649498.0,10672.295213657391,-7.0,1
23:59,851649498.0,10659.305213657392,-12.99,1
23:59,851649498.0,10646.315213657392,-12.99,1
23:59,851649498.0,10630.325213657392,-15.99,1
23:59,851649498.0,10622.335213657392,-7.99,7
23:59,851649498.0,10603.345213657392,-18.99,6
23:59,446720287.0,203.7634408184056,-18.99,6
23:59,918772878.0,-19.40951724532121,-100.0,6
23:59,918772878.0,-38.399517245321206,-18.99,6
23:59,287480331.0,12944.830404170609,-15.99,1
23:59,287480331.0,12938.840404170607,-5.99,1
23:59,287480331.0,12923.85040417061,-14.99,1
23:59,287480331.0,12904.86040417061,-18.99,6
23:59,662610817.0,-1106.192131324928,-18.99,6
23:59,662610817.0,-1122.182131324928,-15.99,1
23:59,401293808.0,181.7690499999992,-18.99,6
23:59,401293808.0,165.7790499999992,-15.99,1
23:59,401293808.0,157.78904999999918,-7.99,7
23:59,401293808.0,57.78904999999918,-100.0,6
23:59,449871732.0,10623.704646956108,-15.99,1
23:59,449871732.0,10615.714646956108,-7.99,7
23:59,449871732.0,10608.714646956108,-7.0,1
23:59,449871732.0,10589.724646956109,-18.99,6
23:59,449871732.0,10489.724646956109,-100.0,6
23:59,971010829.0,410.59125644424535,-18.99,6
23:59,237493332.0,14857.897394494952,-7.99,1
23:59,237493332.0,14838.907394494952,-18.99,6
23:59,237493332.0,14832.917394494953,-5.99,1
23:59,237493332.0,14732.917394494953,-100.0,6
23:59,192202372.0,947.7320190390736,-7.0,1
23:59,192202372.0,939.7420190390736,-7.99,7
23:59,192202372.0,920.7520190390736,-18.99,6
23:59,768271776.0,-302.14174676657944,-5.99,1
23:59,768271776.0,-315.13174676657945,-12.99,1
23:59,768271776.0,-330.12174676657946,-14.99,1
23:59,768271776.0,-336.1117467665795,-5.99,1
23:59,768271776.0,-355.1017467665795,-18.99,6
23:59,768271776.0,-371.0917467665795,-15.99,1
23:59,768271776.0,-379.0817467665795,-7.99,7
23:59,673025413.0,4480.4415573767,-14.99,1
23:59,673025413.0,4474.4515573767,-5.99,1
23:59,532525712.0,-611.8318000000004,-15.99,1
23:59,532525712.0,-619.8218000000004,-7.99,7
23:59,532525712.0,-625.8118000000004,-5.99,1
23:59,532525712.0,-632.8118000000004,-7.0,1
23:59,532525712.0,-645.8018000000004,-12.99,1
23:59,532525712.0,-660.7918000000004,-14.99,1
23:59,509627909.0,225.694649999999,-18.99,6
23:59,509627909.0,209.704649999999,-15.99,1
23:59,509627909.0,201.71464999999895,-7.99,7
23:59,509627909.0,188.72464999999897,-12.99,1
23:59,509627909.0,173.73464999999896,-14.99,1
23:59,373163757.0,12024.421796728537,-15.99,1
23:59,373163757.0,12016.431796728535,-7.99,1
23:59,858560423.0,12240.563784057644,-18.99,6
23:59,858560423.0,12224.573784057644,-15.99,1
23:59,858560423.0,12124.573784057644,-100.0,6
23:59,494789005.0,3434.4435196375307,-18.99,6
23:59,494789005.0,3418.453519637531,-15.99,1
23:59,779236304.0,1417.3975954795326,-7.99,1
23:59,779236304.0,1401.4075954795326,-15.99,1
23:59,779236304.0,1395.4175954795326,-5.99,1
23:59,779236304.0,1295.4175954795326,-100.0,6
23:59,779236304.0,1276.4275954795326,-18.99,6
23:59,656317661.0,-264.16990845859715,-15.99,1
23:59,398429109.0,1136.9550500000012,-15.99,1
23:59,398429109.0,1117.9650500000012,-18.99,6
23:59,398429109.0,1111.9750500000011,-5.99,1
23:59,398429109.0,1098.9850500000011,-12.99,1
23:59,948558249.0,9507.208233470716,-18.99,6
23:59,948558249.0,9499.218233470718,-7.99,7
23:59,948558249.0,9483.228233470718,-15.99,1
23:59,948558249.0,9476.228233470718,-7.0,1
23:59,948558249.0,9470.238233470718,-5.99,1
23:59,214765415.0,-762.3210988501354,-7.99,1
23:59,214765415.0,-778.3110988501354,-15.99,1
23:59,957821152.0,-1196.1610035715498,-15.99,1
23:59,957821152.0,-1204.1510035715498,-7.99,7
23:59,957821152.0,-1223.1410035715498,-18.99,6
23:59,957821152.0,-1323.1410035715498,-100.0,6
23:59,957821152.0,-1338.13100357155,-14.99,1
23:59,143061865.0,7792.037325779382,-15.99,1
23:59,143061865.0,7784.047325779382,-7.99,1
23:59,143061865.0,7765.057325779382,-18.99,6
23:59,299871610.0,507.1156530587666,-18.99,6
23:59,299871610.0,491.1256530587666,-15.99,1
23:59,299871610.0,476.1356530587666,-14.99,1
23:59,478651121.0,49.126129598469795,-15.99,1
23:59,478651121.0,41.13612959846979,-7.99,7
23:59,478651121.0,22.146129598469795,-18.99,6
23:59,478651121.0,16.156129598469796,-5.99,1
23:59,142791593.0,96.5419499999996,-18.99,6
23:59,142791593.0,80.55194999999961,-15.99,1
23:59,142791593.0,74.56194999999961,-5.99,1
23:59,142791593.0,67.56194999999961,-7.0,1
23:59,142791593.0,-32.43805000000039,-100.0,6
23:59,761272540.0,385.8512499999989,-7.99,1
23:59,761272540.0,369.8612499999989,-15.99,1
23:59,761272540.0,356.8712499999989,-12.99,1
23:59,761272540.0,350.8812499999989,-5.99,1
23:59,761272540.0,344.8912499999989,-5.99,1
23:59,761272540.0,338.90124999999887,-5.99,1
23:59,761272540.0,319.91124999999886,-18.99,6
23:59,690523499.0,1528.18445,-18.99,6
23:59,690523499.0,1515.19445,-12.99,1
23:59,690523499.0,1508.19445,-7.0,1
23:59,690523499.0,1501.19445,-7.0,1
23:59,690523499.0,1485.20445,-15.99,1
23:59,690523499.0,1477.21445,-7.99,1
23:59,812012103.0,5.8906999999994785,-7.99,7
23:59,812012103.0,-7.099300000000522,-12.99,1
23:59,812012103.0,-20.08930000000052,-12.99,1
23:59,386277162.0,513.8999999999994,-15.99,1
23:59,386277162.0,498.9099999999994,-14.99,1
23:59,386277162.0,479.9199999999994,-18.99,6
23:59,978951113.0,-259.49299259041914,-7.99,1
23:59,978951113.0,-267.48299259041914,-7.99,7
23:59,978951113.0,-280.47299259041915,-12.99,1
23:59,978951113.0,-299.46299259041916,-18.99,6
23:59,168414279.0,255.23478427492137,-18.99,6
23:59,168414279.0,247.24478427492136,-7.99,1
23:59,487051121.0,1003.92056640451,-15.99,1
23:59,487051121.0,995.93056640451,-7.99,7
23:59,487051121.0,982.94056640451,-12.99,1
23:59,145553416.0,-2488.7356499999996,-5.99,1
23:59,145553416.0,-2494.7256499999994,-5.99,1
23:59,145553416.0,-2509.715649999999,-14.99,1
23:59,145553416.0,-2525.705649999999,-15.99,1
23:59,145553416.0,-2544.6956499999987,-18.99,6
23:59,758885184.0,1953.1871822743449,-15.99,1
23:59,758885184.0,1934.1971822743449,-18.99,6
23:59,837876918.0,-2112.070291465421,-7.99,1
23:59,837876918.0,-2120.060291465421,-7.99,7
23:59,137822385.0,3964.1077171514753,-5.99,1
23:59,137822385.0,3957.1077171514753,-7.0,1
23:59,137822385.0,3944.117717151475,-12.99,1
23:59,137822385.0,3929.127717151476,-14.99,1
23:59,137822385.0,3921.137717151476,-7.99,7
23:59,137822385.0,3902.147717151476,-18.99,6
23:59,952921898.0,-348.9245777080187,-15.99,1
23:59,952921898.0,-354.9145777080187,-5.99,1
23:59,951817450.0,10071.984556535846,-7.99,7
23:59,672913754.0,10931.350918423384,-15.99,1
23:59,672913754.0,10925.360918423385,-5.99,1
23:59,600185455.0,210.1300022474815,-12.99,1
23:59,600185455.0,203.1300022474815,-7.0,1
23:59,600185455.0,188.1400022474815,-14.99,1
23:59,600185455.0,181.1400022474815,-7.0,1
23:59,600185455.0,165.1500022474815,-15.99,1
23:59,600185455.0,157.1600022474815,-7.99,7
23:59,311467864.0,707.8946999999991,-15.99,1
23:59,491392945.0,5003.035500000005,-5.99,1
23:59,491392945.0,4996.035500000005,-7.0,1
23:59,491392945.0,4983.045500000006,-12.99,1
23:59,491392945.0,4975.055500000006,-7.99,1
23:59,491392945.0,4967.065500000006,-7.99,7
23:59,491392945.0,4948.075500000006,-18.99,6
23:59,208381936.0,-801.515578221745,-18.99,6
23:59,208381936.0,-817.505578221745,-15.99,1
23:59,208381936.0,-825.4955782217451,-7.99,7
23:59,461029994.0,7542.416299682367,-18.99,6
23:59,461029994.0,7526.426299682367,-15.99,1
23:59,461029994.0,7518.436299682368,-7.99,7
23:59,350921975.0,-29.33702892612564,-7.0,1
23:59,350921975.0,-35.32702892612564,-5.99,1
23:59,350921975.0,-50.31702892612565,-14.99,1
23:59,350921975.0,-66.30702892612564,-15.99,1
23:59,350921975.0,-85.29702892612563,-18.99,6
23:59,350921975.0,-185.2970289261256,-100.0,6
23:59,124102251.0,4327.947478036823,-15.99,1
23:59,124102251.0,4308.957478036823,-18.99,6
23:59,124102251.0,4302.967478036823,-5.99,1
23:59,916225911.0,-2113.654250000001,-15.99,1
23:59,916225911.0,-2132.6442500000007,-18.99,6
23:59,948069469.0,-576.792000000001,-15.99,1
23:59,948069469.0,-584.7820000000011,-7.99,1
23:59,948069469.0,-603.7720000000011,-18.99,6
23:59,656389634.0,-2869.5993404219867,-7.0,1
23:59,656389634.0,-2884.5893404219864,-14.99,1
23:59,656389634.0,-2890.579340421986,-5.99,1
23:59,656389634.0,-2898.569340421986,-7.99,1
23:59,656389634.0,-2917.559340421986,-18.99,6
23:59,698076160.0,6488.733235659583,-12.99,1
23:59,698076160.0,6469.743235659584,-18.99,6
23:59,405945930.0,4782.36760656814,-18.99,6
23:59,405945930.0,4766.37760656814,-15.99,1
23:59,405945930.0,4758.387606568141,-7.99,7
23:59,757115616.0,2318.800000000003,-18.99,6
23:59,950234174.0,1326.9980599724934,-14.99,1
23:59,950234174.0,1321.0080599724934,-5.99,1
23:59,950234174.0,1306.0180599724931,-14.99,1
23:59,950234174.0,1293.028059972493,-12.99,1
23:59,950234174.0,1277.038059972493,-15.99,1
23:59,950234174.0,1269.048059972493,-7.99,7
23:59,950234174.0,1250.0580599724933,-18.99,6
23:59,200080192.0,9917.205180574085,-100.0,6
23:59,200080192.0,9910.205180574085,-7.0,1
23:59,200080192.0,9895.215180574083,-14.99,1
23:59,200080192.0,9880.225180574083,-14.99,1
23:59,200080192.0,9864.235180574084,-15.99,1
23:59,200080192.0,9856.245180574086,-7.99,7
23:59,200080192.0,9837.255180574086,-18.99,6
23:59,340680761.0,-2837.985599999998,-15.99,1
23:59,340680761.0,-2845.975599999998,-7.99,7
23:59,340680761.0,-2864.9655999999977,-18.99,6
23:59,340680761.0,-2879.9555999999975,-14.99,1
23:59,340680761.0,-2894.9455999999973,-14.99,1
23:59,340680761.0,-2909.935599999997,-14.99,1
23:59,895331556.0,-358.3441000000008,-100.0,6
23:59,895331556.0,-374.3341000000008,-15.99,1
23:59,895331556.0,-393.3241000000008,-18.99,6
23:59,429556122.0,6442.581750000003,-15.99,1
23:59,429556122.0,6435.581750000003,-7.0,1
23:59,429556122.0,6429.591750000003,-5.99,1
23:59,429556122.0,6423.601750000003,-5.99,1
23:59,429556122.0,6323.601750000003,-100.0,6
23:59,429556122.0,6304.611750000004,-18.99,6
23:59,294474095.0,-2212.0012864992395,-12.99,1
23:59,294474095.0,-2227.9912864992393,-15.99,1
23:59,294474095.0,-2246.981286499239,-18.99,6
23:59,198946608.0,6932.8742917621585,-18.99,6
23:59,823208989.0,966.7883138695314,-15.99,1
23:59,823208989.0,958.7983138695314,-7.99,1
23:59,823208989.0,939.8083138695314,-18.99,6
23:59,660561861.0,1218.4828361603002,-15.99,1
23:59,660561861.0,1212.4928361603002,-5.99,1
23:59,660561861.0,1193.5028361603,-18.99,6
23:59,857455726.0,8.06388587568429,-7.99,7
23:59,857455726.0,0.0738858756842901,-7.99,1
23:59,865748375.0,4093.3195024712695,-15.99,1
23:59,865748375.0,4085.3295024712697,-7.99,1
23:59,865748375.0,4072.33950247127,-12.99,1
23:59,865748375.0,4065.33950247127,-7.0,1
23:59,865748375.0,4050.34950247127,-14.99,1
23:59,865748375.0,4031.3595024712704,-18.99,6
23:59,376271050.0,1459.5702468611792,-7.99,1
23:59,348325817.0,10419.92713558439,-100.0,6
23:59,348325817.0,10400.93713558439,-18.99,6
23:59,348325817.0,10384.94713558439,-15.99,1
23:59,248142083.0,-92.47256529748324,-15.99,1
23:59,248142083.0,-99.47256529748324,-7.0,1
23:59,248142083.0,-114.46256529748322,-14.99,1
23:59,248142083.0,-120.45256529748322,-5.99,1
23:59,248142083.0,-126.4425652974832,-5.99,1
23:59,248142083.0,-145.43256529748322,-18.99,6
23:59,518474507.0,15505.785134426214,-7.0,1
23:59,518474507.0,15490.795134426216,-14.99,1
23:59,518474507.0,15475.805134426217,-14.99,1
23:59,518474507.0,15462.815134426217,-12.99,1
23:59,518474507.0,15446.825134426215,-15.99,1
23:59,604334058.0,931.3352999999996,-15.99,1
23:59,604334058.0,923.3452999999996,-7.99,7
23:59,442070890.0,1088.3224124443711,-7.99,1
23:59,442070890.0,1069.3324124443711,-18.99,6
23:59,835829467.0,-1553.0847499999988,-15.99,1
23:59,835829467.0,-1559.0747499999989,-5.99,1
23:59,835829467.0,-1574.0647499999989,-14.99,1
23:59,835829467.0,-1593.0547499999989,-18.99,6
23:59,835829467.0,-1693.0547499999989,-100.0,6
23:59,984783496.0,14768.777214877384,-12.99,1
23:59,984783496.0,14762.787214877384,-5.99,1
23:59,984783496.0,14756.797214877384,-5.99,1
23:59,984783496.0,14740.807214877384,-15.99,1
23:59,984783496.0,14721.817214877385,-18.99,6
23:59,984783496.0,14621.817214877385,-100.0,6
23:59,620227043.0,-1861.297771013424,-15.99,1
23:59,960208650.0,17497.756873270868,-5.99,1
23:59,960208650.0,17482.766873270866,-14.99,1
23:59,960208650.0,17475.766873270866,-7.0,1
23:59,960208650.0,17459.776873270865,-15.99,1
23:59,960208650.0,17451.786873270863,-7.99,7
23:59,960208650.0,17432.79687327086,-18.99,6
23:59,556631012.0,1042.0689230856783,-15.99,1
23:59,556631012.0,1034.0789230856783,-7.99,7
23:59,556631012.0,1015.0889230856784,-18.99,6
23:59,556631012.0,915.0889230856784,-100.0,6
23:59,558119802.0,32558.496692761084,-15.99,1
23:59,558119802.0,32550.50669276108,-7.99,7
23:59,147341222.0,-1313.7663253207954,-15.99,1
23:59,147341222.0,-1321.7563253207954,-7.99,1
23:59,147341222.0,-1340.7463253207954,-18.99,6
23:59,147341222.0,-1440.7463253207954,-100.0,6
23:59,147341222.0,-1455.7363253207957,-14.99,1
23:59,147341222.0,-1468.7263253207957,-12.99,1
23:59,147341222.0,-1483.7163253207957,-14.99,1
23:59,147341222.0,-1498.7063253207957,-14.99,1
23:59,254018059.0,64.60875000000001,-18.99,6
23:59,254018059.0,48.61875000000001,-15.99,1
23:59,254018059.0,40.62875000000001,-7.99,7
23:59,254018059.0,25.63875000000001,-14.99,1
23:59,254018059.0,10.648750000000009,-14.99,1
23:59,380911501.0,-20.149850000000804,-15.99,1
23:59,503575533.0,8234.528090000016,-18.99,6
23:59,503575533.0,8218.538090000016,-15.99,1
23:59,503575533.0,8211.538090000016,-7.0,1
23:59,503575533.0,8196.548090000017,-14.99,1
23:59,503575533.0,8183.558090000017,-12.99,1
23:59,503575533.0,8083.558090000017,-100.0,6
23:59,962295212.0,-3819.7476499999975,-15.99,1
23:59,962295212.0,-3827.7376499999978,-7.99,1
23:59,962295212.0,-3840.727649999997,-12.99,1
23:59,962295212.0,-3853.717649999997,-12.99,1
23:59,962295212.0,-3868.7076499999966,-14.99,1
23:59,962295212.0,-3875.7076499999966,-7.0,1
23:59,961077907.0,260.2028,-15.99,1
23:59,961077907.0,241.2128,-18.99,6
23:59,961077907.0,234.2128,-7.0,1
23:59,961077907.0,227.2128,-7.0,1
23:59,961077907.0,127.21280000000002,-100.0,6
23:59,169006407.0,12176.383327852553,-15.99,1
23:59,169006407.0,12157.393327852553,-18.99,6
23:59,586041848.0,1433.201699999999,-14.99,1
23:59,586041848.0,1418.211699999999,-14.99,1
23:59,586041848.0,1399.221699999999,-18.99,6
23:59,586041848.0,1391.231699999999,-7.99,1
23:59,576188756.0,-3410.6414999999993,-15.99,1
23:59,709151315.0,-203.0007816258401,-12.99,1
23:59,709151315.0,-218.9907816258401,-15.99,1
23:59,709151315.0,-237.9807816258401,-18.99,6
23:59,143383029.0,-156.92116934766136,-15.99,1
23:59,143383029.0,-164.91116934766137,-7.99,7
23:59,143383029.0,-171.91116934766137,-7.0,1
23:59,143383029.0,-186.90116934766135,-14.99,1
23:59,143383029.0,-193.90116934766135,-7.0,1
23:59,229205098.0,7720.055652088711,-18.99,6
23:59,229205098.0,7707.065652088711,-12.99,1
23:59,229205098.0,7701.075652088712,-5.99,1
23:59,229205098.0,7695.085652088712,-5.99,1
23:59,675231808.0,16509.313481391346,-18.99,6
23:59,675231808.0,16501.323481391344,-7.99,7
23:59,697140785.0,-21.6283832638968,-15.99,1
23:59,697140785.0,-29.618383263896803,-7.99,7
23:59,697140785.0,-48.6083832638968,-18.99,6
23:59,697140785.0,-148.6083832638968,-100.0,6
23:59,660789920.0,-2356.3208473823724,-18.99,6
23:59,722358036.0,1178.730840627083,-18.99,6
23:59,722358036.0,1162.740840627083,-15.99,1
23:59,722358036.0,1154.7508406270829,-7.99,7
23:59,300095518.0,921.8912283414176,-7.0,1
23:59,129018172.0,9027.14588775261,-15.99,1
23:59,129018172.0,9014.15588775261,-12.99,1
23:59,129018172.0,9008.16588775261,-5.99,1
23:59,129018172.0,8989.17588775261,-18.99,6
23:59,706301742.0,-2708.003149999998,-12.99,1
23:59,706301742.0,-2723.9931499999984,-15.99,1
23:59,706301742.0,-2731.983149999998,-7.99,1
23:59,706301742.0,-2750.973149999998,-18.99,6
23:59,706301742.0,-2850.973149999998,-100.0,6
23:59,621181115.0,-3.0442495707711608,-18.99,6
23:59,621181115.0,-19.03424957077116,-15.99,1
23:59,621181115.0,-27.02424957077116,-7.99,7
23:59,183186021.0,-2144.792549999999,-15.99,1
23:59,183186021.0,-2163.782549999999,-18.99,6
23:59,519644021.0,3585.944235049471,-15.99,1
23:59,519644021.0,3566.954235049471,-18.99,6
23:59,519644021.0,3466.954235049471,-100.0,6
23:59,659008214.0,-3159.600102290424,-15.99,1
23:59,659008214.0,-3167.5901022904236,-7.99,1
23:59,471897866.0,8921.96068324328,-7.0,1
23:59,471897866.0,8913.97068324328,-7.99,7
23:59,471897866.0,8897.98068324328,-15.99,1
23:59,471897866.0,8878.99068324328,-18.99,6
23:59,625281433.0,-363.25320737075674,-15.99,1
23:59,625281433.0,-371.2432073707567,-7.99,1
23:59,625281433.0,-390.2332073707568,-18.99,6
23:59,625281433.0,-405.2232073707568,-14.99,1
23:59,625281433.0,-420.2132073707568,-14.99,1
23:59,625281433.0,-520.2132073707568,-100.0,6
23:59,605116158.0,2956.9172,-15.99,1
23:59,605116158.0,2948.9272,-7.99,7
23:59,605116158.0,2942.9372000000003,-5.99,1
23:59,605116158.0,2935.9372000000003,-7.0,1
23:59,605116158.0,2920.9472000000005,-14.99,1
23:59,605116158.0,2913.9472000000005,-7.0,1
23:59,605116158.0,2894.9572000000007,-18.99,6
23:59,467207141.0,1768.5930670482635,-7.99,1
23:59,467207141.0,1761.5930670482635,-7.0,1
23:59,467207141.0,1748.6030670482637,-12.99,1
23:59,467207141.0,1729.6130670482637,-18.99,6
23:59,492850697.0,-558.6639133341364,-5.99,1
23:59,492850697.0,-566.6539133341364,-7.99,7
23:59,492850697.0,-666.6539133341364,-100.0,6
23:59,272538745.0,15312.129900000024,-15.99,1
23:59,272538745.0,15293.139900000026,-18.99,6
23:59,272538745.0,15193.139900000026,-100.0,6
23:59,987163717.0,6929.008480000006,-100.0,6
23:59,987163717.0,6913.018480000006,-15.99,1
23:59,366477356.0,591.7184,-15.99,1
23:59,366477356.0,583.7284,-7.99,1
23:59,366477356.0,564.7384,-18.99,6
23:59,943829984.0,496.0165091134572,-18.99,6
23:59,943829984.0,396.0165091134572,-100.0,6
23:59,943829984.0,380.0265091134572,-15.99,1
23:59,873693307.0,10222.646071054014,-18.99,6
23:59,287230540.0,1556.1785989370007,-7.99,1
23:59,287230540.0,1540.1885989370007,-15.99,1
23:59,287230540.0,1521.1985989370007,-18.99,6
23:59,424927189.0,-23.55851725589468,-15.99,1
23:59,424927189.0,-31.54851725589468,-7.99,7
23:59,424927189.0,-37.53851725589468,-5.99,1
23:59,424927189.0,-44.53851725589468,-7.0,1
23:59,824916823.0,9277.94244944959,-12.99,1
23:59,824916823.0,9270.94244944959,-7.0,1
23:59,824916823.0,9263.94244944959,-7.0,1
23:59,824916823.0,9256.94244944959,-7.0,1
23:59,824916823.0,9248.95244944959,-7.99,1
23:59,824916823.0,9229.962449449593,-18.99,6
23:59,766812921.0,225.53689999999935,-15.99,1
23:59,766812921.0,206.54689999999937,-18.99,6
23:59,766812921.0,199.54689999999937,-7.0,1
23:59,766812921.0,186.55689999999936,-12.99,1
23:59,766812921.0,180.56689999999935,-5.99,1
23:59,766812921.0,174.57689999999934,-5.99,1
23:59,310171581.0,-2058.90870434092,-15.99,1
23:59,310171581.0,-2077.8987043409197,-18.99,6
23:59,310171581.0,-2083.8887043409195,-5.99,1
23:59,310171581.0,-2096.8787043409193,-12.99,1
23:59,308897841.0,1112.3766999999991,-15.99,1
23:59,565175333.0,-3524.986022729827,-12.99,1
23:59,565175333.0,-3543.9760227298266,-18.99,6
23:59,565175333.0,-3559.9660227298264,-15.99,1
23:59,417850087.0,17594.60436967904,-15.99,1
23:59,417850087.0,17575.61436967904,-18.99,6
23:59,417850087.0,17568.61436967904,-7.0,1
23:59,417850087.0,17555.624369679037,-12.99,1
23:59,417850087.0,17549.634369679035,-5.99,1
23:59,417850087.0,17542.634369679035,-7.0,1
23:59,559995067.0,4069.449160897453,-5.99,1
23:59,559995067.0,4063.459160897454,-5.99,1
23:59,559995067.0,4057.4691608974535,-5.99,1
23:59,786879739.0,-2135.433294120557,-15.99,1
23:59,786879739.0,-2143.423294120557,-7.99,1
23:59,786879739.0,-2162.4132941205567,-18.99,6
23:59,165045150.0,-1946.456438597144,-7.99,7
23:59,165045150.0,-1959.446438597144,-12.99,1
23:59,108563213.0,23732.73071056487,-12.99,1
23:59,108563213.0,23717.740710564867,-14.99,1
23:59,108563213.0,23711.750710564866,-5.99,1
23:59,108563213.0,23704.750710564866,-7.0,1
23:59,108563213.0,23696.760710564864,-7.99,7
23:59,108563213.0,23680.770710564862,-15.99,1
23:59,108563213.0,23661.78071056486,-18.99,6
23:59,510101371.0,13497.11132114884,-7.99,1
23:59,510101371.0,13481.12132114884,-15.99,1
23:59,683078800.0,2080.7156413499592,-15.99,1
23:59,683078800.0,2072.7256413499595,-7.99,1
23:59,685959099.0,2720.4568660992413,-15.99,1
23:59,685959099.0,2712.4668660992415,-7.99,1
23:59,685959099.0,2693.4768660992418,-18.99,6
23:59,685959099.0,2687.486866099242,-5.99,1
23:59,685959099.0,2681.496866099242,-5.99,1
23:59,145387690.0,6554.1334204604245,-15.99,1
23:59,145387690.0,6454.1334204604245,-100.0,6
23:59,494977194.0,2170.062520597577,-7.99,1
23:59,494977194.0,2162.0725205975773,-7.99,7
23:59,494977194.0,2156.0825205975775,-5.99,1
23:59,494977194.0,2143.0925205975777,-12.99,1
23:59,494977194.0,2128.102520597578,-14.99,1
23:59,494977194.0,2109.112520597578,-18.99,6
23:59,605711527.0,93.0825138325836,-18.99,6
23:59,605711527.0,77.09251383258359,-15.99,1
23:59,605711527.0,69.1025138325836,-7.99,1
23:59,605711527.0,63.112513832583595,-5.99,1
23:59,605711527.0,56.112513832583595,-7.0,1
23:59,605711527.0,49.112513832583595,-7.0,1
23:59,848118081.0,-2195.982798002097,-15.99,1
23:59,848118081.0,-2203.9727980020966,-7.99,7
23:59,848118081.0,-2222.9627980020964,-18.99,6
23:59,848118081.0,-2322.9627980020964,-100.0,6
23:59,836655156.0,-2799.8764552191565,-18.99,6
23:59,836655156.0,-2812.8664552191563,-12.99,1
23:59,836655156.0,-2827.856455219156,-14.99,1
23:59,836655156.0,-2835.846455219156,-7.99,7
23:59,836655156.0,-2935.846455219156,-100.0,6
23:59,625658193.0,-1605.1300802437831,-7.99,1
23:59,625658193.0,-1624.1200802437831,-18.99,6
23:59,625658193.0,-1637.1100802437832,-12.99,1
23:59,625658193.0,-1652.1000802437832,-14.99,1
23:59,625658193.0,-1659.1000802437832,-7.0,1
23:59,625658193.0,-1666.1000802437832,-7.0,1
23:59,644751433.0,-1301.023158465538,-15.99,1
23:59,644751433.0,-1309.013158465538,-7.99,7
23:59,644751433.0,-1328.003158465538,-18.99,6
23:59,979122276.0,348.4809622943287,-18.99,6
23:59,979122276.0,341.4809622943287,-7.0,1
23:59,979122276.0,328.4909622943287,-12.99,1
23:59,979122276.0,312.5009622943287,-15.99,1
23:59,979122276.0,304.5109622943287,-7.99,7
23:59,797184978.0,-968.3299134269804,-15.99,1
23:59,797184978.0,-981.3199134269804,-12.99,1
23:59,797184978.0,-996.3099134269804,-14.99,1
23:59,797184978.0,-1002.2999134269804,-5.99,1
23:59,797184978.0,-1017.2899134269804,-14.99,1
23:59,462962606.0,-1101.920950000001,-15.99,1
23:59,462962606.0,-1108.920950000001,-7.0,1
23:59,462962606.0,-1114.910950000001,-5.99,1
23:59,462962606.0,-1127.900950000001,-12.99,1
23:59,462962606.0,-1134.900950000001,-7.0,1
23:59,462962606.0,-1153.890950000001,-18.99,6
23:59,462962606.0,-1253.890950000001,-100.0,6
23:59,766941757.0,10266.43165420135,-15.99,1
23:59,766941757.0,10247.44165420135,-18.99,6
23:59,766941757.0,10147.44165420135,-100.0,6
23:59,709142813.0,1185.1897999999994,-15.99,1
23:59,709142813.0,1177.1997999999994,-7.99,7
23:59,709142813.0,1164.2097999999994,-12.99,1
23:59,709142813.0,1151.2197999999994,-12.99,1
23:59,709142813.0,1136.2297999999994,-14.99,1
23:59,709632525.0,-1478.0773500000007,-7.0,1
23:59,709632525.0,-1494.0673500000007,-15.99,1
23:59,709632525.0,-1513.0573500000007,-18.99,6
23:59,489964679.0,22339.159598831306,-15.99,1
23:59,489964679.0,22320.1695988313,-18.99,6
23:59,525524239.0,-209.7976497888064,-15.99,1
23:59,525524239.0,-228.7876497888064,-18.99,6
23:59,333054026.0,58.25989402318999,-15.99,1
23:59,333054026.0,50.26989402318999,-7.99,1
23:59,333054026.0,31.279894023189993,-18.99,6
23:59,548638376.0,-303.57481324453346,-7.99,1
23:59,548638376.0,-322.56481324453347,-18.99,6
23:59,601627384.0,5114.07379360435,-7.99,1
23:59,601627384.0,5099.08379360435,-14.99,1
23:59,601627384.0,5086.09379360435,-12.99,1
23:59,601627384.0,5071.10379360435,-14.99,1
23:59,601627384.0,5058.113793604351,-12.99,1
23:59,448279144.0,1255.2023499999991,-18.99,6
23:59,448279144.0,1239.212349999999,-15.99,1
23:59,448279144.0,1231.222349999999,-7.99,7
23:59,448279144.0,1216.232349999999,-14.99,1
23:59,448279144.0,1203.2423499999993,-12.99,1
23:59,687135796.0,27146.89185797793,-7.99,1
23:59,687135796.0,27139.89185797793,-7.0,1
23:59,191161970.0,-3427.698999999997,-18.99,6
23:59,191161970.0,-3435.6889999999967,-7.99,7
23:59,191161970.0,-3443.6789999999964,-7.99,1
23:59,191161970.0,-3456.668999999996,-12.99,1
23:59,703478110.0,4907.63595432897,-15.99,1
23:59,596463612.0,-2253.032604725139,-7.99,1
23:59,596463612.0,-2269.022604725139,-15.99,1
23:59,596463612.0,-2288.0126047251388,-18.99,6
23:59,280130290.0,137.6198999999996,-15.99,1
23:59,280130290.0,129.6298999999996,-7.99,7
23:59,280130290.0,110.6398999999996,-18.99,6
23:59,654329190.0,245.06440094851928,-15.99,1
23:59,492058070.0,-597.9940312595293,-18.99,6
23:59,492058070.0,-613.9840312595293,-15.99,1
23:59,433917275.0,8667.58959930583,-18.99,6
23:59,433917275.0,8652.59959930583,-14.99,1
23:59,433917275.0,8636.60959930583,-15.99,1
23:59,682194230.0,-2098.3983500000004,-18.99,6
23:59,682194230.0,-2106.38835,-7.99,1
23:59,682194230.0,-2119.37835,-12.99,1
23:59,682194230.0,-2134.3683499999997,-14.99,1
23:59,682194230.0,-2147.3583499999995,-12.99,1
23:59,920031185.0,-440.91787051629206,-18.99,6
23:59,920031185.0,-447.91787051629206,-7.0,1
23:59,920031185.0,-454.91787051629206,-7.0,1
23:59,920031185.0,-470.90787051629206,-15.99,1
23:59,406862520.0,852.1697265374105,-15.99,1
23:59,406862520.0,844.1797265374105,-7.99,1
23:59,406862520.0,825.1897265374105,-18.99,6
23:59,406862520.0,818.1897265374105,-7.0,1
23:59,406862520.0,812.1997265374105,-5.99,1
23:59,406862520.0,797.2097265374105,-14.99,1
23:59,203466392.0,3241.6169218971786,-7.99,1
23:59,203466392.0,3228.626921897179,-12.99,1
23:59,203466392.0,3213.636921897179,-14.99,1
23:59,203466392.0,3206.636921897179,-7.0,1
23:59,586315521.0,12495.841803488092,-7.99,1
23:59,586315521.0,12476.851803488093,-18.99,6
23:59,403765849.0,-2254.285499999999,-7.0,1
23:59,403765849.0,-2267.275499999999,-12.99,1
23:59,403765849.0,-2282.2654999999986,-14.99,1
23:59,403765849.0,-2297.2554999999984,-14.99,1
23:59,403765849.0,-2313.245499999998,-15.99,1
23:59,403765849.0,-2321.235499999998,-7.99,1
23:59,403765849.0,-2340.2254999999977,-18.99,6
23:59,121858569.0,1715.5711500000025,-100.0,6
23:59,524425303.0,88.48549999999888,-18.99,6
23:59,524425303.0,72.49549999999888,-15.99,1
23:59,524425303.0,64.50549999999889,-7.99,7
23:59,524425303.0,-35.49450000000111,-100.0,6
23:59,653667523.0,6166.181551326438,-15.99,1
23:59,653667523.0,6158.1915513264385,-7.99,1
23:59,999752672.0,1421.4309435333346,-15.99,1
23:59,194745206.0,885.3703720912431,-15.99,1
23:59,194745206.0,866.3803720912431,-18.99,6
23:59,475277431.0,267.55013694361946,-5.99,1
23:59,475277431.0,261.56013694361945,-5.99,1
23:59,475277431.0,246.57013694361945,-14.99,1
23:59,340295966.0,-1369.6544500000002,-15.99,1
23:59,340295966.0,-1375.6444500000002,-5.99,1
23:59,340295966.0,-1475.6444500000002,-100.0,6
23:59,340295966.0,-1494.6344500000002,-18.99,6
23:59,930271460.0,417.1742475357762,-18.99,6
23:59,930271460.0,410.1742475357762,-7.0,1
23:59,930271460.0,403.1742475357762,-7.0,1
23:59,572333122.0,-3379.295049999997,-15.99,1
23:59,572333122.0,-3385.2850499999968,-5.99,1
23:59,572333122.0,-3392.2850499999968,-7.0,1
23:59,572333122.0,-3407.275049999997,-14.99,1
23:59,572333122.0,-3414.275049999997,-7.0,1
23:59,572333122.0,-3433.2650499999963,-18.99,6
23:59,899692478.0,-1517.7266935240073,-15.99,1
23:59,899692478.0,-1525.7166935240073,-7.99,1
23:59,899692478.0,-1531.7066935240073,-5.99,1
23:59,899692478.0,-1550.6966935240073,-18.99,6
23:59,899692478.0,-1650.6966935240073,-100.0,6
23:59,126929801.0,2566.5277750358764,-15.99,1
23:59,126929801.0,2558.5377750358766,-7.99,1
23:59,126929801.0,2458.5377750358766,-100.0,6
23:59,126929801.0,2439.547775035877,-18.99,6
23:59,734161378.0,-2546.865169434213,-7.99,1
23:59,734161378.0,-2559.8551694342127,-12.99,1
23:59,734161378.0,-2566.8551694342127,-7.0,1
23:59,734161378.0,-2573.8551694342127,-7.0,1
23:59,734161378.0,-2592.8451694342125,-18.99,6
23:59,361955473.0,-188.9258047559156,-18.99,6
23:59,361955473.0,-195.9258047559156,-7.0,1
23:59,361955473.0,-210.9158047559156,-14.99,1
23:59,361955473.0,-225.9058047559156,-14.99,1
23:59,361955473.0,-232.9058047559156,-7.0,1
23:59,297823329.0,1157.044399999999,-7.99,1
23:59,297823329.0,1141.0543999999993,-15.99,1
23:59,297823329.0,1122.0643999999993,-18.99,6
23:59,857997794.0,1304.0326651508872,-15.99,1
23:59,857997794.0,1296.0426651508872,-7.99,7
23:59,857997794.0,1277.0526651508872,-18.99,6
23:59,738958551.0,9649.18260211382,-7.99,7
23:59,738958551.0,9634.19260211382,-14.99,1
23:59,738958551.0,9627.19260211382,-7.0,1
23:59,738958551.0,9608.20260211382,-18.99,6
23:59,738958551.0,9508.20260211382,-100.0,6
23:59,519933553.0,-175.61399584927153,-7.99,7
23:59,519933553.0,-191.6039958492715,-15.99,1
23:59,519933553.0,-210.59399584927155,-18.99,6
23:59,519933553.0,-310.59399584927155,-100.0,6
23:59,519933553.0,-316.58399584927156,-5.99,1
23:59,519933553.0,-323.58399584927156,-7.0,1
23:59,519933553.0,-330.58399584927156,-7.0,1
23:59,519933553.0,-336.57399584927157,-5.99,1
23:59,613729471.0,9331.527285846523,-15.99,1
23:59,613729471.0,9231.527285846523,-100.0,6
23:59,420109571.0,797.0867689636077,-15.99,1
23:59,420109571.0,789.0967689636077,-7.99,7
23:59,420109571.0,783.1067689636077,-5.99,1
23:59,420109571.0,768.1167689636077,-14.99,1
23:59,420109571.0,755.1267689636077,-12.99,1
23:59,420109571.0,740.1367689636077,-14.99,1
23:59,420109571.0,721.1467689636077,-18.99,6
23:59,138351025.0,-494.41790000000026,-12.99,1
23:59,138351025.0,-510.40790000000027,-15.99,1
23:59,138351025.0,-529.3979000000003,-18.99,6
23:59,140893085.0,6085.148056365462,-18.99,6
23:59,445240363.0,-851.0719559632736,-15.99,1
23:59,445240363.0,-870.0619559632736,-18.99,6
23:59,445240363.0,-970.0619559632736,-100.0,6
23:59,445240363.0,-985.0519559632736,-14.99,1
23:59,445240363.0,-992.0519559632736,-7.0,1
23:59,445240363.0,-998.0419559632736,-5.99,1
23:59,388862238.0,1380.619652623988,-18.99,6
23:59,388862238.0,1372.629652623988,-7.99,1
23:59,388862238.0,1364.639652623988,-7.99,7
23:59,388862238.0,1351.649652623988,-12.99,1
23:59,982286721.0,-3253.8280240177305,-7.99,1
23:59,982286721.0,-3266.8180240177303,-12.99,1
23:59,741903302.0,3316.315458740786,-15.99,1
23:59,741903302.0,3297.3254587407864,-18.99,6
23:59,741903302.0,3290.3254587407864,-7.0,1
23:59,741903302.0,3277.335458740786,-12.99,1
23:59,280268430.0,5046.394239937473,-18.99,6
23:59,348460748.0,411.9253999999991,-18.99,6
23:59,348460748.0,395.9353999999991,-15.99,1
23:59,348460748.0,387.9453999999991,-7.99,1
23:59,792845450.0,1071.9331500000012,-7.99,7
23:59,792845450.0,1056.9431500000012,-14.99,1
23:59,792845450.0,956.9431500000012,-100.0,6
23:59,792845450.0,937.9531500000012,-18.99,6
23:59,130522384.0,-366.7938156208604,-18.99,6
23:59,130522384.0,-379.7838156208604,-12.99,1
23:59,130522384.0,-386.7838156208604,-7.0,1
23:59,130522384.0,-393.7838156208604,-7.0,1
23:59,130522384.0,-408.7738156208604,-14.99,1
23:59,130522384.0,-424.7638156208605,-15.99,1
23:59,611143859.0,4822.370550000011,-18.99,6
23:59,611143859.0,4806.380550000011,-15.99,1
23:59,611143859.0,4798.390550000011,-7.99,1
23:59,496674181.0,-1205.5925223307224,-15.99,1
23:59,496674181.0,-1218.5825223307224,-12.99,1
23:59,496674181.0,-1237.5725223307224,-18.99,6
23:59,151278285.0,-590.5046500000003,-15.99,1
23:59,151278285.0,-609.4946500000003,-18.99,6
23:59,760753808.0,-227.6831000000004,-18.99,6
23:59,616924659.0,212.6995798230853,-7.99,1
23:59,616924659.0,204.70957982308528,-7.99,7
23:59,162162212.0,-217.64760667269115,-15.99,1
23:59,162162212.0,-225.63760667269116,-7.99,7
23:59,162162212.0,-244.62760667269117,-18.99,6
23:59,162162212.0,-257.6176066726912,-12.99,1
23:59,162162212.0,-264.6176066726912,-7.0,1
23:59,162162212.0,-277.6076066726912,-12.99,1
23:59,162162212.0,-284.6076066726912,-7.0,1
23:59,119993184.0,-1951.809402910863,-18.99,6
23:59,119993184.0,-1959.799402910863,-7.99,1
23:59,119993184.0,-1965.7894029108627,-5.99,1
23:59,119993184.0,-1978.7794029108627,-12.99,1
23:59,119993184.0,-1991.7694029108627,-12.99,1
23:59,119993184.0,-1998.7694029108627,-7.0,1
23:59,101531259.0,413.8067999999996,-7.99,1
23:59,101531259.0,313.8067999999996,-100.0,6
23:59,969697937.0,-4352.705265670551,-7.0,1
23:59,969697937.0,-4365.695265670551,-12.99,1
23:59,969697937.0,-4380.6852656705505,-14.99,1
23:59,969697937.0,-4386.67526567055,-5.99,1
23:59,969697937.0,-4402.66526567055,-15.99,1
23:59,969697937.0,-4410.65526567055,-7.99,1
23:59,969697937.0,-4510.65526567055,-100.0,6
23:59,969697937.0,-4529.64526567055,-18.99,6
23:59,987656636.0,6511.073942708183,-15.99,1
23:59,987656636.0,6503.083942708183,-7.99,1
23:59,987656636.0,6484.093942708183,-18.99,6
23:59,987656636.0,6477.093942708183,-7.0,1
23:59,987656636.0,6464.103942708183,-12.99,1
23:59,987656636.0,6457.103942708183,-7.0,1
23:59,532478725.0,5281.190229165134,-7.99,1
23:59,532478725.0,5273.200229165134,-7.99,7
23:59,537487133.0,-506.3616500000005,-18.99,6
23:59,537487133.0,-522.3516500000005,-15.99,1
23:59,537487133.0,-530.3416500000005,-7.99,1
23:59,537487133.0,-630.3416500000005,-100.0,6
23:59,348525881.0,-325.1233754050637,-18.99,6
23:59,348525881.0,-332.1233754050637,-7.0,1
23:59,348525881.0,-340.1133754050637,-7.99,1
23:59,527842638.0,2021.2087426329836,-15.99,1
23:59,527842638.0,2002.2187426329835,-18.99,6
23:59,527842638.0,1902.2187426329835,-100.0,6
23:59,705848712.0,26241.259842274612,-15.99,1
23:59,705848712.0,26228.26984227461,-12.99,1
23:59,705848712.0,26215.27984227461,-12.99,1
23:59,705848712.0,26209.289842274608,-5.99,1
23:59,705848712.0,26203.29984227461,-5.99,1
23:59,705848712.0,26184.309842274604,-18.99,6
23:59,705848712.0,26084.309842274604,-100.0,6
23:59,191992682.0,-2511.0864602920637,-15.99,1
23:59,191992682.0,-2526.0764602920635,-14.99,1
23:59,191992682.0,-2533.0764602920635,-7.0,1
23:59,191992682.0,-2539.0664602920633,-5.99,1
23:59,191992682.0,-2546.0664602920633,-7.0,1
23:59,191992682.0,-2565.056460292063,-18.99,6
23:59,478986718.0,-815.5326000000005,-7.99,7
23:59,478986718.0,-834.5226000000005,-18.99,6
23:59,478986718.0,-934.5226000000004,-100.0,6
23:59,838415080.0,-3252.791499999999,-18.99,6
23:59,838415080.0,-3352.791499999999,-100.0,6
23:59,919185264.0,5393.404722887973,-18.99,6
23:59,919185264.0,5386.404722887973,-7.0,1
23:59,919185264.0,5379.404722887973,-7.0,1
23:59,919185264.0,5363.414722887973,-15.99,1
23:59,919185264.0,5355.424722887973,-7.99,7
23:59,108931112.0,14265.043154795789,-15.99,1
23:59,108931112.0,14257.053154795787,-7.99,7
23:59,108931112.0,14244.063154795787,-12.99,1
23:59,108931112.0,14237.063154795787,-7.0,1
23:59,108931112.0,14231.073154795788,-5.99,1
23:59,213096759.0,-1292.7141082144396,-7.99,7
23:59,213096759.0,-1311.7041082144397,-18.99,6
23:59,480557476.0,11517.69020286968,-7.99,1
23:59,480557476.0,11417.69020286968,-100.0,6
23:59,480557476.0,11398.70020286968,-18.99,6
23:59,444428189.0,1369.9693500000028,-15.99,1
23:59,444428189.0,1362.9693500000028,-7.0,1
23:59,444428189.0,1347.9793500000028,-14.99,1
23:59,444428189.0,1332.9893500000028,-14.99,1
23:59,444428189.0,1313.9993500000028,-18.99,6
23:59,282837512.0,14148.084210939209,-7.99,1
23:59,282837512.0,14140.094210939207,-7.99,7
23:59,282837512.0,14121.10421093921,-18.99,6
23:59,282837512.0,14114.10421093921,-7.0,1
23:59,282837512.0,14014.10421093921,-100.0,6
23:59,550644516.0,-24.39085000000136,-15.99,1
23:59,550644516.0,-32.38085000000136,-7.99,7
23:59,550644516.0,-51.370850000001354,-18.99,6
23:59,546296727.0,143.36452730261857,-7.99,7
23:59,546296727.0,135.37452730261856,-7.99,1
23:59,546296727.0,116.38452730261857,-18.99,6
23:59,546296727.0,16.384527302618565,-100.0,6
23:59,630691258.0,401.6265448748414,-15.99,1
23:59,630691258.0,382.6365448748413,-18.99,6
23:59,630691258.0,367.6465448748413,-14.99,1
23:59,630691258.0,361.6565448748413,-5.99,1
23:59,572384506.0,11357.517021642769,-15.99,1
23:59,572384506.0,11349.527021642769,-7.99,7
23:59,572384506.0,11330.537021642767,-18.99,6
23:59,572384506.0,11317.547021642768,-12.99,1
23:59,572384506.0,11304.557021642768,-12.99,1
23:59,572384506.0,11297.557021642768,-7.0,1
23:59,572384506.0,11290.557021642768,-7.0,1
23:59,737547541.0,800.7345995677742,-18.99,6
23:59,643610517.0,-2874.176190729657,-15.99,1
23:59,386729293.0,30511.611561990623,-15.99,1
23:59,386729293.0,30411.611561990623,-100.0,6
23:59,696333897.0,1092.082599999999,-5.99,1
23:59,696333897.0,992.082599999999,-100.0,6
23:59,696333897.0,984.092599999999,-7.99,1
23:59,696333897.0,968.102599999999,-15.99,1
23:59,696333897.0,949.112599999999,-18.99,6
23:59,331450202.0,7710.477744103457,-7.99,1
23:59,331450202.0,7704.487744103457,-5.99,1
23:59,331450202.0,7685.497744103457,-18.99,6
23:59,936917570.0,-2531.7599999999984,-12.99,1
23:59,936917570.0,-2544.749999999998,-12.99,1
23:59,936917570.0,-2563.739999999998,-18.99,6
23:59,936917570.0,-2663.739999999998,-100.0,6
23:59,936917570.0,-2679.7299999999977,-15.99,1
23:59,936917570.0,-2687.7199999999975,-7.99,1
23:59,762896656.0,305.2549981518587,-18.99,6
23:59,762896656.0,289.26499815185866,-15.99,1
23:59,628470485.0,1429.0550299001231,-18.99,6
23:59,628470485.0,1421.0650299001231,-7.99,1
23:59,628470485.0,1321.0650299001231,-100.0,6
23:59,628470485.0,1308.0750299001231,-12.99,1
23:59,628470485.0,1301.0750299001231,-7.0,1
23:59,628470485.0,1288.0850299001231,-12.99,1
23:59,628470485.0,1273.095029900123,-14.99,1
23:59,624563756.0,74.12082878355638,-18.99,6
23:59,624563756.0,67.12082878355638,-7.0,1
23:59,624563756.0,61.130828783556375,-5.99,1
23:59,624563756.0,48.14082878355637,-12.99,1
23:59,624563756.0,35.15082878355637,-12.99,1
23:59,624563756.0,27.16082878355637,-7.99,1
23:59,624563756.0,19.170828783556367,-7.99,7
23:59,624563756.0,-80.82917121644363,-100.0,6
23:59,121113546.0,344.6851560698697,-7.99,1
23:59,121113546.0,325.6951560698697,-18.99,6
23:59,121113546.0,319.7051560698697,-5.99,1
23:59,117308635.0,1821.9829033866536,-7.99,1
23:59,117308635.0,1802.9929033866536,-18.99,6
23:59,117308635.0,1790.0029033866535,-12.99,1
23:59,117308635.0,1784.0129033866535,-5.99,1
23:59,117308635.0,1771.0229033866535,-12.99,1
23:59,117308635.0,1671.0229033866535,-100.0,6
23:59,730002588.0,14076.919384652558,-15.99,1
23:59,730002588.0,14063.929384652558,-12.99,1
23:59,730002588.0,14048.939384652558,-14.99,1
23:59,730002588.0,14041.939384652558,-7.0,1
23:59,730002588.0,14022.949384652558,-18.99,6
23:59,585596026.0,242.54523881125328,-7.99,1
23:59,585596026.0,226.55523881125328,-15.99,1
23:59,585596026.0,207.56523881125327,-18.99,6
23:59,585596026.0,201.57523881125329,-5.99,1
23:59,175452235.0,1688.2772500000003,-18.99,6
23:59,175452235.0,1673.2872500000003,-14.99,1
23:59,175452235.0,1658.2972500000003,-14.99,1
23:59,175452235.0,1652.3072500000003,-5.99,1
23:59,175452235.0,1637.3172500000005,-14.99,1
23:59,809499628.0,16986.194900003502,-18.99,6
23:59,809499628.0,16970.2049000035,-15.99,1
23:59,809499628.0,16955.2149000035,-14.99,1
23:59,856461967.0,25.028353529492513,-5.99,1
23:59,856461967.0,12.038353529492513,-12.99,1
23:59,856461967.0,5.038353529492513,-7.0,1
23:59,856461967.0,-9.951646470507487,-14.99,1
23:59,856461967.0,-28.94164647050749,-18.99,6
23:59,856461967.0,-44.93164647050749,-15.99,1
23:59,856461967.0,-52.92164647050749,-7.99,7
23:59,555804115.0,-1215.4285475587028,-12.99,1
23:59,555804115.0,-1228.4185475587028,-12.99,1
23:59,555804115.0,-1241.4085475587028,-12.99,1
23:59,555804115.0,-1256.3985475587028,-14.99,1
23:59,555804115.0,-1275.3885475587028,-18.99,6
23:59,678851253.0,3907.343974492226,-100.0,6
23:59,678851253.0,3891.3539744922264,-15.99,1
23:59,678851253.0,3883.3639744922266,-7.99,7
23:59,534908754.0,-752.5295000000002,-18.99,6
23:59,534908754.0,-768.5195000000002,-15.99,1
23:59,403902116.0,720.6937499999992,-14.99,1
23:59,403902116.0,707.7037499999992,-12.99,1
23:59,403902116.0,701.7137499999992,-5.99,1
23:59,403902116.0,693.7237499999992,-7.99,1
23:59,403902116.0,674.7337499999992,-18.99,6
23:59,923322792.0,121.77566824636244,-15.99,1
23:59,923322792.0,113.78566824636243,-7.99,7
23:59,923322792.0,94.79566824636244,-18.99,6
23:59,923322792.0,87.79566824636244,-7.0,1
23:59,923322792.0,-12.20433175363756,-100.0,6
23:59,767447966.0,5083.03932551211,-14.99,1
23:59,767447966.0,5068.04932551211,-14.99,1
23:59,767447966.0,5055.05932551211,-12.99,1
23:59,767447966.0,5042.0693255121105,-12.99,1
23:59,767447966.0,5026.079325512111,-15.99,1
23:59,767447966.0,5018.089325512111,-7.99,1
23:59,767447966.0,4999.099325512111,-18.99,6
23:59,767447966.0,4899.099325512111,-100.0,6
23:59,506618547.0,17810.423569052302,-7.99,1
23:59,506618547.0,17802.4335690523,-7.99,7
23:59,506618547.0,17783.4435690523,-18.99,6
23:59,506618547.0,17683.4435690523,-100.0,6
23:59,197050303.0,379.1594325634951,-7.0,1
23:59,197050303.0,366.1694325634951,-12.99,1
23:59,197050303.0,347.1794325634951,-18.99,6
23:59,197050303.0,331.1894325634951,-15.99,1
23:59,316793091.0,1153.024310054951,-12.99,1
23:59,316793091.0,1146.024310054951,-7.0,1
23:59,316793091.0,1140.034310054951,-5.99,1
23:59,316793091.0,1133.034310054951,-7.0,1
23:59,316793091.0,1114.044310054951,-18.99,6
23:59,316793091.0,1098.054310054951,-15.99,1
23:59,316793091.0,1090.064310054951,-7.99,7
23:59,860360312.0,345.27240888268034,-15.99,1
23:59,860360312.0,326.28240888268033,-18.99,6
23:59,329840194.0,2066.096730143148,-14.99,1
23:59,329840194.0,2059.096730143148,-7.0,1
23:59,329840194.0,2052.096730143148,-7.0,1
23:59,329840194.0,2031.116730143148,-7.99,1
23:59,329840194.0,2012.126730143148,-18.99,6
23:59,511179916.0,7056.167710253574,-15.99,1
23:59,511179916.0,7048.177710253574,-7.99,1
23:59,511179916.0,7035.187710253575,-12.99,1
23:59,511179916.0,7020.197710253575,-14.99,1
23:59,511179916.0,7005.207710253575,-14.99,1
23:59,511179916.0,6992.217710253575,-12.99,1
23:59,308068836.0,499.3215225681922,-5.99,1
23:59,308068836.0,483.3315225681922,-15.99,1
23:59,308068836.0,475.3415225681922,-7.99,1
23:59,259015404.0,2217.4791843026605,-15.99,1
23:59,259015404.0,2209.4891843026608,-7.99,7
23:59,259015404.0,2190.499184302661,-18.99,6
23:59,627936697.0,1287.65055,-18.99,6
23:59,627936697.0,1281.66055,-5.99,1
23:59,627936697.0,1265.67055,-15.99,1
23:59,815993333.0,1347.7936390614072,-15.99,1
23:59,815993333.0,1328.8036390614072,-18.99,6
23:59,815993333.0,1322.8136390614072,-5.99,1
23:59,815993333.0,1307.8236390614072,-14.99,1
23:59,898104045.0,-1324.123050000002,-18.99,6
23:59,898104045.0,-1340.113050000002,-15.99,1
23:59,898104045.0,-1348.103050000002,-7.99,7
23:59,898104045.0,-1361.093050000002,-12.99,1
23:59,898104045.0,-1376.083050000002,-14.99,1
23:59,128033695.0,2284.1946293297715,-5.99,1
23:59,128033695.0,2277.1946293297715,-7.0,1
23:59,128033695.0,2270.1946293297715,-7.0,1
23:59,128033695.0,2263.1946293297715,-7.0,1
23:59,128033695.0,2244.2046293297717,-18.99,6
23:59,128033695.0,2228.214629329772,-15.99,1
23:59,128033695.0,2220.224629329772,-7.99,1
23:59,835736339.0,2066.153240414559,-18.99,6
23:59,835736339.0,2053.1632404145594,-12.99,1
23:59,835736339.0,2047.1732404145591,-5.99,1
23:59,835736339.0,2032.1832404145591,-14.99,1
23:59,835736339.0,2025.1832404145591,-7.0,1
23:59,835736339.0,2017.193240414559,-7.99,1
23:59,449387287.0,218.21669383510152,-100.0,6
23:59,449387287.0,202.2266938351015,-15.99,1
23:59,449387287.0,194.2366938351015,-7.99,1
23:59,727417797.0,5549.544500000009,-7.99,1
23:59,727417797.0,5541.554500000009,-7.99,7
23:59,727417797.0,5526.5645000000095,-14.99,1
23:59,727417797.0,5511.57450000001,-14.99,1
23:59,727417797.0,5505.58450000001,-5.99,1
23:59,727417797.0,5486.59450000001,-18.99,6
23:59,815385232.0,10381.408758505717,-7.0,1
23:59,815385232.0,10368.418758505715,-12.99,1
23:59,815385232.0,10355.428758505715,-12.99,1
23:59,815385232.0,10349.438758505716,-5.99,1
23:59,815385232.0,10330.448758505716,-18.99,6
23:59,815385232.0,10314.458758505716,-15.99,1
23:59,595800644.0,-810.8459000000003,-18.99,6
23:59,595800644.0,-818.8359000000003,-7.99,1
23:59,595800644.0,-834.8259000000003,-15.99,1
23:59,454129843.0,1777.058450791789,-5.99,1
23:59,454129843.0,1758.068450791789,-18.99,6
23:59,454129843.0,1750.078450791789,-7.99,7
23:59,435984758.0,5671.0427245273695,-18.99,6
23:59,435984758.0,5658.05272452737,-12.99,1
23:59,435984758.0,5651.05272452737,-7.0,1
23:59,435984758.0,5643.06272452737,-7.99,1
23:59,500051919.0,174.18459665059046,-7.99,7
23:59,500051919.0,158.19459665059046,-15.99,1
23:59,500051919.0,139.20459665059045,-18.99,6
23:59,712474734.0,-1860.051831236004,-7.99,1
23:59,712474734.0,-1879.041831236004,-18.99,6
23:59,673818591.0,1349.1167753758411,-15.99,1
23:59,673818591.0,1334.1267753758411,-14.99,1
23:59,673818591.0,1319.1367753758411,-14.99,1
23:59,673818591.0,1313.1467753758411,-5.99,1
23:59,673818591.0,1298.156775375841,-14.99,1
23:59,626989363.0,1072.5349633173753,-18.99,6
23:59,626989363.0,1056.5449633173753,-15.99,1
23:59,626989363.0,1048.5549633173753,-7.99,7
23:59,626989363.0,1042.5649633173753,-5.99,1
23:59,626989363.0,1036.5749633173752,-5.99,1
23:59,570323670.0,4446.490396172035,-15.99,1
23:59,570323670.0,4438.500396172035,-7.99,1
23:59,570323670.0,4423.510396172035,-14.99,1
23:59,570323670.0,4417.520396172035,-5.99,1
23:59,570323670.0,4404.530396172036,-12.99,1
23:59,570323670.0,4397.530396172036,-7.0,1
23:59,570323670.0,4378.540396172036,-18.99,6
23:59,531186970.0,-457.27744375638053,-7.99,7
23:59,531186970.0,-464.27744375638053,-7.0,1
23:59,531186970.0,-471.27744375638053,-7.0,1
23:59,531186970.0,-486.26744375638054,-14.99,1
23:59,531186970.0,-505.25744375638055,-18.99,6
23:59,335698481.0,-2086.58299669494,-15.99,1
23:59,335698481.0,-2105.57299669494,-18.99,6
23:59,335698481.0,-2205.57299669494,-100.0,6
23:59,987390838.0,-2795.786241210379,-15.99,1
23:59,987390838.0,-2803.776241210379,-7.99,1
23:59,987390838.0,-2822.7662412103787,-18.99,6
23:59,987390838.0,-2835.7562412103784,-12.99,1
23:59,155317149.0,582.0148499999992,-5.99,1
23:59,155317149.0,576.0248499999992,-5.99,1
23:59,155317149.0,557.0348499999992,-18.99,6
23:59,155317149.0,549.0448499999992,-7.99,1
23:59,155317149.0,533.0548499999992,-15.99,1
23:59,713910252.0,180.7588257285413,-12.99,1
23:59,713910252.0,165.7688257285413,-14.99,1
23:59,713910252.0,149.77882572854128,-15.99,1
23:59,713910252.0,141.78882572854127,-7.99,1
23:59,567499591.0,-1229.0653000000004,-100.0,6
23:59,684284526.0,-2883.9013667457584,-15.99,1
23:59,684284526.0,-2891.891366745758,-7.99,1
23:59,684284526.0,-2904.881366745758,-12.99,1
23:59,684284526.0,-2919.8713667457578,-14.99,1
23:59,684284526.0,-2934.8613667457576,-14.99,1
23:59,684284526.0,-2941.8613667457576,-7.0,1
23:59,684284526.0,-2960.8513667457573,-18.99,6
23:59,684284526.0,-3060.8513667457573,-100.0,6
23:59,183546640.0,487.1606973477339,-18.99,6
23:59,183546640.0,472.1706973477339,-14.99,1
23:59,183546640.0,459.18069734773394,-12.99,1
23:59,183546640.0,443.19069734773393,-15.99,1
23:59,183546640.0,435.2006973477339,-7.99,7
23:59,424397946.0,3868.391783605399,-18.99,6
23:59,424397946.0,3853.401783605399,-14.99,1
23:59,868033067.0,-2135.1882864510826,-12.99,1
23:59,868033067.0,-2148.1782864510824,-12.99,1
23:59,868033067.0,-2163.168286451082,-14.99,1
23:59,868033067.0,-2179.158286451082,-15.99,1
23:59,868033067.0,-2187.1482864510817,-7.99,7
23:59,878989510.0,6144.091886141791,-15.99,1
23:59,878989510.0,6125.1018861417915,-18.99,6
23:59,878989510.0,6110.111886141792,-14.99,1
23:59,878989510.0,6097.121886141792,-12.99,1
23:59,878989510.0,6082.131886141792,-14.99,1
23:59,298000165.0,25228.72127679745,-15.99,1
23:59,298000165.0,25220.731276797447,-7.99,7
23:59,298000165.0,25201.74127679745,-18.99,6
23:59,298000165.0,25101.74127679745,-100.0,6
23:59,416060965.0,685.0259021964068,-15.99,1
23:59,416060965.0,677.0359021964068,-7.99,7
23:59,252701364.0,-3483.0586726779165,-7.0,1
23:59,252701364.0,-3490.0586726779165,-7.0,1
23:59,252701364.0,-3505.0486726779163,-14.99,1
23:59,252701364.0,-3521.038672677916,-15.99,1
23:59,252701364.0,-3540.028672677916,-18.99,6
23:59,448004226.0,2432.721760862855,-18.99,6
23:59,448004226.0,2416.731760862855,-15.99,1
23:59,448004226.0,2408.7417608628552,-7.99,1
23:59,448004226.0,2402.7517608628555,-5.99,1
23:59,158414827.0,-1600.5900000000015,-100.0,6
23:59,158414827.0,-1616.5800000000015,-15.99,1
23:59,158414827.0,-1635.5700000000015,-18.99,6
23:59,607629901.0,-3979.098319908144,-14.99,1
23:59,607629901.0,-3995.088319908144,-15.99,1
23:59,607629901.0,-4095.088319908144,-100.0,6
23:59,871866387.0,-49.446400000000715,-5.99,1
23:59,871866387.0,-65.43640000000072,-15.99,1
23:59,871866387.0,-73.42640000000071,-7.99,1
23:59,221356538.0,687.3817999999997,-15.99,1
23:59,221356538.0,579.3917999999996,-100.0,6
23:59,291128777.0,-2589.396440526369,-5.99,1
23:59,291128777.0,-2602.386440526369,-12.99,1
23:59,291128777.0,-2621.3764405263687,-18.99,6
23:59,899983008.0,-2815.0811499999977,-15.99,1
23:59,899983008.0,-2823.0711499999975,-7.99,1
23:59,899983008.0,-2842.0611499999973,-18.99,6
23:59,899983008.0,-2855.051149999997,-12.99,1
23:59,899983008.0,-2868.041149999997,-12.99,1
23:59,899983008.0,-2968.041149999997,-100.0,6
23:59,554771381.0,-1718.50365,-18.99,6
23:59,691843653.0,-2867.168399999995,-15.99,1
23:59,691843653.0,-2875.158399999995,-7.99,7
23:59,691843653.0,-2894.1483999999946,-18.99,6
23:59,691843653.0,-2907.1383999999944,-12.99,1
23:59,691843653.0,-2920.128399999994,-12.99,1
23:59,691843653.0,-2927.128399999994,-7.0,1
23:59,691843653.0,-2942.118399999994,-14.99,1
23:59,215832575.0,-1325.0569637442195,-18.99,6
23:59,215832575.0,-1333.0469637442195,-7.99,7
23:59,215832575.0,-1433.0469637442195,-100.0,6
23:59,720742759.0,2014.1874308830077,-7.99,1
23:59,720742759.0,2001.1974308830077,-12.99,1
23:59,720742759.0,1982.2074308830076,-18.99,6
23:59,494156986.0,253.21554567233488,-15.99,1
23:59,494156986.0,245.22554567233487,-7.99,1
23:59,494156986.0,145.22554567233487,-100.0,6
23:59,494156986.0,130.2355456723349,-14.99,1
23:59,494156986.0,117.24554567233488,-12.99,1
23:59,494156986.0,110.24554567233488,-7.0,1
23:59,494156986.0,104.25554567233488,-5.99,1
23:59,494156986.0,85.26554567233488,-18.99,6
23:59,933491926.0,3599.318300000001,-7.0,1
23:59,933491926.0,3586.328300000001,-12.99,1
23:59,933491926.0,3573.3383000000013,-12.99,1
23:59,933491926.0,3558.3483000000015,-14.99,1
23:59,933491926.0,3542.3583000000017,-15.99,1
23:59,933491926.0,3523.368300000002,-18.99,6
23:59,933491926.0,3423.368300000002,-100.0,6
23:59,769319491.0,523.8119999999994,-12.99,1
23:59,769319491.0,508.82199999999943,-14.99,1
23:59,769319491.0,489.8319999999994,-18.99,6
23:59,769319491.0,481.8419999999994,-7.99,1
23:59,769319491.0,473.8519999999994,-7.99,7
23:59,769319491.0,373.8519999999994,-100.0,6
23:59,583579399.0,1707.3162999999993,-15.99,1
23:59,583579399.0,1699.3262999999993,-7.99,7
23:59,583579399.0,1692.3262999999993,-7.0,1
23:59,583579399.0,1685.3262999999993,-7.0,1
23:59,583579399.0,1672.3362999999993,-12.99,1
23:59,583579399.0,1653.3462999999992,-18.99,6
23:59,583579399.0,1553.3462999999992,-100.0,6
23:59,885259672.0,4360.715583378018,-7.99,7
23:59,885259672.0,4341.725583378018,-18.99,6
23:59,887853850.0,11209.623376421388,-7.99,1
23:59,887853850.0,11203.633376421389,-5.99,1
23:59,887853850.0,11197.643376421389,-5.99,1
23:59,535744551.0,1456.7255659956263,-7.99,1
23:59,535744551.0,1437.7355659956263,-18.99,6
23:59,659415300.0,3498.225340250703,-12.99,1
23:59,659415300.0,3483.2353402507033,-14.99,1
23:59,659415300.0,3477.2453402507035,-5.99,1
23:59,659415300.0,3458.2553402507037,-18.99,6
23:59,659415300.0,3442.265340250704,-15.99,1
23:59,669503912.0,-35.75944965118276,-7.0,1
23:59,669503912.0,-50.749449651182765,-14.99,1
23:59,669503912.0,-58.73944965118277,-7.99,1
23:59,669503912.0,-66.72944965118276,-7.99,7
23:59,669503912.0,-85.71944965118276,-18.99,6
23:59,669503912.0,-185.7194496511827,-100.0,6
23:59,285115279.0,-2895.4466107892877,-15.99,1
23:59,285115279.0,-2903.436610789287,-7.99,7
23:59,250895529.0,2448.4760824692876,-18.99,6
23:59,250895529.0,2432.486082469288,-15.99,1
23:59,250895529.0,2424.496082469288,-7.99,1
23:59,250895529.0,2324.496082469288,-100.0,6
23:59,414805878.0,13662.120118594234,-15.99,1
23:59,414805878.0,13654.130118594234,-7.99,1
23:59,414805878.0,13635.140118594234,-18.99,6
23:59,264208990.0,461.1094499999988,-5.99,1
23:59,264208990.0,453.1194499999988,-7.99,1
23:59,264208990.0,437.1294499999988,-15.99,1
23:59,233981231.0,2476.203815190971,-18.99,6
23:59,233981231.0,2460.213815190971,-15.99,1
23:59,387957305.0,-2532.9486059800793,-15.99,1
23:59,387957305.0,-2540.938605980079,-7.99,7
23:59,387957305.0,-2559.928605980079,-18.99,6
23:59,179173981.0,7246.287592381841,-15.99,1
23:59,179173981.0,7238.297592381841,-7.99,7
23:59,179173981.0,7219.3075923818415,-18.99,6
23:59,179173981.0,7212.3075923818415,-7.0,1
23:59,179173981.0,7199.317592381842,-12.99,1
23:59,179173981.0,7184.327592381842,-14.99,1
23:59,179173981.0,7171.337592381842,-12.99,1
23:59,179173981.0,7071.337592381842,-100.0,6
23:59,285428103.0,9705.651950465588,-15.99,1
23:59,285428103.0,9697.661950465588,-7.99,1
23:59,285428103.0,9597.661950465588,-100.0,6
23:59,285428103.0,9584.671950465588,-12.99,1
23:59,285428103.0,9569.681950465589,-14.99,1
23:59,285428103.0,9554.691950465589,-14.99,1
23:59,285428103.0,9535.70195046559,-18.99,6
23:59,749378808.0,6183.556454255163,-15.99,1
23:59,749378808.0,6175.566454255163,-7.99,1
23:59,749378808.0,6156.576454255163,-18.99,6
23:59,749378808.0,6143.5864542551635,-12.99,1
23:59,749378808.0,6137.596454255164,-5.99,1
23:59,736340277.0,8885.164787223335,-15.99,1
23:59,315078351.0,7550.542551514787,-12.99,1
23:59,315078351.0,7544.552551514787,-5.99,1
23:59,315078351.0,7538.562551514788,-5.99,1
23:59,315078351.0,7515.572551514788,-15.99,1
23:59,315078351.0,7496.582551514788,-18.99,6
23:59,499410772.0,-2650.6268629051624,-7.0,1
23:59,499410772.0,-2750.6268629051624,-100.0,6
23:59,750898750.0,-393.14946531990046,-7.99,1
23:59,750898750.0,-401.13946531990047,-7.99,7
23:59,750898750.0,-420.1294653199005,-18.99,6
23:59,750898750.0,-435.1194653199005,-14.99,1
23:59,750898750.0,-450.1094653199005,-14.99,1
23:59,517934629.0,1330.8376787084264,-15.99,1
23:59,517934629.0,1322.8476787084264,-7.99,1
23:59,517934629.0,1303.8576787084264,-18.99,6
23:59,779946617.0,16871.902331980687,-15.99,1
23:59,779946617.0,16863.912331980686,-7.99,7
23:59,779946617.0,16844.922331980684,-18.99,6
23:59,779946617.0,16829.932331980683,-14.99,1
23:59,779946617.0,16816.94233198068,-12.99,1
23:59,779946617.0,16803.95233198068,-12.99,1
23:59,204855464.0,-952.1509386396158,-15.99,1
23:59,204855464.0,-971.1409386396158,-18.99,6
23:59,204855464.0,-1071.1409386396158,-100.0,6
23:59,108812033.0,979.2956499999984,-12.99,1
23:59,108812033.0,963.3056499999984,-15.99,1
23:59,108812033.0,944.3156499999984,-18.99,6
23:59,108812033.0,844.3156499999984,-100.0,6
23:59,782013626.0,2413.248199311628,-15.99,1
23:59,782013626.0,2405.258199311628,-7.99,7
23:59,782013626.0,2305.258199311628,-100.0,6
23:59,241459011.0,1351.8102132723473,-15.99,1
23:59,241459011.0,1343.8202132723472,-7.99,1
23:59,241459011.0,1336.8202132723472,-7.0,1
23:59,241459011.0,1236.8202132723472,-100.0,6
23:59,670427480.0,2557.441200000001,-5.99,1
23:59,670427480.0,2541.4512000000013,-15.99,1
23:59,670427480.0,2533.4612000000016,-7.99,1
23:59,408057540.0,5430.791440779667,-18.99,6
23:59,408057540.0,5414.801440779667,-15.99,1
23:59,408057540.0,5314.801440779667,-100.0,6
23:59,408057540.0,5308.8114407796675,-5.99,1
23:59,408057540.0,5302.821440779668,-5.99,1
23:59,496865819.0,-569.5234318426824,-100.0,6
23:59,496865819.0,-577.5134318426824,-7.99,1
23:59,496865819.0,-585.5034318426824,-7.99,7
23:59,496865819.0,-604.4934318426824,-18.99,6
23:59,547010927.0,23327.081805952184,-7.0,1
23:59,547010927.0,23308.10180595218,-12.99,1
23:59,547010927.0,23292.11180595218,-15.99,1
23:59,547010927.0,23284.121805952174,-7.99,7
23:59,547010927.0,23265.131805952176,-18.99,6
23:59,252419513.0,-1842.632235813416,-15.99,1
23:59,252419513.0,-1850.622235813416,-7.99,7
23:59,252419513.0,-1869.612235813416,-18.99,6
23:59,124377686.0,-2509.1823999999983,-18.99,6
23:59,124377686.0,-2517.172399999998,-7.99,1
23:59,124377686.0,-2533.162399999998,-15.99,1
23:59,124377686.0,-2633.162399999998,-100.0,6
23:59,609939116.0,7734.516646369859,-14.99,1
23:59,609939116.0,7719.526646369859,-14.99,1
23:59,609939116.0,7713.536646369859,-5.99,1
23:59,609939116.0,7686.55664636986,-18.99,6
23:59,213930646.0,-1379.4711134725633,-7.0,1
23:59,213930646.0,-1395.4611134725633,-15.99,1
23:59,213930646.0,-1414.4511134725633,-18.99,6
23:59,570575024.0,-843.6101000000006,-15.99,1
23:59,570575024.0,-851.6001000000006,-7.99,7
23:59,570575024.0,-870.5901000000006,-18.99,6
23:59,657139925.0,13892.435839386775,-12.99,1
23:59,657139925.0,13879.445839386775,-12.99,1
23:59,657139925.0,13872.445839386775,-7.0,1
23:59,657139925.0,13853.455839386776,-18.99,6
23:59,657139925.0,13845.465839386778,-7.99,1
23:59,657139925.0,13829.475839386778,-15.99,1
23:59,651372390.0,-3383.7007499999986,-15.99,1
23:59,828750680.0,2048.26679521368,-12.99,1
23:59,828750680.0,2040.27679521368,-7.99,1
23:59,828750680.0,2032.28679521368,-7.99,7
23:59,828750680.0,2013.29679521368,-18.99,6
23:59,828750680.0,1913.29679521368,-100.0,6
23:59,793781222.0,2275.838878947404,-18.99,6
23:59,793781222.0,2267.848878947404,-7.99,1
23:59,793781222.0,2259.8588789474043,-7.99,7
23:59,793781222.0,2159.8588789474043,-100.0,6
23:59,793781222.0,2144.8688789474045,-14.99,1
23:59,480198977.0,13087.441297642572,-5.99,1
23:59,480198977.0,13080.441297642572,-7.0,1
23:59,480198977.0,13064.451297642572,-15.99,1
23:59,480198977.0,13045.461297642572,-18.99,6
23:59,726913482.0,255.1851014735239,-15.99,1
23:59,726913482.0,236.1951014735239,-18.99,6
23:59,726913482.0,229.1951014735239,-7.0,1
23:59,520418719.0,3020.391800000003,-14.99,1
23:59,520418719.0,3005.4018000000033,-14.99,1
23:59,520418719.0,2999.4118000000035,-5.99,1
23:59,781554833.0,2255.4524319437232,-18.99,6
23:59,781554833.0,2239.4624319437235,-15.99,1
23:59,683319988.0,8228.72431327215,-5.99,1
23:59,683319988.0,8221.72431327215,-7.0,1
23:59,683319988.0,8202.73431327215,-18.99,6
23:59,683319988.0,8194.744313272151,-7.99,7
23:59,683319988.0,8186.754313272151,-7.99,1
23:59,897592348.0,15147.47998632199,-18.99,6
23:59,897592348.0,15139.48998632199,-7.99,7
23:59,998405607.0,-474.2039999999979,-5.99,1
23:59,998405607.0,-489.1939999999979,-14.99,1
23:59,998405607.0,-502.1839999999979,-12.99,1
23:59,998405607.0,-518.1739999999979,-15.99,1
23:59,998405607.0,-537.1639999999979,-18.99,6
23:59,998405607.0,-637.1639999999979,-100.0,6
23:59,521611005.0,0.7253641489535401,-7.99,1
23:59,521611005.0,-15.26463585104646,-15.99,1
23:59,521611005.0,-115.26463585104646,-100.0,6
23:59,521611005.0,-134.25463585104646,-18.99,6
23:59,741269136.0,396.4209500000004,-15.99,1
23:59,741269136.0,388.4309500000004,-7.99,7
23:59,741269136.0,369.4409500000004,-18.99,6
23:59,741269136.0,356.4509500000004,-12.99,1
23:59,741269136.0,341.46095000000037,-14.99,1
23:59,641376155.0,-109.68748789854884,-15.99,1
23:59,641376155.0,-116.68748789854884,-7.0,1
23:59,641376155.0,-131.67748789854883,-14.99,1
23:59,641376155.0,-150.66748789854884,-18.99,6
23:59,641376155.0,-250.66748789854884,-100.0,6
23:59,668329719.0,9053.831793180148,-7.0,1
23:59,668329719.0,9046.831793180148,-7.0,1
23:59,668329719.0,9031.841793180149,-14.99,1
23:59,668329719.0,9023.851793180149,-7.99,7
23:59,486495235.0,2134.241989388716,-7.99,1
23:59,486495235.0,2118.251989388716,-15.99,1
23:59,486495235.0,2111.251989388716,-7.0,1
23:59,486495235.0,2105.2619893887163,-5.99,1
23:59,486495235.0,2086.2719893887165,-18.99,6
23:59,855129444.0,29.866154562628033,-5.99,1
23:59,340321732.0,1978.3728500000032,-15.99,1
23:59,340321732.0,1970.3828500000031,-7.99,7
23:59,340321732.0,1870.3828500000031,-100.0,6
23:59,340321732.0,1855.3928500000031,-14.99,1
23:59,340321732.0,1840.4028500000031,-14.99,1
23:59,340321732.0,1825.4128500000031,-14.99,1
23:59,744211756.0,-3845.9457499999944,-7.0,1
23:59,744211756.0,-3864.935749999994,-18.99,6
23:59,744211756.0,-3964.935749999994,-100.0,6
23:59,744211756.0,-3980.925749999994,-15.99,1
23:59,744211756.0,-3988.9157499999937,-7.99,7
23:59,384497904.0,916.3690499999992,-15.99,1
23:59,384497904.0,910.3790499999992,-5.99,1
23:59,384497904.0,895.3890499999992,-14.99,1
23:59,384497904.0,795.3890499999992,-100.0,6
23:59,296770890.0,2122.512010379083,-14.99,1
23:59,383625050.0,6505.744314767871,-15.99,1
23:59,383625050.0,6497.754314767872,-7.99,1
23:59,383625050.0,6478.764314767872,-18.99,6
23:59,248658670.0,-911.1283499999996,-15.99,1
23:59,248658670.0,-919.1183499999996,-7.99,7
23:59,248658670.0,-938.1083499999996,-18.99,6
23:59,581618317.0,-4632.701701873207,-7.99,1
23:59,581618317.0,-4640.6917018732065,-7.99,7
23:59,581618317.0,-4647.6917018732065,-7.0,1
23:59,581618317.0,-4662.681701873206,-14.99,1
23:59,581618317.0,-4677.671701873206,-14.99,1
23:59,581618317.0,-4696.661701873206,-18.99,6
23:59,581618317.0,-4796.661701873206,-100.0,6
23:59,785210466.0,2612.263227560572,-7.99,1
23:59,785210466.0,2596.273227560572,-15.99,1
23:59,785210466.0,2577.2832275605724,-18.99,6
23:59,785210466.0,2564.2932275605726,-12.99,1
23:59,785210466.0,2551.303227560573,-12.99,1
23:59,785210466.0,2538.313227560573,-12.99,1
23:59,261793952.0,768.6412602038148,-15.99,1
23:59,261793952.0,760.6512602038148,-7.99,1
23:59,261793952.0,741.6612602038148,-18.99,6
23:59,261793952.0,641.6612602038148,-100.0,6
23:59,889916166.0,177.89340141322668,-7.99,1
23:59,184430449.0,2038.888363885164,-15.99,1
23:59,184430449.0,2019.898363885164,-18.99,6
23:59,135937041.0,300.99810173158835,-15.99,1
23:59,135937041.0,293.00810173158834,-7.99,7
23:59,135937041.0,280.01810173158833,-12.99,1
23:59,135937041.0,274.0281017315883,-5.99,1
23:59,886921642.0,4003.9295075128503,-15.99,1
23:59,886921642.0,3984.9395075128505,-18.99,6
23:59,886921642.0,3884.9395075128505,-100.0,6
23:59,391559884.0,353.9936999999994,-18.99,6
23:59,391559884.0,341.0036999999994,-12.99,1
23:59,391559884.0,325.0136999999994,-15.99,1
23:59,642015139.0,59.481337465638255,-7.99,1
23:59,642015139.0,51.49133746563825,-7.99,7
23:59,196289502.0,15773.748131613433,-15.99,1
23:59,196289502.0,15754.758131613433,-18.99,6
23:59,196289502.0,15747.758131613433,-7.0,1
23:59,196289502.0,15741.768131613431,-5.99,1
23:59,196289502.0,15728.778131613431,-12.99,1
23:59,196289502.0,15715.788131613434,-12.99,1
23:59,512989907.0,-2240.8044039753663,-5.99,1
23:59,512989907.0,-2256.794403975366,-15.99,1
23:59,711045550.0,4506.165350000003,-7.99,1
23:59,711045550.0,4487.175350000003,-18.99,6
23:59,540159353.0,11326.95219235863,-7.99,7
23:59,540159353.0,11307.962192358633,-18.99,6
23:59,540159353.0,11301.972192358631,-5.99,1
23:59,540159353.0,11295.982192358631,-5.99,1
23:59,540159353.0,11280.992192358632,-14.99,1
23:59,592961759.0,-1484.7248000000004,-7.99,1
23:59,592961759.0,-1500.7148000000004,-15.99,1
23:59,479456865.0,1956.510681489405,-18.99,6
23:59,479456865.0,1949.510681489405,-7.0,1
23:59,479456865.0,1936.520681489405,-12.99,1
23:59,479456865.0,1920.530681489405,-15.99,1
23:59,479456865.0,1912.540681489405,-7.99,7
23:59,291580432.0,-224.5659499999997,-5.99,1
23:59,291580432.0,-237.5559499999997,-12.99,1
23:59,264550521.0,10623.293845442202,-15.99,1
23:59,264550521.0,10615.303845442202,-7.99,7
23:59,264550521.0,10609.313845442202,-5.99,1
23:59,264550521.0,10602.313845442202,-7.0,1
23:59,264550521.0,10589.323845442204,-12.99,1
23:59,690958123.0,20261.38434570694,-15.99,1
23:59,690958123.0,20253.39434570694,-7.99,1
23:59,690958123.0,20234.40434570694,-18.99,6
23:59,647936800.0,867.3712128922264,-15.99,1
23:59,647936800.0,859.3812128922264,-7.99,7
23:59,647936800.0,759.3812128922264,-100.0,6
23:59,621652856.0,360.1459696105401,-18.99,6
23:59,779620857.0,-33.65009638517585,-15.99,1
23:59,779620857.0,-41.64009638517585,-7.99,1
23:59,779620857.0,-60.63009638517585,-18.99,6
23:59,701070224.0,-325.3910499999999,-12.99,1
23:59,701070224.0,-338.3810499999999,-12.99,1
23:59,701070224.0,-353.3710499999999,-14.99,1
23:59,701070224.0,-372.3610499999999,-18.99,6
23:59,812692024.0,3937.56093134288,-100.0,6
23:59,812692024.0,3921.5709313428806,-15.99,1
23:59,812692024.0,3913.580931342881,-7.99,1
23:59,812692024.0,3894.590931342881,-18.99,6
23:59,812692024.0,3879.6009313428817,-14.99,1
23:59,812692024.0,3872.6009313428817,-7.0,1
23:59,941285623.0,456.2713990667703,-7.0,1
23:59,941285623.0,449.2713990667703,-7.0,1
23:59,941285623.0,430.2813990667703,-18.99,6
23:59,941285623.0,422.2913990667703,-7.99,1
23:59,941285623.0,414.3013990667703,-7.99,7
23:59,176922958.0,1137.2195471976495,-18.99,6
23:59,176922958.0,1121.2295471976497,-15.99,1
23:59,176922958.0,1113.2395471976497,-7.99,7
23:59,407323346.0,-2380.7179325553125,-18.99,6
23:59,280990953.0,579.1528499999986,-7.99,1
23:59,280990953.0,572.1528499999986,-7.0,1
23:59,280990953.0,553.1628499999986,-18.99,6
23:59,913127700.0,1589.4014380111164,-18.99,6
23:59,913127700.0,1573.4114380111164,-15.99,1
23:59,913127700.0,1565.4214380111164,-7.99,7
23:59,293191074.0,525.8281499999991,-15.99,1
23:59,293191074.0,512.8381499999991,-12.99,1
23:59,293191074.0,505.83814999999913,-7.0,1
23:59,678330503.0,3346.8697297229924,-5.99,1
23:59,678330503.0,3339.8697297229924,-7.0,1
23:59,678330503.0,3320.8797297229926,-18.99,6
23:59,655730067.0,232.40119999999956,-18.99,6
23:59,655730067.0,224.41119999999955,-7.99,1
23:59,655730067.0,216.42119999999952,-7.99,7
23:59,655730067.0,210.4311999999995,-5.99,1
23:59,581655972.0,42233.84587491664,-15.99,1
23:59,581655972.0,42214.85587491664,-18.99,6
23:59,215426302.0,821.2864040256918,-12.99,1
23:59,215426302.0,808.2964040256918,-12.99,1
23:59,450896297.0,13735.21616376906,-15.99,1
23:59,450896297.0,13727.22616376906,-7.99,7
23:59,762785862.0,1492.6957499999994,-100.0,6
23:59,304455868.0,2934.95715971583,-18.99,6
23:59,304455868.0,2926.9671597158303,-7.99,1
23:59,304455868.0,2910.9771597158306,-15.99,1
23:59,304455868.0,2904.987159715831,-5.99,1
23:59,304455868.0,2898.997159715831,-5.99,1
23:59,304455868.0,2886.007159715831,-12.99,1
23:59,304455868.0,2879.007159715831,-7.0,1
23:59,558875206.0,3388.220050000001,-18.99,6
23:59,558875206.0,3372.230050000001,-15.99,1
23:59,994947671.0,1166.9657000000004,-15.99,1
23:59,994947671.0,1151.9757000000004,-14.99,1
23:59,994947671.0,1144.9757000000004,-7.0,1
23:59,868014990.0,-3124.191099999997,-7.99,1
23:59,868014990.0,-3140.1810999999966,-15.99,1
23:59,868014990.0,-3153.1710999999964,-12.99,1
23:59,868014990.0,-3168.161099999996,-14.99,1
23:59,152616936.0,1453.3030078630647,-7.99,1
23:59,152616936.0,1437.3130078630647,-15.99,1
23:59,152616936.0,1337.3130078630647,-100.0,6
23:59,574548998.0,835.0824999999993,-15.99,1
23:59,574548998.0,827.0924999999993,-7.99,1
23:59,574548998.0,808.1024999999993,-18.99,6
23:59,116598243.0,3142.66777609889,-14.99,1
23:59,116598243.0,3127.6777760988903,-14.99,1
23:59,116598243.0,3112.6877760988905,-14.99,1
23:59,116598243.0,3097.6977760988907,-14.99,1
23:59,116598243.0,3081.707776098891,-15.99,1
23:59,242218612.0,480.2463000000006,-18.99,6
23:59,242218612.0,472.2563000000006,-7.99,1
23:59,242218612.0,464.26630000000057,-7.99,7
23:59,215404070.0,-124.31541082015018,-18.99,6
23:59,215404070.0,-140.30541082015017,-15.99,1
23:59,215404070.0,-148.29541082015018,-7.99,7
23:59,215404070.0,-161.2854108201502,-12.99,1
23:59,215404070.0,-167.2754108201502,-5.99,1
23:59,493855007.0,-2482.449131574393,-7.0,1
23:59,493855007.0,-2489.449131574393,-7.0,1
23:59,493855007.0,-2504.439131574393,-14.99,1
23:59,493855007.0,-2517.4291315743926,-12.99,1
23:59,493855007.0,-2533.4191315743924,-15.99,1
23:59,857754342.0,2803.0990218916704,-18.99,6
23:59,857754342.0,2790.10902189167,-12.99,1
23:59,857754342.0,2784.119021891671,-5.99,1
23:59,857754342.0,2769.129021891671,-14.99,1
23:59,147508204.0,388.60971778188656,-15.99,1
23:59,147508204.0,380.61971778188655,-7.99,1
23:59,224215364.0,-1623.1025920882787,-7.99,7
23:59,224215364.0,-1638.0925920882787,-14.99,1
23:59,224215364.0,-1657.0825920882787,-18.99,6
23:59,180719578.0,-4044.597749999996,-15.99,1
23:59,180719578.0,-4052.587749999996,-7.99,7
23:59,180719578.0,-4071.577749999996,-18.99,6
23:59,180719578.0,-4077.567749999995,-5.99,1
23:59,180719578.0,-4090.5577499999954,-12.99,1
23:59,180719578.0,-4097.557749999995,-7.0,1
23:59,180719578.0,-4104.557749999995,-7.0,1
23:59,237684254.0,6459.399651323018,-15.99,1
23:59,237684254.0,6451.409651323018,-7.99,1
23:59,237684254.0,6432.419651323018,-18.99,6
23:59,237684254.0,6426.429651323018,-5.99,1
23:59,237684254.0,6413.439651323019,-12.99,1
23:59,474951915.0,-2465.271095234012,-18.99,6
23:59,474951915.0,-2478.261095234012,-12.99,1
23:59,474951915.0,-2485.261095234012,-7.0,1
23:59,214339619.0,622.6375508683564,-7.99,7
23:59,214339619.0,615.6375508683564,-7.0,1
23:59,214339619.0,608.6375508683564,-7.0,1
23:59,214339619.0,602.6475508683563,-5.99,1
23:59,225210798.0,1151.3337737592087,-15.99,1
23:59,225210798.0,1143.3437737592087,-7.99,7
23:59,225210798.0,1124.3537737592087,-18.99,6
23:59,111137699.0,-6.08949999999958,-15.99,1
23:59,111137699.0,-25.079499999999577,-18.99,6
23:59,632065391.0,-2354.868649999999,-18.99,6
23:59,940569402.0,6703.381681983107,-14.99,1
23:59,940569402.0,6696.381681983107,-7.0,1
23:59,940569402.0,6689.381681983107,-7.0,1
23:59,940569402.0,6673.391681983107,-15.99,1
23:59,940569402.0,6665.401681983108,-7.99,7
23:59,256045540.0,-3323.146399999999,-18.99,6
23:59,535273662.0,156.9973999999995,-18.99,6
23:59,535273662.0,141.00739999999948,-15.99,1
23:59,535273662.0,133.01739999999947,-7.99,7
23:59,854895960.0,3644.8723887147025,-15.99,1
23:59,854895960.0,3625.8823887147023,-18.99,6
23:59,575652395.0,3813.7574197618274,-7.0,1
23:59,575652395.0,3806.7574197618274,-7.0,1
23:59,575652395.0,3791.767419761827,-14.99,1
23:59,575652395.0,3785.777419761828,-5.99,1
23:59,575652395.0,3769.787419761828,-15.99,1
23:59,575652395.0,3761.797419761828,-7.99,7
23:59,575652395.0,3742.807419761829,-18.99,6
23:59,226703987.0,1938.8871999999997,-7.0,1
23:59,226703987.0,1922.8971999999997,-15.99,1
23:59,154246234.0,245.38489210210423,-18.99,6
23:59,154246234.0,229.39489210210425,-15.99,1
23:59,799861885.0,1177.421449999999,-7.99,1
23:59,799861885.0,1158.431449999999,-18.99,6
23:59,466649401.0,970.0924613978916,-18.99,6
23:59,466649401.0,954.1024613978916,-15.99,1
23:59,466649401.0,946.1124613978916,-7.99,7
23:59,466649401.0,933.1224613978916,-12.99,1
23:59,466649401.0,918.1324613978916,-14.99,1
23:59,466649401.0,912.1424613978916,-5.99,1
23:59,466649401.0,899.1524613978916,-12.99,1
23:59,466649401.0,799.1524613978916,-100.0,6
23:59,235881534.0,13239.865492628334,-15.99,1
23:59,235881534.0,13231.875492628336,-7.99,1
23:59,235881534.0,13212.885492628337,-18.99,6
23:59,699313649.0,-2095.150899141906,-18.99,6
23:59,699313649.0,-2110.1408991419057,-14.99,1
23:59,699313649.0,-2125.1308991419055,-14.99,1
23:59,880546403.0,-988.1346500000018,-5.99,1
23:59,880546403.0,-996.1246500000018,-7.99,7
23:59,880546403.0,-1004.1146500000018,-7.99,1
23:59,880546403.0,-1023.1046500000018,-18.99,6
23:59,880546403.0,-1123.1046500000018,-100.0,6
23:59,189335192.0,-769.7329017578602,-18.99,6
23:59,189335192.0,-785.7229017578602,-15.99,1
23:59,189335192.0,-885.7229017578602,-100.0,6
23:59,189335192.0,-891.7129017578602,-5.99,1
23:59,258201793.0,-89.3398000000004,-12.99,1
23:59,258201793.0,-104.3298000000004,-14.99,1
23:59,258201793.0,-117.31980000000038,-12.99,1
23:59,258201793.0,-124.31980000000038,-7.0,1
23:59,258201793.0,-143.3098000000004,-18.99,6
23:59,985188462.0,810.2827887112248,-15.99,1
23:59,985188462.0,802.2927887112248,-7.99,1
23:59,985188462.0,783.3027887112248,-18.99,6
23:59,985188462.0,770.3127887112248,-12.99,1
23:59,985188462.0,764.3227887112248,-5.99,1
23:59,985188462.0,751.3327887112248,-12.99,1
23:59,212560376.0,-134.00387422089784,-18.99,6
23:59,212560376.0,-141.99387422089785,-7.99,1
23:59,212560376.0,-149.98387422089786,-7.99,7
23:59,255814263.0,4302.934696700545,-7.99,7
23:59,743630833.0,399.53531328470126,-15.99,1
23:59,743630833.0,380.5453132847013,-18.99,6
23:59,743630833.0,373.5453132847013,-7.0,1
23:59,743630833.0,358.55531328470124,-14.99,1
23:59,743630833.0,352.56531328470123,-5.99,1
23:59,743630833.0,345.56531328470123,-7.0,1
23:59,202320275.0,-562.6719000000004,-15.99,1
23:59,202320275.0,-570.6619000000004,-7.99,7
23:59,202320275.0,-589.6519000000004,-18.99,6
23:59,703588001.0,239.87084999999956,-5.99,1
23:59,703588001.0,226.88084999999955,-12.99,1
23:59,703588001.0,218.89084999999957,-7.99,1
23:59,703588001.0,199.9008499999995,-18.99,6
23:59,688712152.0,6305.015824437442,-15.99,1
23:59,688712152.0,6297.025824437442,-7.99,1
23:59,688712152.0,6278.035824437442,-18.99,6
23:59,688712152.0,6272.045824437442,-5.99,1
23:59,189757473.0,-2070.4536500000004,-7.99,1
23:59,189757473.0,-2078.44365,-7.99,7
23:59,189757473.0,-2093.43365,-14.99,1
23:59,189757473.0,-2108.4236499999997,-14.99,1
23:59,189757473.0,-2127.4136499999995,-18.99,6
23:59,339791565.0,-3307.383699999997,-15.99,1
23:59,339791565.0,-3326.373699999997,-18.99,6
23:59,339791565.0,-3426.373699999997,-100.0,6
23:59,627917561.0,3608.7950500000034,-7.0,1
23:59,627917561.0,3602.8050500000036,-5.99,1
23:59,627917561.0,3587.815050000004,-14.99,1
23:59,627917561.0,3571.825050000004,-15.99,1
23:59,627917561.0,3563.835050000004,-7.99,7
23:59,627917561.0,3544.8450500000044,-18.99,6
23:59,130154096.0,1589.777610548966,-15.99,1
23:59,130154096.0,1576.787610548966,-12.99,1
23:59,130154096.0,1570.7976105489658,-5.99,1
23:59,130154096.0,1563.7976105489658,-7.0,1
23:59,130154096.0,1556.7976105489658,-7.0,1
23:59,298007503.0,1771.2231036256337,-15.99,1
23:59,298007503.0,1752.2331036256337,-18.99,6
23:59,890830949.0,1318.573999999998,-7.99,1
23:59,890830949.0,1310.583999999998,-7.99,7
23:59,890830949.0,1304.593999999998,-5.99,1
23:59,890830949.0,1291.603999999998,-12.99,1
23:59,706361191.0,394.37884849407806,-15.99,1
23:59,706361191.0,388.3888484940781,-5.99,1
23:59,706361191.0,373.3988484940781,-14.99,1
23:59,706361191.0,366.3988484940781,-7.0,1
23:59,706361191.0,351.40884849407803,-14.99,1
23:59,706361191.0,332.418848494078,-18.99,6
23:59,807098817.0,508.3667999999992,-7.0,1
23:59,807098817.0,500.3767999999992,-7.99,7
23:59,807098817.0,492.3867999999992,-7.99,1
23:59,482513594.0,6755.687929764906,-7.99,1
23:59,482513594.0,6736.697929764906,-18.99,6
23:59,211493028.0,1102.9699999999991,-15.99,1
23:59,211493028.0,1002.9699999999992,-100.0,6
23:59,211493028.0,995.9699999999992,-7.0,1
23:59,211493028.0,989.9799999999992,-5.99,1
23:59,211493028.0,974.9899999999992,-14.99,1
23:59,211493028.0,967.9899999999992,-7.0,1
23:59,655368335.0,5425.701910070222,-18.99,6
23:59,655368335.0,5417.711910070222,-7.99,1
23:59,655368335.0,5410.711910070222,-7.0,1
23:59,655368335.0,5389.7319100702225,-14.99,1
23:59,290751280.0,667.4206966748256,-5.99,1
23:59,290751280.0,654.4306966748256,-12.99,1
23:59,290751280.0,641.4406966748256,-12.99,1
23:59,290751280.0,628.4506966748256,-12.99,1
23:59,924045955.0,1866.3900126586643,-18.99,6
23:59,924045955.0,1851.4000126586643,-14.99,1
23:59,924045955.0,1845.4100126586643,-5.99,1
23:59,924045955.0,1829.4200126586643,-15.99,1
23:59,924045955.0,1821.4300126586645,-7.99,7
23:59,549414742.0,7812.982669225654,-7.99,1
23:59,549414742.0,7796.992669225654,-15.99,1
23:59,549414742.0,7784.002669225654,-12.99,1
23:59,549414742.0,7777.002669225654,-7.0,1
23:59,859264768.0,567.3350837819385,-18.99,6
23:59,859264768.0,559.3450837819385,-7.99,7
23:59,859264768.0,551.3550837819384,-7.99,1
23:59,859264768.0,544.3550837819384,-7.0,1
23:59,859264768.0,529.3650837819384,-14.99,1
23:59,859264768.0,522.3650837819384,-7.0,1
23:59,964702094.0,2205.491376727642,-5.99,1
23:59,964702094.0,2192.5013767276423,-12.99,1
23:59,964702094.0,2186.5113767276425,-5.99,1
23:59,964702094.0,2170.5213767276427,-15.99,1
23:59,964702094.0,2151.531376727643,-18.99,6
23:59,399144202.0,3160.6591483949005,-7.99,1
23:59,399144202.0,3141.6691483949007,-18.99,6
23:59,399144202.0,3041.6691483949007,-100.0,6
23:59,399144202.0,3035.679148394901,-5.99,1
23:59,399144202.0,3028.679148394901,-7.0,1
23:59,700138124.0,6203.541637293152,-18.99,6
23:59,700138124.0,6187.551637293152,-15.99,1
23:59,700138124.0,6179.561637293153,-7.99,7
23:59,762859681.0,670.7675999999989,-15.99,1
23:59,762859681.0,651.7775999999989,-18.99,6
23:59,534325901.0,7159.332618544498,-18.99,6
23:59,534325901.0,7151.342618544498,-7.99,1
23:59,534325901.0,7138.352618544498,-12.99,1
23:59,534325901.0,7131.352618544498,-7.0,1
23:59,534325901.0,7031.352618544498,-100.0,6
23:59,155867488.0,274.29869999999846,-7.99,1
23:59,155867488.0,266.30869999999845,-7.99,7
23:59,155867488.0,247.31869999999844,-18.99,6
23:59,758160963.0,8562.049342693732,-18.99,6
23:59,758160963.0,8554.059342693732,-7.99,7
23:59,758160963.0,8538.069342693732,-15.99,1
23:59,758160963.0,8438.069342693732,-100.0,6
23:59,409971170.0,2883.268845563993,-18.99,6
23:59,409971170.0,2870.2788455639934,-12.99,1
23:59,409971170.0,2854.2888455639936,-15.99,1
23:59,409971170.0,2846.298845563994,-7.99,7
23:59,134461671.0,5951.01193433876,-7.99,7
23:59,134461671.0,5932.02193433876,-18.99,6
23:59,134461671.0,5917.03193433876,-14.99,1
23:59,134461671.0,5817.03193433876,-100.0,6
23:59,536924114.0,-548.3733055930961,-7.99,1
23:59,536924114.0,-556.3633055930961,-7.99,7
23:59,536924114.0,-656.3633055930961,-100.0,6
23:59,536924114.0,-669.3533055930961,-12.99,1
23:59,536924114.0,-675.3433055930961,-5.99,1
23:59,536924114.0,-682.3433055930961,-7.0,1
23:59,536924114.0,-701.3333055930962,-18.99,6
23:59,879091637.0,-38.067476262023085,-5.99,1
23:59,879091637.0,-51.05747626202309,-12.99,1
23:59,879091637.0,-70.04747626202308,-18.99,6
23:59,879091637.0,-86.03747626202308,-15.99,1
23:59,310620484.0,399.3141950921984,-12.99,1
23:59,310620484.0,393.3241950921983,-5.99,1
23:59,310620484.0,378.33419509219834,-14.99,1
23:59,310620484.0,362.34419509219833,-15.99,1
23:59,310620484.0,354.3541950921983,-7.99,1
23:59,310620484.0,335.3641950921983,-18.99,6
23:59,235310449.0,2179.099184830309,-12.99,1
23:59,235310449.0,2164.109184830309,-14.99,1
23:59,235310449.0,2148.119184830309,-15.99,1
23:59,615144184.0,1103.283799125519,-100.0,6
23:59,615144184.0,1095.293799125519,-7.99,7
23:59,615144184.0,1088.293799125519,-7.0,1
23:59,615144184.0,1081.293799125519,-7.0,1
23:59,615144184.0,1068.303799125519,-12.99,1
23:59,615144184.0,1049.313799125519,-18.99,6
23:59,199016328.0,6427.789578394218,-15.99,1
23:59,183888402.0,18366.62298802294,-5.99,1
23:59,183888402.0,18347.63298802294,-18.99,6
23:59,183888402.0,18339.642988022937,-7.99,1
23:59,656812046.0,898.2237537325188,-18.99,6
23:59,764450279.0,19864.567348495,-15.99,1
23:59,764450279.0,19845.577348494997,-18.99,6
23:59,569687509.0,-2027.8854,-15.99,1
23:59,569687509.0,-2046.8754,-18.99,6
23:59,786141370.0,-208.1172000000008,-15.99,1
23:59,786141370.0,-216.10720000000083,-7.99,1
23:59,786141370.0,-235.09720000000084,-18.99,6
23:59,998390769.0,-41.949049059475776,-7.99,1
23:59,998390769.0,-57.93904905947578,-15.99,1
23:59,998390769.0,-72.92904905947577,-14.99,1
23:59,998390769.0,-87.91904905947577,-14.99,1
23:59,998390769.0,-100.90904905947576,-12.99,1
23:59,497772347.0,1737.0820499999982,-15.99,1
23:59,497772347.0,1718.0920499999982,-18.99,6
23:59,497772347.0,1712.102049999998,-5.99,1
23:59,497772347.0,1705.102049999998,-7.0,1
23:59,497772347.0,1699.112049999998,-5.99,1
23:59,497772347.0,1599.112049999998,-100.0,6
23:59,846550094.0,1887.0187405544089,-15.99,1
23:59,846550094.0,1879.0287405544088,-7.99,7
23:59,846550094.0,1872.0287405544088,-7.0,1
23:59,846550094.0,1865.0287405544088,-7.0,1
23:59,846550094.0,1858.0287405544088,-7.0,1
23:59,846550094.0,1839.0387405544088,-18.99,6
23:59,106601471.0,10330.776376068972,-5.99,1
23:59,106601471.0,10324.786376068972,-5.99,1
23:59,106601471.0,10308.796376068973,-15.99,1
23:59,833899961.0,2724.898772838991,-7.0,1
23:59,833899961.0,2709.9087728389914,-14.99,1
23:59,833899961.0,2703.9187728389916,-5.99,1
23:59,833899961.0,2690.928772838992,-12.99,1
23:59,277562576.0,988.1386982249552,-14.99,1
23:59,277562576.0,969.1486982249552,-18.99,6
23:59,277562576.0,961.1586982249552,-7.99,1
23:59,277562576.0,953.168698224955,-7.99,7
23:59,352899149.0,798.0650499999988,-15.99,1
23:59,604288474.0,3593.977263636418,-7.99,1
23:59,604288474.0,3585.987263636418,-7.99,7
23:59,604288474.0,3566.997263636418,-18.99,6
23:59,604288474.0,3552.0072636364184,-14.99,1
23:59,604288474.0,3546.017263636418,-5.99,1
23:59,604288474.0,3539.017263636418,-7.0,1
23:59,850290152.0,-2673.340999999998,-18.99,6
23:59,850290152.0,-2689.330999999998,-15.99,1
23:59,850290152.0,-2697.3209999999976,-7.99,7
23:59,850290152.0,-2710.3109999999974,-12.99,1
23:59,850290152.0,-2716.300999999997,-5.99,1
23:59,850290152.0,-2722.290999999997,-5.99,1
23:59,850290152.0,-2737.2809999999968,-14.99,1
23:59,850290152.0,-2837.2809999999968,-100.0,6
23:59,519935524.0,1396.200189737519,-18.99,6
23:59,519935524.0,1389.200189737519,-7.0,1
23:59,519935524.0,1383.210189737519,-5.99,1
23:59,824218857.0,-3389.346160845429,-100.0,6
23:59,824218857.0,-3405.336160845429,-15.99,1
23:59,824218857.0,-3413.3261608454286,-7.99,1
23:59,213112754.0,7222.557957744279,-7.99,1
23:59,213112754.0,7209.567957744279,-12.99,1
23:59,213112754.0,7196.577957744279,-12.99,1
23:59,213112754.0,7189.577957744279,-7.0,1
23:59,213112754.0,7182.577957744279,-7.0,1
23:59,213112754.0,7163.587957744279,-18.99,6
23:59,166019891.0,8183.06273699807,-15.99,1
23:59,166019891.0,8164.0727369980705,-18.99,6
23:59,166019891.0,8149.082736998071,-14.99,1
23:59,166019891.0,8134.092736998071,-14.99,1
23:59,345582855.0,63.7631528205493,-15.99,1
23:59,613427466.0,6899.911905655877,-7.99,1
23:59,613427466.0,6883.921905655877,-15.99,1
23:59,613427466.0,6864.931905655877,-18.99,6
23:59,613427466.0,6858.941905655877,-5.99,1
23:59,518746136.0,-804.2397282369166,-7.99,1
23:59,518746136.0,-812.2297282369166,-7.99,7
23:59,688328251.0,-873.7541253548271,-18.99,6
23:59,688328251.0,-881.7441253548271,-7.99,1
23:59,688328251.0,-981.7441253548272,-100.0,6
23:59,688328251.0,-988.7441253548272,-7.0,1
23:59,688328251.0,-995.7441253548272,-7.0,1
23:59,688328251.0,-1010.7341253548273,-14.99,1
23:59,688328251.0,-1016.7241253548272,-5.99,1
23:59,160166876.0,1764.293690586244,-18.99,6
23:59,160166876.0,1751.303690586244,-12.99,1
23:59,160166876.0,1744.303690586244,-7.0,1
23:59,433837402.0,-128.97586846418812,-15.99,1
23:59,433837402.0,-136.96586846418813,-7.99,1
23:59,433837402.0,-155.95586846418814,-18.99,6
23:59,433837402.0,-162.95586846418814,-7.0,1
23:59,775790822.0,-2925.6534192160684,-5.99,1
23:59,775790822.0,-2944.643419216068,-18.99,6
23:59,775790822.0,-2952.633419216068,-7.99,7
23:59,138969884.0,975.5982999999994,-15.99,1
23:59,138969884.0,962.6082999999994,-12.99,1
23:59,138969884.0,949.6182999999994,-12.99,1
23:59,138969884.0,942.6182999999994,-7.0,1
23:59,138969884.0,923.6282999999994,-18.99,6
23:59,660874296.0,2597.5274499608468,-7.99,7
23:59,660874296.0,2578.537449960847,-18.99,6
23:59,660874296.0,2572.547449960847,-5.99,1
23:59,660874296.0,2559.5574499608474,-12.99,1
23:59,868377987.0,2966.549969515682,-12.99,1
23:59,868377987.0,2960.5599695156816,-5.99,1
23:59,868377987.0,2954.569969515682,-5.99,1
23:59,868377987.0,2948.579969515682,-5.99,1
23:59,868377987.0,2929.5899695156822,-18.99,6
23:59,868377987.0,2913.5999695156825,-15.99,1
23:59,868377987.0,2905.6099695156827,-7.99,7
23:59,172084472.0,-1279.4207215957183,-14.99,1
23:59,867679563.0,174.53075370171587,-15.99,1
23:59,867679563.0,166.54075370171586,-7.99,1
23:59,867679563.0,147.55075370171585,-18.99,6
23:59,872286364.0,-1087.1079958130997,-15.99,1
23:59,978410962.0,-2706.700839548974,-15.99,1
23:59,978410962.0,-2719.690839548973,-12.99,1
23:59,978410962.0,-2732.680839548973,-12.99,1
23:59,978410962.0,-2747.6708395489727,-14.99,1
23:59,978410962.0,-2754.6708395489727,-7.0,1
23:59,978410962.0,-2773.6608395489725,-18.99,6
23:59,623156843.0,6074.826503011674,-15.99,1
23:59,623156843.0,6068.836503011674,-5.99,1
23:59,623156843.0,6049.846503011674,-18.99,6
23:59,844206657.0,154.3860551465698,-18.99,6
23:59,844206657.0,54.38605514656979,-100.0,6
23:59,844206657.0,46.396055146569786,-7.99,7
23:59,844206657.0,30.406055146569784,-15.99,1
23:59,844206657.0,17.416055146569782,-12.99,1
23:59,925037906.0,1133.6598000000015,-7.99,7
23:59,925037906.0,1117.6698000000015,-15.99,1
23:59,285220959.0,11742.2717587097,-15.99,1
23:59,285220959.0,11734.2817587097,-7.99,1
23:59,285220959.0,11728.2917587097,-5.99,1
23:59,285220959.0,11721.2917587097,-7.0,1
23:59,146686559.0,-340.7839111734777,-15.99,1
23:59,146686559.0,-348.7739111734777,-7.99,7
23:59,146686559.0,-448.7739111734777,-100.0,6
23:59,146686559.0,-467.7639111734777,-18.99,6
23:59,760704118.0,1602.4723127174886,-7.99,1
23:59,760704118.0,1594.4823127174886,-7.99,7
23:59,844835978.0,9964.056549188452,-7.99,7
23:59,844835978.0,9957.056549188452,-7.0,1
23:59,930277104.0,10650.322948827352,-18.99,6
23:59,995615876.0,2082.3051396983888,-12.99,1
23:59,639549973.0,7611.6784614393455,-15.99,1
23:59,639549973.0,7592.688461439346,-18.99,6
23:59,284161641.0,185.9323110405757,-15.99,1
23:59,284161641.0,166.9423110405757,-18.99,6
23:59,284161641.0,151.9523110405757,-14.99,1
23:59,284161641.0,145.96231104057568,-5.99,1
23:59,284161641.0,139.97231104057568,-5.99,1
23:59,284161641.0,132.97231104057568,-7.0,1
23:59,284905540.0,7904.117517180221,-100.0,6
23:59,284905540.0,7885.127517180221,-18.99,6
23:59,284905540.0,7869.137517180221,-15.99,1
23:59,284905540.0,7861.147517180221,-7.99,7
23:59,744398361.0,949.0459999999998,-15.99,1
23:59,744398361.0,941.0559999999998,-7.99,1
23:59,744398361.0,922.0659999999998,-18.99,6
23:59,570410059.0,2354.44664677631,-18.99,6
23:59,475117511.0,8345.266811260568,-100.0,6
23:59,475117511.0,8329.276811260568,-15.99,1
23:59,475117511.0,8314.286811260568,-14.99,1
23:59,475117511.0,8301.296811260569,-12.99,1
23:59,475117511.0,8282.306811260569,-18.99,6
23:59,637649383.0,1077.1064999999985,-15.99,1
23:59,637649383.0,1058.1164999999985,-18.99,6
23:59,637649383.0,1051.1164999999985,-7.0,1
23:59,637649383.0,1038.1264999999985,-12.99,1
23:59,637649383.0,1023.1364999999984,-14.99,1
23:59,637649383.0,923.1364999999984,-100.0,6
23:59,405416860.0,2245.847966958371,-18.99,6
23:59,405416860.0,2229.857966958371,-15.99,1
23:59,165098840.0,-221.57312636237305,-5.99,1
23:59,165098840.0,-228.57312636237305,-7.0,1
23:59,165098840.0,-235.57312636237305,-7.0,1
23:59,165098840.0,-251.56312636237303,-15.99,1
23:59,165098840.0,-270.55312636237306,-18.99,6
23:59,165098840.0,-370.55312636237306,-100.0,6
23:59,975345315.0,35237.22479999997,-18.99,6
23:59,975345315.0,35221.23479999997,-15.99,1
23:59,975345315.0,35206.24479999997,-14.99,1
23:59,975345315.0,35191.25479999997,-14.99,1
23:59,975345315.0,35176.264799999975,-14.99,1
23:59,553734946.0,1214.7348999999988,-15.99,1
23:59,553734946.0,1114.7348999999988,-100.0,6
23:59,553734946.0,1101.7448999999988,-12.99,1
23:59,553734946.0,1094.7448999999988,-7.0,1
23:59,553734946.0,1087.7448999999988,-7.0,1
23:59,553734946.0,1074.7548999999988,-12.99,1
23:59,553734946.0,1055.7648999999988,-18.99,6
23:59,455831435.0,-1537.9046048014943,-15.99,1
23:59,455831435.0,-1545.8946048014946,-7.99,1
23:59,455831435.0,-1564.8846048014946,-18.99,6
23:59,455831435.0,-1570.8746048014946,-5.99,1
23:59,455831435.0,-1576.8646048014946,-5.99,1
23:59,455831435.0,-1676.8646048014946,-100.0,6
23:59,826597014.0,-2254.07694060293,-100.0,6
23:59,826597014.0,-2269.0669406029297,-14.99,1
23:59,826597014.0,-2275.0569406029294,-5.99,1
23:59,826597014.0,-2290.046940602929,-14.99,1
23:59,826597014.0,-2298.036940602929,-7.99,7
23:59,826597014.0,-2314.026940602929,-15.99,1
23:59,826597014.0,-2333.016940602929,-18.99,6
23:59,667367404.0,9806.68603163486,-12.99,1
23:59,667367404.0,9793.69603163486,-12.99,1
23:59,667367404.0,9780.706031634862,-12.99,1
23:59,667367404.0,9764.716031634862,-15.99,1
23:59,667367404.0,9664.716031634862,-100.0,6
23:59,441274121.0,13228.186183444504,-100.0,6
23:59,441274121.0,13209.196183444505,-18.99,6
23:59,441274121.0,13193.206183444505,-15.99,1
23:59,441274121.0,13185.216183444503,-7.99,1
23:59,441274121.0,13178.216183444503,-7.0,1
23:59,441274121.0,13171.216183444503,-7.0,1
23:59,822250278.0,7620.929117435351,-15.99,1
23:59,822250278.0,7612.939117435351,-7.99,1
23:59,345514953.0,1929.3632499999992,-15.99,1
23:59,832564361.0,16319.667008512644,-18.99,6
23:59,832564361.0,16303.677008512645,-15.99,1
23:59,832564361.0,16203.677008512645,-100.0,6
23:59,783650950.0,-644.9326434110114,-14.99,1
23:59,783650950.0,-650.9226434110114,-5.99,1
23:59,783650950.0,-656.9126434110115,-5.99,1
23:59,783650950.0,-663.9126434110115,-7.0,1
23:59,783650950.0,-679.9026434110115,-15.99,1
23:59,783650950.0,-687.8926434110115,-7.99,1
23:59,783650950.0,-706.8826434110115,-18.99,6
23:59,799286313.0,-947.8783128758614,-18.99,6
23:59,799286313.0,-955.8683128758614,-7.99,1
23:59,799286313.0,-1055.8683128758614,-100.0,6
23:59,152488934.0,1863.7741573137307,-15.99,1
23:59,152488934.0,1855.7841573137307,-7.99,7
23:59,152488934.0,1840.7941573137307,-14.99,1
23:59,152488934.0,1833.7941573137307,-7.0,1
23:59,152488934.0,1820.804157313731,-12.99,1
23:59,152488934.0,1805.814157313731,-14.99,1
23:59,152488934.0,1705.814157313731,-100.0,6
23:59,494156462.0,-107.88248648176038,-15.99,1
23:59,494156462.0,-115.87248648176038,-7.99,7
23:59,494156462.0,-134.8624864817604,-18.99,6
23:59,771125520.0,73.43304999999948,-15.99,1
23:59,771125520.0,67.44304999999949,-5.99,1
23:59,771125520.0,48.45304999999949,-18.99,6
23:59,771125520.0,-51.54695000000051,-100.0,6
23:59,637433131.0,573.2703999999992,-15.99,1
23:59,637433131.0,565.2803999999992,-7.99,7
23:59,637433131.0,546.2903999999992,-18.99,6
23:59,637433131.0,446.2903999999992,-100.0,6
23:59,795847804.0,22942.575615137484,-15.99,1
23:59,795847804.0,22923.585615137483,-18.99,6
23:59,436430134.0,-432.44390133718167,-7.0,1
23:59,436430134.0,-439.44390133718167,-7.0,1
23:59,436430134.0,-446.44390133718167,-7.0,1
23:59,436430134.0,-453.44390133718167,-7.0,1
23:59,436430134.0,-469.4339013371817,-15.99,1
23:59,436430134.0,-488.4239013371817,-18.99,6
23:59,132400709.0,711.1093351539398,-14.99,1
23:59,132400709.0,705.1193351539398,-5.99,1
23:59,132400709.0,689.1293351539398,-15.99,1
23:59,132400709.0,681.1393351539398,-7.99,1
23:59,642924505.0,598.1522201835262,-14.99,1
23:59,642924505.0,585.1622201835262,-12.99,1
23:59,642924505.0,578.1622201835262,-7.0,1
23:59,642924505.0,565.1722201835262,-12.99,1
23:59,395654270.0,-1909.4112028122004,-18.99,6
23:59,395654270.0,-1925.4012028122004,-15.99,1
23:59,395654270.0,-1940.3912028122004,-14.99,1
23:59,395654270.0,-1953.3812028122004,-12.99,1
23:59,395654270.0,-1960.3812028122004,-7.0,1
23:59,344219145.0,7681.04723543961,-15.99,1
23:59,119943495.0,-1235.770062112858,-12.99,1
23:59,119943495.0,-1248.760062112858,-12.99,1
23:59,119943495.0,-1263.750062112858,-14.99,1
23:59,119943495.0,-1271.740062112858,-7.99,1
23:59,119943495.0,-1279.730062112858,-7.99,7
23:59,262767079.0,-855.0932000000003,-18.99,6
23:59,262767079.0,-871.0832000000003,-15.99,1
23:59,262767079.0,-886.0732000000003,-14.99,1
23:59,262767079.0,-986.0732000000004,-100.0,6
23:59,753525749.0,-2247.7583999999997,-12.99,1
23:59,753525749.0,-2260.7483999999995,-12.99,1
23:59,753525749.0,-2273.7383999999993,-12.99,1
23:59,753525749.0,-2279.728399999999,-5.99,1
23:59,596328017.0,-2177.7303499999994,-7.99,7
23:59,596328017.0,-2184.7303499999994,-7.0,1
23:59,596328017.0,-2191.7303499999994,-7.0,1
23:59,596328017.0,-2197.720349999999,-5.99,1
23:59,596328017.0,-2216.710349999999,-18.99,6
23:59,596328017.0,-2316.710349999999,-100.0,6
23:59,736310094.0,-614.639424027426,-15.99,1
23:59,419084831.0,-9.54572552610306,-12.99,1
23:59,419084831.0,-16.545725526103062,-7.0,1
23:59,419084831.0,-24.535725526103064,-7.99,1
23:59,419084831.0,-43.52572552610306,-18.99,6
23:59,663479159.0,5491.333541827709,-15.99,1
23:59,421881811.0,4805.721618076135,-15.99,1
23:59,421881811.0,4790.731618076135,-14.99,1
23:59,421881811.0,4775.741618076136,-14.99,1
23:59,421881811.0,4769.751618076136,-5.99,1
23:59,421881811.0,4750.761618076136,-18.99,6
23:59,349107386.0,-3179.668473194562,-14.99,1
23:59,349107386.0,-3186.668473194562,-7.0,1
23:59,349107386.0,-3201.658473194562,-14.99,1
23:59,349107386.0,-3217.6484731945616,-15.99,1
23:59,349107386.0,-3225.638473194562,-7.99,1
23:59,970298834.0,3394.1474494254794,-15.99,1
23:59,970298834.0,3375.1574494254796,-18.99,6
23:59,970298834.0,3360.16744942548,-14.99,1
23:59,970298834.0,3347.17744942548,-12.99,1
23:59,970298834.0,3341.1874494254803,-5.99,1
23:59,970298834.0,3328.1974494254805,-12.99,1
23:59,163470640.0,1385.213,-15.99,1
23:59,163470640.0,1377.223,-7.99,7
23:59,163470640.0,1358.233,-18.99,6
23:59,163470640.0,1258.233,-100.0,6
23:59,280098744.0,1063.9043778716657,-100.0,6
23:59,552980092.0,392.0447191193375,-15.99,1
23:59,552980092.0,384.0547191193375,-7.99,7
23:59,552980092.0,365.0647191193375,-18.99,6
23:59,552980092.0,359.0747191193375,-5.99,1
23:59,552980092.0,353.0847191193375,-5.99,1
23:59,552980092.0,340.09471911933747,-12.99,1
23:59,593191200.0,1615.414349999999,-18.99,6
23:59,593191200.0,1600.424349999999,-14.99,1
23:59,593191200.0,1587.434349999999,-12.99,1
23:59,593191200.0,1581.444349999999,-5.99,1
23:59,912584712.0,808.1926195447331,-15.99,1
23:59,421475159.0,-209.40973732558743,-7.99,7
23:59,421475159.0,-228.39973732558747,-18.99,6
23:59,994214354.0,10262.952848387067,-15.99,1
23:59,994214354.0,10254.96284838707,-7.99,7
23:59,994214354.0,10247.96284838707,-7.0,1
23:59,698955014.0,1592.618954940912,-7.99,1
23:59,698955014.0,1573.628954940912,-18.99,6
23:59,698955014.0,1560.638954940912,-12.99,1
23:59,698955014.0,1553.638954940912,-7.0,1
23:59,143606916.0,438.0574040291897,-18.99,6
23:59,600585971.0,562.2432499999995,-15.99,1
23:59,600585971.0,543.2532499999995,-18.99,6
23:59,600585971.0,443.2532499999995,-100.0,6
23:59,914806976.0,2413.183250185486,-15.99,1
23:59,914806976.0,2394.1932501854862,-18.99,6
23:59,914806976.0,2387.1932501854862,-7.0,1
23:59,914806976.0,2374.2032501854865,-12.99,1
23:59,914806976.0,2274.2032501854865,-100.0,6
23:59,128030172.0,-345.48607744984986,-7.99,7
23:59,128030172.0,-361.47607744984987,-15.99,1
23:59,336171116.0,-431.5245500000004,-5.99,1
23:59,336171116.0,-446.5145500000005,-14.99,1
23:59,336171116.0,-452.5045500000005,-5.99,1
23:59,173335108.0,714.2539999999995,-7.99,1
23:59,173335108.0,706.2639999999994,-7.99,7
23:59,173335108.0,687.2739999999994,-18.99,6
23:59,173335108.0,681.2839999999994,-5.99,1
23:59,402438092.0,1114.454399999999,-15.99,1
23:59,402438092.0,1106.464399999999,-7.99,1
23:59,402438092.0,1087.474399999999,-18.99,6
23:59,718058208.0,3250.869625576504,-14.99,1
23:59,718058208.0,3237.879625576504,-12.99,1
23:59,718058208.0,3231.8896255765044,-5.99,1
23:59,718058208.0,3215.8996255765046,-15.99,1
23:59,718058208.0,3207.909625576505,-7.99,7
23:59,718058208.0,3188.919625576505,-18.99,6
23:59,105375973.0,-664.4603471810594,-18.99,6
23:59,105375973.0,-680.4503471810594,-15.99,1
23:59,105375973.0,-688.4403471810595,-7.99,7
23:59,441142605.0,2543.7977000000046,-7.99,1
23:59,441142605.0,2528.807700000005,-14.99,1
23:59,441142605.0,2513.817700000005,-14.99,1
23:59,441142605.0,2494.8277000000053,-18.99,6
23:59,250957494.0,845.1604999999988,-15.99,1
23:59,250957494.0,837.1704999999988,-7.99,1
23:59,250957494.0,830.1704999999988,-7.0,1
23:59,250957494.0,815.1804999999988,-14.99,1
23:59,250957494.0,809.1904999999988,-5.99,1
23:59,250957494.0,790.2004999999988,-18.99,6
23:59,250957494.0,690.2004999999988,-100.0,6
23:59,279149837.0,1909.6050499999988,-7.99,1
23:59,279149837.0,1809.6050499999988,-100.0,6
23:59,266777719.0,909.3089337802396,-18.99,6
23:59,469561218.0,40.33894999999916,-7.0,1
23:59,469561218.0,24.348949999999157,-15.99,1
23:59,469561218.0,16.358949999999155,-7.99,7
23:59,469561218.0,-2.631050000000844,-18.99,6
23:59,670102069.0,4401.338965014794,-7.99,7
23:59,331048953.0,180.04636797849366,-18.99,6
23:59,331048953.0,167.05636797849365,-12.99,1
23:59,331048953.0,152.06636797849364,-14.99,1
23:59,331048953.0,137.07636797849364,-14.99,1
23:59,796709231.0,-137.56992210370254,-5.99,1
23:59,796709231.0,-143.55992210370255,-5.99,1
23:59,796709231.0,-149.54992210370256,-5.99,1
23:59,796709231.0,-157.53992210370257,-7.99,1
23:59,796709231.0,-176.52992210370255,-18.99,6
23:59,414454079.0,812.6078500000019,-18.99,6
23:59,414454079.0,804.6178500000019,-7.99,7
23:59,136770968.0,252.16239999999965,-12.99,1
23:59,136770968.0,245.16239999999965,-7.0,1
23:59,136770968.0,232.17239999999964,-12.99,1
23:59,136770968.0,226.18239999999963,-5.99,1
23:59,136770968.0,210.1923999999996,-15.99,1
23:59,136770968.0,191.2023999999996,-18.99,6
23:59,534204159.0,6414.486293176783,-18.99,6
23:59,534204159.0,6406.496293176783,-7.99,7
23:59,973086490.0,10811.692676624656,-7.99,7
23:59,973086490.0,10795.702676624656,-15.99,1
23:59,973086490.0,10780.712676624657,-14.99,1
23:59,973086490.0,10761.722676624657,-18.99,6
23:59,973086490.0,10661.722676624657,-100.0,6
23:59,256002321.0,6518.67460129638,-18.99,6
23:59,769311479.0,7421.050620664428,-7.0,1
23:59,769311479.0,7415.060620664428,-5.99,1
23:59,769311479.0,7399.070620664428,-15.99,1
23:59,769311479.0,7380.080620664428,-18.99,6
23:59,901432314.0,4587.539720218267,-12.99,1
23:59,901432314.0,4572.549720218267,-14.99,1
23:59,901432314.0,4553.559720218267,-18.99,6
23:59,901432314.0,4537.569720218267,-15.99,1
23:59,874506295.0,-1327.731756245572,-18.99,6
23:59,874506295.0,-1343.721756245572,-15.99,1
23:59,874506295.0,-1356.711756245572,-12.99,1
23:59,874506295.0,-1456.711756245572,-100.0,6
23:59,493571342.0,-2349.100880907048,-18.99,6
23:59,493571342.0,-2365.090880907048,-15.99,1
23:59,493571342.0,-2373.0808809070477,-7.99,7
23:59,691012931.0,-1581.077250000001,-7.99,1
23:59,691012931.0,-1600.067250000001,-18.99,6
23:59,691012931.0,-1606.057250000001,-5.99,1
23:59,691012931.0,-1612.047250000001,-5.99,1
23:59,691012931.0,-1627.037250000001,-14.99,1
23:59,969804197.0,-1810.926250000001,-15.99,1
23:59,969804197.0,-1818.916250000001,-7.99,7
23:59,969804197.0,-1837.906250000001,-18.99,6
23:59,254853117.0,4579.151604308447,-18.99,6
23:59,254853117.0,4571.161604308447,-7.99,1
23:59,903953091.0,3653.876038995663,-7.99,1
23:59,903953091.0,3637.886038995663,-15.99,1
23:59,903953091.0,3618.8960389956633,-18.99,6
23:59,903953091.0,3518.8960389956633,-100.0,6
23:59,657528784.0,237.0509000000007,-15.99,1
23:59,657528784.0,229.0609000000007,-7.99,7
23:59,657528784.0,210.07090000000068,-18.99,6
23:59,754141345.0,-2685.470335115762,-15.99,1
23:59,754141345.0,-2693.4603351157616,-7.99,7
23:59,754141345.0,-2706.4503351157614,-12.99,1
23:59,754141345.0,-2725.440335115761,-18.99,6
23:59,754141345.0,-2825.440335115761,-100.0,6
23:59,776108637.0,1296.3447536574956,-18.99,6
23:59,776108637.0,1288.3547536574956,-7.99,1
23:59,776108637.0,1272.3647536574956,-15.99,1
23:59,776108637.0,1259.3747536574956,-12.99,1
23:59,776108637.0,1159.3747536574956,-100.0,6
23:59,548549094.0,-518.1036299265087,-14.99,1
23:59,548549094.0,-531.0936299265087,-12.99,1
23:59,548549094.0,-547.0836299265087,-15.99,1
23:59,679911053.0,3111.1999627290324,-18.99,6
23:59,679911053.0,3096.2099627290327,-14.99,1
23:59,679911053.0,3080.219962729033,-15.99,1
23:59,679911053.0,3072.229962729033,-7.99,7
23:59,223207876.0,1262.3211,-15.99,1
23:59,223207876.0,1243.3311,-18.99,6
23:59,223207876.0,1143.3311,-100.0,6
23:59,122884111.0,-2259.0760830729696,-18.99,6
23:59,122884111.0,-2359.0760830729696,-100.0,6
23:59,122884111.0,-2367.0660830729694,-7.99,1
23:59,122884111.0,-2383.056083072969,-15.99,1
23:59,854513972.0,1567.7487,-15.99,1
23:59,854513972.0,1548.7587,-18.99,6
23:59,248625662.0,-995.5669157151474,-18.99,6
23:59,248625662.0,-1011.5569157151474,-15.99,1
23:59,656781737.0,-5454.9599999999955,-18.99,6
23:59,656781737.0,-5470.949999999995,-15.99,1
23:59,656781737.0,-5478.939999999995,-7.99,7
23:59,819515373.0,2790.5251360637913,-7.99,1
23:59,819515373.0,2771.5351360637915,-18.99,6
23:59,945054126.0,-218.9219,-18.99,6
23:59,945054126.0,-226.9119,-7.99,1
23:59,290818242.0,7495.674048927673,-100.0,6
23:59,290818242.0,7479.684048927673,-15.99,1
23:59,290818242.0,7471.694048927673,-7.99,1
23:59,572136270.0,406.3556493335778,-15.99,1
23:59,593378953.0,755.3196500000051,-7.99,1
23:59,593378953.0,739.3296500000051,-15.99,1
23:59,593378953.0,733.3396500000051,-5.99,1
23:59,593378953.0,727.3496500000051,-5.99,1
23:59,593378953.0,712.3596500000051,-14.99,1
23:59,724997545.0,-54.81905800221831,-15.99,1
23:59,724997545.0,-62.809058002218315,-7.99,1
23:59,873701090.0,1217.029513834908,-14.99,1
23:59,873701090.0,1201.039513834908,-15.99,1
23:59,873701090.0,1193.049513834908,-7.99,1
23:59,873701090.0,1174.059513834908,-18.99,6
23:59,383833857.0,24457.814663311256,-5.99,1
23:59,383833857.0,24451.824663311258,-5.99,1
23:59,383833857.0,24444.824663311258,-7.0,1
23:59,455052690.0,-92.9842600513724,-7.99,1
23:59,455052690.0,-98.9742600513724,-5.99,1
23:59,455052690.0,-105.9742600513724,-7.0,1
23:59,455052690.0,-124.9642600513724,-18.99,6
23:59,895750759.0,-198.4737380756658,-15.99,1
23:59,895750759.0,-206.46373807566584,-7.99,7
23:59,895750759.0,-213.46373807566584,-7.0,1
23:59,895750759.0,-232.45373807566585,-18.99,6
23:59,324046160.0,-540.354333213071,-15.99,1
23:59,324046160.0,-559.344333213071,-18.99,6
23:59,252964502.0,-680.5228224913006,-15.99,1
23:59,280200287.0,-1154.610453386949,-15.99,1
23:59,280200287.0,-1162.600453386949,-7.99,1
23:59,956717493.0,1631.8728776068376,-18.99,6
23:59,956717493.0,1618.8828776068376,-12.99,1
23:59,956717493.0,1603.8928776068376,-14.99,1
23:59,956717493.0,1596.8928776068376,-7.0,1
23:59,956717493.0,1588.9028776068376,-7.99,1
23:59,956717493.0,1580.9128776068376,-7.99,7
23:59,956717493.0,1480.9128776068376,-100.0,6
23:59,992204045.0,12837.341384610583,-15.99,1
23:59,992204045.0,12822.351384610583,-14.99,1
23:59,992204045.0,12815.351384610583,-7.0,1
23:59,992204045.0,12800.361384610584,-14.99,1
23:59,992204045.0,12775.381384610586,-18.99,6
23:59,992204045.0,12675.381384610586,-100.0,6
23:59,603375739.0,1295.379063023267,-15.99,1
23:59,627622066.0,3439.738185693057,-18.99,6
23:59,627622066.0,3431.748185693057,-7.99,1
23:59,627622066.0,3418.7581856930574,-12.99,1
23:59,627622066.0,3412.7681856930576,-5.99,1
23:59,627622066.0,3312.7681856930576,-100.0,6
23:59,120634201.0,4842.5935000000045,-15.99,1
23:59,120634201.0,4827.603500000005,-14.99,1
23:59,120634201.0,4821.613500000005,-5.99,1
23:59,120634201.0,4815.623500000005,-5.99,1
23:59,407574996.0,5404.725478801186,-7.99,1
23:59,407574996.0,5396.735478801186,-7.99,7
23:59,407574996.0,5296.735478801186,-100.0,6
23:59,691789577.0,-367.96485000000007,-18.99,6
23:59,902798190.0,-680.8156344310266,-15.99,1
23:59,631744379.0,-2017.3687594910675,-7.99,1
23:59,631744379.0,-2024.3687594910675,-7.0,1
23:59,631744379.0,-2039.3587594910675,-14.99,1
23:59,631744379.0,-2058.3487594910675,-18.99,6
23:59,802697323.0,15883.598488615064,-7.99,7
23:59,344522228.0,-2766.7519882083925,-15.99,1
23:59,219399150.0,-838.2025269529267,-7.99,1
23:59,219399150.0,-853.1925269529268,-14.99,1
23:59,219399150.0,-860.1925269529268,-7.0,1
23:59,219399150.0,-866.1825269529268,-5.99,1
23:59,219399150.0,-885.1725269529268,-18.99,6
23:59,425730826.0,1841.9694093887197,-5.99,1
23:59,425730826.0,1828.9794093887197,-12.99,1
23:59,425730826.0,1813.9894093887197,-14.99,1
23:59,425730826.0,1800.9994093887196,-12.99,1
23:59,425730826.0,1782.0094093887196,-18.99,6
23:59,913801979.0,688.112779914494,-7.99,1
23:59,913801979.0,669.122779914494,-18.99,6
23:59,913801979.0,569.122779914494,-100.0,6
23:59,799453072.0,-49.99740000000109,-18.99,6
23:59,799453072.0,-65.98740000000109,-15.99,1
23:59,799453072.0,-165.9874000000011,-100.0,6
23:59,799453072.0,-172.9874000000011,-7.0,1
23:59,456221621.0,1103.2153673026282,-15.99,1
23:59,456221621.0,1095.2253673026282,-7.99,1
23:59,456221621.0,1076.2353673026282,-18.99,6
23:59,618514666.0,21046.838820035984,-15.99,1
23:59,618514666.0,21038.848820035982,-7.99,1
23:59,618514666.0,21025.85882003598,-12.99,1
23:59,618514666.0,21006.86882003598,-18.99,6
23:59,519649533.0,26.921816370662327,-7.0,1
23:59,519649533.0,13.931816370662329,-12.99,1
23:59,519649533.0,-5.058183629337671,-18.99,6
23:59,519649533.0,-21.04818362933767,-15.99,1
23:59,519649533.0,-29.038183629337674,-7.99,1
23:59,990461108.0,544.2371686206111,-7.99,7
23:59,990461108.0,529.2471686206111,-14.99,1
23:59,990461108.0,516.2571686206111,-12.99,1
23:59,990461108.0,501.2671686206111,-14.99,1
23:59,990461108.0,495.27716862061106,-5.99,1
23:59,990461108.0,476.28716862061106,-18.99,6
23:59,943329213.0,1796.462088533404,-15.99,1
23:59,943329213.0,1788.472088533404,-7.99,7
23:59,943329213.0,1781.472088533404,-7.0,1
23:59,943329213.0,1766.482088533404,-14.99,1
23:59,943329213.0,1759.482088533404,-7.0,1
23:59,943329213.0,1740.492088533404,-18.99,6
23:59,198051483.0,-1135.7169104088568,-7.0,1
23:59,198051483.0,-1148.7069104088569,-12.99,1
23:59,198051483.0,-1164.6969104088569,-15.99,1
23:59,722971557.0,214.60772084307564,-7.0,1
23:59,722971557.0,207.60772084307564,-7.0,1
23:59,722971557.0,201.61772084307563,-5.99,1
23:59,722971557.0,195.6277208430756,-5.99,1
23:59,722971557.0,179.6377208430756,-15.99,1
23:59,722971557.0,171.6477208430756,-7.99,7
23:59,722971557.0,152.6577208430756,-18.99,6
23:59,310740977.0,-35.38347349266518,-5.99,1
23:59,310740977.0,-50.373473492665184,-14.99,1
23:59,310740977.0,-65.36347349266518,-14.99,1
23:59,310740977.0,-81.35347349266517,-15.99,1
23:59,310740977.0,-89.34347349266517,-7.99,7
23:59,310740977.0,-189.34347349266517,-100.0,6
23:59,347110339.0,-128.3467925031481,-7.0,1
23:59,347110339.0,-136.3367925031481,-7.99,1
23:59,347110339.0,-155.3267925031481,-18.99,6
23:59,954263768.0,-7.479100000000235,-5.99,1
23:59,954263768.0,-20.469100000000235,-12.99,1
23:59,954263768.0,-35.459100000000234,-14.99,1
23:59,954263768.0,-43.44910000000024,-7.99,7
23:59,954263768.0,-59.43910000000024,-15.99,1
23:59,891513205.0,962.9584796590692,-7.0,1
23:59,891513205.0,955.9584796590692,-7.0,1
23:59,891513205.0,940.9684796590692,-14.99,1
23:59,891513205.0,924.9784796590692,-15.99,1
23:59,891513205.0,916.9884796590692,-7.99,1
23:59,891513205.0,897.9984796590692,-18.99,6
23:59,891513205.0,797.9984796590692,-100.0,6
23:59,821971408.0,1486.9017213748782,-12.99,1
23:59,821971408.0,1470.9117213748782,-15.99,1
23:59,821971408.0,1462.9217213748782,-7.99,1
23:59,821971408.0,1443.9317213748782,-18.99,6
23:59,337184232.0,-1328.8190000000004,-7.99,1
23:59,337184232.0,-1428.8190000000004,-100.0,6
23:59,337184232.0,-1447.8090000000004,-18.99,6
23:59,337184232.0,-1453.7990000000004,-5.99,1
23:59,337184232.0,-1468.7890000000004,-14.99,1
23:59,337184232.0,-1474.7790000000005,-5.99,1
23:59,897714622.0,8923.08227145535,-15.99,1
23:59,897714622.0,8910.09227145535,-12.99,1
23:59,897714622.0,8895.102271455351,-14.99,1
23:59,897714622.0,8880.112271455351,-14.99,1
23:59,897714622.0,8867.122271455351,-12.99,1
23:59,349614277.0,1661.9371999999996,-15.99,1
23:59,349614277.0,1655.9471999999996,-5.99,1
23:59,349614277.0,1636.9571999999996,-18.99,6
23:59,385685918.0,529.5499408415524,-15.99,1
23:59,385685918.0,521.5599408415524,-7.99,7
23:59,385685918.0,502.5699408415523,-18.99,6
23:59,385685918.0,487.57994084155234,-14.99,1
23:59,385685918.0,472.58994084155233,-14.99,1
23:59,639420537.0,-1415.45895,-18.99,6
23:59,639420537.0,-1423.44895,-7.99,7
23:59,639420537.0,-1431.43895,-7.99,1
23:59,639420537.0,-1437.42895,-5.99,1
23:59,639420537.0,-1452.41895,-14.99,1
23:59,188263947.0,1135.8306500000006,-18.99,6
23:59,425964226.0,3865.010650000002,-18.99,6
23:59,425964226.0,3849.020650000002,-15.99,1
23:59,425964226.0,3749.020650000002,-100.0,6
23:59,426466211.0,-3048.41325,-18.99,6
23:59,426466211.0,-3064.40325,-15.99,1
23:59,426466211.0,-3164.40325,-100.0,6
23:59,681955876.0,-1111.0881000000004,-12.99,1
23:59,681955876.0,-1119.0781000000004,-7.99,1
23:59,392790315.0,-4088.011394372066,-18.99,6
23:59,392790315.0,-4096.001394372066,-7.99,1
23:59,392790315.0,-4111.991394372066,-15.99,1
23:59,392790315.0,-4126.981394372066,-14.99,1
23:59,392790315.0,-4226.981394372066,-100.0,6
23:59,780463728.0,2956.7375709422395,-7.0,1
23:59,780463728.0,2943.7475709422397,-12.99,1
23:59,780463728.0,2936.7475709422397,-7.0,1
23:59,228136274.0,-372.35530000000085,-7.99,7
23:59,228136274.0,-380.34530000000086,-7.99,1
23:59,228136274.0,-480.34530000000086,-100.0,6
23:59,478412511.0,889.7577701974608,-100.0,6
23:59,478412511.0,873.7677701974608,-15.99,1
23:59,478412511.0,854.7777701974608,-18.99,6
23:59,382862215.0,59.2489999999999,-15.99,1
23:59,382862215.0,52.2489999999999,-7.0,1
23:59,382862215.0,46.2589999999999,-5.99,1
23:59,382862215.0,31.2689999999999,-14.99,1
23:59,382862215.0,25.278999999999897,-5.99,1
23:59,382862215.0,6.2889999999998984,-18.99,6
23:59,382862215.0,-93.7110000000001,-100.0,6
23:59,653640811.0,17202.735087902434,-15.99,1
23:59,653640811.0,17194.745087902433,-7.99,1
23:59,653640811.0,17175.75508790243,-18.99,6
23:59,719586818.0,19537.34442480164,-15.99,1
23:59,555393405.0,-814.0748000000001,-18.99,6
23:59,555393405.0,-822.0648000000001,-7.99,1
23:59,555393405.0,-838.0548000000001,-15.99,1
23:59,555393405.0,-845.0548000000001,-7.0,1
23:59,555393405.0,-945.0548,-100.0,6
23:59,909669130.0,491.88288473676664,-15.99,1
23:59,909669130.0,483.89288473676663,-7.99,7
23:59,909669130.0,468.9028847367666,-14.99,1
23:59,909669130.0,453.9128847367666,-14.99,1
23:59,220183538.0,1231.1334499999996,-15.99,1
23:59,220183538.0,1223.1434499999996,-7.99,1
23:59,624500124.0,3995.524769866798,-7.99,7
23:59,624500124.0,3982.5347698667983,-12.99,1
23:59,624500124.0,3975.5347698667983,-7.0,1
23:59,624500124.0,3968.5347698667983,-7.0,1
23:59,624500124.0,3953.5447698667986,-14.99,1
23:59,624500124.0,3934.554769866799,-18.99,6
23:59,801500539.0,-2996.803699999999,-15.99,1
23:59,801500539.0,-3015.793699999999,-18.99,6
23:59,180616589.0,1074.735648033954,-14.99,1
23:59,180616589.0,1068.745648033954,-5.99,1
23:59,180616589.0,1062.755648033954,-5.99,1
23:59,180616589.0,1056.765648033954,-5.99,1
23:59,180616589.0,1040.775648033954,-15.99,1
23:59,180616589.0,1021.785648033954,-18.99,6
23:59,890567652.0,91.4385996796006,-7.99,1
23:59,980500334.0,-698.6244338929041,-7.99,1
23:59,742223719.0,1243.6117573048027,-5.99,1
23:59,742223719.0,1237.6217573048027,-5.99,1
23:59,742223719.0,1231.6317573048027,-5.99,1
23:59,742223719.0,1218.6417573048027,-12.99,1
23:59,742223719.0,1202.651757304803,-15.99,1
23:59,742223719.0,1183.661757304803,-18.99,6
23:59,490790931.0,703.1923499999987,-15.99,1
23:59,490790931.0,695.2023499999987,-7.99,7
23:59,490790931.0,680.2123499999987,-14.99,1
23:59,490790931.0,665.2223499999986,-14.99,1
23:59,490790931.0,650.2323499999986,-14.99,1
23:59,490790931.0,631.2423499999986,-18.99,6
23:59,490790931.0,531.2423499999986,-100.0,6
23:59,703537476.0,1053.916249999999,-7.99,1
23:59,703537476.0,1046.916249999999,-7.0,1
23:59,703537476.0,1040.926249999999,-5.99,1
23:59,703537476.0,1021.9362499999992,-18.99,6
23:59,989506909.0,-2384.6098707594374,-15.99,1
23:59,838830098.0,1066.7371420877844,-15.99,1
23:59,838830098.0,1058.7471420877844,-7.99,1
23:59,838830098.0,1051.7471420877844,-7.0,1
23:59,838830098.0,1036.7571420877844,-14.99,1
23:59,838830098.0,1017.7671420877844,-18.99,6
23:59,838830098.0,917.7671420877844,-100.0,6
23:59,517190750.0,3494.1410899154125,-15.99,1
23:59,964913066.0,-2136.8697,-7.99,7
23:59,964913066.0,-2152.8597,-15.99,1
23:59,964913066.0,-2158.8497,-5.99,1
23:59,964913066.0,-2164.8396999999995,-5.99,1
23:59,964913066.0,-2171.8396999999995,-7.0,1
23:59,964913066.0,-2184.8296999999993,-12.99,1
23:59,964913066.0,-2203.819699999999,-18.99,6
23:59,668175891.0,1100.887073158499,-18.99,6
23:59,668175891.0,1000.8870731584992,-100.0,6
23:59,668175891.0,985.8970731584992,-14.99,1
23:59,668175891.0,979.9070731584992,-5.99,1
23:59,668175891.0,963.9170731584992,-15.99,1
23:59,124125096.0,507.9784943878024,-18.99,6
23:59,124125096.0,491.98849438780235,-15.99,1
23:59,124125096.0,483.99849438780234,-7.99,1
23:59,124125096.0,469.00849438780233,-14.99,1
23:59,124125096.0,463.0184943878023,-5.99,1
23:59,124125096.0,456.0184943878023,-7.0,1
23:59,993238248.0,-226.0724873928839,-15.99,1
23:59,993238248.0,-234.0624873928839,-7.99,1
23:59,993238248.0,-247.0524873928839,-12.99,1
23:59,993238248.0,-347.0524873928839,-100.0,6
23:59,709608057.0,3501.9390388538086,-15.99,1
23:59,709608057.0,3493.949038853809,-7.99,1
23:59,709608057.0,3480.959038853809,-12.99,1
23:59,709608057.0,3473.959038853809,-7.0,1
23:59,709608057.0,3454.9690388538093,-18.99,6
23:59,365608668.0,1096.9021138595588,-15.99,1
23:59,365608668.0,1077.9121138595588,-18.99,6
23:59,365608668.0,977.9121138595588,-100.0,6
23:59,578131296.0,603.4567694440439,-12.99,1
23:59,578131296.0,587.4667694440438,-15.99,1
23:59,578131296.0,579.4767694440438,-7.99,1
23:59,578131296.0,560.4867694440438,-18.99,6
23:59,858989281.0,27258.35408933392,-15.99,1
23:59,143003091.0,21964.056888623894,-18.99,6
23:59,143003091.0,21949.066888623896,-14.99,1
23:59,143003091.0,21933.076888623895,-15.99,1
23:59,655450953.0,-2664.61737845553,-15.99,1
23:59,655450953.0,-2683.6073784555297,-18.99,6
23:59,704517789.0,17458.819066463024,-15.99,1
23:59,704517789.0,17439.829066463022,-18.99,6
23:59,305778936.0,12007.32851129507,-18.99,6
23:59,305778936.0,11992.338511295073,-14.99,1
23:59,305778936.0,11985.338511295073,-7.0,1
23:59,305778936.0,11978.338511295073,-7.0,1
23:59,305778936.0,11878.338511295073,-100.0,6
23:59,804317849.0,-3568.1091330205204,-7.99,1
23:59,804317849.0,-3584.09913302052,-15.99,1
23:59,804317849.0,-3603.08913302052,-18.99,6
23:59,169689461.0,1803.1460999999993,-15.99,1
23:59,169689461.0,1795.1560999999992,-7.99,7
23:59,169689461.0,1695.1560999999992,-100.0,6
23:59,169689461.0,1676.1660999999992,-18.99,6
23:59,647472692.0,25172.03986836512,-7.99,7
23:59,647472692.0,25156.04986836512,-15.99,1
23:59,647472692.0,25137.05986836512,-18.99,6
23:59,867987292.0,4499.504184759218,-14.99,1
23:59,867987292.0,4492.504184759218,-7.0,1
23:59,867987292.0,4479.514184759219,-12.99,1
23:59,867987292.0,4460.524184759219,-18.99,6
23:59,867987292.0,4444.534184759219,-15.99,1
23:59,550169791.0,21361.874202653136,-18.99,6
23:59,550169791.0,21346.884202653135,-14.99,1
23:59,550169791.0,21333.894202653133,-12.99,1
23:59,933745726.0,389.3085564293233,-7.99,1
23:59,933745726.0,381.3185564293233,-7.99,7
23:59,933745726.0,362.32855642932327,-18.99,6
23:59,933745726.0,355.32855642932327,-7.0,1
23:59,933745726.0,340.33855642932326,-14.99,1
23:59,933745726.0,333.33855642932326,-7.0,1
23:59,933745726.0,318.34855642932325,-14.99,1
23:59,836110591.0,7452.976398686184,-15.99,1
23:59,836110591.0,7352.976398686184,-100.0,6
23:59,836110591.0,7345.976398686184,-7.0,1
23:59,836110591.0,7330.986398686184,-14.99,1
23:59,639409800.0,34679.086010524254,-7.99,1
23:59,639409800.0,34663.096010524256,-15.99,1
23:59,639409800.0,34644.10601052426,-18.99,6
23:59,773633520.0,651.7455609385115,-15.99,1
23:59,901037631.0,2468.5393230964064,-100.0,6
23:59,901037631.0,2460.5493230964066,-7.99,1
23:59,901037631.0,2444.559323096407,-15.99,1
23:59,901037631.0,2425.569323096407,-18.99,6
23:59,263882093.0,-1113.7163000000005,-15.99,1
23:59,263882093.0,-1128.7063000000005,-14.99,1
23:59,263882093.0,-1135.7063000000005,-7.0,1
23:59,263882093.0,-1148.6963000000003,-12.99,1
23:59,263882093.0,-1155.6963000000003,-7.0,1
23:59,263882093.0,-1255.6963000000003,-100.0,6
23:59,263882093.0,-1274.6863000000003,-18.99,6
23:59,493640090.0,-2333.47595,-15.99,1
23:59,493640090.0,-2341.46595,-7.99,7
23:59,493640090.0,-2356.4559499999996,-14.99,1
23:59,493640090.0,-2371.4459499999994,-14.99,1
23:59,493640090.0,-2386.435949999999,-14.99,1
23:59,493640090.0,-2399.425949999999,-12.99,1
23:59,493640090.0,-2499.425949999999,-100.0,6
23:59,322720763.0,8100.903192702044,-7.99,1
23:59,828532554.0,533.4231013660719,-5.99,1
23:59,828532554.0,514.4331013660719,-18.99,6
23:59,828532554.0,498.4431013660719,-15.99,1
23:59,834383043.0,5748.105185073417,-18.99,6
23:59,834383043.0,5732.115185073417,-15.99,1
23:59,834383043.0,5632.115185073417,-100.0,6
23:59,587202562.0,812.7270994170688,-18.99,6
23:59,587202562.0,804.7370994170687,-7.99,1
23:59,587202562.0,798.7470994170687,-5.99,1
23:59,587202562.0,785.7570994170687,-12.99,1
23:59,197779140.0,8.34229999999964,-7.0,1
23:59,197779140.0,2.352299999999639,-5.99,1
23:59,197779140.0,-97.64770000000036,-100.0,6
23:59,197779140.0,-116.63770000000036,-18.99,6
23:59,197779140.0,-132.62770000000037,-15.99,1
23:59,627723633.0,-1710.2890780037626,-7.99,1
23:59,627723633.0,-1810.2890780037624,-100.0,6
23:59,899742927.0,12936.49203249545,-7.99,7
23:59,899742927.0,12928.50203249545,-7.99,1
23:59,899742927.0,12909.51203249545,-18.99,6
23:59,899742927.0,12809.51203249545,-100.0,6
23:59,893134725.0,1784.2876629732089,-18.99,6
23:59,893134725.0,1768.2976629732088,-15.99,1
23:59,893134725.0,1753.3076629732088,-14.99,1
23:59,893134725.0,1746.3076629732088,-7.0,1
23:59,893134725.0,1739.3076629732088,-7.0,1
23:59,629078930.0,2214.291290657553,-18.99,6
23:59,629078930.0,2198.301290657553,-15.99,1
23:59,629078930.0,2190.3112906575534,-7.99,7
23:59,713641917.0,1502.47852784912,-15.99,1
23:59,713641917.0,1494.48852784912,-7.99,7
23:59,713641917.0,1475.49852784912,-18.99,6
23:59,358846516.0,968.379672527218,-5.99,1
23:59,358846516.0,955.389672527218,-12.99,1
23:59,358846516.0,940.399672527218,-14.99,1
23:59,358846516.0,927.409672527218,-12.99,1
23:59,358846516.0,911.419672527218,-15.99,1
23:59,358846516.0,892.4296725272179,-18.99,6
23:59,967989787.0,-11.57091735927277,-100.0,6
23:59,162370388.0,-2241.9854,-15.99,1
23:59,162370388.0,-2249.9754,-7.99,7
23:59,162370388.0,-2268.9653999999996,-18.99,6
23:59,346874167.0,642.5450999999991,-18.99,6
23:59,346874167.0,627.5550999999991,-14.99,1
23:59,346874167.0,612.5650999999991,-14.99,1
23:59,346874167.0,596.5750999999991,-15.99,1
23:59,737645298.0,-2452.501699999999,-15.99,1
23:59,737645298.0,-2459.501699999999,-7.0,1
23:59,737645298.0,-2474.4916999999987,-14.99,1
23:59,737645298.0,-2481.4916999999987,-7.0,1
23:59,737645298.0,-2496.4816999999985,-14.99,1
23:59,737645298.0,-2596.4816999999985,-100.0,6
23:59,737645298.0,-2615.4716999999982,-18.99,6
23:59,618138606.0,1818.0743472714344,-15.99,1
23:59,618138606.0,1805.0843472714344,-12.99,1
23:59,618138606.0,1786.0943472714346,-18.99,6
23:59,618138606.0,1686.0943472714346,-100.0,6
23:59,429235692.0,-1191.622,-15.99,1
23:59,429235692.0,-1199.612,-7.99,1
23:59,364396689.0,-465.87425,-18.99,6
23:59,364396689.0,-472.87425,-7.0,1
23:59,364396689.0,-487.86425,-14.99,1
23:59,364396689.0,-508.84425,-5.99,1
23:59,749371623.0,-2532.4116535173425,-7.99,1
23:59,338022396.0,924.4108893757392,-18.99,6
23:59,354894456.0,-35.570000000000384,-14.99,1
23:59,354894456.0,-51.560000000000386,-15.99,1
23:59,354894456.0,-70.55000000000038,-18.99,6
00:12,851181128.0,5207.292276484336,-21.58,9
00:15,726913482.0,196.0551014735239,-33.14,9
00:16,873693307.0,10197.321650307937,-25.32,2
00:16,858989281.0,27238.37408933392,-19.98,9
00:17,585596026.0,174.52433387667006,-27.05,5
00:19,169006407.0,12107.12849387026,-50.26,5
00:29,450896297.0,13698.32616376906,-28.9,9
00:31,633345190.0,7759.953318842052,-30.43,9
00:35,806358207.0,12572.815218880669,-20.54,2
00:35,887853850.0,11164.792156152718,-32.85,5
00:38,987656636.0,6440.680448258677,-16.42,2
00:38,235881534.0,13206.674758690193,-6.21,4
00:42,409971170.0,2842.620947687682,-3.68,7
00:48,264550521.0,10563.679421147786,-25.64,2
00:49,709142813.0,1113.779799999999,-22.45,9
00:51,905860285.0,18895.450210221727,-32.8,5
00:59,853907490.0,7399.688629543602,-74.47,5
01:04,324224854.0,3302.3041640001006,-8.98,7
01:09,572384506.0,11254.907021642768,-35.65,9
01:14,534204159.0,6377.021099942184,-29.48,8
01:15,647936800.0,745.5249669842249,-13.86,4
01:39,785210466.0,2501.942256969546,-36.37,2
01:41,836110591.0,7287.666398686184,-43.32,9
01:44,651756497.0,13737.316339878284,-53.06,7
01:49,534325901.0,6973.4687440893495,-57.88,5
01:51,815385232.0,10268.91724782533,-45.54,2
01:54,482513594.0,6728.759480098633,-7.94,5
02:00,500043411.0,13745.465080924105,-16.07,7
02:04,623156843.0,6009.096915441173,-40.75,2
02:05,730002588.0,14022.50731359715,-0.44,5
02:11,290818242.0,7434.903897083393,-36.79,7
02:25,802697323.0,15853.618488615066,-29.98,9
02:28,117273481.0,9511.546862292542,-18.93,8
02:34,203466392.0,3198.8690217553803,-7.77,5
02:35,471897866.0,8874.910040574423,-4.08,4
02:36,473820682.0,11722.29800750199,-6.14,7
02:40,131388684.0,22093.186403997697,-61.81,2
02:40,970298834.0,3297.305286764242,-30.89,7
02:45,145387690.0,6426.183420460425,-27.95,9
02:47,518474507.0,15424.725134426217,-22.1,9
02:48,187541224.0,2728.525500336543,-38.25,9
02:50,705848712.0,26058.470254779368,-25.84,5
02:53,719586818.0,19524.399724968072,-12.94,8
02:54,779236304.0,1257.3975954795326,-19.03,9
02:55,519644021.0,3465.4157527222787,-1.54,8
02:59,558875206.0,3346.9162791022163,-25.31,2
03:00,949032480.0,5098.275399610855,-25.33,9
03:07,758160963.0,8423.928897328988,-14.14,2
03:11,899742927.0,12788.784065739515,-20.73,2
03:16,145387690.0,6387.6045221508075,-38.58,2
03:19,496395938.0,13106.352920231611,-19.66,7
03:20,809499628.0,16935.514900003498,-19.7,9
03:21,237493332.0,14714.627394494952,-18.29,9
03:25,624500124.0,3920.8695138464977,-13.69,7
03:28,216285378.0,23676.86938463492,-38.72,9
03:29,586315521.0,12465.47752371608,-11.37,7
03:34,417850087.0,17540.514804801707,-2.12,2
03:34,287480331.0,12871.86040417061,-33.0,9
03:36,489964679.0,22288.9795988313,-31.19,9
03:38,500043411.0,13728.225080924103,-17.24,9
03:45,985188462.0,725.3627887112248,-25.97,9
03:46,874431242.0,10010.508625778077,-25.89,9
03:48,601627384.0,5031.950503803205,-26.16,5
03:48,130154096.0,1493.8703820134183,-62.93,7
03:50,550169791.0,21316.859638786213,-17.03,5
03:51,383833857.0,24440.179840100085,-4.64,5
03:55,399144202.0,2995.539148394901,-33.14,9
03:57,709608057.0,3411.0390388538094,-43.93,9
03:58,667367404.0,9635.551582417123,-29.16,2
03:58,949032480.0,5093.738096417496,-4.54,2
03:58,143383029.0,-220.78116934766135,-26.88,9
03:59,910730524.0,8230.659948667713,-45.03,7
04:01,407574996.0,5249.828224210992,-46.91,5
04:03,366550080.0,25752.24944634537,-51.15,7
04:04,383625050.0,6445.359795958787,-33.4,2
04:10,851181128.0,5179.613124885358,-27.68,7
04:13,769311479.0,7367.964703502261,-12.12,8
04:17,108563213.0,23624.984472926175,-36.8,7
04:18,129018172.0,8930.579896282195,-58.6,4
04:18,237493332.0,14687.815660937928,-26.81,2
04:20,679911053.0,3059.564891547145,-12.67,4
04:29,187541224.0,2701.72000811304,-26.81,7
04:30,532478725.0,5240.110229165134,-33.09,9
04:32,832564361.0,16195.687975369949,-7.99,7
04:43,930277104.0,10648.639680678543,-1.68,2
04:43,824916823.0,9214.508079830252,-15.45,5
04:49,308505160.0,14562.41787712552,-14.93,2
04:52,270374623.0,10503.266088936783,-12.95,5
04:57,779946617.0,16796.219925656707,-7.73,5
04:59,668329719.0,9011.425911468896,-12.43,7
04:59,195895574.0,7646.121025060883,-21.74,9
04:59,298000165.0,25065.40000644025,-36.34,5
05:02,822250278.0,7589.331630907275,-23.61,5
05:03,795847804.0,22891.333850674167,-32.25,7
05:04,183888402.0,18313.22298802294,-26.42,9
05:05,198946608.0,6918.325162265428,-14.55,7
05:08,196289502.0,15712.315007739026,-3.47,7
05:08,245690309.0,9802.222812589223,-23.62,5
05:12,532478725.0,5222.428308856673,-17.68,7
05:13,873701090.0,1144.9508067897723,-29.11,2
05:14,196289502.0,15696.935007739026,-15.38,9
05:15,187111705.0,7039.10442890696,-0.54,5
05:16,940569402.0,6632.146492382451,-33.26,2
05:21,766941757.0,10108.11165420135,-39.33,9
05:24,310375875.0,4562.94996120708,-0.12,2
05:25,613729471.0,9222.903188156715,-8.62,5
05:27,559995067.0,4001.460857673037,-56.01,7
05:30,256002321.0,6505.434601296381,-13.24,9
05:36,704517789.0,17425.237808394006,-14.59,2
05:39,441274121.0,13145.17640602232,-26.04,7
05:41,785749304.0,8793.261522320243,-10.76,7
05:42,660561861.0,1170.54978743765,-22.95,2
05:43,461990622.0,10530.8407595541,-7.96,5
05:46,510101371.0,13442.55132114884,-38.57,9
05:48,547010927.0,23234.481805952175,-30.65,9
05:51,683319988.0,8160.104313272152,-26.65,9
05:52,844835978.0,9935.771938921,-21.28,7
05:52,609939116.0,7640.171885528362,-46.38,2
06:07,108931112.0,14202.903154795787,-28.17,9
06:08,874431242.0,9995.88049460054,-14.63,8
06:08,541639148.0,5113.944170735479,-8.12,2
06:09,588565416.0,7650.934008600479,-8.56,7
06:11,679662108.0,16154.77885807078,-12.02,5
06:11,975345315.0,35091.52294286371,-84.74,5
06:13,678851253.0,3855.0780680629505,-28.29,5
06:13,113747882.0,12455.823496438026,-27.8,7
06:14,912705941.0,18486.40297687836,-25.28,7
06:15,587225252.0,7767.276500358111,-34.34,7
06:16,581655972.0,42144.81143604193,-70.04,5
06:16,286484726.0,1152.0985725793273,-0.65,7
06:19,454356905.0,3269.351765222882,-41.38,9
06:22,480557476.0,11396.251997742494,-2.45,8
06:26,683319988.0,8125.832796850574,-34.27,5
06:28,170637730.0,3267.6205379111825,-13.36,2
06:34,706250160.0,11932.886954426953,-1.15,2
06:41,259015404.0,2166.909184302661,-23.59,9
06:42,749378808.0,6107.716454255164,-29.88,9
06:52,752362502.0,10864.619751878572,-2.21,7
06:53,108481285.0,8740.758543597589,-47.16,8
06:53,845648250.0,294.95684999999946,-20.9,9
06:54,836110591.0,7246.538850244705,-41.13,5
07:02,124102251.0,4275.012097239023,-27.96,5
07:04,736340277.0,8823.260054828788,-61.9,8
07:05,675806859.0,7052.891067181562,-6.12,2
07:06,282837512.0,13974.180545831332,-39.92,2
07:06,718058208.0,3164.6045528466807,-24.32,7
07:06,179173981.0,7048.422190049186,-22.92,4
07:06,284905540.0,7830.750902505019,-30.4,2
07:06,435984758.0,5612.245937124246,-30.82,2
07:07,229205098.0,7690.057913194845,-5.03,7
07:16,994214354.0,10238.4630382494,-9.5,7
07:18,749378808.0,6080.510095015426,-27.21,7
07:19,973086490.0,10655.02697096182,-6.7,7
07:19,984783496.0,14602.627214877384,-19.19,9
07:27,195895574.0,7637.86993790824,-8.25,4
07:27,259015404.0,2164.8471632040155,-2.06,8
07:29,699139822.0,1918.0134864856827,-17.68,7
07:32,678330503.0,3301.1598835981267,-19.72,2
07:33,414805878.0,13604.960118594234,-30.18,9
07:35,213112754.0,7133.145322816018,-30.44,8
07:39,822135975.0,11421.050174302123,-49.29,7
07:42,518474507.0,15418.97114930045,-5.75,2
07:46,419550103.0,18901.84660905829,-4.21,5
07:47,252760664.0,7111.273380637775,-48.22,5
07:50,822718326.0,11204.65230721936,-6.34,7
07:52,450896297.0,13652.854482699811,-45.47,7
07:54,188263947.0,1097.3806500000003,-38.45,9
07:55,812692024.0,3818.702857948952,-53.9,2
08:01,348325817.0,10379.358745031885,-5.59,2
08:04,414805878.0,13602.61478422754,-2.35,7
08:09,558119802.0,32522.566692761084,-27.94,9
08:10,547010927.0,23171.588031674033,-62.89,7
08:15,364357875.0,7981.652776080191,-79.9,7
08:17,776431321.0,3551.984402412706,-11.22,7
08:18,408057540.0,5294.7993081579,-8.02,7
08:24,522188082.0,8390.835870661067,-66.64,2
08:40,126929801.0,2385.37044806513,-54.18,7
08:42,305778936.0,11870.838482991823,-7.5,7
08:42,489964679.0,22278.066433998945,-10.91,5
08:45,842682241.0,6294.601606557324,-5.48,2
08:49,558119802.0,32476.519658348552,-46.05,2
08:55,146909202.0,6138.385082069184,-27.94,7
09:03,494789005.0,3414.19405696252,-4.26,5
09:05,370521542.0,26037.03296341989,-7.16,5
09:10,151968462.0,9295.553675044826,-53.32,5
09:12,386729293.0,30362.077101643405,-49.53,5
09:13,283027736.0,83.04424397017284,-19.98,4
09:13,361201224.0,3381.930232067893,-13.03,7
09:15,534204159.0,6361.643759942184,-15.38,4
09:16,344843570.0,-7.824317509333801,-6.0,7
09:17,587202562.0,765.7670994170687,-19.99,4
09:17,604334058.0,866.3752999999995,-56.97,4
09:18,346874167.0,576.6050999999991,-19.97,7
09:21,218795010.0,452.4014499999996,-122.62,2
09:21,757115616.0,2312.810000000003,-5.99,7
09:21,722971557.0,95.7477208430756,-56.91,1
09:22,556631012.0,895.0989230856783,-19.99,4
09:22,938992364.0,598.1426437313995,-26.04,4
09:22,183546640.0,406.24069734773394,-28.96,1
09:22,709142813.0,1046.8697999999993,-66.91,7
09:24,227104649.0,2941.9330543161777,-41.05,4
09:24,516051449.0,1904.048287516744,-24.96,1
09:24,711140907.0,1229.5005999999994,-59.98,4
09:25,535744551.0,1430.7455659956263,-6.99,4
09:25,769311479.0,7357.94470350226,-10.02,1
09:25,250895529.0,2193.516082469288,-130.98,6
09:26,752362502.0,10847.609751878572,-17.01,7
09:27,570269025.0,3298.8715333598893,-23.97,1
09:27,147508204.0,361.6497177818866,-18.97,7
09:27,154246234.0,195.44489210210423,-33.95,7
09:28,229205098.0,7661.547913194845,-28.51,7
09:28,384497904.0,770.3890499999992,-25.0,6
09:29,266777719.0,903.2989337802396,-6.01,1
09:30,446720287.0,17.78344081840561,-185.98,2
09:30,596171893.0,335.3117448255111,-41.95,7
09:30,603721739.0,1588.2018994831842,-21.97,7
09:30,221868392.0,5737.107238586128,-79.57,7
09:30,218795010.0,350.4014499999996,-102.0,2
09:30,629078930.0,2166.351290657554,-23.96,7
09:30,667367404.0,9596.881582417123,-38.67,6
09:31,627622066.0,3285.798185693058,-26.97,7
09:33,909676212.0,1344.141169740084,-254.1,2
09:33,971010829.0,400.6112564442453,-9.98,7
09:34,678726554.0,465.9357523483896,-32.96,1
09:34,653640811.0,17153.76508790243,-21.99,1
09:35,549414742.0,7744.440169225654,-32.56,4
09:35,170637730.0,3243.9025379111827,-23.72,4
09:36,700138124.0,6155.91168243974,-23.65,2
09:36,514362267.0,526.4773191070603,-31.49,4
09:38,331048953.0,66.15636797849363,-70.92,7
09:38,785210466.0,2486.9522569695464,-14.99,4
09:38,630691258.0,339.6765448748413,-21.98,4
09:40,446720287.0,-26.71655918159439,-44.5,2
09:41,130522384.0,-446.7238156208604,-21.96,7
09:41,280098744.0,1041.4243778716657,-22.48,4
09:43,637433131.0,314.31039999999916,-131.98,6
09:43,654329190.0,204.1144009485193,-40.95,1
09:44,986774156.0,3935.206931625768,-15.97,7
09:44,719586818.0,19333.99972496807,-190.4,2
09:45,331450202.0,7656.4596776465405,-29.04,7
09:45,605116158.0,2785.9572000000007,-109.0,2
09:45,897714622.0,8865.712862608838,-1.41,7
09:45,581655972.0,41943.21143604193,-201.6,2
09:47,134461671.0,5797.00193433876,-20.03,6
09:47,138351025.0,-595.1699000000003,-65.77,2
09:49,938992364.0,550.1626437313995,-47.98,1
09:49,868377987.0,2863.959545877851,-41.65,2
09:50,373163757.0,11721.031796728535,-295.4,2
09:50,925659248.0,-501.9101392295712,-49.99,4
09:51,844835978.0,9918.791938921002,-16.98,4
09:51,117273481.0,9476.59686229254,-34.95,7
09:52,873701090.0,1142.9448067897724,-2.01,4
09:53,494156462.0,-241.7299864817604,-106.87,2
09:54,849096144.0,2625.809858910518,-149.98,6
09:55,490790931.0,491.29234999999863,-39.95,7
09:56,858989281.0,27171.873371419137,-66.5,5
09:58,585596026.0,143.57433387667007,-30.95,7
09:58,603375739.0,1279.409063023267,-15.97,7
09:58,535744551.0,1409.7755659956265,-20.97,7
09:59,429556122.0,6259.531750000004,-45.08,6
09:59,681955876.0,-1177.2031000000004,-58.12,2
10:00,280098744.0,1006.4243778716656,-35.0,6
10:01,668692488.0,2395.740903563903,-52.99,4
10:02,722971557.0,29.26772084307559,-66.48,4
10:02,939972497.0,117.95325860001076,-35.95,1
10:03,518466565.0,941.4864499999996,-35.0,6
10:03,909676212.0,1227.241169740084,-116.9,2
10:05,218795010.0,279.1514499999996,-71.25,2
10:05,303843160.0,593.9081000000017,-5.99,1
10:07,660874296.0,2550.0774499608474,-9.48,4
10:07,699997811.0,2018.8652000000036,-20.96,1
10:07,446720287.0,-116.69655918159438,-89.98,2
10:08,618138606.0,1673.1043472714346,-12.99,6
10:10,490790931.0,481.3023499999986,-9.99,4
10:10,859264768.0,502.3750837819384,-19.99,4
10:11,188263947.0,989.0056500000004,-108.38,2
10:12,116169597.0,1389.3669499999996,-49.99,4
10:12,492215823.0,2504.1093338154437,-52.11,4
10:13,681955876.0,-1194.0781000000004,-16.88,2
10:13,703478110.0,4897.65595432897,-9.98,7
10:13,261793952.0,576.6212602038148,-65.04,6
10:14,442079728.0,1042.665119219314,-85.99,2
10:14,715068825.0,131.2869999999998,-74.62,2
10:16,744398361.0,897.0659999999998,-25.0,2
10:17,154246234.0,45.46489210210424,-149.98,2
10:17,867679563.0,112.57075370171586,-34.98,4
10:17,939972497.0,93.98325860001076,-23.97,4
10:18,524425303.0,-109.99450000000112,-74.5,2
10:19,821971408.0,1308.9417213748782,-134.99,2
10:20,987229118.0,4788.958762694481,-1.5,4
10:20,760704118.0,1559.4923127174886,-34.99,2
10:20,667367404.0,9595.324042417124,-1.56,4
10:20,386277162.0,441.9699999999994,-37.95,7
10:20,781554833.0,2187.4724319437237,-51.99,2
10:21,874431242.0,9888.08049460054,-107.8,2
10:21,918772878.0,-307.8995172453212,-269.5,2
10:21,626989363.0,972.5949633173752,-63.98,2
10:22,943829984.0,348.0365091134572,-31.99,2
10:23,442079728.0,1004.685119219314,-37.98,2
10:24,176922958.0,1026.9895471976497,-86.25,2
10:24,695607232.0,396.1404946105599,-35.98,2
10:25,149684419.0,1443.1717999999985,-136.49,2
10:25,737547541.0,740.7345995677742,-60.0,2
10:25,546296727.0,-39.59517269738144,-55.98,5
10:26,570410059.0,2241.47664677631,-112.97,2
10:26,874506295.0,-1477.389256245572,-20.68,5
10:26,494156462.0,-316.7074864817604,-74.98,2
10:27,690523499.0,1193.02845,-284.19,2
10:27,154246234.0,9.484892102104247,-35.98,2
10:27,722971557.0,-53.8082791569244,-83.08,5
10:27,680773155.0,945.9427833310916,-44.99,2
10:29,160166876.0,1658.3336905862438,-85.97,2
10:29,130522384.0,-486.7038156208605,-39.98,2
10:29,384497904.0,707.8258499999991,-62.56,5
10:29,446720287.0,-254.1765591815944,-137.48,2
10:30,719586818.0,19100.19972496807,-233.8,2
10:30,850290152.0,-2864.348499999997,-27.07,5
10:30,299652176.0,-26.42561674312077,-156.44,2
10:30,380228542.0,88.74454181556543,-25.0,2
10:31,596171893.0,305.3217448255111,-29.99,2
10:31,581655972.0,41776.61143604193,-166.6,2
10:31,250895529.0,2158.526082469288,-34.99,2
10:31,635679314.0,-2863.6758291195188,-27.72,5
10:32,524425303.0,-311.4945000000011,-201.5,2
10:33,235663459.0,400.3744298120152,-41.07,5
10:33,395654270.0,-1996.2462028122004,-35.87,5
10:34,993238248.0,-372.0524873928839,-25.0,2
10:35,147508204.0,283.65971778188657,-77.99,2
10:35,776431321.0,3516.034402412706,-35.95,1
10:35,844835978.0,9783.811938921002,-134.98,2
10:36,857997794.0,1247.0726651508871,-29.98,2
10:36,744398361.0,884.0759999999998,-12.99,2
10:36,130522384.0,-566.6838156208604,-79.98,2
10:36,303843160.0,501.9181000000017,-91.99,2
10:36,266777719.0,836.1189337802396,-67.18,2
10:36,679911053.0,2994.947891547145,-64.62,5
10:37,197865285.0,688.6029617312201,-89.85,5
10:37,160166876.0,1610.3436905862438,-47.99,2
10:39,442079728.0,979.725119219314,-24.96,1
10:39,668329719.0,8910.205911468896,-101.22,5
10:39,951817450.0,10021.906556535849,-50.08,5
10:39,349614277.0,1586.8826999999997,-50.07,5
10:40,585625048.0,2158.6956190586343,-49.99,2
10:40,188263947.0,869.3806500000005,-119.62,2
10:41,497772347.0,1539.132049999998,-59.98,2
10:41,546296727.0,-59.58517269738144,-19.99,2
10:41,681955876.0,-1262.7031000000004,-68.62,2
10:41,472995101.0,2367.141523888331,-6.99,4
10:42,355940285.0,930.3529781896834,-20.97,7
10:42,598793068.0,1047.0503499999984,-21.98,4
10:42,417850087.0,17475.39480480171,-65.12,2
10:43,406862520.0,755.2297265374104,-41.98,2
10:43,786879739.0,-2218.693294120557,-56.28,5
10:43,576188756.0,-3455.8289999999993,-45.19,5
10:43,654329190.0,161.1344009485193,-42.98,2
10:44,886837068.0,693.9080999999994,-22.0,2
10:44,860360312.0,159.30240888268034,-166.98,2
10:45,874431242.0,9602.48049460054,-285.6,2
10:45,138351025.0,-764.5559000000003,-169.39,2
10:46,715068825.0,19.536999999999807,-111.75,2
10:46,867679563.0,60.58075370171586,-51.99,2
10:46,901037631.0,2390.469323096407,-35.1,2
10:46,923322792.0,-156.19433175363758,-143.99,2
10:47,218795010.0,137.7764499999996,-141.38,2
10:47,626989363.0,817.6149633173752,-154.98,2
10:47,744398361.0,862.0759999999998,-22.0,2
10:47,240643705.0,557.5250911206153,-12.99,4
10:48,938992364.0,433.0626437313995,-117.1,2
10:48,361201224.0,3375.920232067893,-6.01,2
10:48,821971408.0,1301.9517213748782,-6.99,7
10:49,475277431.0,205.62013694361943,-40.95,7
10:49,290751280.0,466.4806966748256,-161.97,2
10:49,690523499.0,991.44245,-201.59,2
10:49,373163757.0,11477.431796728535,-243.6,2
10:49,494156462.0,-421.6924864817604,-104.98,2
10:50,520447032.0,9362.648594237997,-50.01,2
10:50,456221621.0,1063.2453673026282,-12.99,2
10:52,730002588.0,13935.707313597151,-86.8,2
10:52,168414279.0,167.25478427492135,-79.99,2
10:52,585625048.0,2053.7156190586343,-104.98,2
10:52,149684419.0,1358.6717999999985,-84.5,2
10:53,499410772.0,-2806.741862905162,-56.11,5
10:53,250895529.0,2104.6160824692884,-53.91,1
10:53,422955974.0,278.0227849990499,-29.99,2
10:53,857997794.0,1227.0826651508871,-19.99,4
10:54,913801979.0,524.132779914494,-44.99,2
10:55,943829984.0,236.0665091134572,-111.97,6
10:55,860360312.0,59.312408882680344,-99.99,2
10:55,971010829.0,382.6312564442453,-17.98,7
10:56,918772878.0,-516.4995172453212,-208.6,2
10:56,290751280.0,444.4806966748256,-22.0,2
10:56,427909748.0,2256.463200000013,-29.99,4
10:57,154246234.0,-40.51510789789575,-50.0,2
10:57,737547541.0,676.7545995677742,-63.98,2
10:57,140893085.0,6035.178056365462,-49.97,2
10:58,685959099.0,2603.516866099242,-77.98,2
10:58,969697937.0,-4575.41026567055,-45.77,5
10:58,642924505.0,532.2022201835262,-32.97,4
10:58,703588001.0,99.63214999999954,-100.27,5
10:59,680773155.0,923.9427833310916,-22.0,2
10:59,504055745.0,55.4449613417669,-29.99,4
10:59,585596026.0,48.59433387667006,-94.98,2
11:00,581655972.0,41568.01143604193,-208.6,2
11:03,668175891.0,929.947073158499,-33.97,4
11:03,338022396.0,814.4308893757391,-109.98,2
11:03,978951113.0,-324.46299259041916,-25.0,2
11:04,216285378.0,23670.53938463492,-6.33,2
11:04,930271460.0,381.1742475357762,-22.0,2
11:04,364357875.0,7818.230776080191,-163.42,5
11:05,386277162.0,439.9799999999994,-1.99,4
11:05,279149837.0,1803.6150499999987,-5.99,7
11:06,475277431.0,178.65013694361946,-26.97,4
11:06,859264768.0,472.3850837819384,-29.99,2
11:07,427909748.0,2224.473200000013,-31.99,2
11:08,168414279.0,161.26478427492134,-5.99,1
11:08,990461108.0,462.30716862061104,-13.98,7
11:10,188263947.0,800.0056500000005,-69.38,2
11:10,700138124.0,6128.20568243974,-27.71,5
11:11,235881534.0,13134.614758690192,-72.06,2
11:11,730002588.0,13763.549313597152,-172.16,2
11:11,749378808.0,6017.390095015426,-63.12,2
11:12,909669130.0,404.89288473676663,-49.02,2
11:13,192202372.0,873.7820190390737,-46.97,4
11:13,358836279.0,677.034892807586,-19.99,2
11:14,642924505.0,432.21222018352614,-99.99,2
11:14,668175891.0,909.957073158499,-19.99,2
11:14,857997794.0,1207.0926651508871,-19.99,2
11:15,508518911.0,107.47475027901044,-31.99,2
11:15,552980092.0,110.49471911933747,-229.6,2
11:16,690523499.0,937.54245,-53.9,2
11:16,183546640.0,358.25069734773393,-47.99,2
11:16,971010829.0,320.6512564442453,-61.98,2
11:16,441142605.0,2378.8577000000055,-115.97,2
11:16,358846516.0,859.4296725272179,-33.0,4
11:16,615144184.0,1014.3137991255188,-35.0,2
11:16,135937041.0,214.05810173158832,-59.97,4
11:16,456221621.0,1020.2653673026282,-42.98,2
11:16,703588001.0,36.652149999999544,-62.98,2
11:16,214339619.0,534.6775508683563,-67.97,2
11:16,993238248.0,-450.0424873928839,-77.99,2
11:17,504055745.0,17.494961341766896,-37.95,7
11:17,494156462.0,-547.6774864817604,-125.99,2
11:17,280990953.0,453.17284999999856,-99.99,2
11:17,630691258.0,289.6865448748413,-49.99,2
11:17,680773155.0,888.0627833310917,-35.88,4
11:19,138351025.0,-895.4419000000003,-130.89,2
11:19,978951113.0,-354.45299259041917,-29.99,4
11:20,943829984.0,233.0665091134572,-3.0,4
11:20,218795010.0,59.40144999999961,-78.38,2
11:21,225210798.0,1099.3537737592087,-25.0,2
11:21,427909748.0,2201.513200000013,-22.96,1
11:22,165098840.0,-428.5431263623731,-57.99,6
11:24,895331556.0,-440.6189000000009,-47.29,5
11:24,314980178.0,3671.1058500000054,-54.99,2
11:24,715068825.0,-95.9630000000002,-115.5,2
11:24,261793952.0,550.6112602038148,-6.0,1
11:25,489964679.0,22145.766433998942,-132.3,2
11:25,993238248.0,-515.0224873928839,-64.98,2
11:26,871200314.0,23.76707424263836,-70.12,5
11:26,141521177.0,7674.755900000014,-56.06,5
11:26,758160963.0,8331.748897328987,-92.18,2
11:26,347110339.0,-182.2967925031481,-26.97,4
11:27,280990953.0,373.19284999999854,-79.98,2
11:29,504055745.0,-27.495038658233103,-44.99,6
11:30,155317149.0,464.0548499999992,-69.0,2
11:30,220183538.0,1214.1534499999996,-8.99,4
11:31,188263947.0,744.1306500000005,-55.88,2
11:31,823208989.0,779.5083138695314,-160.3,2
11:31,737547541.0,601.7745995677742,-74.98,2
11:32,678726554.0,445.9457523483896,-19.99,2
11:32,581655972.0,41428.01143604193,-140.0,2
11:32,600585971.0,326.2265499999995,-117.03,5
11:34,552980092.0,43.994719119337475,-66.5,2
11:34,978951113.0,-368.3829925904192,-13.93,4
11:34,625658193.0,-1880.0480802437833,-213.95,5
11:35,121113546.0,288.7451560698697,-30.96,7
11:36,769319491.0,363.8719999999994,-9.98,1
11:36,427909748.0,2150.5432000000133,-50.97,2
11:37,448279144.0,1178.2423499999993,-25.0,2
11:38,214339619.0,484.7075508683563,-49.97,4
11:38,585596026.0,38.59433387667006,-10.0,4
11:39,346874167.0,534.635099999999,-41.97,2
11:39,534325901.0,6961.4687440893495,-12.0,9
11:40,287480331.0,12846.411220597109,-25.45,5
11:40,979122276.0,224.53096229432867,-79.98,2
11:44,480557476.0,11365.721997742494,-30.53,2
11:44,873701090.0,1057.7148067897724,-85.23,2
11:44,762785862.0,1358.1957499999994,-134.5,2
11:45,358836279.0,652.034892807586,-25.0,2
11:45,220183538.0,1169.1734499999995,-44.98,2
11:46,155317149.0,421.0748499999992,-42.98,2
11:47,298000165.0,24957.26400644025,-108.14,5
11:48,250895529.0,2020.6160824692884,-84.0,2
11:49,637433131.0,294.32039999999915,-19.99,2
11:49,494156462.0,-676.6624864817604,-128.99,2
11:50,346874167.0,506.63509999999906,-28.0,2
11:50,990461108.0,434.30716862061104,-28.0,2
11:52,978951113.0,-528.3529925904191,-159.97,2
11:53,311467864.0,585.9046999999991,-121.99,2
11:53,822718326.0,11173.692307219362,-30.96,7
11:54,652048867.0,140.345149999999,-21.97,1
11:55,490790931.0,373.3223499999986,-107.98,2
11:55,832564361.0,16155.577975369946,-40.11,5
11:55,469330905.0,223.50006802921553,-79.98,2
11:56,365608668.0,890.9421138595587,-86.97,4
11:57,823208989.0,439.30831386953145,-340.2,2
11:57,698076160.0,6383.538235659584,-86.2,5
11:57,585596026.0,-61.39566612332993,-99.99,2
11:57,909676212.0,919.941169740084,-307.3,2
11:58,642924505.0,380.2322201835261,-51.98,2
11:59,541639148.0,5056.195670735479,-57.75,4
12:01,552980092.0,-85.50528088066253,-129.5,2
12:01,489964679.0,22068.066433998945,-77.7,2
12:01,762785862.0,1096.1957499999994,-262.0,2
12:02,346874167.0,486.64509999999905,-19.99,2
12:02,626989363.0,812.6249633173752,-4.99,7
12:03,824916823.0,9187.858079830254,-26.65,9
12:03,812012103.0,-120.07930000000052,-99.99,2
12:03,433917275.0,8603.824999114468,-32.78,7
12:04,604288474.0,3535.732940056582,-3.28,7
12:04,303843160.0,451.9181000000017,-50.0,2
12:05,715068825.0,-178.0880000000002,-82.12,2
12:06,657139925.0,13822.225839386778,-7.25,9
12:07,601627384.0,5004.2705038032045,-27.68,9
12:07,446720287.0,-441.1665591815944,-186.99,2
12:07,887853850.0,11145.56215615272,-19.23,9
12:08,188263947.0,665.3806500000005,-78.75,2
12:09,494789005.0,3412.1840569625197,-2.01,4
12:10,736340277.0,8768.954054828788,-54.31,5
12:10,938992364.0,403.0526437313995,-30.01,2
12:11,494156462.0,-789.1474864817604,-112.48,2
12:11,758885184.0,1797.2271822743448,-136.97,2
12:12,581655972.0,41234.811436041935,-193.2,2
12:12,806358207.0,12569.735218880667,-3.08,4
12:12,819515373.0,2685.5651360637917,-85.97,4
12:13,266777719.0,780.9689337802396,-55.15,2
12:14,941285623.0,384.31139906677026,-29.99,2
12:15,155317149.0,391.0748499999992,-30.0,2
12:16,344843570.0,-80.8643175093338,-73.04,2
12:17,761272540.0,212.54034999999885,-107.37,5
12:17,149684419.0,1192.6917999999982,-165.98,2
12:17,823208989.0,321.00831386953143,-118.3,2
12:18,893134725.0,1699.567262973209,-39.74,5
12:19,506618547.0,17670.672301694536,-5.03,7
12:20,489964679.0,21895.880433998944,-172.19,2
12:21,303843160.0,431.9281000000017,-19.99,4
12:21,194745206.0,860.3703720912431,-6.01,2
12:23,672994751.0,104.1613075841374,-55.98,2
12:23,121858569.0,1696.5911500000025,-18.98,2
12:24,524425303.0,-526.4945000000012,-215.0,2
12:24,835736339.0,1998.1842504145593,-19.01,4
12:25,690523499.0,932.54245,-5.0,4
12:25,762785862.0,984.1957499999994,-112.0,2
12:25,101531259.0,301.8267999999996,-11.98,4
12:27,973086490.0,10645.07697096182,-9.95,9
12:27,166019891.0,8131.795909578562,-2.3,8
12:27,838830098.0,911.7771420877845,-5.99,2
12:27,572384506.0,11250.088380711588,-4.82,2
12:28,446720287.0,-479.1365591815944,-37.97,2
12:28,331048953.0,40.17636797849363,-25.98,4
12:29,194745206.0,828.2803720912431,-32.09,2
12:29,660561861.0,1164.57978743765,-5.97,4
12:30,806358207.0,12523.976218880667,-45.76,5
12:33,241459011.0,1176.8402132723472,-59.98,4
12:34,448279144.0,1171.2523499999993,-6.99,1
12:34,715068825.0,-293.9630000000002,-115.88,2
12:34,418717120.0,-1902.5606465372296,-30.28,9
12:34,637433131.0,262.33039999999914,-31.99,2
12:35,762896656.0,270.26499815185866,-19.0,2
12:36,867987292.0,4401.664511013429,-42.87,7
12:37,117308635.0,1580.0509033866535,-90.97,2
12:38,758885184.0,1752.2371822743448,-44.99,2
12:38,603375739.0,1225.419063023267,-53.99,2
12:39,678726554.0,395.9557523483896,-49.99,4
12:39,358836279.0,611.0848928075859,-40.95,1
12:39,168414279.0,76.27478427492134,-84.99,2
12:40,556631012.0,815.1189230856783,-79.98,2
12:41,909669130.0,389.88288473676664,-15.01,4
12:42,726913482.0,129.0651014735239,-66.99,2
12:43,581655972.0,40984.91143604193,-249.9,2
12:43,165691047.0,524.2429999999991,-23.65,5
12:44,188263947.0,612.8806500000005,-52.5,2
12:45,823208989.0,248.20831386953145,-72.8,2
12:46,218795010.0,-92.8485500000004,-152.25,2
12:47,938992364.0,362.0226437313995,-41.03,2
12:47,556631012.0,733.1389230856782,-81.98,2
12:48,489964679.0,21860.880433998944,-35.0,2
12:50,615144184.0,914.3237991255188,-99.99,2
12:52,672994751.0,99.84629078601009,-4.32,2
12:52,155317149.0,334.09484999999916,-56.98,2
12:53,742223719.0,1125.671757304803,-57.99,2
12:53,880546403.0,-1314.1046500000018,-191.0,2
12:54,117308635.0,1498.1649033866536,-81.89,2
12:54,987163717.0,6876.138480000006,-36.88,9
12:55,116169597.0,1269.1839499999996,-120.18,5
12:56,126929801.0,2313.38044806513,-71.99,2
12:58,581655972.0,40894.61143604193,-90.3,2
12:59,241459011.0,1141.8502132723472,-34.99,2
13:00,187111705.0,7034.10442890696,-5.0,9
13:00,897592348.0,15106.53998632199,-32.95,1
13:01,585625048.0,2045.8156190586344,-7.9,9
13:01,556631012.0,727.1489230856782,-5.99,2
13:01,711140907.0,1212.5205999999994,-16.98,7
13:02,715068825.0,-394.0880000000002,-100.12,2
13:02,149684419.0,1049.7217999999982,-142.97,2
13:02,218795010.0,-189.5985500000004,-96.75,2
13:03,857997794.0,1137.122665150887,-69.97,2
13:04,183546640.0,353.25069734773393,-5.0,9
13:05,277562576.0,948.468698224955,-4.7,9
13:05,534325901.0,6912.4687440893495,-49.0,2
13:05,873693307.0,10127.937650307937,-69.38,5
13:06,524425303.0,-570.9945000000012,-44.5,2
13:06,257633312.0,-272.25165000000084,-64.5,2
13:06,749378808.0,6012.3400950154255,-5.05,9
13:07,358836279.0,446.2348928075859,-164.85,4
13:07,719586818.0,18927.29972496807,-172.9,2
13:07,923322792.0,-179.27183175363757,-23.08,5
13:08,489964679.0,21745.422433998945,-115.46,2
13:09,552980092.0,-218.50528088066253,-133.0,2
13:10,758885184.0,1648.2671822743448,-103.97,2
13:11,441142605.0,2375.8677000000057,-2.99,4
13:11,823208989.0,85.10831386953143,-163.1,2
13:13,192202372.0,832.7920190390737,-40.99,2
13:13,166019891.0,8074.297909578562,-57.5,5
13:14,406862520.0,625.2597265374104,-129.97,1
13:16,859603181.0,4338.375666544273,-39.9,5
13:17,859603181.0,4333.593302889902,-4.78,4
13:18,679911053.0,2958.967891547145,-35.98,4
13:19,494156462.0,-873.1399864817604,-83.99,2
13:19,414454079.0,792.4678500000019,-12.15,4
13:19,913801979.0,518.142779914494,-5.99,2
13:20,446720287.0,-512.1265591815944,-32.99,2
13:20,581655972.0,40719.61143604193,-175.0,2
13:21,698955014.0,1443.076054940912,-110.56,5
13:21,141521177.0,7569.083900000014,-105.67,7
13:22,923322792.0,-253.52183175363757,-74.25,2
13:26,812692024.0,3813.952857948952,-4.75,9
13:26,918772878.0,-596.9995172453212,-80.5,2
13:26,241459011.0,1065.8802132723472,-75.97,2
13:26,709142813.0,1044.8797999999992,-1.99,4
13:27,534325901.0,6880.5627440893495,-31.91,5
13:27,730002588.0,13536.777313597153,-226.77,2
13:28,155317149.0,274.09484999999916,-60.0,2
13:30,895750759.0,-356.4437380756658,-123.99,2
13:30,149684419.0,986.2417999999982,-63.48,2
13:31,491392945.0,4900.0855000000065,-47.99,2
13:33,257633312.0,-438.7516500000008,-166.5,2
13:33,715068825.0,-473.9630000000002,-79.88,2
13:34,680773155.0,850.0727833310917,-37.99,2
13:35,896821055.0,-201.89182631476464,-77.98,2
13:35,918772878.0,-715.2995172453211,-118.3,2
13:37,762785862.0,844.6957499999994,-139.5,2
13:38,824916823.0,9122.608079830254,-4.07,4
13:38,218795010.0,-269.8485500000004,-80.25,2
13:38,695607232.0,346.1504946105599,-49.99,2
13:40,489964679.0,21743.232113998944,-2.19,4
13:41,730002588.0,13344.31931359715,-192.46,2
13:41,421881811.0,4745.191618076136,-5.57,4
13:42,823208989.0,-16.39168613046857,-101.5,2
13:43,923322792.0,-304.14683175363757,-50.62,2
13:44,758885184.0,1549.2771822743448,-98.99,2
13:45,706301742.0,-2906.255649999998,-55.28,5
13:47,678726554.0,272.9857523483896,-122.97,2
13:49,637433131.0,105.35039999999915,-156.98,2
13:49,349107386.0,-3288.045973194561,-62.41,5
13:49,165098840.0,-598.5131263623731,-169.97,6
13:50,494156462.0,-909.8824864817605,-36.74,2
13:50,913801979.0,506.1727799144939,-11.97,4
13:51,603721739.0,1466.5068994831845,-121.69,5
13:52,188263947.0,471.8806500000005,-141.0,2
13:52,815385232.0,10256.81724782533,-12.1,7
13:52,141521177.0,7521.497900000014,-47.59,7
13:54,698076160.0,6381.85968356395,-1.68,2
13:54,994214354.0,10202.5930382494,-35.87,9
13:55,117273481.0,9444.60686229254,-31.99,2
13:55,155317149.0,197.10484999999915,-76.99,2
13:55,758885184.0,1484.7871822743448,-64.49,2
13:56,918772878.0,-983.399517245321,-268.1,2
13:57,286484726.0,1064.0985725793273,-88.0,2
13:57,719586818.0,18773.29972496807,-154.0,2
13:59,895750759.0,-455.9337380756658,-99.49,2
13:59,454356905.0,3263.263445222882,-6.09,4
14:01,218795010.0,-402.2235500000004,-132.38,2
14:03,486495235.0,1945.5646393887164,-140.71,5
14:03,261793952.0,487.5812602038149,-63.03,2
14:04,581655972.0,40621.56943604193,-98.04,5
14:04,771125520.0,-109.3221500000005,-57.78,5
14:05,188263947.0,293.3806500000005,-178.5,2
14:06,424927189.0,-83.97851725589467,-39.44,9
14:06,168414279.0,70.28478427492135,-5.99,4
14:08,681955876.0,-1340.7031000000004,-78.0,2
14:08,655730067.0,163.43119999999954,-47.0,2
14:12,631111289.0,-586.6215000000007,-7.24,5
14:12,346874167.0,360.78509999999903,-125.86,4
14:15,695607232.0,333.1604946105599,-12.99,2
14:16,895750759.0,-518.4237380756658,-62.49,2
14:17,615144184.0,859.3337991255189,-54.99,2
14:17,373163757.0,11241.531796728535,-235.9,2
14:19,497772347.0,1437.142049999998,-101.99,2
14:20,758885184.0,1256.8171822743448,-227.97,2
14:20,923322792.0,-339.77183175363757,-35.62,2
14:21,581655972.0,40432.56943604193,-189.0,2
14:23,918772878.0,-1161.199517245321,-177.8,2
14:23,138609932.0,3512.9750032945853,-16.5,4
14:24,141521177.0,7381.525900000014,-139.97,4
14:25,241459011.0,1002.5855132723472,-63.29,5
14:26,448279144.0,1129.2823499999993,-41.97,4
14:26,604288474.0,3490.848940056582,-44.88,5
14:26,762785862.0,759.6957499999994,-85.0,2
14:28,713910252.0,100.33272572854126,-41.46,5
14:29,679911053.0,2830.987891547145,-127.98,2
14:31,489964679.0,21599.760113998946,-143.47,7
14:31,719586818.0,18521.99972496807,-251.3,2
14:31,853907490.0,7381.938629543602,-17.75,9
14:35,218795010.0,-437.8485500000004,-35.62,2
14:35,347110339.0,-217.2967925031481,-35.0,2
14:36,758885184.0,1055.8371822743447,-200.98,2
14:39,730002588.0,13260.31931359715,-84.0,2
14:41,668175891.0,888.0519731584991,-21.91,5
14:41,726913482.0,48.065101473523896,-81.0,2
14:42,405945930.0,4710.570606568141,-47.82,5
14:42,245198540.0,-41.33860119822053,-4.99,1
14:43,655730067.0,39.31369999999953,-124.12,2
14:44,681955876.0,-1374.4531000000004,-33.75,2
14:45,489964679.0,21531.874113998943,-67.89,4
14:45,762785862.0,689.6957499999994,-70.0,2
14:45,581655972.0,40280.66943604193,-151.9,2
14:49,373163757.0,11136.531796728535,-105.0,2
14:53,347110339.0,-222.7967925031481,-5.5,4
14:54,257633312.0,-542.7516500000008,-104.0,2
14:55,923322792.0,-474.7718317536376,-135.0,2
14:58,719586818.0,18479.99972496807,-42.0,2
14:59,918772878.0,-1386.5995172453208,-225.4,2
14:59,856957948.0,9453.66039333536,-8.97,4
14:59,874431242.0,9390.38049460054,-212.1,2
15:01,834581602.0,667.6372499999991,-19.99,4
15:02,709142813.0,1019.8797999999992,-25.0,2
15:02,615144184.0,847.3537991255189,-11.98,1
15:03,913127700.0,1559.4314380111164,-5.99,2
15:03,218795010.0,-562.7235500000004,-124.88,2
15:04,489964679.0,21447.202113998945,-84.67,2
15:06,347110339.0,-244.7667925031481,-21.97,7
15:07,224112146.0,628.0955499999986,-28.91,5
15:08,857997794.0,1089.182665150887,-47.94,1
15:11,742223719.0,1119.6817573048029,-5.99,4
15:11,508518911.0,74.50475027901045,-32.97,2
15:13,828532554.0,468.4931013660719,-29.95,7
15:13,657139925.0,13821.262829985057,-0.96,8
15:14,709142813.0,954.9097999999992,-64.97,2
15:14,844835978.0,9747.831938921005,-35.98,2
15:15,548907062.0,313.0974887682886,-29.99,4
15:16,762785862.0,574.6957499999994,-115.0,2
15:16,581655972.0,40182.66943604193,-98.0,2
15:17,285428103.0,9463.950726544275,-71.75,2
15:24,655730067.0,-63.038800000000464,-102.35,2
15:26,719586818.0,18309.19972496807,-170.8,2
15:26,155317149.0,152.10484999999915,-45.0,2
15:27,188263947.0,225.88065000000051,-67.5,2
15:28,552980092.0,-441.8052808806625,-223.3,2
15:29,605116158.0,2659.4572000000007,-126.5,2
15:29,130154096.0,1455.9203820134182,-37.95,7
15:30,895750759.0,-589.4037380756658,-70.98,2
15:31,489964679.0,21342.216113998944,-104.99,2
15:31,149684419.0,897.7517999999982,-88.49,2
15:33,200080192.0,9809.075180574086,-28.18,1
15:33,581655972.0,39869.76943604193,-312.9,2
15:34,874431242.0,9192.28049460054,-198.1,2
15:38,215311171.0,6607.258951603203,-33.57,5
15:38,913801979.0,500.1827799144939,-5.99,7
15:41,923322792.0,-582.7718317536376,-108.0,2
15:43,245690309.0,9789.216812589226,-13.01,5
15:44,489964679.0,21316.330113998945,-25.89,2
15:45,149684419.0,837.7517999999982,-60.0,2
15:45,655730067.0,-163.15630000000047,-100.12,2
15:46,762785862.0,401.6957499999994,-173.0,2
15:47,918772878.0,-1484.5995172453208,-98.0,7
15:48,546296727.0,-199.55517269738144,-139.97,2
15:50,668175891.0,814.0719731584991,-73.98,2
15:50,433917275.0,8576.934999114468,-26.89,9
15:51,874431242.0,9048.78049460054,-143.5,2
15:52,719586818.0,18085.899724968072,-223.3,2
15:53,188263947.0,140.00565000000051,-85.88,2
15:54,155317149.0,126.11484999999917,-25.99,2
15:55,546296727.0,-227.55517269738144,-28.0,2
15:56,895750759.0,-613.8937380756659,-24.49,2
15:56,605116158.0,2509.9572000000007,-149.5,2
15:56,923322792.0,-616.5218317536376,-33.75,2
15:59,489964679.0,21151.844113998945,-164.49,2
16:03,918772878.0,-1676.3995172453208,-191.8,4
16:03,446720287.0,-603.6165591815944,-91.49,2
16:03,373163757.0,10870.531796728535,-266.0,2
16:05,690523499.0,814.2564500000001,-118.29,2
16:09,603721739.0,1418.5168994831845,-47.99,2
16:09,331048953.0,24.19636797849363,-15.98,2
16:11,655368335.0,5289.641910070222,-100.09,2
16:12,655730067.0,-212.27380000000048,-49.12,2
16:13,489964679.0,21033.558113998944,-118.29,2
16:13,149684419.0,730.7917999999981,-106.96,2
16:16,373163757.0,10515.631796728538,-354.9,2
16:16,719586818.0,17946.599724968073,-139.3,2
16:17,690523499.0,702.2564500000001,-112.0,2
16:18,155317149.0,100.11484999999917,-26.0,2
16:20,918772878.0,-1984.3995172453208,-308.0,4
16:22,695607232.0,253.1804946105599,-79.98,2
16:24,874431242.0,8791.18049460054,-257.6,2
16:24,587225252.0,7734.67650035811,-32.6,2
16:27,923322792.0,-700.5218317536376,-84.0,2
16:27,446720287.0,-662.6165591815944,-59.0,2
16:29,117308635.0,1253.8929033866536,-244.27,7
16:31,703588001.0,-9.287850000000454,-45.94,7
16:33,422955974.0,214.04278499904993,-63.98,2
16:33,489964679.0,20901.258113998945,-132.3,2
16:34,128033695.0,2205.4421708904983,-14.78,4
16:35,766812921.0,144.59689999999935,-29.98,4
16:39,329840194.0,1999.086730143148,-13.04,2
16:40,912584712.0,795.2126195447331,-12.98,7
16:40,762785862.0,334.1957499999994,-67.5,2
16:42,494156462.0,-954.1324864817605,-44.25,2
16:42,719586818.0,17623.899724968072,-322.7,2
16:43,655730067.0,-334.14130000000046,-121.87,2
16:45,198946608.0,6747.995162265428,-170.33,2
16:46,941285623.0,362.34139906677024,-21.97,7
16:46,472995101.0,2331.632950571365,-35.51,7
16:49,519935524.0,1302.909909737519,-80.3,4
16:51,758885184.0,991.3371822743449,-64.5,2
16:52,329840194.0,1941.145890143148,-57.94,4
16:52,155317149.0,92.62484999999916,-7.49,2
16:53,409370545.0,1553.55427554552,-16.04,7
16:54,489964679.0,20836.886113998946,-64.37,2
16:54,918772878.0,-2194.399517245321,-210.0,7
16:55,690523499.0,418.0704500000001,-284.19,2
16:57,886921642.0,3824.5990275128506,-60.34,4
17:02,149684419.0,602.8317999999981,-127.96,2
17:03,681955876.0,-1426.5781000000004,-52.12,2
17:04,218795010.0,-671.4735500000004,-108.75,2
17:06,670102069.0,4377.958965014794,-23.38,7
17:07,719586818.0,17492.299724968074,-131.6,2
17:09,758885184.0,834.8671822743447,-156.47,2
17:09,762785862.0,160.6957499999994,-173.5,2
17:13,660874296.0,2523.1174499608474,-26.96,7
17:14,170637730.0,3236.8825379111827,-7.02,7
17:14,180616589.0,986.1967092146951,-35.59,2
17:15,425964226.0,3723.060650000002,-25.96,1
17:15,120634201.0,4793.683500000006,-21.94,9
17:19,494156462.0,-1044.1024864817605,-89.97,2
17:22,510101371.0,13436.30508353747,-6.25,4
17:23,290818242.0,7394.563897083392,-40.34,6
17:25,218795010.0,-707.0985500000004,-35.62,2
17:27,489964679.0,20738.914113998944,-97.97,2
17:28,149684419.0,520.3317999999981,-82.5,2
17:28,681955876.0,-1501.5781000000004,-75.0,2
17:29,738958551.0,9496.560612607089,-11.64,7
17:30,155317149.0,22.634849999999147,-69.99,2
17:31,809499628.0,16933.614230916883,-1.9,2
17:36,613729471.0,9180.613188156714,-42.29,7
17:37,149684419.0,422.8417999999981,-97.49,2
17:37,762785862.0,16.195749999999407,-144.5,2
17:38,956717493.0,1434.4328776068376,-46.48,4
17:41,218795010.0,-822.5985500000004,-115.5,2
17:43,730002588.0,13041.947313597151,-218.37,2
17:47,399144202.0,2989.4878941421493,-6.05,5
17:56,730002588.0,12911.06131359715,-130.89,2
17:57,984783496.0,14551.130531748417,-51.5,5
18:12,149684419.0,358.8517999999981,-63.99,2
18:12,687135796.0,27093.601844915116,-46.29,8
18:14,690523499.0,294.89845000000014,-123.17,2
18:37,788740658.0,4161.298307204005,-10.77,5
18:49,119943495.0,-1307.510062112858,-27.78,9
19:09,376271050.0,1443.282806905744,-16.29,2
19:17,511179916.0,6946.629101057554,-45.59,2
19:33,687135796.0,27083.61184491511,-9.99,9
20:16,886921642.0,3824.500655738601,-0.1,2
21:32,672913754.0,10872.111451182016,-53.25,5
00:11,879091637.0,-128.48747626202308,-42.45,9
00:11,912705941.0,18446.791789395156,-39.61,4
00:12,421881811.0,4673.000136830225,-72.19,4
00:14,518474507.0,15380.991149300453,-37.98,9
00:18,237493332.0,14643.326751137432,-44.49,2
00:21,902798190.0,-710.1056344310266,-29.29,9
00:21,859603181.0,4301.423302889902,-32.17,9
00:22,851181128.0,5145.797056395124,-33.82,7
00:22,836110591.0,7210.088850244705,-36.45,9
00:26,254853117.0,4532.721604308447,-38.44,9
00:30,795847804.0,22890.061521942614,-1.27,5
00:31,851649498.0,10591.759499423986,-11.59,5
00:33,383345285.0,-1109.6523735880762,-34.08,9
00:57,802697323.0,15824.178488615064,-29.44,9
00:59,471897866.0,8852.718715768768,-22.19,8
01:03,718058208.0,3153.7544721119184,-10.85,5
01:09,116598243.0,3071.0135918213837,-5.1,2
01:09,221868392.0,5700.007238586128,-37.1,9
01:10,534204159.0,6354.526591633311,-7.12,2
01:14,949032480.0,5076.7880964174965,-16.95,9
01:18,215311171.0,6590.353117946841,-16.91,4
01:19,624500124.0,3905.351733166728,-15.52,2
01:28,985188462.0,686.6227887112248,-38.74,9
01:28,581655972.0,39826.96842342423,-42.8,8
01:29,824916823.0,9101.868079830254,-20.74,9
01:39,108481285.0,8710.348849376112,-30.41,5
01:40,221868392.0,5693.869407632678,-6.14,5
01:40,679911053.0,2795.4109453530355,-35.58,5
01:42,651756497.0,13714.137458445852,-23.18,7
01:45,949032480.0,5064.772243696383,-12.02,4
01:49,822135975.0,11417.458696617436,-3.59,2
01:53,858989281.0,27144.683371419134,-27.19,9
01:56,705848712.0,25990.600145046767,-67.87,7
01:56,887853850.0,11075.951947329737,-69.61,7
01:56,836110591.0,7208.24758923861,-1.84,5
02:02,705848712.0,25976.15014504677,-14.45,9
02:02,235881534.0,13132.621601182514,-1.99,4
02:05,815385232.0,10237.552666709087,-19.26,7
02:06,518474507.0,15375.52873422776,-5.46,8
02:08,851181128.0,5109.097056395124,-36.7,9
02:10,213112754.0,7129.536631498844,-3.61,5
02:19,647936800.0,741.7297651707817,-3.8,5
02:27,519644021.0,3455.6933105835938,-9.72,7
02:28,785749304.0,8732.647797121968,-60.61,7
02:32,414454079.0,748.527850000002,-43.94,9
02:34,256002321.0,6494.534601296381,-10.9,9
02:36,699139822.0,1888.0443024642263,-29.97,2
02:43,940569402.0,6614.196492382451,-17.95,9
02:45,146909202.0,6052.7715883913215,-85.61,5
02:47,749378808.0,5981.890095015426,-30.45,9
02:51,992204045.0,12647.887830313548,-27.49,7
02:51,200080192.0,9790.431183790588,-18.64,5
02:54,417850087.0,17399.413113484297,-75.98,5
02:54,480557476.0,11358.573504459377,-7.15,8
03:00,480557476.0,11343.073504459377,-15.5,9
03:02,252760664.0,7087.955340910995,-23.32,7
03:14,256002321.0,6472.494566194131,-22.04,7
03:15,897714622.0,8861.640972653864,-4.07,8
03:16,660874296.0,2485.9874499608472,-37.13,9
03:18,858989281.0,27144.582679648254,-0.1,2
03:20,604288474.0,3487.267517777079,-3.58,5
03:24,506618547.0,17651.153252965683,-19.52,7
03:30,383625050.0,6387.987815257541,-57.37,2
03:30,558119802.0,32449.829658348553,-26.69,9
03:34,802697323.0,15820.638044083056,-3.54,2
03:35,124102251.0,4236.308873313035,-38.7,7
03:35,709608057.0,3377.3590388538096,-33.68,9
03:44,940569402.0,6554.515396902039,-59.68,2
03:45,994214354.0,10174.6830382494,-27.91,9
03:45,698076160.0,6364.875466600322,-16.98,7
03:46,601627384.0,4976.100503803204,-28.17,9
03:46,280268430.0,5038.211644637379,-8.18,2
03:47,450896297.0,13622.754482699813,-30.1,9
03:48,532478725.0,5192.128308856672,-30.3,9
03:48,887853850.0,11042.751947329734,-33.2,9
03:50,675806859.0,7021.612634997781,-31.28,8
03:50,541639148.0,5046.713252880655,-9.48,7
03:56,633345190.0,7759.429489268265,-0.52,2
03:56,270374623.0,10469.124237774076,-34.14,2
03:57,264550521.0,10507.487696115344,-46.16,7
04:00,586315521.0,12414.14664436622,-51.33,4
04:01,558119802.0,32435.576486475707,-14.25,7
04:08,245690309.0,9722.372389055115,-66.84,7
04:11,749378808.0,5941.366902407846,-40.52,5
04:15,741903302.0,3238.155458740787,-39.18,9
04:16,752362502.0,10838.100022976636,-9.51,7
04:21,766941757.0,10069.47165420135,-38.64,9
04:23,399144202.0,2957.0878941421493,-32.4,9
04:26,779946617.0,16772.582715026154,-23.64,5
04:30,166019891.0,8024.514696868971,-49.78,5
04:30,441274121.0,13080.211267807132,-64.97,2
04:33,973086490.0,10639.07697096182,-6.0,9
04:35,324224854.0,3297.4246187916283,-4.88,5
04:36,657139925.0,13801.862829985055,-19.4,9
04:41,994214354.0,10171.355514809247,-3.33,7
04:42,769311479.0,7351.5617160806,-6.38,8
04:44,305778936.0,11847.888482991824,-22.95,9
04:45,216285378.0,23642.34938463492,-28.19,9
04:45,853907490.0,7370.514738243206,-11.42,5
04:47,667367404.0,9557.426885378278,-37.9,2
04:50,145387690.0,6360.654522150808,-26.95,9
04:52,237684254.0,6384.94082943501,-28.5,5
04:54,391559884.0,284.4136999999994,-40.6,9
04:59,454356905.0,3244.663594020451,-18.6,7
05:06,806358207.0,12522.578833385896,-1.4,2
05:07,719586818.0,17429.077663235446,-63.22,2
05:07,108931112.0,14167.633154795789,-35.27,9
05:09,461990622.0,10530.3619248401,-0.48,5
05:20,187541224.0,2666.80000811304,-34.92,9
05:26,832564361.0,16120.382495624204,-35.2,7
05:27,510101371.0,13398.675083537471,-37.63,9
05:31,128033695.0,2194.870570069667,-10.57,5
05:32,229205098.0,7660.915040838551,-0.63,2
05:33,370521542.0,26023.69296341989,-13.34,9
05:34,433917275.0,8535.686055347733,-41.25,7
05:38,169006407.0,12100.949998947312,-6.18,7
05:40,905860285.0,18888.355567946488,-7.09,2
05:44,187111705.0,7028.902515978613,-5.2,4
05:45,315546581.0,27464.468111817092,-7.28,5
05:47,120634201.0,4774.733500000006,-18.95,9
05:48,809499628.0,16914.12423091688,-19.49,9
05:50,137822385.0,3841.118257226486,-61.03,5
05:50,613729471.0,9096.85483879571,-83.76,4
05:52,738958551.0,9464.277537924,-32.28,8
05:59,822250278.0,7549.090345473256,-40.24,7
06:00,987656636.0,6426.7259127339885,-13.95,2
06:02,730002588.0,12889.98721931829,-21.07,5
06:02,455831435.0,-1710.1546048014943,-33.29,9
06:03,473820682.0,11692.318257391738,-29.98,5
06:05,930277104.0,10581.93793559953,-66.7,5
06:07,706250160.0,11870.350367268142,-62.54,2
06:09,409971170.0,2833.40554369978,-9.22,2
06:11,873693307.0,10113.130274121191,-14.81,2
06:13,203466392.0,3149.779488036957,-49.09,5
06:18,282837512.0,13919.123286844002,-55.06,5
06:19,494789005.0,3390.801690105945,-21.38,7
06:19,874431242.0,8772.003726567125,-19.18,7
06:22,108563213.0,23604.122215771393,-20.86,7
06:22,704517789.0,17411.591280284018,-13.65,2
06:24,259015404.0,2141.907163204015,-22.94,9
06:25,550169791.0,21266.65980453299,-50.2,5
06:29,683319988.0,8121.13275490109,-4.7,5
06:31,496395938.0,13100.151113616905,-6.2,7
06:31,500043411.0,13724.742781470297,-3.48,7
06:39,170637730.0,3215.2930886715435,-21.59,5
06:39,383833857.0,24428.686601390094,-11.49,7
06:42,305778936.0,11843.058188685576,-4.83,7
06:49,899742927.0,12733.223889279354,-55.56,2
06:50,414805878.0,13574.93478422754,-27.68,9
06:51,679662108.0,16130.1017112989,-24.68,4
06:56,145387690.0,6355.885580159986,-4.77,7
07:03,183888402.0,18270.842988022938,-42.38,9
07:03,489964679.0,20703.834113998942,-35.08,9
07:05,143003091.0,21920.74822185322,-12.33,5
07:07,290818242.0,7387.52229501555,-7.04,2
07:16,885259672.0,4292.795831179314,-21.07,4
07:18,366550080.0,25737.11499727154,-15.13,7
07:19,549414742.0,7696.465389242677,-45.64,9
07:23,482513594.0,6724.547543821098,-4.21,7
07:42,842682241.0,6251.241894198192,-43.36,7
07:48,678851253.0,3793.2609984254377,-61.82,5
07:49,554792076.0,27135.25287101872,-45.63,2
07:51,511179916.0,6924.12018330804,-22.51,7
07:51,435984758.0,5591.68531926911,-20.56,7
07:53,322221939.0,4248.903830136137,-14.46,2
07:54,407574996.0,5237.726903608547,-12.1,4
07:54,547010927.0,23132.531210764093,-39.06,7
08:02,609939116.0,7608.974478510411,-31.2,5
08:07,885259672.0,4286.595831179314,-6.2,9
08:09,456221621.0,1014.6153673026282,-5.65,9
08:09,364357875.0,7813.646651247878,-4.58,2
08:12,901432314.0,4511.2392405075825,-18.34,7
08:13,657139925.0,13742.050466063689,-59.81,2
08:15,380228542.0,83.39454181556543,-5.35,9
08:17,618514666.0,20963.06282003598,-43.81,5
08:19,143061865.0,7741.983034299202,-23.07,4
08:19,854895960.0,3613.166338882227,-12.72,7
08:21,395284483.0,692.7863402113086,-7.6,9
08:23,212560376.0,-217.75087422089783,-67.77,5
08:24,956717493.0,1411.0248776068377,-23.41,5
08:24,666952234.0,-143.17685187551302,-38.88,5
08:24,170233640.0,-1354.0617600501027,-58.55,5
08:25,995615876.0,1992.2308896983889,-90.07,5
08:26,344522228.0,-2777.3119882083924,-10.56,5
08:27,835736339.0,1958.3262504145591,-39.86,5
08:27,344219145.0,7625.18723543961,-55.86,5
08:28,308505160.0,14504.929898231265,-57.49,7
08:30,285220959.0,11637.743350047009,-83.55,8
08:32,246753533.0,900.9408999999988,-48.62,5
08:32,213930646.0,-1475.0592134725632,-60.61,5
08:33,651372390.0,-3408.7282499999988,-25.03,5
08:33,691789577.0,-491.47530000000006,-123.51,5
08:33,654329190.0,130.6508009485193,-30.48,5
08:34,891513205.0,760.5523296590692,-37.45,5
08:35,817294757.0,-2540.3133000000003,-47.65,5
08:39,684988568.0,-459.64007342720146,-69.37,5
08:41,467207141.0,1614.0427170482635,-115.57,5
08:41,569687509.0,-2060.5854,-13.71,5
08:42,252760664.0,6993.945340910995,-94.01,5
08:42,229502829.0,-3402.2067741862475,-97.62,5
08:43,992204045.0,12591.649830313549,-56.24,5
08:44,699313649.0,-2178.7033991419057,-53.57,5
08:45,218795010.0,-960.6924500000003,-138.09,5
08:45,180719578.0,-4152.122749999995,-47.56,5
08:46,809499628.0,16857.186230916883,-56.94,5
08:48,750094757.0,-1955.7293000000004,-117.47,5
08:49,912584712.0,645.7976195447332,-149.41,5
08:52,475117511.0,8204.664014215998,-77.64,2
08:52,585625048.0,1987.9186190586345,-57.9,5
08:53,383833857.0,24365.014601390096,-63.67,5
08:54,954263768.0,-90.77390000000024,-31.33,5
08:55,482513594.0,6691.269543821098,-33.28,5
08:55,331450202.0,7619.7096776465405,-36.75,5
08:56,426474982.0,-3573.53725,-61.45,5
08:58,812839908.0,-1660.9973500000003,-47.06,5
08:58,570269025.0,3258.8518333598895,-40.02,5
09:00,138609932.0,3506.8250032945853,-6.15,9
09:01,252419513.0,-2005.172485813416,-135.56,5
09:02,441274121.0,13073.311267807134,-6.9,9
09:02,558875206.0,3339.766279102216,-7.15,9
09:04,151278285.0,-703.3793500000004,-93.88,5
09:04,169006407.0,12093.849998947311,-7.1,9
09:05,198946608.0,6690.161162265428,-57.83,5
09:07,648644594.0,-143.73525000000086,-102.84,5
09:07,540159353.0,11275.592192358632,-5.4,9
09:09,690958123.0,20229.40434570694,-5.0,9
09:10,551755686.0,6626.570655850648,-158.21,5
09:10,180616589.0,944.0987092146952,-42.1,5
09:10,618138606.0,1666.0043472714349,-7.1,9
09:13,990461108.0,359.31511862061103,-74.99,5
09:14,383833857.0,24336.324601390097,-28.69,1
09:15,254853117.0,4505.7316043084475,-26.99,7
09:16,916270283.0,2344.7642499999993,-12.99,2
09:16,399144202.0,2918.5915545962284,-38.5,7
09:17,466649401.0,719.6118113978915,-79.54,5
09:18,586315521.0,12407.996644366222,-6.15,9
09:18,815993333.0,1253.6856390614073,-54.14,5
09:20,683078800.0,2065.8256413499594,-6.9,9
09:20,398429109.0,1048.0050500000011,-50.98,2
09:20,639549973.0,7527.420461439346,-65.27,5
09:21,117273481.0,9436.706862292542,-7.9,9
09:22,473820682.0,11659.90825739174,-32.41,2
09:23,886837068.0,688.5080999999994,-5.4,9
09:24,417850087.0,17393.613113484298,-5.8,9
09:24,128033695.0,2177.160570069667,-17.71,4
09:25,792845450.0,922.9631500000012,-14.99,4
09:25,421475159.0,-331.23673732558746,-102.84,5
09:26,355733816.0,5061.493234880616,-16.98,7
09:26,987229118.0,4628.9687626944815,-159.99,2
09:26,250895529.0,1975.6160824692884,-45.0,2
09:26,647472692.0,25098.08386836512,-38.98,5
09:26,214339619.0,479.6075508683562,-5.1,9
09:28,155317149.0,-46.91085000000086,-69.55,5
09:29,541639148.0,5025.223252880655,-21.49,1
09:29,151916463.0,1567.7315555991686,-158.9,2
09:30,788740658.0,4127.318307204006,-33.98,7
09:30,903468956.0,539.8593999999994,-55.98,2
09:30,535744551.0,1389.7855659956265,-19.99,2
09:31,722971557.0,-75.8082791569244,-22.0,2
09:31,370521542.0,26019.316986966343,-4.38,8
09:32,520447032.0,9177.148594237997,-185.5,2
09:34,519935524.0,1131.534909737519,-171.38,2
09:34,254853117.0,4413.661604308448,-92.07,2
09:34,596328017.0,-2413.145349999999,-96.44,5
09:36,121113546.0,178.3061560698697,-110.44,5
09:37,347110339.0,-327.7367925031481,-82.97,2
09:38,570410059.0,2041.9367467763104,-199.54,5
09:38,175452235.0,1599.5592500000002,-37.76,5
09:38,653667523.0,6060.205551326439,-97.99,2
09:39,943329213.0,1727.2306602446365,-13.26,8
09:41,348325817.0,10321.308745031884,-58.05,2
09:42,521611005.0,-154.24463585104647,-19.99,2
09:42,522188082.0,8357.970943312577,-32.86,8
09:42,987656636.0,6392.535912733989,-34.19,7
09:43,760704118.0,1505.606312717489,-53.89,2
09:43,261793952.0,444.3632602038149,-43.22,5
09:45,472213568.0,-263.11409420605327,-49.08,5
09:48,467207141.0,1504.5427170482635,-109.5,2
09:48,479456865.0,1885.570681489405,-26.97,4
09:49,168414279.0,-93.68521572507863,-163.97,2
09:49,948558249.0,9398.061233470718,-72.18,5
09:50,695607232.0,203.19049461055988,-49.99,2
09:51,535744551.0,1383.7855659956265,-6.0,4
09:51,898104045.0,-1464.478050000002,-88.39,5
09:52,364396689.0,-581.88225,-73.04,5
09:53,195895574.0,7637.735392052056,-0.13,5
09:54,907987693.0,-2388.034499999999,-16.92,5
09:54,151916463.0,1477.4315555991686,-90.3,2
09:55,467207141.0,1276.5427170482635,-228.0,2
09:55,366550080.0,25625.394997271535,-111.72,5
09:57,494156986.0,-14.829454327665118,-100.09,2
09:57,913127700.0,1336.1314380111164,-223.3,2
09:58,901432314.0,4420.281240507583,-90.96,2
09:58,741903302.0,3210.155458740787,-28.0,2
10:02,250895529.0,1905.6160824692884,-70.0,2
10:03,680773155.0,803.6690833310918,-46.4,5
10:03,945054126.0,-282.4619,-55.55,5
10:03,661295096.0,3335.5942044119356,-30.96,1
10:05,101531259.0,196.9895499999996,-104.84,5
10:06,781554833.0,2171.4924319437237,-15.98,2
10:06,519935524.0,1005.534909737519,-126.0,2
10:07,653667523.0,5968.519551326439,-91.69,2
10:10,254018059.0,-11.874799999999992,-22.52,5
10:10,924045955.0,1814.4300126586645,-7.0,7
10:11,711140907.0,1102.5405999999994,-109.98,2
10:11,904154012.0,1240.9074581204322,-119.99,2
10:11,943829984.0,149.0504091134572,-84.02,5
10:13,279149837.0,1783.6450499999987,-19.97,1
10:16,129018172.0,8900.619896282196,-29.96,1
10:17,192202372.0,719.8020190390737,-112.99,2
10:18,519644021.0,3450.6833105835935,-5.01,4
10:18,760704118.0,1348.1203127174886,-157.49,2
10:18,246753533.0,894.7908999999987,-6.15,9
10:19,352291960.0,3516.0000533035736,-60.05,2
10:22,287480331.0,12840.711220597108,-5.7,9
10:23,425730826.0,1759.0819093887196,-22.93,5
10:24,695607232.0,157.00449461055987,-46.19,2
10:25,228136274.0,-574.5891000000008,-94.24,5
10:26,660561861.0,1136.57978743765,-28.0,2
10:27,264550521.0,10228.187696115345,-279.3,2
10:27,165691047.0,485.75299999999913,-38.49,2
10:28,549414742.0,7695.985349714945,-0.48,7
10:29,175452235.0,1453.7092500000003,-145.85,2
10:29,519935524.0,903.159909737519,-102.38,2
10:30,709935470.0,601.5857376997724,-178.5,2
10:31,151916463.0,1393.4315555991686,-84.0,2
10:32,494156986.0,-96.55695432766512,-81.73,2
10:32,347110339.0,-359.7267925031481,-31.99,2
10:32,575652395.0,3732.797419761828,-10.01,4
10:33,653667523.0,5788.6335513264385,-179.89,2
10:34,857997794.0,1071.794665150887,-17.39,5
10:35,901432314.0,4349.595240507583,-70.69,2
10:38,250895529.0,1739.6160824692884,-166.0,2
10:39,695607232.0,-45.967505389440134,-202.97,2
10:44,570269025.0,3238.8618333598897,-19.99,2
10:44,165691047.0,379.2629999999991,-106.49,2
10:45,553734946.0,971.4960999999988,-84.27,5
10:46,828532554.0,426.5131013660719,-41.98,2
10:47,760704118.0,1286.5343127174883,-61.59,2
10:50,709935470.0,522.0857376997724,-79.5,2
10:52,696333897.0,777.132599999999,-171.98,2
10:52,521611005.0,-174.22463585104646,-19.98,4
10:56,461029994.0,7452.818299682367,-65.62,5
10:57,856147482.0,302.63715140137515,-153.99,2
10:57,519935524.0,747.159909737519,-156.0,2
10:59,760704118.0,1212.3483127174886,-74.19,2
11:01,264550521.0,9997.187696115345,-231.0,2
11:05,615144184.0,800.3537991255189,-47.0,2
11:06,183546640.0,189.75069734773393,-163.5,2
11:07,250895529.0,1699.6160824692884,-40.0,2
11:10,586041848.0,1316.555699999999,-74.68,5
11:10,347110339.0,-584.7067925031481,-224.98,2
11:11,134461671.0,5733.767893959772,-23.2,7
11:13,165691047.0,349.7629999999991,-29.5,2
11:14,310620484.0,316.2641950921983,-19.1,7
11:15,494156986.0,-253.2919543276651,-156.74,2
11:16,490790931.0,332.4447999999986,-40.88,5
11:22,924045955.0,1762.4000126586643,-52.03,2
11:22,407574996.0,5205.6569036085475,-32.07,1
11:22,250895529.0,1639.6160824692884,-60.0,2
11:22,856147482.0,135.14715140137514,-167.49,2
11:24,760704118.0,1076.5763127174887,-135.77,2
11:24,519935524.0,711.534909737519,-35.62,2
11:27,494156986.0,-275.7619543276651,-22.47,2
11:33,637649383.0,865.1564999999982,-57.98,2
11:33,695607232.0,-177.56750538944013,-131.6,2
11:34,941285623.0,296.40139906677024,-65.94,7
11:36,834383043.0,5619.125185073417,-12.99,2
11:38,856147482.0,6.64715140137514,-128.5,2
11:38,663479159.0,5462.383541827709,-28.95,7
11:40,519935524.0,623.364909737519,-88.17,2
11:43,494156986.0,-427.6219543276651,-151.86,2
11:45,151916463.0,1230.3315555991687,-163.1,2
11:47,165691047.0,303.2729999999991,-46.49,2
11:54,760704118.0,942.8903127174888,-133.69,2
11:55,475117511.0,8169.714014215998,-34.95,7
11:55,726913482.0,-15.9248985264761,-63.99,2
11:56,467207141.0,1186.5427170482635,-90.0,2
11:57,613427466.0,6835.971905655877,-22.97,7
11:59,909676212.0,915.2089779858976,-4.73,7
12:01,143003091.0,21860.76822185322,-59.98,4
12:02,611143859.0,4489.983500000011,-308.41,5
12:04,769319491.0,291.9119999999994,-71.96,7
12:04,152616936.0,1252.7460078630647,-84.57,5
12:07,856147482.0,-25.332848598624857,-31.98,2
12:08,170637730.0,3176.1130886715437,-39.18,7
12:10,136770968.0,189.7023999999996,-1.5,4
12:12,907987693.0,-2430.5244999999986,-42.49,9
12:12,165691047.0,296.2829999999991,-6.99,2
12:12,331048953.0,-40.78363202150638,-64.98,2
12:14,355940285.0,751.8529781896834,-178.5,2
12:16,766812921.0,67.66689999999934,-76.93,4
12:17,615144184.0,743.3637991255189,-56.99,2
12:17,987656636.0,6362.335912733989,-30.2,2
12:22,165691047.0,246.7829999999991,-49.5,2
12:22,913801979.0,475.1827799144939,-25.0,2
12:23,494156986.0,-512.364454327665,-84.74,2
12:26,467207141.0,1047.5427170482635,-139.0,2
12:26,237684254.0,6226.054829435009,-158.89,2
12:27,726913482.0,-110.4248985264761,-94.5,2
12:28,264550521.0,9712.287696115343,-284.9,2
12:30,548907062.0,241.1274887682886,-71.97,2
12:32,757115616.0,2307.8200000000033,-4.99,7
12:33,769319491.0,215.4219999999994,-76.49,4
12:33,766812921.0,-82.32310000000066,-149.99,2
12:34,106601471.0,10273.047824193807,-35.75,5
12:34,711140907.0,1074.5405999999994,-28.0,2
12:35,355940285.0,677.8529781896834,-74.0,2
12:35,380911501.0,-57.8298500000008,-37.68,9
12:38,760704118.0,773.5043127174887,-169.39,2
12:41,478651121.0,-76.9106204015302,-93.07,5
12:43,446720287.0,-747.5038091815944,-84.89,5
12:43,165691047.0,98.7829999999991,-148.0,2
12:43,779236304.0,1232.0075954795325,-25.39,9
12:44,695607232.0,-266.7545053894401,-89.19,5
12:44,655730067.0,-424.0559500000005,-89.91,5
12:46,660561861.0,1101.57978743765,-35.0,2
12:48,709935470.0,316.0857376997724,-206.0,2
12:48,918772878.0,-2224.9545172453204,-30.55,5
12:49,766692943.0,-1863.4217500000004,-11.46,5
12:49,722971557.0,-99.7282791569244,-23.92,4
12:50,915666111.0,-4149.562074772038,-40.71,5
12:50,146686559.0,-543.9330111734778,-76.17,5
12:51,856147482.0,-92.32284859862486,-66.99,2
12:52,760704118.0,677.6323127174887,-95.87,2
12:53,868014990.0,-3181.871099999996,-13.71,5
12:54,237684254.0,6054.582829435009,-171.47,2
12:56,572333122.0,-3484.7300499999965,-51.47,5
12:59,479366718.0,2079.6514476324005,-26.98,4
12:59,726913482.0,-213.41489852647612,-102.99,2
12:59,494156986.0,-616.9744543276651,-104.61,2
12:59,407323346.0,-2418.1204325553126,-37.4,5
13:03,688712152.0,6264.545824437442,-7.5,9
13:05,165691047.0,40.29299999999911,-58.49,2
13:06,290751280.0,437.8806966748256,-6.6,9
13:06,856147482.0,-211.81284859862484,-119.49,2
13:07,769319491.0,90.9319999999994,-124.49,4
13:09,660561861.0,1035.58978743765,-65.99,2
13:10,709935470.0,233.5857376997724,-82.5,2
13:12,433837402.0,-195.73586846418817,-32.78,9
13:14,948558249.0,9393.07123347072,-4.99,1
13:18,856147482.0,-309.2828485986248,-97.47,2
13:21,421881811.0,4652.770136830225,-20.23,2
13:24,696333897.0,641.991299999999,-135.14,5
13:25,695607232.0,-353.5125053894401,-86.76,2
13:26,670102069.0,4346.108965014793,-31.85,9
13:27,703537476.0,887.2632499999991,-134.67,5
13:28,519935524.0,511.98990973751904,-111.38,2
13:28,108812033.0,809.8619999999984,-34.45,5
13:31,657528784.0,155.9539000000007,-54.12,5
13:31,660561861.0,997.08978743765,-38.5,4
13:31,237684254.0,5992.996829435009,-61.59,2
13:34,421881811.0,4642.538816830225,-10.23,4
13:35,901432314.0,4115.837240507583,-233.76,2
13:37,653667523.0,5675.947551326439,-112.69,2
13:43,726913482.0,-332.4148985264761,-119.0,2
13:45,673025413.0,4435.5215573767,-38.93,9
13:46,519935524.0,476.36490973751904,-35.62,2
13:48,480198977.0,13033.481297642573,-11.98,4
13:49,403383649.0,1927.6094660994445,-143.7,5
13:49,250895529.0,1477.6160824692884,-162.0,2
13:49,392790315.0,-4291.526394372066,-64.55,5
13:56,467207141.0,943.0427170482636,-104.5,2
13:56,598793068.0,1014.1003499999983,-32.95,7
13:58,769319491.0,6.94199999999941,-83.99,7
14:01,726913482.0,-446.9148985264761,-114.5,2
14:06,973086490.0,10517.30697096182,-121.77,2
14:08,924045955.0,1732.3800126586646,-30.02,2
14:09,520447032.0,8883.848594237996,-293.3,2
14:11,519935524.0,436.30490973751904,-40.06,2
14:14,299871610.0,428.3156530587666,-47.82,5
14:18,250895529.0,1285.1160824692884,-192.5,2
14:22,183546640.0,15.250697347733931,-174.5,2
14:28,924045955.0,1717.3650126586645,-15.01,4
14:30,151916463.0,1100.8315555991687,-129.5,2
14:30,519935524.0,353.80490973751904,-82.5,2
14:31,681955876.0,-1585.7581000000005,-84.18,5
14:32,660561861.0,972.08978743765,-25.0,2
14:43,834383043.0,5603.145185073417,-15.98,1
14:45,250895529.0,1163.6160824692884,-121.5,2
14:45,521611005.0,-197.19463585104648,-22.97,7
14:49,355940285.0,620.8529781896834,-57.0,2
14:56,711140907.0,1024.560599999999,-49.98,4
14:59,151916463.0,889.4315555991687,-211.4,2
14:59,519935524.0,254.42990973751904,-99.38,2
15:07,556631012.0,557.1789230856782,-169.97,2
15:13,886921642.0,3776.1306557386006,-48.37,5
15:14,709935470.0,90.08573769977238,-143.5,2
15:14,653667523.0,5631.161551326439,-44.79,2
15:14,886921642.0,3742.752390571949,-33.38,8
15:27,355940285.0,486.3529781896834,-134.5,2
15:27,556631012.0,516.1617230856782,-41.02,5
15:28,812692024.0,3775.472857948952,-38.48,4
15:28,555804115.0,-1302.423547558703,-27.04,5
15:29,165691047.0,-27.20700000000089,-67.5,2
15:39,520447032.0,8883.635889922754,-0.21,5
15:40,355940285.0,444.3529781896834,-42.0,2
15:43,709935470.0,-16.41426230022762,-106.5,2
15:44,653667523.0,5568.175551326439,-62.99,2
15:58,796709231.0,-226.68422210370255,-50.15,5
15:59,165691047.0,-48.18700000000089,-20.98,2
16:00,225210798.0,1096.3537737592087,-3.0,4
16:00,678330503.0,3159.157883598127,-142.0,5
16:00,250895529.0,1051.6160824692884,-112.0,2
16:06,973086490.0,10501.535873944376,-15.77,5
16:08,126929801.0,2288.3904480651304,-24.99,9
16:12,868033067.0,-2230.903286451082,-43.76,5
16:13,467207141.0,904.0427170482636,-39.0,2
16:14,709935470.0,-135.41426230022762,-119.0,2
16:14,452974357.0,-3078.303949999995,-21.41,5
16:18,856147482.0,-468.7628485986248,-159.48,2
16:21,720742759.0,1860.2274308830076,-121.98,2
16:24,653667523.0,5358.917551326439,-209.26,2
16:25,678330503.0,3095.3978835981266,-63.76,2
16:25,467207141.0,849.5427170482637,-54.5,2
16:25,311467864.0,542.4934999999991,-43.41,5
16:26,250895529.0,870.6160824692884,-181.0,2
16:28,867987292.0,4391.664511013429,-10.0,2
16:32,165691047.0,-65.1670000000009,-16.98,2
16:32,744968736.0,-1524.6768265694238,-26.36,5
16:33,520447032.0,8747.135889922754,-136.5,2
16:33,370757362.0,1739.7265898126757,-31.99,2
16:36,678330503.0,3050.761521936265,-44.64,7
16:41,628470485.0,1246.125029900123,-26.97,4
16:41,856147482.0,-597.7628485986248,-129.0,2
16:44,709608057.0,3343.78160132997,-33.58,5
16:48,624500124.0,3788.451733166728,-116.9,2
16:50,713641917.0,1325.03852784912,-150.46,7
16:53,653667523.0,5260.245551326439,-98.67,2
16:53,603721739.0,1396.5368994831842,-21.98,4
16:53,785210466.0,2454.6598569695466,-32.29,5
16:57,467207141.0,604.0427170482637,-245.5,2
17:02,520447032.0,8611.335889922755,-135.8,2
17:02,198051483.0,-1182.3519104088568,-17.66,5
17:02,769319491.0,-68.02800000000059,-74.97,7
17:05,151916463.0,696.9315555991687,-192.5,2
17:05,766941757.0,10000.98415884242,-68.49,7
17:07,641764023.0,-1151.9838037720044,-30.42,5
17:08,165691047.0,-141.1570000000009,-75.99,2
17:08,556631012.0,401.1817230856782,-114.98,6
17:08,183186021.0,-2191.570049999999,-27.79,5
17:11,196289502.0,15665.694706194805,-31.24,2
17:12,348325817.0,10301.047039448778,-20.26,2
17:13,519935524.0,228.17990973751904,-26.25,2
17:14,532478725.0,5135.112093654671,-38.07,1
17:16,556992209.0,11750.458625924426,-11.51,4
17:17,556992209.0,11744.97625814561,-5.48,5
17:20,361955473.0,-263.5858047559156,-30.68,9
17:20,151968462.0,9275.06065516934,-20.49,5
17:23,815385232.0,10209.372666709089,-28.18,7
17:24,165691047.0,-176.6470000000009,-35.49,2
17:25,874431242.0,8696.693726567126,-75.31,2
17:27,713641917.0,1149.05852784912,-175.98,4
17:28,758160963.0,8324.233897328988,-7.51,4
17:28,450896297.0,13574.073722699812,-48.68,4
17:28,730002588.0,12857.707219318288,-32.28,2
17:29,450896297.0,13557.993154010845,-16.08,8
17:29,138609932.0,3494.885003294585,-11.94,4
17:29,416060965.0,611.0559021964068,-65.98,2
17:29,785749304.0,8676.357797121967,-56.29,2
17:30,467207141.0,542.0427170482637,-62.0,2
17:31,824916823.0,9092.718079830254,-9.15,4
17:31,419550103.0,18876.84660905829,-25.0,2
17:31,365608668.0,867.9821138595587,-22.96,7
17:32,873693307.0,10102.950274121193,-10.18,2
17:32,442070890.0,1014.8324124443712,-54.5,2
17:32,651756497.0,13694.937458445853,-19.2,7
17:32,613427466.0,6743.907905655877,-92.06,5
17:32,478412511.0,819.2977701974607,-35.48,9
17:34,769319491.0,-197.99800000000056,-129.97,4
17:34,633345190.0,7727.379489268264,-32.05,9
17:34,876890798.0,2961.488220699931,-35.95,7
17:35,726913482.0,-486.4148985264761,-39.5,2
17:35,809499628.0,16763.886230916884,-93.3,2
17:35,742223719.0,1050.9939073048026,-68.69,5
17:36,213112754.0,7119.186631498844,-10.35,2
17:36,924045955.0,1617.2750126586643,-100.09,2
17:37,795847804.0,22789.791521942618,-100.27,2
17:37,668329719.0,8900.8420171348,-9.36,7
17:38,355940285.0,362.8529781896834,-81.5,2
17:39,519935524.0,190.67990973751904,-37.5,2
17:39,482513594.0,6635.039543821098,-56.23,2
17:39,695607232.0,-478.0845053894401,-124.57,2
17:41,141521177.0,7320.545900000015,-60.98,2
17:43,987163717.0,6832.248480000006,-43.89,9
17:43,280268430.0,4908.23164463738,-129.98,2
17:44,639409800.0,34632.056010524255,-12.05,7
17:45,639409800.0,34622.906788351575,-9.15,2
17:45,624500124.0,3712.921733166728,-75.53,5
17:47,250895529.0,741.1160824692884,-129.5,2
17:51,822135975.0,11411.408696617438,-6.05,4
17:52,742223719.0,1025.0139073048026,-25.98,2
17:52,806358207.0,12501.412303385896,-21.17,4
17:54,324224854.0,3215.4746187916285,-81.95,2
17:55,874431242.0,8653.703586567126,-42.99,4
17:57,336171116.0,-477.9445500000005,-25.44,9
17:57,574548998.0,760.6613999999993,-47.44,5
17:59,956717493.0,1386.0248776068377,-25.0,2
17:59,726913482.0,-620.4048985264761,-133.99,2
18:00,511179916.0,6868.28118330804,-55.84,5
18:00,250895529.0,652.6160824692884,-88.5,2
18:02,496395938.0,13078.759113616905,-21.39,5
18:07,905860285.0,10910.517567946488,-47.84,5
18:08,992204045.0,12394.99183031355,-196.66,4
18:09,822250278.0,7521.150345473256,-27.94,9
18:10,891716230.0,761.6429840412952,-34.19,9
18:12,639409800.0,34556.18978835158,-66.72,5
18:13,355940285.0,218.35297818968343,-144.5,2
18:14,587202562.0,647.2042494170687,-118.56,5
18:16,519935524.0,96.92990973751904,-93.75,2
18:18,235881534.0,13066.551601182517,-66.07,7
18:21,653640811.0,17129.109012021483,-24.66,2
18:27,960208650.0,17416.76644845599,-16.03,5
18:28,726913482.0,-625.3948985264761,-4.99,2
18:30,491392945.0,4892.385500000007,-7.7,5
18:30,237493332.0,14583.854751137433,-59.47,2
18:30,259015404.0,2080.537627364386,-61.37,2
18:42,683078800.0,2003.8210413499592,-62.0,5
18:43,531186970.0,7397.76255624362,-26.98,7
18:43,762700245.0,-292.0402999999975,-42.15,9
18:43,992204045.0,12249.391830313549,-145.6,7
18:44,586315521.0,12376.04664436622,-31.95,9
18:45,660789920.0,-2378.325847382373,-22.0,5
18:46,975345315.0,35085.79054549698,-5.73,2
18:47,308068836.0,434.6515225681922,-40.69,9
18:48,785749304.0,8660.565797121968,-15.79,5
18:49,517190750.0,3465.0010899154126,-29.14,9
18:49,503575533.0,8050.151258699422,-33.41,5
18:54,726913482.0,-672.8848985264761,-47.49,2
18:56,270374623.0,10457.944237774074,-11.18,7
19:03,403902116.0,401.1593999999992,-273.57,5
19:08,687135796.0,27076.432069742317,-7.18,5
19:13,696758548.0,-3293.082896320137,-49.08,5
19:13,726913482.0,-791.3648985264762,-118.48,2
19:19,844835978.0,9699.279938921003,-48.55,5
19:26,807714284.0,1191.770860736,-80.0,5
19:31,625281433.0,-615.3148573707567,-95.1,5
19:35,801500539.0,-3064.656199999999,-48.86,5
19:37,461990622.0,10410.1369248401,-120.22,5
19:42,987656636.0,6328.798912733989,-33.54,5
19:42,308505160.0,14392.306898231263,-112.62,5
19:42,471897866.0,8751.834715768768,-100.88,5
19:51,108563213.0,23501.11721577139,-103.0,5
19:51,395284483.0,616.8293402113086,-75.96,5
19:55,913127700.0,1135.7403380111164,-200.39,5
20:00,726913482.0,-911.9626485264762,-120.6,5
20:12,405416860.0,2201.2279669583713,-28.63,9
20:13,370521542.0,25953.138986966344,-66.18,5
20:14,392270893.0,12582.564054162727,-38.87,5
20:16,975345315.0,35051.50454549698,-34.29,5
20:19,670102069.0,4291.628078360482,-54.48,4
20:26,348525881.0,215.2516245949363,-34.63,5
20:29,822135975.0,11321.906696617438,-89.5,5
20:36,245690309.0,9701.372389055115,-21.0,5
20:42,441274121.0,13061.361267807131,-11.95,9
20:43,287480331.0,12838.701212619288,-2.01,2
20:49,287480331.0,12807.831212619289,-30.87,9
20:56,758160963.0,8304.540404035144,-19.69,7
00:23,305778936.0,11819.177464712562,-23.88,4
00:24,613729471.0,9067.646789486183,-29.21,7
00:28,766941757.0,9979.524169936918,-21.46,7
00:33,480557476.0,11337.55724680105,-5.52,8
00:42,151968462.0,9267.183009742655,-7.88,5
00:43,779236304.0,1191.5675954795324,-40.44,9
00:51,407574996.0,5153.162566105467,-52.49,7
01:03,973086490.0,10492.485873944375,-9.05,9
01:19,766941757.0,9951.184169936918,-28.34,9
01:33,305778936.0,11782.277464712564,-36.9,9
02:09,399144202.0,2891.8915545962286,-26.7,9
02:14,518474507.0,15340.39873422776,-35.13,9
02:29,973086490.0,10472.178577818442,-20.31,2
02:43,601627384.0,4930.610503803205,-45.49,9
02:44,886921642.0,3715.673736472822,-27.08,5
02:48,534908754.0,-792.6695000000002,-24.15,9
02:50,304455868.0,2842.3071597158314,-36.7,9
02:53,588565416.0,7639.826238791576,-11.11,5
02:56,252760664.0,6984.98589308615,-8.96,5
02:59,264550521.0,9712.203441632611,-0.08,7
03:00,987163717.0,6795.958480000006,-36.29,9
03:11,678851253.0,3746.152964067223,-47.11,8
03:12,473820682.0,11627.400769803597,-32.51,7
03:24,187111705.0,7019.773755963787,-9.13,8
03:24,549414742.0,7680.005349714946,-15.98,9
03:25,940569402.0,6539.215396902039,-15.3,9
03:28,785210466.0,2435.3198569695464,-19.34,9
03:29,899742927.0,12687.284912081052,-45.94,5
03:29,287480331.0,12783.611212619287,-24.22,9
03:32,192202372.0,707.7202062815809,-12.08,5
03:34,348325817.0,10295.974992070453,-5.07,7
03:37,836110591.0,7204.428582299712,-3.82,5
03:37,270374623.0,10442.457905978712,-15.49,7
03:42,417850087.0,17346.93964259695,-46.67,2
03:47,145387690.0,6336.935580159986,-18.95,9
03:50,905860285.0,10905.75820453025,-4.76,5
03:51,930277104.0,10571.766641247892,-10.17,5
03:56,854895960.0,3587.5285824849148,-25.64,7
03:58,290818242.0,7357.203647282046,-30.32,2
04:00,287480331.0,12725.412623328177,-58.2,7
04:01,259015404.0,2046.687627364386,-33.85,9
04:01,116598243.0,3029.7605908522896,-41.25,7
04:08,687135796.0,27027.229377231215,-49.2,5
04:15,651756497.0,13674.955116704205,-19.98,8
04:16,419550103.0,18851.504827277087,-25.34,5
04:18,145387690.0,6317.019017815652,-19.92,2
04:19,108931112.0,14132.753154795788,-34.88,9
04:19,489964679.0,20668.104113998943,-35.73,9
04:22,203466392.0,3144.5515736901298,-5.23,2
04:26,460463595.0,-606.7079454185788,-42.9,9
04:32,310620484.0,289.0741950921983,-27.19,9
04:35,678330503.0,3048.9317263506077,-1.83,8
04:38,256002321.0,6455.594566194131,-16.9,9
04:42,572384506.0,11208.858380711588,-41.23,9
04:42,510101371.0,13369.97508353747,-28.7,9
04:43,873693307.0,10092.460274121191,-10.49,9
04:43,940569402.0,6493.8004687681205,-45.41,8
04:51,414805878.0,13537.09478422754,-37.84,9
04:51,221868392.0,5657.469407632679,-36.4,9
04:53,683319988.0,8082.09275490109,-39.04,9
04:53,699139822.0,1862.102244707942,-25.94,7
04:55,741269136.0,311.0109500000004,-30.45,9
04:56,679662108.0,16074.033343448173,-56.07,5
05:00,370521542.0,25910.026204472662,-43.11,8
05:00,128033695.0,2126.6121406060893,-50.55,8
05:02,255814263.0,4266.434696700545,-36.5,9
05:09,195895574.0,7634.988844549896,-2.75,2
05:13,647936800.0,717.12375348852,-24.61,5
05:16,623156843.0,5981.55352993249,-27.54,7
05:24,683319988.0,8050.379742140981,-31.71,8
05:27,873693307.0,10075.224796191733,-17.24,2
05:28,519644021.0,3447.8431167165377,-2.84,2
05:29,541639148.0,5015.98867215876,-9.23,5
05:30,949032480.0,5060.0880459658665,-4.68,2
05:32,496395938.0,13042.06681067362,-36.69,7
05:32,216285378.0,23604.36938463492,-37.98,9
05:33,414805878.0,13524.922115691114,-12.17,7
05:35,604288474.0,3472.820613932162,-14.45,5
05:40,183888402.0,18239.11298802294,-31.73,9
05:42,435984758.0,5583.283171097993,-8.4,7
05:43,675806859.0,7016.237850154607,-5.37,2
05:44,215311171.0,6546.761386940079,-43.59,8
05:45,657139925.0,13721.850466063686,-20.2,9
05:45,364357875.0,7808.030283330145,-5.62,7
05:49,985188462.0,650.7227887112248,-35.9,9
05:53,828532554.0,404.29310136607194,-22.22,9
05:55,315546581.0,27439.654376309736,-24.81,5
05:56,506618547.0,17648.51472511743,-2.64,7
05:57,187541224.0,2633.78000811304,-33.02,9
05:57,322720763.0,8078.229064954557,-22.67,5
05:58,987229118.0,4600.0385683096965,-28.93,2
06:00,166019891.0,7969.944230537427,-54.57,5
06:03,779946617.0,16765.55126175921,-7.03,5
06:05,670102069.0,4287.191408819105,-4.44,2
06:05,282837512.0,13902.643286844002,-16.48,9
06:10,245690309.0,9647.24530312403,-54.13,2
06:14,285220959.0,11616.366981774972,-21.38,5
06:14,776431321.0,3505.404246236963,-10.63,7
06:15,256002321.0,6443.096660736622,-12.5,7
06:16,994214354.0,10137.425514809249,-33.93,9
06:20,554792076.0,27132.551530922778,-2.7,5
06:23,310375875.0,4527.05996120708,-35.89,9
06:27,134461671.0,5721.977377813026,-11.79,7
06:28,383625050.0,6340.240769855387,-47.75,4
06:30,858989281.0,27125.292679648257,-19.29,9
06:30,213112754.0,7119.178326131793,-0.01,5
06:34,399144202.0,2854.822418315386,-37.07,5
06:41,282837512.0,13873.207957289833,-29.44,7
06:44,373875019.0,16191.282523365682,-31.68,9
06:45,550169791.0,21223.58333298675,-43.08,5
06:46,806358207.0,12455.519398204236,-45.89,5
06:47,893134725.0,1669.409381936779,-30.16,5
06:49,994214354.0,10117.950893121742,-19.47,5
06:49,851181128.0,5065.559089931723,-43.54,7
06:54,421881811.0,4642.1357913016645,-0.4,7
06:54,310375875.0,4513.296036019641,-13.76,5
06:56,540159353.0,11250.85963418178,-24.73,2
06:59,667367404.0,9555.027549049672,-2.4,2
07:01,108563213.0,23498.151680434643,-2.97,4
07:02,308505160.0,14385.463185310944,-6.84,2
07:05,809499628.0,16741.696230916885,-22.19,9
07:08,776108637.0,1154.0247536574957,-5.35,9
07:13,832564361.0,16087.639981621338,-32.74,5
07:17,785749304.0,8633.984837623024,-26.58,2
07:20,802697323.0,15778.748044083057,-41.89,9
07:21,885259672.0,4270.604496755063,-15.99,4
07:21,858989281.0,27075.629249220587,-49.66,2
07:23,532478725.0,5067.1400185797875,-36.61,5
07:24,322221939.0,4244.274896758526,-4.63,2
07:25,558119802.0,32421.196486475703,-14.38,9
07:28,842682241.0,6229.9738887483945,-21.27,7
07:30,586315521.0,12366.96812125888,-9.08,7
07:32,912705941.0,18411.979508781624,-34.81,7
07:35,887853850.0,11027.358608563822,-15.39,2
07:36,366550080.0,25624.630051454023,-0.76,7
07:37,324224854.0,3177.1853922996975,-38.29,5
07:37,822250278.0,7513.230737489886,-7.92,2
07:40,719586818.0,17409.467780282233,-19.61,5
07:42,853907490.0,7320.509629381036,-50.01,2
07:44,179173981.0,7041.668170711992,-6.75,8
07:44,738958551.0,9462.967663117031,-1.31,2
07:47,901432314.0,4086.427314110735,-29.41,7
07:55,500043411.0,13687.907936243068,-36.83,8
07:56,558119802.0,32388.109600071217,-33.09,2
08:00,874431242.0,8603.642277402976,-50.06,2
08:01,297823329.0,1116.5643999999993,-5.5,9
08:02,587225252.0,7697.581820229153,-37.09,5
08:02,358846516.0,853.7296725272179,-5.7,9
08:05,235881534.0,13055.94907646339,-10.6,2
08:06,824916823.0,9073.232665705387,-19.49,4
08:08,482513594.0,6593.728475835489,-41.31,2
08:08,395284483.0,611.3793402113085,-5.45,9
08:09,386729293.0,30336.94442889855,-25.13,2
08:10,822135975.0,11268.648203800178,-53.26,2
08:10,241459011.0,996.4355132723472,-6.15,9
08:12,897714622.0,8825.962486105349,-35.68,5
08:14,749378808.0,5932.804326503347,-8.56,2
08:17,930277104.0,10533.987641247892,-37.78,5
08:22,441274121.0,13046.1420281148,-15.22,2
08:26,504055745.0,-102.18783865823312,-74.69,5
08:27,187111705.0,6954.169755963787,-65.6,5
08:29,564214408.0,-55.48691527427391,-23.35,5
08:30,581655972.0,39824.27763760348,-2.69,7
08:30,673025413.0,4367.263738347661,-68.26,7
08:31,339791565.0,-3440.466199999997,-14.09,5
08:36,820686957.0,-794.5201163111959,-125.94,5
08:36,910730524.0,8138.5539486677135,-92.11,5
08:36,682194230.0,-2187.7458499999993,-40.39,5
08:37,663479159.0,5357.404541827709,-104.98,5
08:38,308897841.0,1070.415199999999,-41.96,5
08:40,925037906.0,978.3768000000016,-139.29,5
08:41,124102251.0,4163.015242451667,-73.29,2
08:41,744398361.0,790.9489999999998,-71.13,5
08:42,108931112.0,14003.750154795787,-129.0,5
08:46,237493332.0,14514.736751137432,-69.12,5
08:51,788740658.0,4006.8833072040056,-120.43,5
08:55,854895960.0,3383.2405824849147,-204.29,5
08:57,609939116.0,7594.307066790585,-14.67,8
08:59,752362502.0,10232.980638624354,-13.21,5
09:03,690958123.0,20223.90434570694,-5.5,9
09:04,624563756.0,-87.27917121644363,-6.45,9
09:05,540159353.0,11244.75963418178,-6.1,9
09:07,506618547.0,17642.01472511743,-6.5,9
09:12,558875206.0,3332.266279102216,-7.5,9
09:12,290818242.0,7351.053647282047,-6.15,9
09:12,441274121.0,13039.7920281148,-6.35,9
09:13,527842638.0,1766.2993926329837,-135.92,5
09:14,214339619.0,472.7075508683563,-6.9,9
09:14,417850087.0,17340.13964259695,-6.8,9
09:14,237684254.0,5989.012359447234,-3.98,2
09:17,853907490.0,7262.031629381036,-58.48,5
09:17,499244466.0,-273.4793312834222,-127.36,5
09:18,819515373.0,2669.5851360637917,-15.98,4
09:19,117273481.0,9430.10686229254,-6.6,9
09:19,979135922.0,-75.66669940954924,-45.03,2
09:19,129018172.0,8703.828896282197,-196.79,5
09:20,618138606.0,1661.0043472714349,-5.0,9
09:20,799861885.0,1080.441449999999,-77.99,2
09:21,261793952.0,414.38326020381487,-29.98,7
09:22,246753533.0,882.8108999999987,-11.98,4
09:23,143061865.0,7667.979034299202,-74.0,5
09:23,587225252.0,7667.021820229153,-30.56,2
09:24,757115616.0,2284.8600000000033,-22.96,7
09:25,564744955.0,578.3136585888419,-5.99,2
09:26,170233640.0,204.43823994989725,-1.5,4
09:26,494789005.0,3377.547978619463,-13.25,5
09:27,261894284.0,-3436.553799999997,-46.43,5
09:28,168414279.0,-223.18521572507865,-129.5,2
09:32,668175891.0,644.0819731584991,-169.99,2
09:32,762859681.0,613.8275999999988,-37.95,7
09:32,383833857.0,24322.908228517605,-13.42,5
09:33,678726554.0,181.2857523483896,-91.7,2
09:33,987656636.0,6313.438208231313,-15.36,8
09:33,272538745.0,15161.149900000026,-31.99,2
09:33,407574996.0,5035.499566105467,-117.66,5
09:35,250895529.0,593.1251824692883,-59.49,5
09:35,414454079.0,739.427850000002,-9.1,4
09:36,738958551.0,9409.437663117033,-53.53,2
09:38,948558249.0,9377.10123347072,-15.97,7
09:41,264550521.0,9690.143441632612,-22.06,7
09:42,399538448.0,8192.54652725647,-205.1,2
09:43,781554833.0,2044.5306319437236,-126.96,5
09:45,680773155.0,773.6790833310918,-29.99,2
09:49,642015139.0,36.51133746563825,-14.98,1
09:50,403383649.0,1900.6194660994445,-26.99,1
09:50,259015404.0,2022.727627364386,-23.96,7
09:53,977899503.0,-319.56110641914745,-77.78,5
09:54,407574996.0,4909.029566105467,-126.47,6
09:56,572384506.0,11188.188380711588,-20.67,2
10:00,598793068.0,998.1203499999984,-15.98,4
10:01,718058208.0,3133.7244621119185,-20.03,4
10:03,625658193.0,421.9219197562168,-38.03,2
10:04,741903302.0,3088.155458740787,-122.0,2
10:06,282837512.0,13867.057957289831,-6.15,9
10:09,246753533.0,877.8108999999987,-5.0,9
10:10,287480331.0,12719.762623328175,-5.65,9
10:11,678726554.0,35.69975234838961,-145.59,2
10:11,258201793.0,-273.28980000000035,-129.98,2
10:14,108931112.0,13981.491854795788,-22.26,4
10:15,984783496.0,14540.860531748416,-10.27,2
10:16,722971557.0,-197.7082791569244,-97.98,2
10:26,727417797.0,5421.38950000001,-65.2,5
10:29,865748375.0,3845.843189479151,-178.16,2
10:30,678726554.0,-33.5722476516104,-69.27,2
10:33,553734946.0,829.5260999999987,-141.97,2
10:37,284905540.0,7754.490902505019,-76.26,6
10:38,767447966.0,4818.081325512111,-81.02,5
10:39,857455726.0,-189.42611412431572,-189.5,2
10:40,259015404.0,1986.027082655348,-36.7,2
10:41,964702094.0,2001.551376727643,-149.98,2
10:41,741903302.0,3014.155458740787,-74.0,2
10:45,815993333.0,1030.3856390614071,-223.3,2
10:45,399538448.0,7946.146527256471,-246.4,2
10:47,277562576.0,924.498698224955,-23.97,4
10:50,766941757.0,9895.870009936918,-55.31,4
10:50,821971408.0,1284.971721374878,-16.98,7
10:52,344843570.0,-101.8443175093338,-20.98,7
10:54,550832673.0,3484.5271344744074,-61.98,2
10:54,941285623.0,236.42139906677025,-59.98,4
10:56,575652395.0,3682.767419761828,-50.03,2
10:56,151916463.0,571.6875555991687,-125.24,5
11:00,399538448.0,7828.546527256471,-117.6,2
11:03,857455726.0,-389.92611412431575,-200.5,2
11:03,744398361.0,693.9589999999998,-96.99,2
11:04,672994751.0,-69.64370921398994,-169.49,2
11:04,815993333.0,898.0856390614074,-132.3,2
11:05,550832673.0,3483.0271344744074,-1.5,4
11:06,586041848.0,1171.655699999999,-144.9,2
11:07,519644021.0,3153.143116716538,-294.7,2
11:10,521611005.0,-207.1846358510465,-9.99,2
11:11,534204159.0,6344.733132706447,-9.79,2
11:12,679943657.0,5423.832891111273,-45.21,2
11:12,456246119.0,19793.88199821335,-5.0,4
11:16,722971557.0,-237.6882791569244,-39.98,2
11:20,625658193.0,378.9019197562168,-43.02,2
11:21,538003940.0,2115.4000000000087,-6.99,4
11:24,551755686.0,6620.570655850648,-6.0,4
11:25,519644021.0,3070.833116716538,-82.31,2
11:26,169689461.0,1654.1660999999992,-22.0,6
11:28,170233640.0,176.47823994989724,-27.96,7
11:29,522188082.0,8349.765548527579,-8.21,7
11:29,625658193.0,312.8519197562168,-66.05,2
11:37,779946617.0,16714.416261759212,-51.13,5
11:37,857455726.0,-479.42611412431575,-89.5,2
11:37,672994751.0,-151.14370921398995,-81.5,2
11:39,421881811.0,4522.477791301664,-119.66,2
11:43,849096144.0,2609.829858910518,-15.98,7
11:46,718058208.0,3095.832818450834,-37.89,4
11:48,709608057.0,3321.60160132997,-22.18,2
11:48,441142605.0,2368.3677000000057,-7.5,4
11:51,711140907.0,961.5605999999992,-63.0,2
11:56,586041848.0,977.0556999999988,-194.6,2
12:01,857455726.0,-526.9261141243157,-47.5,2
12:01,169689461.0,1624.6760999999992,-29.49,2
12:06,162162212.0,-399.5876066726912,-114.98,2
12:07,480557476.0,11294.80724680105,-42.75,6
12:07,224215364.0,-1683.4625920882788,-26.38,9
12:08,700138124.0,6057.72968243974,-70.48,5
12:11,421881811.0,4370.577791301665,-151.9,2
12:11,567499591.0,-1252.3553000000004,-23.29,9
12:26,556631012.0,375.2217230856782,-25.96,7
12:28,421881811.0,4234.077791301665,-136.5,2
12:31,984783496.0,14516.710531748417,-24.15,9
12:33,586041848.0,747.4556999999988,-229.6,2
12:37,904154012.0,1230.9174581204322,-9.99,7
12:41,127809299.0,1840.629868947285,-88.12,2
12:47,518746136.0,-827.2897282369165,-15.06,5
12:48,741903302.0,2864.155458740787,-150.0,2
12:51,421881811.0,4047.1917913016646,-186.89,2
12:59,538003940.0,2083.4400000000087,-31.96,7
13:02,215426302.0,792.0704040256918,-16.23,5
13:04,816685391.0,-602.9926037084263,-61.94,5
13:04,338022396.0,695.6382393757391,-58.79,5
13:05,688712152.0,6258.095824437442,-6.45,9
13:06,305778936.0,11771.887464712565,-10.39,2
13:09,857455726.0,-749.9261141243157,-223.0,2
13:11,127809299.0,1759.254868947285,-81.38,2
13:13,910730524.0,8132.853948667714,-5.7,9
13:13,709608057.0,3281.95160132997,-39.65,9
13:13,678726554.0,-149.05824765161037,-115.49,2
13:15,741903302.0,2789.655458740787,-74.5,2
13:16,857455726.0,-954.4261141243156,-204.5,2
13:19,849096144.0,2604.7798589105178,-5.05,9
13:20,421881811.0,3874.3057913016646,-172.89,2
13:20,984783496.0,14491.664585113484,-25.05,5
13:20,305778936.0,11751.107464712562,-20.78,1
13:23,744211756.0,-4002.625749999994,-13.71,5
13:25,815993333.0,807.7856390614074,-90.3,4
13:27,598586358.0,-3280.217449999996,-41.36,5
13:28,520447032.0,8561.144821446022,-50.19,5
13:31,762896656.0,140.76499815185866,-129.5,2
13:33,155867488.0,226.22869999999844,-21.09,9
13:33,280098744.0,871.4343778716657,-134.99,2
13:39,549414742.0,7669.710389714945,-10.29,4
13:40,132400709.0,597.6485851539397,-83.49,5
13:41,678726554.0,-290.45824765161035,-141.4,2
13:41,165691047.0,-282.06280000000095,-105.42,5
13:43,127809299.0,1650.879868947285,-108.38,2
13:45,815993333.0,699.9856390614075,-107.8,7
13:47,941285623.0,187.42139906677025,-49.0,2
13:47,909676212.0,882.2589779858977,-32.95,7
13:47,932820758.0,-2433.124066775554,-37.96,5
13:53,762896656.0,133.76499815185866,-7.0,2
13:57,494789005.0,3333.6299786194627,-43.92,5
14:08,346874167.0,302.01239999999905,-58.77,5
14:13,494977194.0,1967.627120597578,-141.49,5
14:19,762896656.0,-50.33500184814133,-184.1,2
14:20,625658193.0,292.8419197562168,-20.01,2
14:22,941285623.0,155.92139906677025,-31.5,2
14:27,520447032.0,8526.214821446021,-34.93,9
14:27,169689461.0,1559.1960999999992,-65.48,2
14:30,421881811.0,3685.6627913016646,-188.64,5
14:31,857455726.0,-1051.4261141243155,-97.0,2
14:35,348325817.0,10277.604992070452,-18.37,9
14:48,535744551.0,1253.3524659956263,-130.43,5
14:55,857455726.0,-1195.9261141243155,-144.5,2
14:55,865748375.0,3815.401760595295,-30.44,7
14:56,556992209.0,11702.85025814561,-42.13,5
14:58,941285623.0,94.33539906677026,-61.59,2
15:03,280098744.0,841.4443778716657,-29.99,4
15:07,272538745.0,15116.169900000026,-44.98,4
15:19,741903302.0,2660.655458740787,-129.0,2
15:22,857455726.0,-1320.9261141243155,-125.0,2
15:23,994947671.0,1133.0357000000004,-11.94,4
15:26,169689461.0,1489.2160999999992,-69.98,2
15:29,941285623.0,-59.664600933229735,-154.0,2
15:33,158414827.0,-1667.3500000000015,-31.78,5
15:33,741903302.0,2575.655458740787,-85.0,2
15:39,762896656.0,-183.33500184814133,-133.0,2
15:40,479456865.0,1860.370681489405,-25.2,9
15:41,169689461.0,1311.2260999999992,-177.99,2
15:41,587225252.0,7641.941820229153,-25.08,9
15:46,127809299.0,1566.879868947285,-84.0,2
15:46,625658193.0,241.25037975621677,-51.59,4
15:47,168414279.0,-313.48521572507866,-90.3,2
15:47,941285623.0,-70.15060093322974,-10.49,2
15:49,857455726.0,-1414.9261141243155,-94.0,2
16:04,625658193.0,190.23037975621676,-51.02,2
16:07,305778936.0,11737.597464712562,-13.51,2
16:08,151916463.0,549.6675555991687,-22.02,2
16:13,298000165.0,24937.20134189493,-20.06,7
16:13,762896656.0,-267.33500184814136,-84.0,2
16:15,340295966.0,-1520.2394500000005,-25.61,5
16:23,169689461.0,1202.7360999999992,-108.49,7
16:25,762896656.0,-452.1350018481413,-184.8,2
16:30,691012931.0,-1659.017250000001,-31.98,5
16:31,127809299.0,1512.504868947285,-54.38,2
16:32,698076160.0,6317.875466600322,-47.0,2
16:35,624500124.0,3706.831733166728,-6.09,2
16:38,345582855.0,54.7324528205493,-9.03,5
16:46,227104649.0,2911.9530543161777,-29.98,7
16:47,421881811.0,3500.9047913016648,-184.76,2
16:47,834383043.0,5563.254932435832,-39.89,5
16:56,548907062.0,201.1474887682886,-39.98,4
16:59,522188082.0,8273.493308527579,-76.27,4
16:59,586041848.0,663.4556999999988,-84.0,2
17:00,633345190.0,7692.249489268264,-35.13,9
17:01,605116158.0,2501.467200000001,-8.49,4
17:02,678726554.0,-361.8582476516103,-71.4,2
17:04,399538448.0,7647.2465272564705,-181.3,2
17:05,604334058.0,846.3852999999995,-19.99,4
17:06,127809299.0,1424.379868947285,-88.12,2
17:07,736310094.0,-674.662324027426,-60.02,5
17:09,380228542.0,-224.79305818443453,-308.19,5
17:10,237493332.0,14500.149992578115,-14.59,5
17:12,678726554.0,-433.2582476516103,-71.4,2
17:16,730002588.0,12842.895867913308,-14.81,2
17:17,399538448.0,7479.94652725647,-167.3,2
17:17,752362502.0,10222.980638624354,-10.0,7
17:17,807714284.0,1163.770860736,-28.0,2
17:19,706250160.0,11839.000693428548,-31.35,2
17:20,887853850.0,10985.768608563822,-41.59,7
17:21,586041848.0,460.4556999999989,-203.0,2
17:21,824916823.0,9049.802665705389,-23.43,9
17:24,255814263.0,4244.474696700545,-21.96,1
17:25,705848712.0,25961.160145046764,-14.99,9
17:25,919185264.0,5349.434722887973,-5.99,1
17:26,296770890.0,2062.532010379083,-59.98,2
17:26,698955014.0,1413.086054940912,-29.99,2
17:27,854895960.0,3205.2605824849147,-177.98,2
17:28,574548998.0,755.6713999999993,-4.99,7
17:28,352899149.0,693.5750499999988,-104.49,2
17:28,361201224.0,3369.9102320678926,-6.01,7
17:28,141521177.0,7281.575900000014,-38.97,2
17:28,229205098.0,7648.980643277926,-11.93,8
17:30,846550094.0,1830.0587405544088,-8.98,4
17:30,836110591.0,7195.098582299712,-9.33,4
17:30,625658193.0,88.16037975621677,-102.07,2
17:30,478986718.0,-998.9877000000004,-64.47,5
17:31,454129843.0,1706.128450791789,-43.95,7
17:32,450896297.0,13520.603154010843,-37.39,9
17:32,166019891.0,7944.674230537426,-25.27,2
17:32,287230540.0,1481.248598937001,-39.95,1
17:33,678726554.0,-648.1302476516103,-214.87,2
17:33,417850087.0,17279.91944259695,-60.22,4
17:33,315546581.0,27427.644376309738,-12.01,4
17:37,127809299.0,1345.629868947285,-78.75,2
17:39,203466392.0,3080.22157369013,-64.33,5
17:41,352899149.0,670.0850499999988,-23.49,2
17:42,905860285.0,10828.75820453025,-77.0,2
17:47,220183538.0,1113.7323999999996,-55.44,5
17:47,152488934.0,1666.3131573137307,-39.5,5
17:47,322720763.0,8045.229064954557,-33.0,4
17:48,169006407.0,12093.79977487662,-0.05,2
17:48,769311479.0,7294.005044107092,-57.56,2
17:48,583579399.0,1506.3762999999992,-46.97,4
17:48,698076160.0,6274.277370235582,-43.6,2
17:49,558875206.0,3301.3162791022164,-30.95,7
17:51,131388684.0,22069.595711743783,-23.59,7
17:52,713910252.0,37.57002572854125,-62.76,5
17:53,878989510.0,5962.0398861417925,-120.09,5
17:53,196289502.0,15649.424706194804,-16.27,4
17:54,399538448.0,7251.7465272564705,-228.2,2
17:54,832564361.0,15989.639981621338,-98.0,2
17:54,441274121.0,13020.8172081148,-18.97,4
17:55,315546581.0,27328.04137630974,-99.6,5
17:55,785749304.0,8585.278837623024,-48.71,5
17:55,198946608.0,6680.929256534036,-9.23,7
17:57,352899149.0,637.5950499999988,-32.49,2
17:58,851181128.0,5040.409089931723,-25.15,9
18:00,893134725.0,1662.419381936779,-6.99,7
18:04,704517789.0,17407.858189558705,-3.73,7
18:04,127809299.0,1252.254868947285,-93.38,2
18:05,540159353.0,11202.68963418178,-42.07,5
18:08,905860285.0,10801.45820453025,-27.3,2
18:09,245690309.0,9610.32145312403,-36.92,4
18:10,245690309.0,9588.38145312403,-21.94,9
18:11,113747882.0,12413.679541532314,-42.14,4
18:11,741903302.0,2416.655458740787,-159.0,2
18:16,170637730.0,3138.643592681713,-37.47,7
18:18,127809299.0,1199.754868947285,-52.5,2
18:18,450896297.0,13506.65226212724,-13.95,5
18:18,399538448.0,7150.2465272564705,-101.5,2
18:21,788740658.0,3954.395799998452,-52.49,8
18:24,196289502.0,15551.536706194804,-97.89,5
18:28,836110591.0,7169.708582299711,-25.39,9
18:30,419550103.0,18844.51482727709,-6.99,7
18:32,321372947.0,-282.70675078909943,-33.89,5
18:36,229502829.0,-3429.8967741862475,-27.69,9
18:36,433917275.0,8519.757105347733,-15.93,7
18:39,627917561.0,3514.9250500000044,-29.92,9
18:40,905860285.0,10759.45820453025,-42.0,2
18:44,842682241.0,6123.587888748394,-106.39,5
18:44,108481285.0,8708.543573213212,-1.81,7
18:44,690523499.0,287.39845000000014,-7.5,7
18:45,493855007.0,-2553.489131574393,-20.07,5
18:45,887853850.0,10953.878608563822,-31.89,9
18:47,785749304.0,8568.828837623023,-16.45,9
18:48,336557504.0,1568.787695019486,-107.45,5
18:48,851181128.0,5020.282889931724,-20.13,7
18:49,117273481.0,9303.82686229254,-126.28,5
18:53,131388684.0,22055.483711743786,-14.11,5
19:02,795847804.0,22786.684006446805,-3.11,7
19:08,256045540.0,-3374.393899999999,-51.25,5
19:09,627723633.0,-1923.1063280037629,-112.82,5
19:10,559995067.0,3997.9830771445304,-3.48,2
19:12,547010927.0,23097.081210764092,-35.45,9
19:13,901432314.0,4068.115314110735,-18.31,5
19:16,905860285.0,10612.45820453025,-147.0,2
19:20,280098744.0,775.9873778716657,-65.46,5
19:21,713057426.0,-1627.6417500000002,-40.91,5
19:22,331684336.0,-1498.7522199513214,-77.9,5
19:28,809499628.0,16739.543532613552,-2.15,5
19:29,687135796.0,27005.039377231216,-22.19,9
19:30,705848712.0,25893.190145046763,-67.97,5
19:36,859603181.0,4277.553704216416,-23.87,5
19:36,213112754.0,7109.1883261317935,-9.99,9
19:40,409971170.0,2831.5211271209755,-1.88,5
19:43,329840194.0,1832.470890143148,-108.67,5
19:49,620227043.0,-1950.870271013424,-89.57,5
19:52,871866387.0,-137.6122000000007,-64.19,5
19:57,978410962.0,-2808.9183395489727,-35.26,5
19:57,930277104.0,10494.817641247892,-39.17,9
19:59,679943657.0,5412.833520430275,-11.0,2
19:59,245690309.0,9564.609453124029,-23.77,5
20:01,859264768.0,413.3729837819384,-59.01,5
20:03,195895574.0,7610.838844549896,-24.15,9
20:05,668329719.0,8875.447704301298,-25.39,7
20:14,890830949.0,1175.874049999998,-115.73,5
20:18,949032480.0,5028.108045965867,-31.98,9
20:23,795847804.0,22744.096006446805,-42.59,5
20:28,933491926.0,3378.610300000002,-44.76,5
20:43,859603181.0,4116.273704216416,-161.28,5
20:48,610645022.0,-664.2393626449183,-117.61,5
20:50,200080192.0,9731.407183790589,-59.02,5
20:50,503575533.0,8009.243258699422,-40.91,5
20:58,806358207.0,12345.143398204234,-110.38,5
20:58,930271460.0,322.8005475357762,-58.37,5
21:00,678726554.0,-696.6192476516103,-48.49,5
21:00,518474507.0,15306.095728973496,-34.3,2
02:25,749378808.0,5903.014326503347,-29.79,9
02:33,364357875.0,7790.340283330145,-17.69,9
02:37,216285378.0,23573.93938463492,-30.43,9
02:37,987163717.0,6759.958480000006,-36.0,9
02:40,541639148.0,5012.676122427698,-3.31,7
02:43,221868392.0,5616.779407632679,-40.69,9
02:44,985188462.0,620.8427887112248,-29.88,9
02:47,822135975.0,11243.37257440949,-25.28,8
02:48,779236304.0,1164.3575954795324,-27.21,9
02:52,873693307.0,10069.391632101164,-5.83,7
02:55,290818242.0,7298.564707157009,-52.49,2
02:57,779946617.0,16688.808647793685,-25.61,7
03:03,749378808.0,5894.91133350851,-8.1,5
03:05,647936800.0,711.0687916349477,-6.05,4
03:14,221868392.0,5580.938670119835,-35.84,8
03:18,383625050.0,6336.189051254782,-4.05,5
03:25,187541224.0,2598.60000811304,-35.18,9
03:32,822250278.0,7493.718277609907,-19.51,8
03:35,145387690.0,6287.219017815652,-29.8,9
03:38,547010927.0,23062.211210764093,-34.87,9
03:41,433917275.0,8480.517105347733,-39.24,9
03:51,809499628.0,16733.55353261355,-5.99,9
03:58,388862238.0,1348.5438071334413,-3.11,5
03:59,366550080.0,25617.048098798183,-7.58,2
04:03,549414742.0,7639.760389714946,-29.95,9
04:06,994214354.0,10090.460893121744,-27.49,9
04:07,124102251.0,4147.399758263949,-15.62,2
04:09,534325901.0,6801.090376047201,-9.76,8
04:09,547010927.0,23059.71859400783,-2.49,5
04:09,647472692.0,25061.43386836512,-36.65,9
04:11,836110591.0,7138.758582299712,-30.95,9
04:20,785749304.0,8504.546641541066,-64.28,7
04:21,237493332.0,14464.159381487803,-35.99,2
04:21,120634201.0,4759.293500000006,-15.44,9
04:23,117308635.0,1234.6429506565316,-19.25,8
04:24,113747882.0,12385.319541532312,-28.36,9
04:30,145387690.0,6282.255495550866,-4.96,2
04:31,851649498.0,10570.663905583686,-21.1,5
04:36,324224854.0,3166.7990722189634,-10.39,2
04:36,489964679.0,20637.164113998944,-30.94,9
04:42,667367404.0,9538.51274257692,-16.51,4
04:46,183888402.0,18198.892988022937,-40.22,9
04:52,949032480.0,4963.358804989143,-64.75,2
04:55,522188082.0,8221.25632663365,-52.24,5
05:00,752362502.0,10200.17209197982,-22.81,7
05:00,213112754.0,7095.328924679306,-13.86,5
05:03,473820682.0,11624.917544388289,-2.48,2
05:05,899742927.0,12640.317187071898,-46.97,8
05:05,550169791.0,21216.15061450632,-7.43,8
05:05,802697323.0,15732.928044083055,-45.82,9
05:06,510101371.0,13330.53508353747,-39.44,9
05:06,604288474.0,3470.957903061716,-1.86,2
05:07,229205098.0,7646.932178615594,-2.05,7
05:08,683319988.0,8028.259127273063,-22.12,7
05:09,824916823.0,9019.632665705389,-30.17,9
05:10,706250160.0,11806.34067696298,-32.66,7
05:19,370521542.0,25883.17590195193,-26.85,8
05:24,687135796.0,26994.049377231215,-10.99,9
05:26,183888402.0,18183.85362839636,-15.04,8
05:29,818552503.0,321.5967499999989,-38.14,9
05:29,287480331.0,12664.814962387243,-54.95,5
05:31,143061865.0,7667.243498500871,-0.74,8
05:31,581655972.0,39819.89157974267,-4.39,4
05:32,558875206.0,3290.8845941428617,-10.43,5
05:34,858989281.0,27062.129249220587,-13.5,9
05:35,558119802.0,32375.129600071217,-12.98,9
05:37,285873880.0,11532.565543619496,-63.82,7
05:39,383833857.0,24306.368336388074,-16.54,5
05:42,678851253.0,3737.7792341465774,-8.37,7
05:50,187111705.0,6924.432642966037,-29.74,8
05:51,673025413.0,4284.4854300527095,-82.78,7
05:55,399144202.0,2836.8085556579676,-18.01,5
05:59,237684254.0,5972.514586653854,-16.5,2
06:03,699139822.0,1823.569014825545,-38.53,2
06:04,310375875.0,4507.452223543661,-5.84,2
06:05,116598243.0,3018.24956248784,-11.51,7
06:05,679911053.0,2779.311643583127,-16.1,2
06:05,758160963.0,8302.322468487651,-2.22,7
06:08,987656636.0,6272.371579223929,-41.07,2
06:09,905860285.0,10590.117802615903,-22.34,7
06:12,166019891.0,7920.334230537426,-24.34,9
06:12,709608057.0,3236.76160132997,-45.19,9
06:15,108563213.0,23491.68519465088,-6.47,4
06:17,195895574.0,7590.6230361048365,-20.22,7
06:19,633345190.0,7660.979489268264,-31.27,9
06:21,305778936.0,11686.208624374896,-51.39,5
06:22,143003091.0,21848.208606499007,-12.56,5
06:23,940569402.0,6480.860468768121,-12.94,9
06:24,417850087.0,17221.485083979667,-58.43,5
06:25,851181128.0,4996.685394376763,-23.6,2
06:31,487051121.0,949.0119637034942,-33.93,5
06:37,670102069.0,4265.471408819105,-21.72,9
06:43,482513594.0,6558.41683119399,-35.31,7
06:45,532478725.0,5029.150018579788,-37.99,9
06:45,203466392.0,3047.3045358822833,-32.92,7
06:45,433917275.0,8450.75958309654,-29.76,7
06:45,951817450.0,9990.218848918035,-31.69,2
06:46,450896297.0,13472.30226212724,-34.35,9
06:46,518474507.0,15273.095728973496,-33.0,9
06:47,270374623.0,10355.74010413148,-86.72,4
06:47,613729471.0,9050.638005030452,-17.01,8
06:48,252760664.0,6962.070407507306,-22.92,8
06:51,506618547.0,17569.83278913601,-72.18,2
06:53,117273481.0,9301.374917595089,-2.45,2
06:55,897714622.0,8772.432868061951,-53.53,7
06:55,558119802.0,32331.78223832509,-43.35,5
06:57,169006407.0,12082.40427623865,-11.4,7
06:59,806358207.0,12328.163398204237,-16.98,9
07:01,679662108.0,16044.86582762582,-29.17,5
07:03,422955974.0,178.91278499904993,-35.13,9
07:08,776108637.0,1148.6747536574958,-5.35,9
07:08,108931112.0,13932.601854795788,-48.89,9
07:10,146909202.0,6045.144056889959,-7.63,2
07:12,960208650.0,17414.549274992998,-2.22,2
07:15,698076160.0,6245.944838017044,-28.33,5
07:15,285220959.0,11615.4649086432,-0.9,8
07:19,461990622.0,10405.400783070305,-4.74,2
07:21,647472692.0,25004.723128364338,-56.71,7
07:21,815385232.0,10172.770328706903,-36.6,5
07:24,471897866.0,8719.684038839947,-32.15,8
07:25,609939116.0,7584.519187710644,-9.79,7
07:25,639549973.0,7502.050037354493,-25.37,7
07:26,601627384.0,4900.370569671502,-30.24,5
07:27,901037631.0,393.9693230964071,-6.5,9
07:32,494789005.0,3332.766482803271,-0.86,7
07:32,730002588.0,12808.910435348687,-33.99,5
07:33,179173981.0,7015.168570235178,-26.5,2
07:35,633345190.0,7589.712204949599,-71.27,2
07:36,858989281.0,27034.92879775344,-27.2,4
07:40,668329719.0,8851.450085113254,-24.0,2
07:41,986267641.0,7576.986484856536,-8.24,8
07:42,690958123.0,20217.973478441658,-5.93,5
07:42,408057540.0,5274.290861361828,-20.51,7
07:42,887853850.0,10937.727402354863,-16.15,5
07:42,795847804.0,22738.07985899546,-6.02,2
07:44,235881534.0,13046.654224556283,-9.29,7
07:51,930277104.0,10486.562051723891,-8.26,2
07:52,256002321.0,6420.246660736621,-22.85,9
07:53,718058208.0,3092.7360199628333,-3.1,2
07:54,687135796.0,26926.67807927523,-67.37,2
07:57,535744551.0,1214.6524659956262,-38.7,9
07:58,454129843.0,1700.428450791789,-5.7,9
07:59,572384506.0,11163.923731572831,-24.26,2
08:00,943329213.0,1718.6120323664966,-8.62,5
08:04,395284483.0,605.6793402113085,-5.7,9
08:05,399538448.0,7144.44652725647,-5.8,9
08:06,519935524.0,90.77990973751903,-6.15,9
08:06,719586818.0,17388.197228530917,-21.27,8
08:07,380228542.0,-230.14305818443452,-5.35,9
08:10,992204045.0,12248.929033090786,-0.46,2
08:13,358846516.0,849.0296725272178,-4.7,9
08:15,885259672.0,4264.854496755063,-5.75,9
08:15,336557504.0,1562.987695019486,-5.8,9
08:19,252964502.0,-695.4853224913006,-14.96,5
08:20,472213568.0,-326.45534420605327,-63.34,5
08:22,170637730.0,3129.3368074473706,-9.31,2
08:23,467207141.0,536.2927170482637,-5.75,9
08:23,264550521.0,9667.370361198107,-22.77,7
08:23,734161378.0,-2619.3651694342125,-26.52,5
08:23,948558249.0,9371.75123347072,-5.35,9
08:23,435984758.0,5572.748593062955,-10.53,4
08:24,554771381.0,-1744.5811500000002,-26.08,5
08:24,700138124.0,6054.879262580885,-2.85,2
08:24,191161970.0,-3475.127999999996,-18.46,5
08:25,416060965.0,577.2225448328345,-33.83,2
08:26,146909202.0,6039.0440568899585,-6.1,9
08:29,832564361.0,15954.701310483088,-34.94,2
08:32,308505160.0,14363.267316396385,-22.2,7
08:32,901432314.0,4061.7653141107353,-6.35,9
08:32,704517789.0,17295.403189558703,-112.45,5
08:35,809499628.0,16733.00825243335,-0.55,2
08:36,741903302.0,2244.646558740787,-172.01,5
08:38,414805878.0,13486.192115691114,-38.73,9
08:39,196289502.0,15537.646706194804,-13.89,9
08:39,245198540.0,-54.33360119822053,-12.99,5
08:46,954263768.0,-114.42130000000024,-23.65,5
08:46,984783496.0,14438.101065678997,-53.56,7
08:51,403383649.0,1839.4677637323432,-61.15,8
08:59,550832673.0,3388.863134474407,-94.16,5
09:00,627936697.0,1010.4103,-255.26,5
09:00,855129444.0,-112.736445437372,-142.6,5
09:01,866941383.0,3101.800750000006,-73.91,5
09:02,998390769.0,-235.49174905947575,-134.58,5
09:03,967989787.0,-178.41276735927278,-166.84,5
09:05,659415300.0,3341.577690250704,-100.69,5
09:07,117273481.0,9295.974917595087,-5.4,9
09:07,624563756.0,-93.17917121644363,-5.9,9
09:08,637433131.0,-10.333000000000853,-115.68,5
09:08,534204159.0,6323.831734861799,-20.9,7
09:09,741903302.0,2239.446558740787,-5.2,9
09:09,690958123.0,20212.62347844166,-5.35,9
09:10,442079728.0,959.755119219314,-19.97,7
09:13,618138606.0,1655.4043472714347,-5.6,9
09:14,851649498.0,10565.013905583686,-5.65,9
09:15,506618547.0,17563.38278913601,-6.45,9
09:16,999752672.0,1414.9309435333346,-6.5,9
09:16,581655972.0,39812.741579742666,-7.15,9
09:17,558875206.0,3284.8845941428617,-6.0,9
09:17,540159353.0,11195.889634181782,-6.8,9
09:18,583558311.0,-653.9422152486677,-138.91,5
09:18,258201793.0,-352.2573000000003,-78.97,5
09:19,895331556.0,-470.59890000000087,-29.98,4
09:20,417850087.0,17215.435083979668,-6.05,9
09:20,727417797.0,5397.909500000011,-23.48,4
09:20,596171893.0,277.3617448255111,-27.96,7
09:21,322221939.0,4204.124896758526,-40.15,1
09:22,322221939.0,4203.911482595395,-0.21,2
09:23,441142605.0,2343.9090000000056,-24.46,5
09:24,996042490.0,5900.967696170786,-3.98,4
09:26,667367404.0,9531.412742576918,-7.1,9
09:26,214339619.0,467.0075508683563,-5.7,9
09:28,409370545.0,1547.54427554552,-6.01,7
09:28,290818242.0,7294.264707157009,-4.3,9
09:30,490868147.0,-80.17522087869847,-44.69,5
09:32,127809299.0,1174.754868947285,-25.0,2
09:36,442079728.0,879.2551192193139,-80.5,2
09:37,147508204.0,156.90971778188657,-126.75,2
09:38,865748375.0,3790.124146368891,-25.28,7
09:38,345514953.0,314.8632499999992,-84.5,2
09:42,615144184.0,697.9376491255189,-45.43,5
09:43,979122276.0,99.23096229432868,-125.3,7
09:43,618514666.0,20933.072820035977,-29.99,4
09:44,508518911.0,46.50475027901045,-28.0,2
09:46,475277431.0,85.55013694361946,-93.1,2
09:48,480198977.0,12883.856297642573,-149.62,5
09:49,147508204.0,-6.21528221811343,-163.12,2
09:49,929044080.0,660.0838915056283,-9.99,2
09:51,605711527.0,-48.1594861674164,-97.27,5
09:52,264550521.0,9651.266201198108,-16.1,4
09:54,687135796.0,26921.49807927523,-5.18,4
09:57,391688371.0,334.15229956852306,-162.13,2
09:59,287480331.0,12650.731802387245,-14.08,4
10:01,101531259.0,27.48954999999961,-169.5,2
10:02,524425303.0,-614.7914000000012,-43.8,5
10:03,979122276.0,-142.26903770567128,-241.5,4
10:04,442079728.0,671.3551192193139,-207.9,2
10:05,654329190.0,107.6808009485193,-22.97,1
10:07,345514953.0,224.8632499999992,-90.0,2
10:08,287480331.0,12645.681802387244,-5.05,9
10:09,162162212.0,-479.5876066726912,-80.0,2
10:09,866941383.0,3071.850750000006,-29.95,7
10:10,117308635.0,1219.6329506565316,-15.01,4
10:10,373875019.0,16156.282523365682,-35.0,2
10:18,147508204.0,-127.71528221811344,-121.5,2
10:20,647472692.0,24876.62312836434,-128.1,2
10:22,890830949.0,1137.894049999998,-37.98,2
10:23,687135796.0,26891.40807927523,-30.09,1
10:23,152616936.0,1246.7560078630647,-5.99,2
10:25,259015404.0,1977.8903989885248,-8.14,2
10:25,117308635.0,1185.5329506565315,-34.1,7
10:28,311467864.0,439.5034999999991,-102.99,2
10:29,414454079.0,733.3578500000019,-6.07,4
10:29,588565416.0,7532.831238791576,-107.0,5
10:30,519644021.0,3069.960519786155,-0.87,5
10:31,779376323.0,2901.5657666549405,-6.52,8
10:33,179173981.0,6912.478570235178,-102.69,2
10:34,348325817.0,10267.930832070451,-9.67,4
10:35,647472692.0,24654.723128364338,-221.9,2
10:36,711045550.0,4447.737350000003,-39.44,5
10:38,245198540.0,-67.31360119822052,-12.98,1
10:38,853907490.0,7252.842603750994,-9.19,5
10:40,370521542.0,25867.45750195193,-15.72,4
10:41,345514953.0,58.3632499999992,-166.5,2
10:42,642015139.0,0.5513374656382481,-35.96,1
10:43,890830949.0,1027.914049999998,-109.98,2
10:44,475277431.0,-154.54986305638053,-240.1,2
10:45,472995101.0,2323.1429505713654,-8.49,4
10:46,442079728.0,604.8551192193139,-66.5,2
10:52,782013626.0,2039.258199311628,-266.0,2
10:53,147508204.0,-217.34028221811343,-89.62,2
10:55,311467864.0,367.5234999999991,-71.98,2
10:55,890830949.0,972.944049999998,-54.97,2
11:00,179173981.0,6902.218570235178,-10.26,2
11:12,345514953.0,-187.6367500000008,-246.0,2
11:17,890830949.0,927.944049999998,-45.0,2
11:25,782013626.0,1969.9581993116285,-69.3,2
11:27,799861885.0,983.9414499999988,-96.5,2
11:36,890830949.0,882.944049999998,-45.0,2
11:40,910730524.0,8110.813948667714,-22.04,4
11:41,769319491.0,-229.98800000000057,-31.99,2
11:41,147508204.0,-340.71528221811343,-123.38,2
11:45,637649383.0,790.6564999999982,-74.5,2
11:51,520447032.0,8512.782092424435,-13.43,7
11:52,890830949.0,828.964049999998,-53.98,2
11:56,133755851.0,897.8335416180115,-7.21,5
11:57,442079728.0,506.8551192193139,-98.0,2
11:57,311467864.0,311.5434999999991,-55.98,2
11:59,345514953.0,-276.1367500000008,-88.5,2
12:01,611143859.0,4484.283500000011,-5.7,9
12:05,909669130.0,383.9028847367666,-5.98,4
12:08,254018059.0,-50.46479999999999,-38.59,9
12:13,448004226.0,2306.6725608628553,-96.08,5
12:14,147508204.0,-495.59028221811343,-154.88,2
12:15,162162212.0,-601.5776066726912,-121.99,2
12:16,475277431.0,-259.54986305638056,-105.0,2
12:18,101531259.0,-67.01045000000039,-94.5,2
12:21,345514953.0,-480.6367500000008,-204.5,2
12:22,311467864.0,229.04349999999909,-82.5,2
12:27,442079728.0,422.8551192193139,-84.0,2
12:27,406862520.0,596.7697265374104,-28.49,9
12:28,799861885.0,934.4514499999988,-49.49,2
12:29,890830949.0,780.474049999998,-48.49,2
12:31,979122276.0,-289.2690377056713,-147.0,2
12:32,290751280.0,415.0506966748256,-22.83,9
12:32,549414742.0,7638.155708077961,-1.6,5
12:38,585625048.0,1975.501183241531,-12.42,2
12:39,767447966.0,4776.551325512111,-41.53,9
12:40,890567652.0,37.034949679600615,-54.4,5
12:40,890830949.0,755.474049999998,-25.0,2
12:45,979122276.0,-359.2690377056713,-70.0,2
12:50,782013626.0,1809.6581993116283,-160.3,2
12:52,868014990.0,-3209.0660999999964,-27.2,5
12:53,612304466.0,-2050.165750000001,-40.31,5
12:55,657528784.0,82.93690000000068,-73.02,5
12:55,970298834.0,3291.278606443268,-6.03,2
13:00,585625048.0,1969.551183241531,-5.95,9
13:02,890830949.0,741.984049999998,-13.49,2
13:02,812012103.0,-197.71930000000052,-77.64,5
13:02,904154012.0,1223.9274581204322,-6.99,7
13:04,722358036.0,1103.8982906270828,-50.85,5
13:05,652048867.0,94.918999999999,-45.43,5
13:06,497772347.0,1427.152049999998,-9.99,4
13:08,766692943.0,-1896.8342500000003,-33.41,5
13:09,936813994.0,992.5742608327882,-125.31,5
13:11,348325817.0,10261.130832070452,-6.8,9
13:11,187111705.0,6918.3326429660365,-6.1,9
13:11,749378808.0,5889.261333508511,-5.65,9
13:11,630691258.0,282.1865448748413,-7.5,9
13:12,578131296.0,533.5667694440439,-26.92,9
13:12,147508204.0,-573.9652822181134,-78.38,2
13:12,722358036.0,1097.798290627083,-6.1,9
13:14,128030172.0,-442.1738274498499,-80.7,5
13:15,277562576.0,747.768298224955,-176.73,5
13:15,259015404.0,1972.1403989885248,-5.75,9
13:15,480557476.0,11289.80724680105,-5.0,9
13:16,890830949.0,643.494049999998,-98.49,2
13:17,101531259.0,-233.5104500000004,-166.5,2
13:17,575652395.0,3395.613419761828,-287.15,5
13:20,277562576.0,741.768298224955,-6.0,9
13:21,688712152.0,6252.995824437442,-5.1,9
13:23,782013626.0,1570.2581993116282,-239.4,2
13:24,647472692.0,24355.12312836434,-299.6,2
13:24,856461967.0,-158.40464647050746,-105.48,5
13:25,345514953.0,-664.6367500000008,-184.0,2
13:26,979122276.0,-484.5690377056713,-125.3,7
13:28,890830949.0,595.004049999998,-48.49,2
13:40,982286721.0,-3289.97802401773,-23.16,5
13:43,300095518.0,902.9786283414176,-18.91,5
13:47,311467864.0,133.55349999999908,-95.49,2
13:51,979122276.0,-551.0690377056712,-66.5,4
13:54,890830949.0,560.004049999998,-35.0,2
13:54,235310449.0,2106.6021848303094,-41.52,5
14:00,311467864.0,118.07349999999909,-15.48,2
14:12,668175891.0,620.111973158499,-23.97,1
14:21,890830949.0,520.0240499999979,-39.98,2
14:24,345514953.0,-747.1367500000008,-82.5,2
14:25,799861885.0,821.4714499999989,-112.98,2
14:27,556631012.0,238.5642230856782,-136.66,5
14:32,668175891.0,588.6707731584991,-31.44,5
14:44,442079728.0,311.5551192193139,-111.3,2
14:46,311467864.0,-98.91650000000094,-216.99,2
14:49,890830949.0,360.02404999999794,-160.0,2
14:57,890830949.0,248.0240499999979,-112.0,2
14:59,266777719.0,765.9489337802396,-15.02,7
15:01,345514953.0,-927.1367500000008,-180.0,2
15:06,637649383.0,665.1964999999982,-125.46,2
15:06,979122276.0,-593.0690377056712,-42.0,7
15:27,442079728.0,179.2551192193139,-132.3,2
15:29,637649383.0,491.2064999999982,-173.99,2
15:32,720742759.0,1838.3374308830075,-21.89,4
15:34,890830949.0,205.53404999999793,-42.49,2
15:36,311467864.0,-255.90650000000096,-156.99,2
15:42,274818272.0,444.0695285671315,-48.58,5
15:43,147508204.0,-644.4652822181134,-70.5,2
15:50,108481285.0,8703.380181242861,-5.16,5
15:52,985188462.0,610.6527887112247,-10.19,7
15:56,979122276.0,-769.4690377056712,-176.4,7
16:04,345514953.0,-1004.1367500000008,-77.0,2
16:08,311467864.0,-274.386500000001,-18.48,2
16:08,890830949.0,101.54404999999792,-103.99,2
16:16,532478725.0,5028.016720745161,-1.13,5
16:17,799861885.0,745.9714499999989,-75.5,2
16:18,345514953.0,-1200.6367500000008,-196.5,2
16:20,857997794.0,1062.814665150887,-8.98,4
16:25,637649383.0,461.7164999999982,-29.49,2
16:26,653667523.0,5229.25555132644,-30.99,2
16:27,624500124.0,3658.425566046517,-48.41,7
16:30,678330503.0,3029.9731197879883,-18.96,5
16:37,799861885.0,658.9914499999988,-86.98,2
16:37,350921975.0,-254.2841289261256,-68.99,5
16:39,194745206.0,797.200372091243,-31.08,2
16:40,345514953.0,-1280.6367500000008,-80.0,2
16:41,311467864.0,-354.866500000001,-80.48,2
16:41,979122276.0,-880.7690377056712,-111.3,7
16:42,886921642.0,3702.6204925518423,-13.05,7
16:46,413557825.0,713.8894999999995,-31.96,1
16:46,624500124.0,3645.225566046517,-13.2,2
16:47,442079728.0,-109.14488078068608,-288.4,2
16:47,345514953.0,-1513.1367500000008,-232.5,2
16:48,227104649.0,2660.6530543161775,-251.3,2
16:50,885259672.0,4241.775496755064,-23.08,5
16:50,639420537.0,-1500.53145,-48.11,5
16:51,610450243.0,-845.2496,-7.14,5
16:54,666952234.0,-215.13650187551303,-71.96,5
16:55,512989907.0,-2297.526903975366,-40.73,5
16:56,198946608.0,6661.238922540677,-19.69,2
16:58,286484726.0,922.0346225793272,-142.06,5
16:58,890830949.0,94.55404999999791,-6.99,2
16:58,957821152.0,-1384.1357035715498,-46.0,5
16:59,345582855.0,10.629652820549303,-44.1,5
17:02,807714284.0,1111.770860736,-52.0,2
17:02,311467864.0,-568.346500000001,-213.48,2
17:02,637649383.0,407.2164999999982,-54.5,2
17:03,303843160.0,359.4165000000017,-72.51,5
17:03,799861885.0,533.5014499999988,-125.49,2
17:06,901432314.0,3991.295314110735,-70.47,2
17:06,399144202.0,2800.1785556579675,-36.63,9
17:12,227104649.0,2531.1530543161775,-129.5,2
17:13,345514953.0,-1720.6367500000008,-207.5,2
17:15,442079728.0,-459.1448807806861,-350.0,2
17:18,311467864.0,-597.826500000001,-29.48,2
17:18,314980178.0,3440.1198500000055,-230.99,2
17:19,551755686.0,6590.580655850648,-29.99,4
17:20,949032480.0,4930.228804989143,-33.13,9
17:20,233981231.0,2458.713815190971,-1.5,4
17:21,785749304.0,8492.346641541066,-12.2,9
17:21,851181128.0,4967.785394376763,-28.9,9
17:22,285428103.0,9441.980726544278,-21.97,7
17:24,166019891.0,7889.690820537427,-30.64,4
17:25,705848712.0,25887.190145046763,-6.0,9
17:26,799861885.0,353.01144999999883,-180.49,2
17:26,628470485.0,1220.845029900123,-25.28,9
17:26,890830949.0,15.564049999997934,-78.99,2
17:26,531186970.0,7297.78255624362,-99.98,2
17:27,873693307.0,9987.901632101164,-81.49,2
17:29,885259672.0,4168.301993464332,-73.47,7
17:30,192202372.0,566.5162062815809,-141.2,5
17:32,392270893.0,12488.421054162727,-94.14,5
17:32,147508204.0,-710.0902822181134,-65.62,2
17:33,551755686.0,6572.600655850649,-17.98,4
17:33,919185264.0,5319.4447228879735,-29.99,2
17:34,184430449.0,1967.908363885164,-51.99,2
17:34,237493332.0,14360.969381487805,-103.19,2
17:35,956717493.0,1353.0448776068376,-32.98,2
17:36,587225252.0,7630.644868689347,-11.3,8
17:37,285428103.0,9364.980726544278,-77.0,4
17:38,500843551.0,1073.0150999999996,-36.98,7
17:39,540159353.0,11189.899634181782,-5.99,4
17:40,844835978.0,9697.289938921003,-1.99,4
17:41,113747882.0,12373.079541532314,-12.24,4
17:41,322720763.0,7967.159064954558,-78.07,2
17:42,836110591.0,7125.248582299711,-13.51,7
17:42,442070890.0,998.8624124443712,-15.97,1
17:43,698955014.0,1400.106054940912,-12.98,4
17:44,491392945.0,4846.101500000007,-46.28,5
17:45,117273481.0,9293.984917595088,-1.99,4
17:45,586315521.0,12126.64812125888,-240.32,2
17:45,252701364.0,-3573.973672677916,-33.95,5
17:46,423208402.0,1319.6433000000025,-7.99,4
17:46,854513972.0,1394.7786999999998,-153.98,2
17:47,806358207.0,12321.926378813858,-6.24,2
17:47,858989281.0,26999.44879775344,-35.48,1
17:48,131388684.0,21902.883711743783,-152.6,2
17:48,890830949.0,-117.93595000000208,-133.5,2
17:48,668692488.0,2315.865903563903,-79.88,2
17:49,147508204.0,-809.4652822181134,-99.38,2
17:52,466649401.0,683.6518113978915,-35.96,7
17:52,311467864.0,-714.826500000001,-117.0,2
17:53,631111289.0,-609.0965000000007,-22.48,5
17:53,200080192.0,9498.349183790588,-233.06,7
17:53,893134725.0,1632.108681936779,-30.31,5
17:55,769311479.0,7285.219537568475,-8.79,7
17:55,842682241.0,5850.815888849614,-218.4,2
17:56,196289502.0,15536.089166194804,-1.56,4
17:58,314980178.0,3284.0198500000056,-156.1,2
17:59,675806859.0,7008.4657917861605,-7.77,5
18:01,799861885.0,222.54144999999883,-130.47,2
18:02,534325901.0,6764.5923760472015,-36.5,5
18:03,668692488.0,2310.248403563903,-5.62,2
18:07,601627384.0,4865.370569671502,-35.0,9
18:07,890830949.0,-181.91595000000208,-63.98,2
18:10,213112754.0,7015.892924679306,-79.44,5
18:13,842682241.0,5606.5158888496135,-244.3,2
18:14,833899961.0,2622.619972838992,-68.31,5
18:15,705848712.0,25882.926041183833,-4.26,5
18:15,391559884.0,43.098499999999376,-241.32,5
18:17,195895574.0,7569.033036104836,-21.59,9
18:18,758160963.0,8272.20246848765,-30.12,7
18:18,131388684.0,21738.383711743783,-164.5,2
18:22,200080192.0,9424.863183790589,-73.49,4
18:22,858560423.0,12087.593784057644,-36.98,7
18:22,858989281.0,26790.14879775344,-209.3,2
18:24,510101371.0,13307.10508353747,-23.43,7
18:26,140893085.0,6019.228056365462,-15.95,9
18:28,668692488.0,2213.1309035639033,-97.12,2
18:30,940569402.0,6468.484290613316,-12.38,7
18:30,518474507.0,15241.879709410556,-31.22,7
18:31,461029994.0,7395.848299682367,-56.97,7
18:32,536924114.0,-753.3629055930961,-52.03,5
18:32,215311171.0,6517.757164712965,-29.0,5
18:34,128030172.0,-468.1138274498499,-25.94,9
18:36,683319988.0,7988.409127273063,-39.85,9
18:36,270374623.0,10342.50010413148,-13.24,9
18:40,736340277.0,8707.550054828787,-61.4,5
18:40,802697323.0,15716.500614083056,-16.43,7
18:42,475117511.0,8142.744014215998,-26.97,7
18:43,890830949.0,-293.90595000000206,-111.99,2
18:46,858989281.0,26781.762797753443,-8.39,2
18:47,290818242.0,7239.062707157009,-55.2,5
18:53,131388684.0,21577.383711743783,-161.0,2
18:55,905860285.0,10529.280802615904,-60.84,5
18:58,668692488.0,2148.2634035639035,-64.87,2
18:59,719742742.0,-1064.4925077779633,-38.82,5
18:59,345514953.0,-1789.045300000001,-68.41,5
18:59,224112146.0,549.7718499999986,-78.32,5
19:00,628470485.0,1217.845029900123,-3.0,7
19:01,890830949.0,-380.8959500000021,-86.99,2
19:03,200080192.0,9412.944742825164,-11.92,7
19:04,639409800.0,34514.191369198576,-42.0,7
19:05,912705941.0,18406.469616526476,-5.51,4
19:05,165045150.0,-2014.008938597144,-54.56,5
19:08,993039226.0,-4055.141999999994,-26.27,5
19:12,858989281.0,26670.50479775344,-111.26,2
19:12,851649498.0,10535.207905583686,-29.81,5
19:12,836110591.0,7117.794056543398,-7.45,7
19:14,131388684.0,21438.083711743784,-139.3,2
19:16,135937041.0,130.70700173158832,-83.35,5
19:18,672913754.0,10745.817451182016,-126.29,5
19:19,282837512.0,13837.01795728983,-30.04,9
19:20,581618317.0,-4825.206701873206,-28.55,5
19:21,256002321.0,6375.781644694916,-44.47,4
19:24,482513594.0,6530.73883119399,-27.68,5
19:24,291128777.0,-2681.8714405263686,-60.49,5
19:28,744968736.0,-1566.0368265694235,-41.36,5
19:29,559995067.0,3948.6960771445306,-49.29,5
19:29,858989281.0,26629.20479775344,-41.3,2
19:33,651756497.0,13628.01607870782,-46.94,8
19:34,450896297.0,13448.473055636645,-23.83,5
19:34,824916823.0,9004.10413333418,-15.53,7
19:38,441274121.0,13010.3272081148,-10.49,9
19:39,500043411.0,13616.748556548444,-71.16,7
19:43,151968462.0,9261.16999785686,-6.01,7
19:46,291580432.0,-325.4356999999997,-87.88,5
19:48,887853850.0,10909.797402354863,-27.93,9
19:50,315546581.0,27319.165263468793,-8.88,5
19:57,460463595.0,-675.3779454185787,-68.67,5
19:57,229205098.0,7545.838178615594,-101.09,5
19:57,424397946.0,3797.604783605399,-55.8,5
20:01,867987292.0,4380.409517398178,-11.25,5
20:10,419550103.0,18803.107473752447,-41.41,7
20:13,586315521.0,12113.504014953667,-13.14,8
20:13,834581602.0,624.1661999999991,-43.47,5
20:21,473820682.0,11596.245544388286,-28.67,5
20:23,785210466.0,2414.7447569695464,-20.58,5
20:24,358846516.0,805.3790725272179,-43.65,5
20:25,441274121.0,12969.946424947631,-40.38,8
20:25,131388684.0,21423.677711743785,-14.41,5
20:28,815385232.0,10159.820328706905,-12.95,9
20:31,119993184.0,-2021.246902910863,-22.48,5
20:37,690958123.0,20099.74847844166,-112.88,5
20:42,738958551.0,9384.056192811777,-25.38,2
20:45,149684419.0,316.8117999999981,-42.04,9
21:08,930277104.0,10459.462051723893,-27.1,9
21:25,480557476.0,11285.830379859788,-3.98,2
01:09,683319988.0,7961.900925138937,-26.51,2
01:21,809499628.0,16713.058252433348,-19.95,9
01:42,779946617.0,16651.418324332015,-37.39,5
02:05,687135796.0,26848.856164252065,-42.55,5
02:33,558119802.0,32310.802238325086,-20.98,9
02:34,809499628.0,16701.643106743973,-11.42,2
02:41,570323670.0,4356.054430587189,-22.49,7
02:44,858989281.0,26610.814797753443,-18.39,9
02:46,806358207.0,12293.056852045873,-28.87,7
02:48,709608057.0,3206.9216013299697,-29.84,9
02:51,853907490.0,7231.979888897852,-20.86,2
02:55,450896297.0,13415.333055636644,-33.14,9
03:00,779236304.0,1143.4575954795323,-20.9,9
03:04,256002321.0,6351.631644694917,-24.15,9
03:04,558119802.0,32307.40084263496,-3.4,4
03:14,383833857.0,24280.676862732773,-25.69,2
03:21,769311479.0,7237.000017635131,-48.22,4
03:26,450896297.0,13408.594558536452,-6.74,5
03:29,873693307.0,9987.459966517914,-0.44,7
03:34,108931112.0,13891.561854795787,-41.04,9
03:35,639409800.0,34508.05895400318,-6.13,7
03:37,414805878.0,13457.262115691114,-28.93,9
03:41,822135975.0,11236.483111497617,-6.89,5
03:44,994214354.0,10063.940893121742,-26.52,9
03:46,802697323.0,15672.800614083057,-43.7,9
03:55,572384506.0,11079.68673157283,-27.18,9
03:55,657139925.0,13702.960466063689,-18.89,9
03:59,506618547.0,17560.917194703874,-2.47,2
03:59,480557476.0,11275.436824349412,-10.39,2
04:00,550169791.0,21212.17334410901,-3.98,2
04:03,331450202.0,7601.858333909695,-17.85,7
04:06,730002588.0,12802.284876756705,-6.63,7
04:06,534204159.0,6323.49878551369,-0.33,5
04:08,719586818.0,17367.3171236017,-20.88,5
04:11,587225252.0,7627.839458206224,-2.81,7
04:13,520447032.0,8499.924160577359,-12.86,7
04:15,960208650.0,17367.149199018146,-47.4,4
04:17,433917275.0,8428.242106991363,-22.52,7
04:21,836110591.0,7087.064056543399,-30.73,9
04:25,985188462.0,581.2127887112247,-29.44,9
04:28,994214354.0,10033.707215980075,-30.23,7
04:32,198630866.0,-556.7501235612685,-19.24,9
04:41,940569402.0,6410.104554186614,-58.38,7
04:41,399144202.0,2780.020178695343,-20.16,7
04:49,520239952.0,-1310.1724766547632,-21.9,9
04:49,370521542.0,25867.11374458431,-0.34,2
04:49,195895574.0,7543.133036104837,-25.9,9
04:51,899742927.0,12637.056103587382,-3.26,2
04:52,166019891.0,7878.400050265532,-11.29,5
04:56,285220959.0,11593.8681413767,-21.6,5
04:56,588565416.0,7531.691567020767,-1.14,2
04:59,554792076.0,27099.33273690799,-33.22,2
04:59,383625050.0,6323.866812784158,-12.32,8
05:02,216285378.0,23535.79938463492,-38.14,9
05:04,601627384.0,4836.020569671502,-29.35,9
05:04,836110591.0,7074.698282231016,-12.37,2
05:05,609939116.0,7553.91522592997,-30.6,8
05:05,547010927.0,23034.53859400783,-25.18,9
05:05,613729471.0,9048.179877297214,-2.46,2
05:06,912705941.0,18403.622012454267,-2.85,2
05:15,496395938.0,13037.053671945563,-5.01,8
05:18,675806859.0,6990.560132607031,-17.91,5
05:23,322221939.0,4193.260549065618,-10.65,5
05:25,256002321.0,6308.592031952659,-43.04,5
05:26,195895574.0,7513.68365977502,-29.45,7
05:27,679662108.0,16037.638724772758,-7.23,2
05:30,518474507.0,15211.149709410556,-30.73,9
05:32,237493332.0,14289.515194837284,-71.45,5
05:37,430910686.0,1027.6733000000004,-20.93,9
05:41,187541224.0,2569.52000811304,-29.08,9
05:42,549414742.0,7602.815708077961,-35.34,9
05:46,668329719.0,8843.58891099217,-7.86,7
05:46,290818242.0,7182.262637813258,-56.8,7
05:49,421881811.0,3485.1676411149933,-15.74,7
05:49,169006407.0,12075.73611790391,-6.67,5
05:51,282837512.0,13835.49995766145,-1.52,5
05:52,678330503.0,3001.4340991706727,-28.54,5
05:53,108563213.0,23459.670406876612,-32.01,2
05:55,170637730.0,3044.983994674962,-84.35,7
05:58,815385232.0,10141.84234231926,-17.98,7
06:01,541639148.0,4994.012033767836,-18.66,8
06:02,324224854.0,3138.398315074553,-28.4,2
06:06,766941757.0,9851.73000993692,-44.14,9
06:06,776431321.0,3505.194020184439,-0.21,4
06:12,203466392.0,3014.571726498665,-32.73,8
06:15,435984758.0,5550.1268858673175,-22.62,5
06:18,126929801.0,2286.569106340476,-1.82,4
06:19,108481285.0,8703.225878460107,-0.15,5
06:26,151968462.0,9254.328213246898,-6.84,5
06:28,832564361.0,15947.201310483088,-7.5,9
06:30,522188082.0,8186.086974600136,-35.17,7
06:31,718058208.0,3038.403867723705,-54.33,2
06:32,987163717.0,6722.038480000006,-37.92,9
06:38,472995101.0,2284.0029505713655,-39.14,9
06:39,749378808.0,5869.511333508511,-19.75,9
06:40,200080192.0,9367.43283441888,-45.51,7
06:43,858989281.0,26558.43599533263,-52.38,5
06:43,461990622.0,10405.131355686895,-0.27,7
06:44,822250278.0,7481.487530867491,-12.23,8
06:50,183888402.0,18152.81362839636,-31.04,9
06:56,510101371.0,13272.91508353747,-34.19,9
06:57,296770890.0,2027.1020103790831,-35.43,9
06:57,136770968.0,171.76239999999962,-17.94,9
06:58,667367404.0,9528.903861002143,-2.51,7
06:58,874431242.0,8575.452277402976,-28.19,9
06:59,832564361.0,15905.69640674724,-41.5,8
07:00,547010927.0,23001.353837876453,-33.18,4
07:00,601627384.0,4835.375626161958,-0.64,2
07:02,673025413.0,4249.454530466023,-35.03,7
07:07,128033695.0,2116.2258578797328,-10.39,7
07:09,678851253.0,3703.179287022603,-34.6,7
07:12,228136274.0,-603.7391000000008,-29.15,9
07:17,519644021.0,3064.8275599367594,-5.13,7
07:19,633345190.0,7545.4822049496,-44.23,9
07:19,749378808.0,5809.746826795181,-59.76,5
07:20,305778936.0,11680.100560491766,-6.11,7
07:22,187111705.0,6909.694854726869,-8.64,7
07:22,670102069.0,4199.0623346859,-66.41,2
07:24,705848712.0,25869.676041183833,-13.25,9
07:24,776108637.0,1143.574753657496,-5.1,9
07:31,221868392.0,5552.956609535651,-27.98,8
07:32,795847804.0,22704.84458162858,-33.24,5
07:34,752362502.0,10165.317570812696,-34.85,7
07:45,473820682.0,11529.4922181015,-66.75,2
07:46,511179916.0,6867.478376420005,-0.8,2
07:49,532478725.0,4993.326720745162,-34.69,9
07:52,252760664.0,6932.883428822923,-29.19,7
07:55,992204045.0,12230.974117966032,-17.95,2
07:57,905860285.0,10513.193552774856,-16.09,7
08:01,874431242.0,8516.39323082393,-59.06,2
08:02,540159353.0,11168.676605276412,-21.22,2
08:05,949032480.0,4911.995587617363,-18.23,2
08:08,399538448.0,7138.796527256471,-5.65,9
08:09,549414742.0,7559.805165281045,-43.01,5
08:09,241459011.0,989.8355132723472,-6.6,9
08:11,373163757.0,10514.314781725976,-1.32,2
08:16,564744955.0,573.3136585888419,-5.0,9
08:18,246753533.0,857.9007999999986,-19.91,5
08:19,395284483.0,598.1793402113085,-7.5,9
08:20,270374623.0,10340.812632138077,-1.69,5
08:26,416060965.0,535.8693559540573,-41.35,5
08:26,842682241.0,5558.385141170544,-48.13,5
08:26,259015404.0,1934.7503989885247,-37.39,9
08:26,519935524.0,86.07990973751903,-4.7,9
08:27,449387287.0,109.2916938351015,-84.95,5
08:29,151968462.0,9204.369213246897,-49.96,5
08:30,492850697.0,-745.0889133341364,-78.44,5
08:31,380228542.0,-235.14305818443452,-5.0,9
08:31,215832575.0,-1459.2594637442196,-26.21,5
08:32,482513594.0,6529.812336256868,-0.93,5
08:32,644751433.0,-1374.008158465538,-46.01,5
08:32,146909202.0,6033.644056889959,-5.4,9
08:33,390747457.0,474.0145999999981,-57.28,5
08:34,229205098.0,7536.402321241312,-9.44,2
08:35,279149837.0,1649.1400499999986,-134.5,5
08:38,655450953.0,-2708.79987845553,-25.19,5
08:38,603375739.0,1193.331063023267,-32.09,5
08:39,426466211.0,-3206.05825,-41.66,5
08:40,874506295.0,-1508.656756245572,-31.27,5
08:43,489964679.0,20595.114113998945,-42.05,9
08:44,108812033.0,676.4363999999983,-133.43,5
08:44,520418719.0,2918.0756500000034,-81.34,5
08:45,760753808.0,-346.64495000000045,-118.96,5
08:45,366550080.0,25599.229868316932,-17.82,8
08:45,998405607.0,-672.166499999998,-35.0,5
08:46,215426302.0,782.5644040256918,-9.51,5
08:47,769311479.0,7152.6430176351305,-84.36,5
08:48,760704118.0,628.8283127174888,-48.8,5
08:49,973086490.0,10372.162577818444,-100.02,5
08:50,909669130.0,341.7978847367666,-42.11,5
08:53,785749304.0,8461.73318103714,-30.61,4
08:54,771125520.0,-205.1819000000005,-95.86,5
08:54,176922958.0,972.2215471976494,-54.77,5
08:57,264550521.0,9586.583961314576,-64.68,5
08:59,290818242.0,7174.3626378132585,-7.9,9
09:00,586315521.0,12107.104014953668,-6.4,9
09:03,624563756.0,-98.97917121644365,-5.8,9
09:06,364357875.0,7731.929331436408,-58.41,7
09:07,308505160.0,14356.46418820643,-6.8,2
09:07,344843570.0,-126.7968175093338,-24.95,5
09:07,361955473.0,-417.8990547559156,-154.31,5
09:09,214339619.0,461.0075508683563,-6.0,9
09:10,618138606.0,1649.5043472714349,-5.9,9
09:11,832564361.0,15844.02640674724,-61.67,5
09:11,973086490.0,10350.361177887517,-21.8,5
09:12,409370545.0,1501.1762755455202,-46.37,5
09:12,690958123.0,20093.598478441658,-6.15,9
09:12,683319988.0,7956.550925138937,-5.35,9
09:13,613729471.0,9042.479877297214,-5.7,9
09:13,407574996.0,4840.438741001842,-68.59,7
09:14,454356905.0,3209.4681123163687,-35.2,2
09:15,383833857.0,24274.27686273277,-6.4,9
09:16,819515373.0,2595.3112860637916,-74.27,5
09:16,647472692.0,24354.641341768776,-0.48,7
09:16,660561861.0,895.7897874376499,-76.3,2
09:16,585133606.0,4624.22459404309,-255.88,5
09:17,558875206.0,3278.784594142862,-6.1,9
09:17,141521177.0,7202.433900000015,-79.14,5
09:18,920031185.0,-597.4507205162921,-126.54,5
09:21,540159353.0,11163.326605276412,-5.35,9
09:21,391688371.0,309.1322995685231,-25.02,2
09:21,851649498.0,10528.857905583684,-6.35,9
09:21,169006407.0,12070.686117903912,-5.05,9
09:22,117273481.0,9286.184917595088,-7.8,9
09:22,986774156.0,3865.216931625768,-69.99,6
09:22,743630833.0,252.05966328470123,-93.51,5
09:24,987656636.0,6272.276682382347,-0.09,5
09:24,687135796.0,26693.016164252065,-155.84,2
09:24,933745726.0,210.4610564293233,-107.89,5
09:24,581655972.0,39807.79157974267,-4.95,9
09:25,593191200.0,1438.474349999999,-142.97,2
09:25,782013626.0,1560.2681993116282,-9.99,6
09:27,570269025.0,3076.89183335989,-26.98,4
09:30,916270283.0,2265.7742499999995,-78.99,2
09:30,441274121.0,12964.596424947633,-5.35,9
09:32,421881811.0,3479.0187311149934,-6.15,4
09:34,430910686.0,978.6733000000004,-49.0,2
09:36,709151315.0,-307.3857816258401,-69.41,5
09:37,285873880.0,11438.821543619497,-93.74,5
09:39,352291960.0,3301.800053303574,-214.2,2
09:41,819515373.0,2565.361286063792,-29.95,7
09:41,680773155.0,659.2190833310917,-114.46,7
09:43,298007503.0,1726.8931036256336,-25.34,7
09:44,310620484.0,275.9941950921983,-13.08,2
09:47,856957948.0,9440.67039333536,-12.99,2
09:47,688712152.0,6244.205044430709,-8.79,8
09:47,660561861.0,737.5897874376499,-158.2,2
09:47,168414279.0,-363.69771572507864,-50.21,5
09:48,647472692.0,24212.009341768775,-142.63,5
09:49,520447032.0,8432.17816057736,-67.75,5
09:50,215426302.0,633.5204040256918,-149.04,2
09:51,535744551.0,1196.6524659956262,-18.0,4
09:53,430910686.0,880.1733000000004,-98.5,2
09:54,996042490.0,5867.487696170787,-33.48,4
09:55,494789005.0,3310.616482803271,-22.15,2
09:59,422955974.0,-1.0772150009500765,-179.99,2
09:59,680773155.0,466.7290833310917,-192.49,4
10:02,919185264.0,5287.4847228879735,-31.96,7
10:02,930277104.0,10455.137134833614,-4.32,4
10:03,572136270.0,348.4607493335777,-57.89,5
10:03,352291960.0,3111.4000533035737,-190.4,2
10:05,282046994.0,-227.3326499999997,-123.59,5
10:08,299871610.0,409.3356530587666,-18.98,2
10:11,430910686.0,693.6733000000004,-186.5,2
10:13,145387690.0,6230.341134433936,-51.91,5
10:13,284905540.0,7710.730176042516,-43.76,7
10:13,769319491.0,-241.96800000000056,-11.98,1
10:15,215426302.0,557.9344040256918,-75.59,2
10:17,627936697.0,935.4103,-75.0,7
10:24,793781222.0,468.38887894740446,-36.48,4
10:24,282837512.0,13830.49995766145,-5.0,9
10:29,414454079.0,728.2878500000019,-5.07,4
10:29,352291960.0,2975.6000533035735,-135.8,2
10:30,812012103.0,-297.7093000000005,-99.99,2
10:32,430910686.0,623.6733000000004,-70.0,2
10:33,585625048.0,1718.251183241531,-251.3,2
10:34,192202372.0,538.5162062815809,-28.0,2
10:37,258201793.0,-389.0073000000003,-36.75,2
10:37,627936697.0,866.4103,-69.0,4
10:38,155867488.0,220.74869999999845,-5.48,4
10:39,904154012.0,1200.9574581204322,-22.97,7
10:39,618514666.0,20850.248820035977,-82.82,5
10:40,703537476.0,859.2432499999991,-28.02,2
10:46,585625048.0,1548.851183241531,-169.4,2
10:49,497772347.0,1170.375599999998,-256.78,5
10:51,136770968.0,129.76239999999962,-42.0,2
10:53,215426302.0,321.3484040256918,-236.59,2
10:57,358836279.0,394.62424280758586,-51.61,5
10:58,430910686.0,461.6733000000004,-162.0,2
11:01,304455868.0,2817.257159715831,-25.05,2
11:03,821971408.0,1274.7657213748782,-10.21,5
11:06,258201793.0,-567.8823000000003,-178.88,2
11:06,618514666.0,20848.14084480656,-2.11,7
11:09,679662108.0,16000.00872477276,-37.63,7
11:14,762859681.0,593.8275999999988,-20.0,4
11:14,430910686.0,275.1733000000004,-186.5,2
11:17,987229118.0,4490.048568309697,-109.99,2
11:18,504055745.0,-132.1678386582331,-29.98,4
11:18,767447966.0,4760.519325512111,-16.03,4
11:20,215426302.0,237.36240402569183,-83.99,2
11:20,630691258.0,127.20654487484128,-154.98,2
11:21,668175891.0,490.69077315849904,-97.98,2
11:32,913801979.0,468.19277991449394,-6.99,7
11:35,604288474.0,3241.385903061716,-229.57,4
11:35,430910686.0,152.17330000000038,-123.0,2
11:35,136770968.0,56.27239999999962,-73.49,2
11:36,604288474.0,3229.3526553071397,-12.03,2
11:38,978951113.0,-731.0649425904192,-202.71,5
11:40,627936697.0,719.9103,-146.5,4
11:40,240643705.0,378.02509112061534,-179.5,2
11:45,541639148.0,4945.842033767836,-48.17,2
11:52,215426302.0,24.562404025691848,-212.8,2
11:58,660561861.0,702.5897874376499,-35.0,2
11:59,179173981.0,6896.1561319251905,-6.06,2
12:01,136770968.0,6.272399999999621,-50.0,2
12:04,699139822.0,1791.9790148255452,-31.59,9
12:05,310740977.0,-267.3234734926652,-77.98,2
12:06,547010927.0,22908.133837876452,-93.22,2
12:08,284905540.0,7694.390176042516,-16.34,9
12:09,258201793.0,-618.5073000000003,-50.62,7
12:09,430910686.0,92.17330000000038,-60.0,2
12:11,588565416.0,7524.701567020768,-6.99,7
12:12,598793068.0,990.1303499999984,-7.99,4
12:13,554792076.0,27093.342736907987,-5.99,9
12:13,660561861.0,608.7897874376499,-93.8,2
12:21,627936697.0,485.4103,-234.5,4
12:22,258201793.0,-824.0073000000003,-205.5,4
12:24,604288474.0,2973.1666553071395,-256.19,4
12:29,588565416.0,7492.711567020768,-31.99,2
12:30,160166876.0,1529.3511905862438,-80.99,2
12:31,163470640.0,1248.243,-9.99,4
12:32,660561861.0,476.48978743765,-132.3,2
12:42,160166876.0,1449.8586905862437,-79.49,2
12:45,191161970.0,-3504.716999999996,-29.59,5
12:46,258201793.0,-876.1323000000003,-52.12,7
12:47,430910686.0,33.17330000000038,-59.0,2
12:50,215426302.0,-128.72359597430813,-153.29,2
12:53,490790931.0,292.8547999999986,-39.59,9
13:01,604288474.0,2884.9806553071394,-88.19,7
13:02,866941383.0,3061.860750000006,-9.99,4
13:02,585625048.0,1541.351183241531,-7.5,9
13:04,277562576.0,736.4182982249549,-5.35,9
13:06,936917570.0,-2718.3724999999977,-30.65,5
13:07,849096144.0,2596.4798589105176,-8.3,9
13:09,688712152.0,6238.105044430708,-6.1,9
13:09,117308635.0,1160.4329506565318,-25.1,2
13:11,322221939.0,4188.560549065618,-4.7,9
13:12,258201793.0,-1017.1323000000004,-141.0,4
13:13,340321732.0,1819.9128500000031,-5.5,9
13:15,630691258.0,121.70654487484128,-5.5,9
13:19,828750680.0,1822.42454521368,-90.87,5
13:20,215426302.0,-383.4815959743081,-254.76,2
13:22,812692024.0,3769.772857948952,-5.7,9
13:25,160166876.0,1364.7486905862438,-85.11,2
13:26,187111705.0,6904.24485472687,-5.45,9
13:31,699139822.0,1767.401994889755,-24.58,5
13:34,425730826.0,1723.0219093887197,-36.06,5
13:36,843174694.0,-4775.413499999998,-17.53,5
13:40,215426302.0,-587.1535959743081,-203.67,2
13:42,496865819.0,-640.7234318426824,-36.23,9
13:45,258201793.0,-1201.2573000000002,-184.12,7
13:48,160166876.0,1308.8736905862438,-55.88,2
13:51,744211756.0,-4023.588249999994,-20.96,5
13:55,348460748.0,281.5320999999991,-106.41,5
13:58,783650950.0,-841.1356434110114,-134.25,5
14:05,287480331.0,12433.581802387243,-212.1,2
14:20,518746136.0,184.3002717630835,-28.41,5
14:21,287480331.0,12207.481802387245,-226.1,2
14:22,258201793.0,-1262.7573000000002,-61.5,4
14:27,160166876.0,1278.5211905862438,-30.35,2
14:41,287480331.0,11970.881802387245,-236.6,2
14:47,916270283.0,2205.7942499999995,-59.98,2
14:54,497772347.0,1106.455599999998,-63.92,7
14:57,258201793.0,-1322.7573000000002,-60.0,7
15:02,160166876.0,1211.3961905862438,-67.12,2
15:13,287480331.0,11721.681802387242,-249.2,2
15:14,160166876.0,1122.1536905862438,-89.24,2
15:16,660561861.0,323.88978743764994,-152.6,2
15:25,409370545.0,1496.1662755455202,-5.01,7
15:26,857997794.0,1050.6766651508872,-12.14,5
15:29,246753533.0,836.9000999999986,-21.0,5
15:32,258201793.0,-1458.5073000000002,-135.75,4
15:33,660561861.0,142.58978743764996,-181.3,2
15:38,160166876.0,1059.5361905862435,-62.62,2
15:50,680773155.0,394.2390833310917,-72.49,7
15:52,287480331.0,11527.081802387242,-194.6,2
16:00,720742759.0,1688.8374308830075,-149.5,7
16:09,160166876.0,1031.4111905862435,-28.12,2
16:09,660561861.0,107.58978743764996,-35.0,2
16:12,145553416.0,-2574.808149999999,-30.11,5
16:12,901432314.0,3926.424374110736,-64.87,4
16:13,565175333.0,-3590.9110227298265,-30.95,5
16:14,310375875.0,4479.951622861491,-27.5,2
16:15,287480331.0,11342.98180238724,-184.1,2
16:16,169689461.0,1197.7460999999992,-4.99,7
16:17,116598243.0,2801.94956248784,-216.3,7
16:21,660561861.0,-17.710212562350037,-125.3,2
16:25,899742927.0,12622.076103587382,-14.98,7
16:28,136770968.0,-89.71760000000039,-95.99,2
16:28,605116158.0,2486.227200000001,-15.24,9
16:30,838830098.0,853.7971420877843,-57.98,2
16:31,399538448.0,7094.671870949233,-44.12,4
16:33,896821055.0,-363.57992631476463,-161.69,5
16:35,901432314.0,3909.904374110736,-16.52,5
16:35,696333897.0,594.001299999999,-47.99,2
16:38,409971170.0,2814.1811271209754,-17.34,7
16:42,385685918.0,422.5999408415523,-49.99,2
16:46,116598243.0,2568.84956248784,-233.1,4
16:50,246753533.0,821.9100999999986,-14.99,4
16:51,456221621.0,957.6253673026282,-56.99,2
16:51,964702094.0,1954.928226727643,-46.62,5
16:51,583579399.0,1367.264949999999,-139.11,5
16:52,104832000.0,-2862.634858905844,-42.2,5
16:58,388862238.0,1312.4941571334414,-36.05,5
17:02,603721739.0,1233.5468994831842,-162.99,2
17:07,386729293.0,30321.065191797017,-15.88,8
17:10,940569402.0,6392.914554186615,-17.19,9
17:11,605116158.0,2474.2572000000014,-11.97,4
17:17,296972867.0,-796.9415000000009,-74.4,5
17:17,297823329.0,1085.6143999999993,-30.95,1
17:19,668175891.0,280.69077315849904,-210.0,4
17:20,383625050.0,6162.286812784158,-161.58,2
17:20,408057540.0,5213.400861361828,-60.89,2
17:21,824916823.0,9001.636491389234,-2.47,7
17:22,651756497.0,13603.999693756588,-24.02,7
17:22,564744955.0,469.6268585888419,-103.69,5
17:24,785210466.0,2394.754756969546,-19.99,2
17:24,851181128.0,4946.601880705422,-21.18,7
17:25,361201224.0,3330.8002320678925,-39.11,7
17:27,151968462.0,9167.322203246897,-37.05,4
17:27,500043411.0,13584.808156548444,-31.94,4
17:27,730002588.0,12771.024876756705,-31.26,7
17:28,500043411.0,13567.08939174554,-17.72,8
17:28,258201793.0,-1496.0073000000002,-37.5,7
17:29,970298834.0,3277.7495131874334,-13.53,2
17:29,992204045.0,12200.954117966032,-30.02,2
17:29,987163717.0,6701.628480000006,-20.41,2
17:30,788740658.0,3923.3466184459226,-31.05,7
17:31,124102251.0,3793.899758263949,-353.5,2
17:31,627917561.0,3488.9450500000044,-25.98,2
17:32,531186970.0,7275.78255624362,-22.0,2
17:33,605116158.0,2420.432100000002,-53.83,5
17:34,951817450.0,9936.238848918038,-53.98,7
17:36,108563213.0,23405.580406876612,-54.09,2
17:37,699997811.0,1954.6461500000037,-64.22,5
17:37,482513594.0,6517.226336256867,-12.59,2
17:38,897714622.0,8751.25286806195,-21.18,7
17:38,420109571.0,639.1767689636076,-81.97,2
17:39,624500124.0,3634.055566046517,-11.17,7
17:41,925037906.0,960.8768000000016,-17.5,4
17:41,169689461.0,1047.7660999999991,-149.98,2
17:42,912705941.0,18183.122012454267,-220.5,2
17:43,683319988.0,7909.342925138937,-47.21,5
17:43,141521177.0,7170.443900000015,-31.99,2
17:44,160166876.0,1002.1836905862438,-29.23,2
17:45,624563756.0,-139.91657121644363,-40.94,5
17:46,197865285.0,616.6129617312201,-71.99,2
17:48,668175891.0,49.19077315849904,-231.5,7
17:48,587202562.0,618.5042494170686,-28.7,9
17:48,409971170.0,2784.167137648711,-30.01,2
17:49,956717493.0,1270.4917776068376,-82.55,5
17:50,143061865.0,7637.253498500872,-29.99,4
17:51,660561861.0,-257.81021256235005,-240.1,2
17:51,258201793.0,-1635.1323000000002,-139.12,4
17:51,833499132.0,2901.135250000001,-24.96,7
17:52,653667523.0,5098.76155132644,-130.49,5
17:54,535804582.0,-1295.585050000001,-61.21,5
17:55,893134725.0,1622.118681936779,-9.99,2
17:55,857997794.0,1041.6966651508872,-8.98,4
17:56,867987292.0,4245.232517398178,-135.18,5
17:56,670102069.0,4031.7623346859,-167.3,2
17:57,987656636.0,6171.586682382347,-100.69,2
17:57,822718326.0,11122.354307219362,-51.34,5
17:59,169006407.0,11970.404117903912,-100.28,5
18:00,822135975.0,11205.073111497615,-31.41,7
18:00,914806976.0,2262.7132501854867,-11.49,4
18:00,128033695.0,2089.3858578797326,-26.84,9
18:01,668175891.0,-107.30922684150096,-156.5,7
18:01,183186021.0,-225.4125499999989,-23.84,5
18:07,475117511.0,8123.695195780393,-19.05,2
18:07,984783496.0,14422.801065678996,-15.3,9
18:09,627936697.0,395.4103,-90.0,7
18:09,482513594.0,6440.968336256868,-76.26,2
18:09,116598243.0,2367.94956248784,-200.9,4
18:11,660561861.0,-393.61021256235006,-135.8,2
18:13,912705941.0,18050.122012454267,-133.0,2
18:14,474951915.0,-2537.6485952340117,-52.39,5
18:14,258201793.0,-1706.3823000000002,-71.25,4
18:15,868377987.0,2799.7404958778507,-64.22,5
18:16,806358207.0,12276.076852045871,-16.98,7
18:17,331450202.0,7568.286333909695,-33.57,5
18:17,776108637.0,1075.2925536574958,-68.28,5
18:18,624563756.0,-204.41657121644363,-64.5,2
18:18,214339619.0,446.0175508683563,-14.99,7
18:20,433837402.0,-236.07586846418815,-40.34,9
18:20,939972497.0,-65.65664139998923,-159.64,5
18:21,160166876.0,941.8161905862436,-60.37,2
18:22,221868392.0,5514.366609535651,-38.59,9
18:23,383833857.0,24260.27686273277,-14.0,9
18:23,586315521.0,12086.4668309854,-20.64,5
18:25,194745206.0,762.060372091243,-35.14,9
18:25,120634201.0,4669.889500000007,-89.4,5
18:28,124102251.0,3791.8745277489465,-2.03,7
18:30,455052690.0,-170.2822600513724,-45.32,5
18:31,668175891.0,-207.30922684150096,-100.0,4
18:32,213112754.0,6993.608295058842,-22.28,5
18:33,138609932.0,3464.945003294585,-29.94,7
18:35,321372947.0,-297.3234507890994,-14.62,5
18:35,897714622.0,8719.14678119721,-32.11,8
18:35,624563756.0,-268.41657121644363,-64.0,2
18:39,616924659.0,-6.532920176914722,-11.24,5
18:40,687135796.0,26670.176164252065,-22.84,7
18:42,134847904.0,4090.932044386296,-89.97,7
18:43,482513594.0,6301.696336256868,-139.27,2
18:45,647936800.0,659.9504369346982,-6.69,5
18:47,298007503.0,1693.0631036256336,-33.83,9
18:48,660561861.0,-442.61021256235006,-49.0,2
18:50,258201793.0,-1881.8823,-175.5,7
18:51,493571342.0,-2397.875880907048,-24.8,5
18:52,197865285.0,556.2043617312202,-60.41,5
18:52,659008214.0,-3188.8751022904235,-21.29,5
18:57,680773155.0,355.5626833310917,-38.68,5
18:58,979135922.0,-106.22919940954924,-30.56,5
18:59,518474507.0,15161.239679402725,-49.91,2
19:00,500843551.0,945.4946999999996,-127.52,5
19:00,170233640.0,114.69308994989724,-61.79,5
19:01,383625050.0,6113.818812784159,-48.47,5
19:02,248142083.0,-191.5695652974832,-46.14,5
19:02,824916823.0,8928.220491389235,-73.42,5
19:07,322720763.0,7965.740128077425,-1.42,2
19:09,310375875.0,4448.711622861491,-31.24,9
19:09,344522228.0,-2784.8119882083924,-7.5,5
19:20,762859681.0,548.1975999999988,-45.63,5
19:20,938992364.0,290.07664373139954,-71.95,5
19:21,684988568.0,-493.09622342720144,-33.46,5
19:22,660561861.0,-634.41021256235,-191.8,2
19:22,482513594.0,6121.810336256867,-179.89,2
19:24,892354433.0,-1088.4599606343386,-40.73,5
19:26,764450279.0,19806.748348494995,-38.83,5
19:26,248625662.0,-1078.2869157151474,-58.74,5
19:32,417850087.0,17214.860263326438,-0.57,5
19:33,429235692.0,-1228.922,-29.31,5
19:34,180616589.0,915.7067092146953,-28.39,5
19:36,660561861.0,-893.41021256235,-259.0,2
19:37,683319988.0,7889.162925138937,-20.18,9
19:39,824916823.0,8898.390491389235,-29.83,9
19:40,198051483.0,-1231.2069104088569,-48.86,5
19:43,503575533.0,6446.948258699422,-92.3,5
19:43,859603181.0,4102.145793344815,-14.13,2
19:48,550169791.0,21137.79134410901,-74.38,5
19:49,706250160.0,11796.736178887646,-9.6,7
19:49,352291960.0,2912.8520533035735,-62.75,5
19:56,392270893.0,12454.89424595739,-33.53,7
19:59,482513594.0,5998.6243362568675,-123.19,2
20:04,124102251.0,3723.330527748946,-68.54,5
20:05,835736339.0,1941.17835209188,-17.15,5
20:05,851181128.0,4921.971880705422,-24.63,9
20:07,158766229.0,-657.16633589347,-87.86,5
20:07,975345315.0,34971.64854549698,-79.86,5
20:07,441274121.0,12954.59343999456,-10.0,2
20:18,355602925.0,1664.3079695597523,-67.97,5
20:19,131388684.0,21376.833711743784,-46.84,5
20:24,152488934.0,1578.9720573137306,-87.34,5
20:27,623156843.0,5915.539974042767,-66.01,5
20:30,690523499.0,154.63120000000015,-132.77,5
20:32,551196328.0,4845.919133942313,-64.41,5
20:42,366477356.0,393.1484499999999,-171.59,5
20:57,405945930.0,4666.062914555129,-44.51,8
20:59,741269136.0,245.9784500000004,-65.03,5
21:01,287480331.0,11299.94180238724,-43.04,9
21:08,851649498.0,10509.002457314707,-19.86,7
21:12,572136270.0,331.0326115880232,-17.43,2
21:21,886921642.0,3629.800715435717,-72.82,5
22:36,414805878.0,13442.836699283103,-14.43,7
00:18,287480331.0,11297.128925066543,-2.81,8
01:21,718058208.0,3010.588769631888,-27.82,7
01:26,679662108.0,15982.381633915073,-17.63,5
02:09,985188462.0,548.2927887112247,-32.92,9
02:16,187541224.0,2533.12000811304,-36.4,9
02:28,421881811.0,3428.5087360133407,-50.51,2
02:31,383833857.0,24238.906227917396,-21.37,5
02:35,940569402.0,6370.164554186615,-22.75,9
02:36,547010927.0,22882.287215295895,-25.85,5
02:38,633345190.0,7517.9922049496,-27.49,9
02:42,370521542.0,25807.09300013152,-60.02,8
02:45,572384506.0,11043.636731572831,-36.05,9
02:49,901432314.0,3889.065465741571,-20.84,7
03:02,795847804.0,22702.14165528906,-2.7,7
03:04,820686957.0,-819.8101163111959,-25.29,9
03:08,651756497.0,13564.919479978636,-39.08,8
03:22,779236304.0,1113.6575954795323,-29.8,9
03:23,930277104.0,10442.878752245802,-12.26,5
03:29,128033695.0,2072.2363225871245,-17.15,2
03:31,541639148.0,4921.395569961161,-24.45,7
03:34,108563213.0,23386.726234612957,-18.85,5
03:35,473820682.0,11521.362605105083,-8.13,2
03:36,352291960.0,2879.1620533035734,-33.69,9
03:41,897714622.0,8674.768105376636,-44.38,5
03:46,851649498.0,10454.219623863268,-54.78,5
03:51,940569402.0,6367.408686429097,-2.76,5
03:52,704517789.0,17271.948459113515,-23.45,8
03:52,518474507.0,15130.549679402722,-30.69,9
03:55,108931112.0,13813.192251354683,-78.37,2
03:55,237684254.0,5947.213471401791,-25.3,7
03:57,113747882.0,12327.010828177356,-46.07,2
03:59,687135796.0,26645.436164252063,-24.74,9
04:04,134461671.0,5706.483493525734,-15.49,5
04:06,183888402.0,18118.67362839636,-34.14,9
04:11,604288474.0,2868.5306553071396,-16.45,9
04:11,506618547.0,17481.56686007622,-74.25,7
04:14,853907490.0,7215.779888897852,-16.2,9
04:14,613427466.0,6732.784956011864,-11.12,7
04:19,256002321.0,6294.10203195266,-14.49,9
04:23,970298834.0,3275.4307191173903,-2.32,5
04:28,675806859.0,6986.152500083344,-4.41,2
04:29,518474507.0,15124.168315521869,-6.38,7
04:30,324224854.0,3126.544612850285,-11.85,5
04:30,259015404.0,1896.5003989885247,-38.25,9
04:32,987163717.0,6659.178480000006,-42.45,9
04:41,282837512.0,13793.26995766145,-37.23,9
04:44,510101371.0,13237.385083537469,-35.53,9
04:46,534325901.0,6753.55301658259,-11.04,7
04:48,522188082.0,8182.823115111133,-3.26,2
04:59,203466392.0,2991.3817030584146,-23.19,2
04:59,604288474.0,2838.429884626828,-30.1,2
05:02,853907490.0,7209.966346208197,-5.81,4
05:10,433917275.0,8398.252106991364,-29.99,9
05:11,670102069.0,4020.2422221106553,-11.52,5
05:13,558119802.0,32276.22084263496,-31.18,9
05:13,661295096.0,3332.135839904151,-3.46,2
05:13,779946617.0,16598.27795340083,-53.14,5
05:14,256002321.0,6283.616511007853,-10.49,5
05:17,187111705.0,6865.321633076638,-38.92,7
05:19,653640811.0,17121.443027224912,-7.67,5
05:25,633345190.0,7490.556101480143,-27.44,5
05:27,195895574.0,7494.0436597750195,-19.64,9
05:29,532478725.0,4961.446720745162,-31.88,9
05:32,322221939.0,4176.0099805743475,-12.55,8
05:34,960208650.0,17363.54902722312,-3.6,2
05:36,146909202.0,6026.733913144668,-6.91,5
05:36,832564361.0,15814.301564971604,-29.72,5
05:37,108481285.0,8677.626684024859,-25.6,5
05:38,749378808.0,5786.466826795181,-23.28,9
05:38,519644021.0,3006.887370418898,-57.94,7
05:41,433917275.0,8392.450560783487,-5.8,2
05:44,822250278.0,7415.880633478772,-65.61,2
05:44,824916823.0,8870.150491389235,-28.24,9
05:46,179173981.0,6854.534511154971,-41.62,2
05:48,683319988.0,7859.722925138937,-29.44,9
05:53,170637730.0,3043.4752066862357,-1.51,7
05:54,769311479.0,7150.190264830979,-2.45,2
05:59,639409800.0,34502.61926203531,-5.44,2
06:01,221868392.0,5513.49906173594,-0.87,5
06:01,973086490.0,10335.461177887517,-14.9,9
06:02,308505160.0,14290.31645032941,-66.15,7
06:04,887853850.0,10908.423855430294,-1.37,2
06:09,749378808.0,5781.884574688399,-4.58,2
06:10,851181128.0,4883.971880705422,-38.0,9
06:16,858989281.0,26542.50599533263,-15.93,9
06:18,802697323.0,15636.420614083056,-36.38,9
06:18,305778936.0,11645.195055897944,-34.91,5
06:19,849096144.0,2593.1800207513415,-3.3,7
06:22,480557476.0,11222.604422167242,-52.83,7
06:23,414805878.0,13401.906699283105,-40.93,9
06:24,683319988.0,7848.472334092514,-11.25,2
06:27,264550521.0,9566.853047143171,-19.73,5
06:27,348325817.0,10225.240832070453,-35.89,9
06:29,549414742.0,7522.065165281046,-37.74,9
06:29,441274121.0,12896.489915928169,-58.1,5
06:30,252760664.0,6928.580337333635,-4.3,2
06:30,859603181.0,4097.39104859219,-4.75,5
06:30,216285378.0,23494.70938463492,-41.09,9
06:43,489964679.0,20553.484113998944,-41.63,9
06:44,709608057.0,3179.3916013299695,-27.53,9
06:44,290818242.0,7157.792433577287,-16.57,2
06:44,874431242.0,8506.375086316573,-10.02,8
06:47,550169791.0,21094.398530535385,-43.39,5
06:48,196289502.0,15515.059166194804,-21.03,9
06:49,195895574.0,7486.850976331346,-7.19,4
06:49,435984758.0,5547.607192901997,-2.52,5
06:49,151968462.0,9087.190797326,-80.13,7
06:50,237493332.0,14269.325194837284,-20.19,9
06:53,711140907.0,936.3705999999992,-25.19,9
06:54,905860285.0,10508.434502077924,-4.76,7
06:54,809499628.0,16682.243106743972,-19.4,9
06:55,532478725.0,4937.4656718345295,-23.98,7
06:57,806358207.0,12254.4313748205,-21.65,8
06:58,417850087.0,17155.217667918918,-59.64,7
06:59,994214354.0,10004.837215980077,-28.87,9
07:02,454356905.0,3171.018112316369,-38.45,9
07:02,657139925.0,13676.976478475395,-25.98,8
07:02,824916823.0,8838.197324261162,-31.95,7
07:07,310375875.0,4438.67549517658,-10.04,2
07:07,705848712.0,25851.746041183833,-17.93,9
07:08,987656636.0,6150.718366749944,-20.87,5
07:11,586315521.0,12078.41124815483,-8.06,8
07:12,496395938.0,12994.783940219066,-42.27,2
07:13,858989281.0,26535.811160027977,-6.69,7
07:16,891716230.0,744.4789036880779,-17.16,2
07:21,450896297.0,13375.314558536453,-33.28,9
07:23,829914501.0,946.360806570974,-5.0,9
07:26,758160963.0,8242.577584054574,-29.62,5
07:29,836110591.0,7065.208516312729,-9.49,8
07:33,785749304.0,8460.051822973179,-1.68,4
07:33,235881534.0,12976.969355016008,-69.68,2
07:35,613729471.0,9027.30114566232,-15.18,8
07:35,766941757.0,9823.540009936918,-28.19,9
07:37,647936800.0,653.0342551106808,-6.92,5
07:38,213112754.0,6905.395718853726,-88.21,7
07:39,899742927.0,12606.964233060837,-15.11,2
07:39,581655972.0,39727.66208992106,-80.13,4
07:41,383625050.0,6067.929818338912,-45.89,7
07:43,706250160.0,11778.54855325722,-18.19,2
07:44,873693307.0,9931.447167541037,-56.01,4
07:44,815385232.0,10127.958949406351,-13.88,5
07:45,366550080.0,25557.60273197348,-41.63,5
07:45,719586818.0,17358.973957783892,-8.34,7
07:46,705848712.0,25832.874895701916,-18.87,5
07:50,667367404.0,9504.161243711538,-24.74,2
07:50,198946608.0,4066.560167804257,-14.68,7
07:52,229205098.0,7534.36275146256,-2.04,5
07:53,752362502.0,10158.831614854467,-6.49,4
07:56,678851253.0,3655.318937329109,-47.86,7
07:57,237493332.0,14252.245421172463,-17.08,5
07:57,822135975.0,11138.161225831684,-66.91,5
07:58,534204159.0,6261.511133604721,-61.99,2
08:00,420109571.0,608.1338107166796,-31.04,5
08:05,399538448.0,7089.171870949233,-5.5,9
08:08,519935524.0,80.67990973751903,-5.4,9
08:09,456221621.0,951.6253673026282,-6.0,9
08:09,461990622.0,10403.016051342418,-2.12,8
08:09,145387690.0,6176.124555691376,-54.22,2
08:10,467207141.0,529.8427170482637,-6.45,9
08:11,842682241.0,5532.387245559344,-26.0,4
08:12,169006407.0,11927.883978167594,-42.52,7
08:15,241459011.0,983.7855132723472,-6.05,9
08:17,285220959.0,11536.347752822943,-57.52,8
08:21,348325817.0,10173.52342887821,-51.72,2
08:25,146909202.0,6022.033913144668,-4.7,9
08:26,482513594.0,5996.726635850919,-1.9,7
08:26,738958551.0,9280.022192811775,-104.03,5
08:33,873701090.0,1050.89906948246,-6.82,2
08:34,954263768.0,-136.06040000000024,-21.64,5
08:35,215426302.0,-611.3315959743081,-24.18,5
08:39,310171581.0,-2115.8462043409195,-18.97,5
08:39,173317688.0,-2247.718734884285,-34.38,5
08:41,344219145.0,7546.04523543961,-79.14,5
08:42,949032480.0,4882.541274110012,-29.45,7
08:43,668329719.0,8838.499561992192,-5.09,7
08:43,314980178.0,3175.6388500000057,-108.38,5
08:46,752362502.0,10146.693614854468,-12.14,5
08:46,876890798.0,2891.762970699931,-69.73,5
08:47,315546581.0,27312.981832971655,-6.18,7
08:49,564214408.0,-72.11191527427391,-16.62,5
08:50,699139822.0,1761.669025197241,-5.73,2
08:51,441274121.0,12873.977915928168,-22.51,5
08:52,643610517.0,-2917.181190729657,-43.01,5
08:55,737537711.0,-1099.7894663984644,-41.49,5
08:57,425964226.0,3670.392650000002,-52.67,5
08:58,197865285.0,550.8043617312202,-5.4,9
08:58,891716230.0,696.060253688078,-48.42,5
09:00,706361191.0,189.377348494078,-143.04,5
09:01,667367404.0,9499.461243711536,-4.7,9
09:02,613729471.0,9021.60114566232,-5.7,9
09:02,520447032.0,8391.415766173628,-40.76,2
09:03,189335192.0,-949.7275017578602,-58.01,5
09:03,441274121.0,12867.777915928167,-6.2,9
09:04,506618547.0,17474.76686007622,-6.8,9
09:05,683078800.0,1998.7710413499592,-5.05,9
09:06,290818242.0,7149.992433577287,-7.8,9
09:07,895750759.0,-691.1600880756658,-77.27,5
09:09,406862520.0,339.3349265374104,-257.43,5
09:10,270374623.0,10338.5907432454,-2.22,5
09:11,166019891.0,7821.196050265532,-57.2,5
09:15,322720763.0,7892.996128077425,-72.74,5
09:16,338022396.0,612.6482393757391,-82.99,2
09:16,540159353.0,11157.426605276412,-5.9,9
09:17,586315521.0,12073.41124815483,-5.0,9
09:17,690958123.0,20088.24847844166,-5.35,9
09:19,909669130.0,327.8578847367666,-13.94,4
09:19,117273481.0,9280.684917595088,-5.5,9
09:19,678851253.0,3522.9389373291087,-132.38,2
09:19,355733816.0,5023.543234880616,-37.95,7
09:20,194745206.0,693.8803720912431,-68.18,2
09:20,108931112.0,13738.922251354685,-74.27,2
09:20,417850087.0,17147.317667918916,-7.9,9
09:20,425730826.0,1660.0419093887197,-62.98,2
09:21,503575533.0,6374.908258699422,-72.04,2
09:22,822250278.0,7264.197633478772,-151.68,5
09:22,116169597.0,1233.2139499999996,-35.97,4
09:22,618138606.0,1642.6543472714347,-6.85,9
09:23,214339619.0,440.3175508683563,-5.7,9
09:23,456246119.0,19792.38199821335,-1.5,4
09:24,480557476.0,11147.648422167242,-74.96,5
09:24,414454079.0,723.2178500000018,-5.07,4
09:25,402438092.0,1043.504399999999,-43.97,2
09:26,494789005.0,3181.726482803271,-128.89,2
09:29,282837512.0,13780.317450741071,-12.95,5
09:30,287480331.0,11289.978925066544,-7.15,7
09:31,973086490.0,10327.366003319448,-8.1,5
09:32,549414742.0,7495.037260056985,-27.03,2
09:32,986774156.0,3851.236931625768,-13.98,7
09:39,494789005.0,3174.637202803271,-7.09,4
09:42,117308635.0,1126.537782856075,-33.9,2
09:44,586041848.0,421.50569999999885,-38.95,7
09:44,703537476.0,759.163249999999,-100.08,2
09:47,365608668.0,668.2959138595587,-199.69,5
09:47,553734946.0,769.5460999999987,-59.98,4
09:48,865748375.0,3778.979631068943,-11.14,5
09:50,215311171.0,6481.8071647129655,-35.95,7
09:51,647472692.0,24206.743712330375,-5.27,7
09:52,145387690.0,6087.938555691377,-88.19,2
09:54,298000165.0,24934.082391718068,-3.12,8
10:01,700138124.0,5935.879262580885,-119.0,2
10:02,673025413.0,4145.630530466024,-103.82,5
10:03,909676212.0,805.2889779858976,-76.97,4
10:04,279149837.0,1624.1800499999986,-24.96,7
10:04,534204159.0,6237.201133604721,-24.31,4
10:04,903953091.0,3403.9560389956637,-77.99,2
10:04,596171893.0,233.3817448255111,-43.98,2
10:06,170637730.0,2995.9417066862356,-47.53,4
10:13,647472692.0,24186.927132330376,-19.82,4
10:17,737547541.0,447.2705995677742,-55.3,2
10:18,145387690.0,5856.252555691377,-231.69,2
10:22,919185264.0,5097.084722887974,-190.4,2
10:34,127809299.0,1105.7877189472852,-68.97,5
10:35,700138124.0,5775.5792625808845,-160.3,2
10:39,913801979.0,321.5403299144939,-146.65,5
10:41,737547541.0,384.2845995677742,-62.99,2
10:48,903953091.0,3374.986038995664,-28.97,4
10:48,237684254.0,5862.457471401791,-84.76,5
10:53,333054026.0,2.1998940231899944,-29.08,7
10:54,700138124.0,5584.479262580884,-191.1,2
10:56,919185264.0,4952.184722887974,-144.9,2
10:58,578131296.0,762.5867694440439,-40.98,2
11:04,572384506.0,11037.319141465776,-6.32,2
11:06,117308635.0,1075.357782856075,-51.18,2
11:06,223207876.0,1120.2611000000002,-23.07,2
11:07,737547541.0,250.5845995677742,-133.7,2
11:11,578131296.0,697.6167694440438,-64.97,4
11:11,136770968.0,-189.68760000000037,-99.97,2
11:13,673025413.0,4124.3662010579565,-21.26,8
11:25,700138124.0,5490.679262580884,-93.8,2
11:25,454356905.0,3124.846112316369,-46.17,2
11:28,280268430.0,4876.2616446373795,-31.97,4
11:28,919185264.0,4795.384722887974,-156.8,2
11:29,895331556.0,-535.0989000000009,-64.5,2
11:37,407574996.0,4831.076301739017,-9.36,7
11:37,280098744.0,767.4973778716657,-8.49,4
11:39,722358036.0,1025.808290627083,-71.99,2
11:41,480557476.0,11083.45842216724,-64.19,2
11:42,737547541.0,179.18459956777423,-71.4,2
11:44,514362267.0,509.4973191070603,-16.98,4
11:44,259015404.0,1871.7145175305493,-24.79,2
11:46,456246119.0,19727.73966096351,-64.64,5
11:48,454356905.0,3044.402112316369,-80.44,2
11:55,779236304.0,1029.5875954795324,-84.07,2
12:06,299652176.0,-66.75561674312077,-40.33,9
12:06,348525881.0,177.0316245949363,-38.22,5
12:07,828750680.0,1806.44454521368,-15.98,4
12:11,145387690.0,5548.266555691377,-307.99,2
12:12,454356905.0,2963.230112316369,-81.17,2
12:12,919185264.0,4669.384722887974,-126.0,2
12:18,504055745.0,-142.15783865823312,-9.99,4
12:19,145387690.0,5443.280555691377,-104.99,2
12:20,828750680.0,1761.46454521368,-44.98,2
12:25,448004226.0,2300.6825608628556,-5.99,4
12:25,737547541.0,136.51259956777423,-42.67,2
12:27,919185264.0,4405.484722887974,-263.9,2
12:35,776431321.0,3480.2240201844393,-24.97,2
12:37,775790822.0,-2978.943419216068,-26.31,5
12:41,941285623.0,-100.13860093322974,-29.99,5
12:43,266777719.0,739.7964337802396,-26.15,5
12:44,659415300.0,3325.077690250704,-16.5,4
12:46,919185264.0,4190.584722887975,-214.9,2
12:47,737547541.0,66.51259956777423,-70.0,2
12:47,448004226.0,2197.8525608628556,-102.83,2
12:48,224524792.0,-2179.6481824308485,-50.38,5
12:49,262767079.0,-1051.0703000000003,-65.0,5
12:49,194023154.0,-2453.989671784734,-45.36,5
12:52,601627384.0,4808.1356261619585,-27.24,9
12:59,799453072.0,-213.4659500000011,-40.48,5
13:00,277562576.0,731.4182982249549,-5.0,9
13:01,570323670.0,4328.024430587189,-28.03,2
13:03,585625048.0,1534.0511832415311,-7.3,9
13:04,259015404.0,1866.0145175305493,-5.7,9
13:04,812692024.0,3764.672857948952,-5.1,9
13:06,407574996.0,4824.676301739018,-6.4,9
13:06,656389634.0,-2931.651840421986,-14.09,5
13:07,147341222.0,-1617.5285253207956,-118.82,5
13:08,187111705.0,6858.971633076638,-6.35,9
13:08,722358036.0,1019.3582906270829,-6.45,9
13:08,737547541.0,31.51259956777423,-35.0,2
13:19,903468956.0,475.59379999999936,-64.27,5
13:22,145387690.0,5357.194555691377,-86.09,2
13:23,849096144.0,2586.380020751342,-6.8,9
13:34,609939116.0,7548.232812898968,-5.68,7
13:40,762785862.0,-41.9984000000006,-58.19,5
13:44,985188462.0,542.1827887112247,-6.11,7
13:55,145387690.0,5171.708555691377,-185.49,2
14:03,235310449.0,1986.7761848303096,-119.83,5
14:35,504055745.0,-149.14783865823313,-6.99,9
15:09,919185264.0,4188.972223913123,-1.61,5
15:12,448004226.0,2169.8665608628557,-27.99,2
15:12,149684419.0,242.67759999999808,-74.13,5
15:13,191161970.0,-3565.133999999996,-60.42,5
15:35,678330503.0,2988.760932469418,-12.67,2
15:36,136770968.0,-226.65760000000037,-36.97,4
15:36,116598243.0,2364.1327529866585,-3.82,2
15:40,503575533.0,6368.908258699422,-6.0,2
15:41,352899149.0,585.6650499999988,-51.93,1
15:48,421881811.0,3403.1787360133408,-25.33,9
15:50,764450279.0,19726.948348494996,-79.8,4
16:01,346874167.0,155.37989999999903,-146.63,5
16:04,742223719.0,923.6479573048026,-101.37,5
16:13,885259672.0,4164.808503464332,-3.49,4
16:17,158414827.0,-1699.6200000000017,-32.27,5
16:25,587225252.0,7571.709458206224,-56.13,2
16:25,399144202.0,2746.1321519230346,-33.89,7
16:26,587225252.0,7503.6310942261425,-68.08,5
16:27,880546403.0,-1356.598150000002,-42.49,5
16:28,134461671.0,5643.383493525734,-63.1,2
16:32,698076160.0,6212.350245982021,-33.59,7
16:32,448004226.0,2069.766560862856,-100.1,2
16:33,919185264.0,4010.4722239131233,-178.5,2
16:35,587225252.0,7468.301094226143,-35.33,9
16:36,912584712.0,628.8276195447331,-16.97,7
16:40,310620484.0,254.29419509219832,-21.7,9
16:42,456221621.0,895.3796673026281,-56.25,5
16:49,399144202.0,2713.7569119230347,-32.38,4
16:50,604334058.0,776.3852999999995,-70.0,2
16:52,919185264.0,3726.272223913123,-284.2,2
16:52,603721739.0,1214.5768994831842,-18.97,7
16:59,399144202.0,2688.056911923035,-25.7,9
17:02,738958551.0,9230.31278031752,-49.71,2
17:05,653667523.0,5064.81155132644,-33.95,7
17:08,844206657.0,-60.66824485343023,-78.08,5
17:08,836110591.0,7038.528516312729,-26.68,9
17:09,559995067.0,3940.6254002592977,-8.07,7
17:11,366477356.0,365.3184499999999,-27.83,9
17:14,126929801.0,2233.639106340476,-52.93,7
17:15,901432314.0,3839.981465741572,-49.08,5
17:16,169006407.0,11920.873978167594,-7.01,7
17:18,220183538.0,1103.7523999999996,-9.98,7
17:19,613427466.0,6601.1849560118635,-131.6,2
17:21,596463612.0,-917.9001047251388,-29.89,5
17:22,478412511.0,809.2977701974607,-10.0,4
17:22,651756497.0,13542.239479978634,-22.68,9
17:23,233981231.0,2400.7438151909714,-57.97,2
17:24,169689461.0,917.2731499999992,-130.49,5
17:24,442070890.0,938.8724124443712,-59.99,2
17:24,452974357.0,-3093.3564499999948,-15.05,5
17:25,414805878.0,13383.967099283103,-17.94,4
17:27,639409800.0,34494.54108203531,-8.08,4
17:28,832564361.0,15787.471564971604,-26.83,7
17:28,690523499.0,151.63120000000015,-3.0,4
17:29,556992209.0,11632.81025814561,-70.04,2
17:31,893134725.0,1565.500581936779,-56.62,5
17:31,419550103.0,18794.35756792787,-8.75,8
17:35,769311479.0,7076.850264830979,-73.34,2
17:35,613427466.0,6534.6849560118635,-66.5,2
17:36,331450202.0,7528.476333909694,-39.81,7
17:36,912705941.0,18039.772704306004,-10.35,5
17:36,534325901.0,6746.41301658259,-7.14,1
17:37,506618547.0,17338.96686007622,-135.8,2
17:38,785210466.0,2329.3586569695467,-65.4,5
17:39,113747882.0,12309.590828177355,-17.42,7
17:39,287480331.0,11211.525055066544,-78.45,4
17:39,413557825.0,508.6039999999995,-205.29,5
17:40,496395938.0,12937.131940219066,-57.65,5
17:42,703478110.0,4875.69595432897,-21.96,7
17:42,990461108.0,298.32796862061105,-60.99,5
17:42,287230540.0,1322.248598937001,-159.0,2
17:43,246753533.0,797.2700999999986,-24.64,9
17:44,420109571.0,578.1438107166796,-29.99,2
17:46,147474476.0,4656.677865119361,-5.99,7
17:47,558875206.0,3150.794594142862,-127.99,2
17:47,886921642.0,3584.391637364053,-45.41,2
17:49,618514666.0,20820.18084480656,-27.96,7
17:49,629078930.0,1072.3612906575534,-53.99,2
17:50,618514666.0,20814.721450858175,-5.46,2
17:50,587202562.0,569.0042494170686,-49.5,4
17:51,137913631.0,1644.439,-77.98,2
17:52,520418719.0,2778.0756500000034,-140.0,2
17:53,500043411.0,13516.48672046388,-50.6,5
17:57,699997811.0,1926.6861500000036,-27.96,7
17:57,506618547.0,17311.66686007622,-27.3,2
17:58,809499628.0,16619.943106743973,-62.3,2
17:58,713910252.0,-95.51642427145876,-133.09,5
17:59,200080192.0,9362.85867202743,-4.57,2
17:59,990461108.0,287.347968620611,-10.98,7
18:00,235881534.0,12944.937355016007,-32.03,4
18:02,414805878.0,13348.965633189036,-35.0,2
18:03,719586818.0,17321.194957783893,-37.78,5
18:04,435313070.0,3189.344308622464,-130.19,2
18:05,949032480.0,4862.901274110011,-19.64,9
18:07,687135796.0,26593.43572439856,-52.0,2
18:08,287230540.0,1217.748598937001,-104.5,2
18:13,506618547.0,17105.86686007622,-205.8,2
18:14,520418719.0,2634.0756500000034,-144.0,2
18:17,124102251.0,3703.5332132803537,-19.8,7
18:19,873693307.0,9915.097167541036,-16.35,9
18:21,435313070.0,3002.472308622464,-186.87,2
18:27,449871732.0,10486.584801655228,-3.14,5
18:28,386729293.0,30307.499566815215,-13.57,7
18:31,137822385.0,3762.834457226486,-78.28,5
18:33,891716230.0,689.070253688078,-6.99,7
18:35,176922958.0,949.2915471976496,-22.93,9
18:36,264208990.0,405.8094499999988,-31.32,9
18:37,698076160.0,6175.8522459820215,-36.5,5
18:37,340680761.0,-2967.775599999997,-57.84,5
18:40,321372947.0,-332.6881507890994,-35.36,5
18:41,987390838.0,-2866.5437412103784,-30.79,5
18:41,999752672.0,1361.3452435333345,-53.59,5
18:45,631744379.0,-2072.8387594910673,-14.49,9
18:47,691843653.0,-2974.638399999994,-32.52,5
18:49,305778936.0,11619.745055897944,-25.45,9
18:51,556992209.0,11628.162928127642,-4.65,7
18:52,331450202.0,7465.224333909694,-63.25,5
18:55,587202562.0,549.0142494170686,-19.99,4
18:55,951817450.0,9865.720848918038,-70.52,5
18:56,234952520.0,-2053.2486000000013,-32.53,5
18:58,344219145.0,7533.539988943078,-12.51,7
18:59,435984758.0,5522.715192901997,-24.89,5
18:59,994214354.0,9951.079135980077,-53.76,7
19:03,473820682.0,11473.960545105085,-23.79,5
19:04,417850087.0,17034.253667918918,-113.06,5
19:05,500043411.0,13491.60872046388,-24.88,5
19:05,215311171.0,6457.138933284082,-24.67,2
19:09,255814263.0,4184.066096700545,-60.41,5
19:15,994214354.0,9948.762180273863,-2.32,5
19:17,373163757.0,10406.458781725976,-107.86,5
19:18,943329213.0,1711.1157241813244,-7.5,5
19:34,287480331.0,11176.835055066544,-34.69,9
19:37,851181128.0,4869.310726626786,-14.66,2
19:39,621181115.0,-78.03324957077115,-51.01,5
19:40,886921642.0,3558.393637364053,-26.0,5
19:45,996042490.0,5730.651696170787,-136.84,5
19:46,221868392.0,5480.81906173594,-32.68,9
19:50,933491926.0,3327.706300000002,-50.9,5
19:51,785749304.0,8449.66182297318,-10.39,9
19:53,305778936.0,11476.630055897944,-143.12,5
19:59,844835978.0,9629.697938921005,-67.59,5
20:00,310375875.0,4406.73549517658,-31.94,9
20:02,586315521.0,12048.47124815483,-24.94,9
20:03,948069469.0,-697.071500000001,-93.3,5
20:04,554792076.0,27062.696736907987,-30.65,5
20:10,730002588.0,12764.01420633996,-7.01,5
20:11,423208402.0,1237.7485500000023,-81.89,5
20:16,986267641.0,7537.407653107966,-39.58,2
20:19,245690309.0,9548.52345312403,-16.09,5
20:27,604334058.0,586.7538999999995,-189.63,5
20:28,383833857.0,24164.762227917396,-74.14,5
20:29,409971170.0,2780.376709491795,-3.79,2
20:29,887853850.0,10885.493855430292,-22.93,9
20:31,654329190.0,68.8182009485193,-38.86,5
20:35,984783496.0,14366.570247285405,-56.23,7
20:41,245690309.0,9526.786738226903,-21.74,2
20:42,482513594.0,5944.282635850918,-52.44,5
20:47,587225252.0,7389.824094226143,-78.48,5
20:47,478986718.0,-1035.8021000000006,-36.81,5
20:54,136770968.0,-371.1754000000004,-144.52,5
21:25,364357875.0,7708.351756308086,-23.58,5
00:53,117308635.0,1056.003886416121,-19.35,4
00:58,678851253.0,3512.4126652487375,-10.53,2
02:23,170637730.0,2995.3541134636725,-0.59,5
02:39,688328251.0,-1033.174125354827,-16.45,9
02:43,802697323.0,15603.230614083055,-33.19,9
02:44,887853850.0,10864.293855430293,-21.2,9
02:51,618138606.0,1607.5143472714346,-35.14,9
02:52,195895574.0,7456.510976331346,-30.34,9
02:53,985188462.0,507.5027887112247,-34.68,9
02:54,639409800.0,34477.89108203531,-16.65,9
02:56,949032480.0,4834.501274110012,-28.4,9
02:59,134461671.0,5590.663080320996,-52.72,5
03:03,108563213.0,23374.160999757296,-12.57,5
03:07,290818242.0,7128.513431963602,-21.48,5
03:07,108931112.0,13710.442251354683,-28.48,9
03:08,549414742.0,7466.117260056985,-28.92,9
03:10,853907490.0,7155.121734865344,-54.84,7
03:15,887853850.0,10852.16284591145,-12.13,8
03:16,308505160.0,14257.068327173209,-33.25,4
03:16,855129444.0,-142.87644543737198,-30.14,9
03:23,899742927.0,12599.05302994021,-7.91,2
03:23,500043411.0,13489.777977818065,-1.83,7
03:24,187541224.0,2486.49000811304,-46.63,9
03:26,910730524.0,8096.40403275596,-14.41,7
03:29,113747882.0,12279.910828177355,-29.68,9
03:30,949032480.0,4823.438847115203,-11.06,5
03:34,651756497.0,13521.458287675894,-20.78,8
03:36,183888402.0,18083.78362839636,-34.89,9
03:36,940569402.0,6360.418686429097,-6.99,9
03:37,414805878.0,13310.185633189034,-38.78,9
03:39,549414742.0,7424.356846504677,-41.76,7
03:41,822135975.0,11134.005732999238,-4.16,2
03:44,195895574.0,7438.274534010187,-18.24,5
03:47,809499628.0,16603.003106743974,-16.94,9
03:53,558119802.0,32248.58860596213,-27.63,2
03:53,417850087.0,17016.86003154697,-17.39,7
03:59,613729471.0,9011.984525644892,-9.62,2
04:06,766941757.0,9789.960009936918,-33.58,9
04:07,940569402.0,6356.880826022189,-3.54,5
04:08,572384506.0,10994.719141465775,-42.6,9
04:08,604288474.0,2800.4973082539277,-37.93,7
04:10,836110591.0,6998.438516312729,-40.09,9
04:11,237684254.0,5849.025096730863,-13.43,2
04:16,183888402.0,18041.025877513563,-42.76,7
04:21,874431242.0,8499.746649828272,-6.63,7
04:22,433917275.0,8357.020560783487,-35.43,9
04:23,738958551.0,9191.672780317522,-38.64,9
04:23,124102251.0,3661.282733360937,-42.25,5
04:26,704517789.0,17265.085110801407,-6.86,7
04:27,518474507.0,15081.488315521869,-42.68,9
04:30,213112754.0,6893.145718853726,-12.25,9
04:41,187111705.0,6816.050553167516,-42.92,2
04:41,131388684.0,21358.203711743783,-18.63,9
04:46,229205098.0,7521.201294529929,-13.16,5
04:50,482513594.0,5918.813802488146,-25.47,2
04:50,687135796.0,26548.26830382361,-45.17,2
04:51,473820682.0,11439.79356548094,-34.17,2
04:59,668329719.0,8833.005337179464,-5.49,7
05:00,858989281.0,26516.471160027977,-19.34,9
05:02,419550103.0,18761.43639246948,-32.92,2
05:02,738958551.0,9171.04061321836,-20.63,2
05:02,581655972.0,39672.19890297844,-55.46,7
05:03,795847804.0,22685.04554432171,-17.1,5
05:06,252760664.0,6911.979618142906,-16.6,2
05:06,609939116.0,7528.431536136792,-19.8,5
05:11,383833857.0,24153.704432784303,-11.06,8
05:13,865748375.0,3752.290563725289,-26.69,7
05:15,897714622.0,8598.344488039653,-76.42,5
05:19,867987292.0,4232.416517528466,-12.82,7
05:21,237493332.0,14240.328911979976,-11.92,7
05:23,752362502.0,10114.358942026374,-32.33,5
05:25,547010927.0,22858.797215295897,-23.49,9
05:28,510101371.0,13196.605083537468,-40.78,9
05:32,832564361.0,15782.56193129852,-4.91,8
05:36,730002588.0,12723.060382830838,-40.95,5
05:38,221868392.0,5438.87906173594,-41.94,9
05:39,639409800.0,34458.59976100304,-19.29,8
05:40,675806859.0,6951.4736756565535,-34.68,5
05:41,912705941.0,18039.73955910594,-0.03,5
05:42,216285378.0,23458.82938463492,-35.88,9
05:44,633345190.0,7454.256101480143,-36.3,9
05:48,886921642.0,3514.7382570027135,-43.66,5
05:48,973086490.0,10301.996946501638,-25.37,7
05:48,586315521.0,12027.041678238837,-21.43,7
05:49,709608057.0,3147.2916013299696,-32.1,9
05:50,128033695.0,2052.1948453116333,-20.04,2
05:52,858989281.0,26482.652671772168,-33.82,7
05:53,259015404.0,1833.3745175305492,-32.64,9
05:55,873693307.0,9910.931764936817,-4.17,2
05:58,842682241.0,5473.052152802984,-59.34,2
05:58,256002321.0,6263.6865110078525,-19.93,9
06:07,146909202.0,6017.938380145412,-4.1,7
06:08,749378808.0,5773.7217322189945,-8.16,7
06:10,310375875.0,4404.7998695270535,-1.94,2
06:22,815385232.0,10122.06598742425,-5.89,2
06:22,987656636.0,6121.511304056115,-29.21,7
06:23,779946617.0,16586.245726696063,-12.03,2
06:23,970298834.0,3199.077213793015,-76.35,7
06:26,718058208.0,3007.6646377221437,-2.92,5
06:28,348325817.0,10156.2355532594,-17.29,2
06:28,169006407.0,11846.989366803922,-73.88,2
06:30,213112754.0,6889.274667482869,-3.87,8
06:32,198946608.0,4058.995061533149,-7.57,7
06:33,305778936.0,11463.94100512969,-12.69,8
06:34,522188082.0,8168.287142772153,-14.54,7
06:35,433917275.0,8354.423210867555,-2.6,5
06:39,670102069.0,3998.8812321334194,-21.36,5
06:44,383625050.0,6064.969322183975,-2.96,7
06:52,324224854.0,3105.564612850285,-20.98,9
06:54,435984758.0,5483.074566705052,-39.64,8
06:55,851181128.0,4850.110726626786,-19.2,9
07:00,822250278.0,7224.641175529614,-39.56,2
07:03,547010927.0,22806.57202420784,-52.23,2
07:04,506618547.0,17091.0362691048,-14.83,8
07:04,779236304.0,991.8475954795324,-37.74,9
07:04,559995067.0,3916.6462334037033,-23.98,8
07:05,973086490.0,10287.796946501638,-14.2,9
07:06,987163717.0,6627.1584800000055,-32.02,9
07:06,366550080.0,25550.304917623707,-7.3,5
07:08,116598243.0,2338.4770996229695,-25.66,8
07:08,960208650.0,17353.875217902205,-9.67,2
07:09,365608668.0,636.6150848377233,-31.68,5
07:10,905860285.0,10506.675379458518,-1.76,7
07:10,532478725.0,4932.429537648056,-5.04,8
07:13,647936800.0,652.8049207461647,-0.23,4
07:14,285220959.0,11532.8847593247,-3.46,2
07:19,496395938.0,12921.369331061567,-15.76,5
07:20,930277104.0,10411.538752245802,-31.34,9
07:23,324224854.0,3085.9381493812075,-19.63,5
07:25,441274121.0,12849.697841250209,-18.08,7
07:31,705848712.0,25817.52489570192,-15.35,9
07:37,698955014.0,1395.546716951667,-4.56,4
07:39,471897866.0,8639.137040297399,-80.55,5
07:41,399144202.0,2658.156911923035,-29.9,9
07:43,758160963.0,8185.223717493009,-57.35,2
07:50,679911053.0,2754.4518653524538,-24.86,7
07:50,256002321.0,6211.865064633519,-51.82,5
07:51,984783496.0,14348.527106505266,-18.04,4
07:52,108931112.0,13700.406176546672,-10.04,5
07:55,270374623.0,10321.674594937524,-16.92,7
07:56,930277104.0,10387.076689674826,-24.46,2
07:58,108481285.0,8651.838961054244,-25.79,2
07:59,145387690.0,5161.166543113603,-10.54,2
08:00,480557476.0,11072.478422167242,-10.98,9
08:01,719586818.0,17314.757087754468,-6.44,2
08:03,994214354.0,9934.053069836544,-14.71,5
08:03,550169791.0,21080.758530535382,-13.64,9
08:04,678330503.0,2961.242278559369,-27.52,2
08:08,667367404.0,9464.145854291088,-35.32,2
08:10,851181128.0,4846.413420266941,-3.7,2
08:13,151968462.0,9083.044186376394,-4.15,7
08:16,245690309.0,9507.073088358777,-19.71,7
08:17,287480331.0,11171.487781716552,-5.35,2
08:18,399538448.0,7083.471870949234,-5.7,9
08:19,766941757.0,9772.931549961211,-17.03,7
08:19,769311479.0,7074.132937508333,-2.72,2
08:19,822718326.0,11053.133921296396,-69.22,2
08:21,461990622.0,10401.053337695022,-1.96,5
08:22,489964679.0,20517.604113998943,-35.88,9
08:26,556992209.0,11561.99892812764,-66.16,5
08:26,308897841.0,1014.089699999999,-56.33,5
08:26,455831435.0,-1750.6096048014945,-40.45,5
08:29,297823329.0,1002.1036999999992,-83.51,5
08:29,494789005.0,3118.833202803271,-55.8,5
08:30,220183538.0,1061.0992999999996,-42.65,5
08:30,859264768.0,362.9194337819384,-50.45,5
08:34,550169791.0,21031.54008000215,-49.22,5
08:38,957821152.0,-1493.4018535715495,-109.27,5
08:38,930271460.0,260.37699753577624,-62.42,5
08:38,919185264.0,3615.1822239131234,-111.09,5
08:39,444371478.0,671.7743999999988,-40.5,5
08:39,469561218.0,-87.27890000000085,-84.65,5
08:43,901432314.0,3834.781465741572,-5.2,9
08:43,897592348.0,15009.85598632199,-96.68,5
08:45,264550521.0,9547.225146290932,-19.63,5
08:48,131388684.0,21338.618550178133,-19.59,5
08:50,683319988.0,7806.642334092514,-41.83,9
08:50,441274121.0,12758.78184125021,-90.92,5
08:52,510101371.0,13111.471083537468,-85.13,5
08:54,111137699.0,-135.52269999999956,-110.44,5
08:55,175452235.0,1405.4722500000005,-48.24,5
08:55,670427480.0,2463.5364500000014,-69.92,5
08:55,361201224.0,3268.0942320678923,-62.71,5
08:55,773633520.0,554.4398109385115,-157.31,5
08:58,409370545.0,1399.7632755455202,-86.37,5
08:59,776431321.0,3480.028243370994,-0.2,8
08:59,147474476.0,4559.601165119361,-97.08,5
09:03,678726554.0,-835.8702476516103,-139.25,5
09:04,581655972.0,39569.38290297844,-102.82,5
09:04,673025413.0,4118.350447102897,-6.02,8
09:06,679662108.0,15832.441633915072,-149.94,5
09:07,647472692.0,24156.69677815621,-30.23,5
09:08,899983008.0,-3019.146149999997,-51.11,5
09:09,718058208.0,2870.4296377221435,-137.23,5
09:11,245198540.0,-87.13860119822053,-19.82,5
09:11,200080192.0,9361.256847037725,-1.6,8
09:12,119943495.0,-1357.100062112858,-49.59,5
09:13,237684254.0,5797.035096730863,-51.99,1
09:13,613729471.0,9006.584525644894,-5.4,9
09:14,163470640.0,1198.9133,-49.33,5
09:15,166019891.0,7798.470319297811,-22.73,5
09:15,786141370.0,-320.2970000000008,-85.2,5
09:16,604334058.0,580.7638999999995,-5.99,4
09:16,461029994.0,7360.848299682367,-35.0,2
09:17,407574996.0,4797.64880771548,-27.03,4
09:17,388862238.0,1279.534157133441,-32.96,7
09:17,541639148.0,4919.905721831282,-1.49,7
09:18,553734946.0,738.5960999999986,-30.95,7
09:18,627622066.0,3247.818185693058,-37.98,2
09:18,943329213.0,1667.8977241813243,-43.22,5
09:19,270374623.0,10197.734594937525,-123.94,2
09:19,425964226.0,3571.412650000002,-98.98,2
09:19,779376323.0,2861.6457666549404,-39.92,4
09:20,223207876.0,956.2511000000002,-164.01,5
09:20,769311479.0,7046.002937508333,-28.13,1
09:20,647936800.0,624.7349207461647,-28.07,2
09:21,699139822.0,1757.1724022769806,-4.5,5
09:22,370521542.0,25602.31300013152,-204.78,2
09:23,187541224.0,2470.12000811304,-16.37,7
09:24,456221621.0,760.3896673026281,-134.99,2
09:24,802697323.0,15575.010614083058,-28.22,7
09:24,633345190.0,7287.906101480143,-166.35,2
09:25,373163757.0,10395.448781725976,-11.01,4
09:26,487051121.0,883.8951637034942,-65.12,5
09:27,912705941.0,17959.599499105938,-80.14,4
09:27,757115616.0,2263.8900000000035,-20.97,7
09:27,720742759.0,1658.8774308830075,-29.96,1
09:28,785749304.0,8443.869242302768,-5.79,2
09:30,819515373.0,2537.361286063792,-28.0,2
09:30,108931112.0,13694.565056546671,-5.84,4
09:30,699997811.0,1920.6961500000036,-5.99,2
09:33,799286313.0,-1142.3914628758614,-86.52,5
09:34,376271050.0,1393.292806905744,-49.99,4
09:34,752362502.0,10096.348942026374,-18.01,7
09:36,683078800.0,1928.7710413499592,-70.0,2
09:36,225210798.0,1066.3637737592087,-29.99,4
09:37,510101371.0,13101.881083537468,-9.59,4
09:38,489964679.0,20508.39350684321,-9.21,4
09:38,519644021.0,2975.4873534649932,-31.4,7
09:39,373163757.0,10359.458781725976,-35.99,7
09:40,598793068.0,981.1403499999984,-8.99,4
09:40,603375739.0,1188.341063023267,-4.99,7
09:40,604288474.0,2741.2353082539275,-59.26,5
09:41,878989510.0,5788.439886141792,-173.6,2
09:42,441142605.0,2332.9090000000056,-11.0,4
09:42,298007503.0,1681.9231036256335,-11.14,7
09:42,654329190.0,31.868200948519306,-36.95,1
09:42,461029994.0,7297.3022996823665,-63.55,5
09:42,514362267.0,435.6223191070603,-73.88,7
09:43,517934629.0,1256.8576787084264,-47.0,2
09:45,454129843.0,1678.428450791789,-22.0,2
09:47,960208650.0,17233.775217902206,-120.1,2
09:48,821971408.0,1219.5077213748782,-55.26,5
09:50,704517789.0,17137.725110801406,-127.36,2
09:50,711045550.0,4406.598350000003,-41.14,5
09:51,611143859.0,1418.2535000000114,-26.03,2
09:51,478412511.0,574.2977701974607,-235.0,2
09:51,235881534.0,12942.08324056494,-2.85,5
09:52,672913754.0,10714.857451182015,-30.96,7
09:56,408057540.0,5188.200861361828,-25.2,5
09:56,448279144.0,1099.3223499999992,-29.96,1
09:57,188263947.0,101.05565000000053,-38.95,7
09:57,506618547.0,17077.9262691048,-13.11,2
09:57,878989510.0,5571.439886141792,-217.0,2
09:59,835736339.0,1892.7103520918797,-48.47,5
10:00,496395938.0,12871.279331061569,-50.09,2
10:01,849096144.0,2443.118020751341,-143.26,5
10:06,585596026.0,-225.36566612332993,-163.97,2
10:08,373163757.0,10264.303721725975,-95.16,4
10:08,514362267.0,337.7548191070603,-97.87,4
10:08,651756497.0,13501.218287675894,-20.24,4
10:08,322221939.0,4108.3269805743475,-67.68,5
10:10,480557476.0,11035.252458666451,-37.23,5
10:10,108563213.0,23348.120999757295,-26.04,7
10:10,416060965.0,506.8793559540573,-28.99,2
10:11,466649401.0,667.6718113978915,-15.98,2
10:11,322221939.0,4093.1977345325326,-15.13,7
10:11,581655972.0,39536.43290297844,-32.95,7
10:15,951817450.0,9799.961933522529,-65.76,5
10:17,833499132.0,2799.885250000001,-101.25,2
10:17,478412511.0,450.2977701974607,-124.0,2
10:17,986267641.0,7490.253533107966,-47.15,4
10:17,551196328.0,4741.619133942313,-104.3,2
10:18,203466392.0,2960.5171085554466,-30.86,2
10:19,497772347.0,1096.465599999998,-9.99,7
10:19,520418719.0,2597.1256500000036,-36.95,1
10:20,851649498.0,10436.884331061612,-17.34,2
10:21,679911053.0,2652.9718653524537,-101.48,4
10:21,517190750.0,3452.0010899154126,-13.0,2
10:23,380228542.0,-291.1130581844345,-55.97,2
10:23,137822385.0,3756.934457226486,-5.9,9
10:24,282837512.0,13756.907383085225,-23.41,7
10:24,916270283.0,2195.8042499999997,-9.99,1
10:24,605116158.0,2390.4421000000016,-29.99,4
10:28,700138124.0,5475.139262580884,-15.54,9
10:28,586315521.0,12006.311678238835,-20.73,7
10:29,616924659.0,-29.51292017691472,-22.98,2
10:30,514362267.0,329.5198191070603,-8.23,4
10:31,135937041.0,-75.79299826841168,-206.5,2
10:31,241459011.0,981.7955132723472,-1.99,4
10:32,143061865.0,7631.263498500872,-5.99,1
10:34,551196328.0,4554.047133942313,-187.57,2
10:35,895331556.0,-548.3989000000008,-13.3,5
10:35,653640811.0,16963.97102722491,-157.47,2
10:35,422955974.0,-201.05721500095007,-199.98,2
10:35,416060965.0,422.8893559540573,-83.99,2
10:36,242218612.0,414.27630000000056,-49.99,2
10:37,414805878.0,13308.137409014967,-2.05,7
10:38,541639148.0,4900.492221831282,-19.41,4
10:39,534204159.0,6202.087074389439,-35.11,7
10:39,280098744.0,659.9143778716657,-107.58,5
10:39,413557825.0,447.49399999999946,-61.11,7
10:40,792845450.0,919.9631500000012,-3.0,4
10:41,833499132.0,2725.260250000001,-74.62,2
10:41,497772347.0,1046.475599999998,-49.99,4
10:42,834581602.0,469.81304999999907,-154.35,5
10:43,494789005.0,3076.190101131912,-42.64,5
10:46,623156843.0,5912.353987429746,-3.19,5
10:47,365608668.0,577.6250848377233,-58.99,2
10:47,518474507.0,15080.246704637168,-1.24,2
10:47,551196328.0,4406.361133942313,-147.69,2
10:48,706250160.0,11768.456150355927,-10.09,2
10:48,878989510.0,5421.639886141792,-149.8,2
10:49,297823329.0,892.1136999999992,-109.99,2
10:51,690958123.0,20038.15843844166,-50.09,4
10:56,297823329.0,839.1136999999992,-53.0,2
10:57,413557825.0,380.36899999999946,-67.12,4
10:58,514362267.0,268.0348191070603,-61.48,7
11:00,423208402.0,1219.7485500000023,-18.0,4
11:00,653640811.0,16701.48502722491,-262.49,2
11:00,833499132.0,2628.510250000001,-96.75,2
11:02,910730524.0,7960.16403275596,-136.24,2
11:04,822135975.0,11101.535732999238,-32.47,2
11:04,416060965.0,402.8993559540572,-19.99,2
11:05,450896297.0,13360.15352194517,-15.16,5
11:06,851649498.0,10412.860331061613,-24.02,5
11:06,179173981.0,6820.731095413636,-33.8,5
11:07,135937041.0,-183.7829982684117,-107.99,2
11:09,433917275.0,8267.651210867554,-86.77,5
11:12,893134725.0,1444.500581936779,-121.0,2
11:13,414454079.0,708.0078500000018,-15.21,4
11:13,596171893.0,228.3917448255111,-4.99,7
11:13,255814263.0,4152.576096700545,-31.49,7
11:14,878989510.0,5146.539886141792,-275.1,2
11:16,409370545.0,1374.6732755455205,-25.09,7
11:22,435984758.0,5345.174566705053,-137.9,2
11:22,822135975.0,11091.40573299924,-10.13,4
11:23,413557825.0,249.88399999999945,-130.49,4
11:24,124125096.0,324.04924438780233,-131.97,5
11:26,762859681.0,500.6975999999988,-47.5,2
11:26,548907062.0,99.1674887682886,-101.98,6
11:28,131388684.0,21256.708550178133,-81.91,2
11:29,878989510.0,4916.939886141791,-229.6,2
11:30,549414742.0,7380.947126504678,-43.41,4
11:32,511179916.0,6857.7211863676,-9.76,8
11:32,135937041.0,-303.75299826841166,-119.97,2
11:32,255814263.0,4031.096096700546,-121.48,4
11:34,514362267.0,254.06981910706028,-13.96,5
11:34,454356905.0,2928.716192316369,-34.51,4
11:35,310375875.0,4372.683819527054,-32.12,4
11:35,867679563.0,-51.25894629828415,-111.84,5
11:37,655368335.0,5027.141910070222,-262.5,4
11:37,416060965.0,344.9193559540572,-57.98,2
11:38,435984758.0,5019.674566705053,-325.5,2
11:39,510101371.0,13095.206273433456,-6.67,7
11:40,131388684.0,21127.71855017813,-128.99,2
11:41,893134725.0,1384.500581936779,-60.0,2
11:45,409971170.0,2779.503371794026,-0.87,7
11:45,143061865.0,7470.963498500872,-160.3,2
11:51,551196328.0,4302.061133942313,-104.3,2
11:52,642015139.0,-49.44866253436175,-50.0,2
11:52,570323670.0,4267.934400587189,-60.09,4
11:53,992204045.0,12052.824117966033,-148.13,2
11:53,413557825.0,196.28899999999945,-53.6,7
11:54,651756497.0,13437.358287675894,-63.86,2
11:56,408057540.0,5101.400861361828,-86.8,7
11:56,135937041.0,-408.7329982684116,-104.98,2
11:57,929044080.0,632.2663915056283,-27.82,5
11:58,657139925.0,13663.227798354865,-13.75,7
11:58,806358207.0,12244.703953243968,-9.73,5
12:01,583579399.0,1344.2949499999993,-22.97,7
12:01,113747882.0,12265.910755000294,-14.0,7
12:02,143061865.0,7415.005498500872,-55.96,2
12:03,255814263.0,3909.6160967005458,-121.48,2
12:03,878989510.0,4724.439886141791,-192.5,2
12:03,551196328.0,4190.789133942313,-111.27,2
12:04,637433131.0,-24.02300000000085,-13.69,9
12:05,416060965.0,332.4193559540572,-12.5,2
12:06,412823730.0,68.44572585048974,-19.94,9
12:08,776108637.0,1015.3125536574958,-59.98,2
12:08,108812033.0,638.5363999999984,-37.9,9
12:09,992204045.0,12026.834117966033,-25.99,1
12:09,433917275.0,8053.451210867554,-214.2,2
12:11,429556122.0,6227.481750000004,-32.05,2
12:11,655368335.0,4731.041910070222,-296.1,7
12:14,792845450.0,839.9831500000012,-79.98,2
12:17,885259672.0,4135.011841050232,-29.8,5
12:20,657139925.0,13640.477798354865,-22.75,9
12:28,514362267.0,239.82731910706028,-14.24,2
12:29,413557825.0,148.29649999999947,-47.99,7
12:29,532478725.0,4911.949537648056,-20.48,9
12:30,680773155.0,343.3126833310917,-12.25,9
12:31,235881534.0,12912.09324056494,-29.99,7
12:31,492215823.0,2479.219333815444,-24.89,9
12:32,408057540.0,4971.900861361828,-129.5,4
12:34,255814263.0,3840.6160967005458,-69.0,2
12:35,433917275.0,7945.651210867554,-107.8,2
12:35,878989510.0,4571.139886141791,-153.3,2
12:36,416060965.0,263.9293559540572,-68.49,2
12:36,540159353.0,11107.426605276412,-50.0,2
12:41,135937041.0,-506.7229982684116,-97.99,2
12:41,506618547.0,17046.6962691048,-31.23,1
12:43,143061865.0,7310.719498500872,-104.29,2
12:44,857754342.0,2745.092382099382,-24.04,2
12:48,331450202.0,7447.074333909694,-18.15,9
12:49,413557825.0,41.05399999999946,-107.24,4
12:49,868033067.0,-2252.488286451082,-21.59,5
12:51,433917275.0,7659.351210867554,-286.3,2
12:54,282837512.0,13720.997383085223,-35.91,2
12:56,551196328.0,4026.317133942313,-164.47,2
12:57,815385232.0,10099.88598742425,-22.18,2
12:57,736340277.0,8701.333452182518,-6.22,8
12:59,720742759.0,1546.7584308830076,-112.12,5
13:00,277562576.0,726.1682982249549,-5.25,9
13:00,169006407.0,11759.739366803922,-87.25,2
13:01,585625048.0,1529.351183241531,-4.7,9
13:01,564214408.0,-98.04691527427391,-25.94,5
13:02,514362267.0,164.8423191070603,-74.98,2
13:03,245690309.0,9467.355088358776,-39.72,5
13:04,408057540.0,4909.600861361828,-62.3,2
13:04,416060965.0,208.4493559540572,-55.48,2
13:05,822135975.0,11085.41573299924,-5.99,9
13:05,493640090.0,-2521.940949999999,-22.52,5
13:05,795847804.0,22649.605544321712,-35.44,1
13:06,480557476.0,11027.352458666452,-7.9,9
13:06,993663752.0,260.87819241039654,-86.54,5
13:07,493855007.0,-2585.4691315743926,-31.98,5
13:07,914806976.0,2223.6332501854868,-39.08,9
13:07,874431242.0,8465.416649828272,-34.33,9
13:07,749378808.0,5767.571732218995,-6.15,9
13:08,893134725.0,1265.000581936779,-119.5,2
13:08,449871732.0,10386.512801655228,-100.07,7
13:08,435984758.0,4810.3745667050525,-209.3,2
13:10,450896297.0,13321.65352194517,-38.5,9
13:12,135937041.0,-632.7029982684116,-125.98,2
13:12,454129843.0,1649.0957715607594,-29.33,2
13:12,971010829.0,286.6712564442453,-13.98,1
13:16,331048953.0,-83.38163202150638,-122.6,5
13:17,143003091.0,21840.98992240584,-7.22,7
13:18,551196328.0,3966.8451339423127,-59.47,2
13:19,656812046.0,865.0857537325188,-33.14,5
13:20,348325817.0,10150.2355532594,-6.0,9
13:20,408057540.0,4695.400861361828,-214.2,2
13:21,519644021.0,2966.457353464993,-9.03,4
13:21,143061865.0,7144.175498500872,-166.54,2
13:24,893134725.0,1213.000581936779,-52.0,2
13:24,500843551.0,943.5046999999996,-1.99,4
13:24,340321732.0,1814.5628500000032,-5.35,9
13:25,627917561.0,3483.9550500000046,-4.99,1
13:28,878989510.0,4327.539886141791,-243.6,2
13:30,833499132.0,2524.260250000001,-104.25,2
13:30,516051449.0,1883.078287516744,-20.97,1
13:32,245198540.0,-167.1286011982205,-79.99,2
13:33,449871732.0,10218.540801655228,-167.97,4
13:36,416060965.0,114.44935595405718,-94.0,2
13:37,656812046.0,845.0357537325189,-20.05,2
13:38,179173981.0,6797.581095413636,-23.15,9
13:39,124377686.0,-2657.079899999998,-23.92,5
13:42,143061865.0,6994.403498500872,-149.77,2
13:43,435984758.0,4563.274566705052,-247.1,2
13:44,331450202.0,7353.054333909694,-94.02,2
13:45,706250160.0,11705.736150355928,-62.72,7
13:47,799861885.0,62.881599999998826,-159.66,5
13:48,878989510.0,4265.2398861417905,-62.3,2
13:51,449871732.0,10201.560801655229,-16.98,1
13:52,854513972.0,1355.8286999999998,-38.95,7
13:55,489964679.0,20464.39844684321,-44.0,4
13:58,587202562.0,421.51424941706864,-127.5,2
13:58,886837068.0,630.5380999999994,-57.97,4
13:59,255814263.0,3742.1260967005455,-98.49,7
13:59,986267641.0,7452.1835331079665,-38.07,2
13:59,143061865.0,6893.631498500872,-100.77,2
14:01,416060965.0,-14.550644045942818,-129.0,2
14:02,216286013.0,47.542806653940005,-109.45,5
14:03,490868147.0,-145.38022087869848,-65.2,5
14:06,135937041.0,-783.6829982684117,-150.98,2
14:08,969697937.0,-4594.22026567055,-18.81,5
14:08,514362267.0,90.59981910706028,-74.24,7
14:08,690523499.0,148.63120000000015,-3.0,4
14:14,878989510.0,4073.4398861417903,-191.8,2
14:16,135937041.0,-923.1729982684116,-139.49,2
14:17,761272540.0,163.48329999999885,-49.06,5
14:19,255814263.0,3556.6560967005457,-185.47,4
14:23,514362267.0,19.364819107060285,-71.23,4
14:27,587202562.0,191.01424941706864,-230.5,2
14:31,478412511.0,298.79777019746075,-151.5,2
14:32,653640811.0,16519.52702722491,-181.96,2
14:34,893134725.0,1041.000581936779,-172.0,2
14:36,785749304.0,8436.879242302768,-6.99,9
14:37,416060965.0,-69.53064404594281,-54.98,2
14:38,466649401.0,547.9319113978914,-119.74,5
14:43,135937041.0,-982.1729982684116,-59.0,2
14:48,216285378.0,23337.29938463492,-121.53,2
14:51,893134725.0,843.0005819367791,-198.0,2
14:55,221868392.0,5407.635069436627,-31.24,7
14:56,736340277.0,8672.623452182519,-28.71,7
15:01,416060965.0,-167.5006440459428,-97.97,2
15:03,514362267.0,-14.010180892939715,-33.38,2
15:05,413557825.0,14.061499999999462,-26.99,7
15:05,574548998.0,739.7013999999992,-15.97,1
15:08,241459011.0,918.7668132723472,-63.03,5
15:14,508518911.0,-110.47524972098954,-156.98,2
15:17,135937041.0,-1141.1529982684117,-158.98,2
15:34,514362267.0,-114.88518089293972,-100.88,2
15:35,135937041.0,-1180.1329982684117,-38.98,2
15:38,331450202.0,7342.638290863449,-10.42,8
15:40,867987292.0,4197.386517528466,-35.03,2
15:41,833499132.0,2461.260250000001,-63.0,2
15:46,518466565.0,851.7912499999996,-89.7,5
15:51,454356905.0,2898.721850146718,-29.99,7
15:51,135937041.0,-1250.1329982684117,-70.0,2
15:55,514362267.0,-122.37768089293972,-7.49,2
16:01,653640811.0,16514.53702722491,-4.99,1
16:02,683319988.0,7806.344829983084,-0.3,7
16:03,833499132.0,2334.510250000001,-126.75,2
16:29,570575024.0,-967.2279000000004,-96.64,5
16:35,408057540.0,4524.600861361828,-170.8,7
16:52,698955014.0,1259.8468169516668,-135.7,5
17:01,349614277.0,1480.0504499999995,-106.83,5
17:05,408057540.0,4381.800861361828,-142.8,4
17:08,536924114.0,-847.8660555930961,-94.5,5
17:16,779620857.0,-205.76634638517584,-145.14,5
17:27,462962606.0,-1280.2709500000012,-26.38,9
17:30,833499132.0,2230.635250000001,-103.88,2
17:36,653667523.0,5058.388310761824,-6.42,4
17:37,408057540.0,4257.900861361828,-123.9,2
17:41,610450243.0,-858.8946,-13.64,5
17:41,514362267.0,-180.8551808929397,-58.48,7
17:52,788740658.0,3915.7659016518032,-7.58,2
17:55,504055745.0,-201.11783865823313,-51.97,4
17:57,135937041.0,-1397.1229982684115,-146.99,2
17:59,604288474.0,2735.1025882539275,-6.13,4
18:04,984783496.0,14316.341106505266,-32.19,5
18:07,833499132.0,2163.510250000001,-67.12,2
18:10,135937041.0,-1489.0929982684115,-91.97,2
18:10,516051449.0,1839.153038940098,-43.93,5
18:10,233981231.0,2352.3178151909715,-48.43,5
18:11,514362267.0,-266.7301808929397,-85.88,4
18:15,429235692.0,-1251.852,-22.93,9
18:16,642924505.0,268.6518701835261,-24.52,5
18:26,613729471.0,8979.104525644894,-27.48,9
18:29,455052690.0,-219.1492600513724,-48.87,5
18:29,679662108.0,15827.71670142058,-4.72,5
18:45,687135796.0,26541.01830382361,-7.25,9
18:51,203466392.0,2949.727108555446,-10.79,9
18:52,856957948.0,9431.67039333536,-9.0,7
18:55,514362267.0,-319.5901808929397,-52.86,2
19:02,587225252.0,7348.634094226143,-41.19,9
19:04,361201224.0,3236.6642320678925,-31.43,9
19:08,444428189.0,1288.7093500000028,-25.29,9
19:39,472213568.0,-429.03824420605326,-102.58,5
19:41,392270893.0,12444.980532200016,-9.91,2
19:52,899742927.0,12464.08602994021,-134.97,5
19:56,722358036.0,922.5209906270828,-96.84,5
19:59,768271776.0,-505.4450467665795,-126.36,5
20:30,522188082.0,8047.684142772153,-120.6,5
20:33,514362267.0,-353.9301808929397,-34.34,9
20:34,762700245.0,-341.9782999999975,-49.94,5
20:35,994214354.0,9899.573069836544,-34.48,9
20:47,919185264.0,3586.3322239131235,-28.85,9
20:52,310375875.0,4239.669819527054,-133.01,5
21:21,520447032.0,8365.785766173629,-25.63,9
21:27,822250278.0,7194.271175529614,-30.37,9
21:52,520447032.0,8314.91161948961,-50.87,5
00:19,324224854.0,3062.925278999527,-23.01,2
00:21,473820682.0,11417.614978818232,-22.18,7
00:23,990461108.0,246.40796862061103,-40.94,9
00:28,853907490.0,7150.670481203352,-4.45,7
00:42,473820682.0,11405.364978818232,-12.25,9
00:42,409971170.0,2772.8457481866385,-6.66,8
00:44,853907490.0,7137.670481203352,-13.0,9
00:48,450896297.0,13307.273530197755,-14.38,7
00:50,874431242.0,8420.830569197464,-44.59,7
00:50,196289502.0,15494.909166194804,-20.15,9
00:50,601627384.0,4780.145626161959,-27.99,9
00:54,419550103.0,18753.141029603845,-8.3,8
00:54,450896297.0,13277.873530197756,-29.4,9
00:55,433917275.0,7624.701210867554,-34.65,9
00:57,802697323.0,15540.310614083057,-34.7,9
01:03,169006407.0,11738.436319347364,-21.3,5
01:05,858989281.0,26462.952671772167,-19.7,9
01:10,940569402.0,6325.02656673281,-31.85,5
01:17,315078351.0,7491.459558736246,-5.12,7
01:20,986267641.0,7444.059042672556,-8.12,2
01:21,887853850.0,10845.65454649475,-6.51,2
01:29,235881534.0,12867.801642635446,-44.29,4
01:36,705848712.0,25803.29489570192,-14.23,9
01:36,534325901.0,6738.17301658259,-8.24,9
01:36,858989281.0,26441.20674607857,-21.75,2
01:42,237493332.0,14227.194844043684,-13.13,2
01:47,987163717.0,6591.738480000005,-35.42,9
01:53,824916823.0,8807.017324261162,-31.18,9
01:58,482513594.0,5907.120609603857,-11.69,7
01:59,290818242.0,7091.132728521849,-37.38,7
02:07,705848712.0,25802.816940990582,-0.48,5
02:15,873693307.0,9902.855986993289,-8.08,2
02:15,270374623.0,10181.981298417462,-15.75,4
02:16,130522384.0,-586.5838156208604,-19.9,9
02:17,572384506.0,10963.969141465775,-30.75,9
02:21,809499628.0,16584.753106743974,-18.25,9
02:22,709608057.0,3113.2016013299694,-34.09,9
02:23,815385232.0,10082.273891709912,-17.61,5
02:23,633345190.0,7254.676101480143,-33.23,9
02:31,506618547.0,17031.137259159826,-15.56,7
02:31,824916823.0,8759.519513906847,-47.5,4
02:32,166019891.0,7764.986109021354,-33.48,2
02:40,822135975.0,11083.686111996903,-1.73,5
02:41,489964679.0,20426.81844684321,-37.58,9
02:41,145387690.0,5145.997285222662,-15.17,5
02:44,471897866.0,8625.56173608934,-13.58,7
02:47,421881811.0,3354.1099139004473,-49.07,2
02:49,522188082.0,8031.837326204563,-15.85,2
02:51,678851253.0,3499.2524526438674,-13.16,5
02:52,809499628.0,16582.117914677696,-2.64,5
03:03,179173981.0,6786.755085207676,-10.83,2
03:03,388862238.0,1235.815807474455,-43.72,5
03:04,216285378.0,23302.36938463492,-34.93,9
03:06,221868392.0,5376.245069436627,-31.39,9
03:10,836110591.0,6970.408516312729,-28.03,9
03:10,639549973.0,7498.530121166341,-3.52,7
03:12,604288474.0,2659.1423046084956,-75.96,2
03:14,489964679.0,20365.842247169752,-60.98,7
03:20,572384506.0,10884.288807577135,-79.68,7
03:21,700138124.0,5462.3258675425395,-12.81,5
03:22,183888402.0,18003.78587751356,-37.24,9
03:23,518474507.0,15043.106704637168,-37.14,9
03:24,113747882.0,12246.820439285617,-19.09,5
03:31,994214354.0,9862.383069836544,-37.19,9
03:32,749378808.0,5744.444048530705,-23.13,2
03:34,519644021.0,2957.7485736881995,-8.71,5
03:41,282837512.0,13686.557383085225,-34.44,9
03:41,383833857.0,24133.654432784304,-20.05,9
03:47,905860285.0,10485.769398382916,-20.91,5
03:49,310375875.0,4199.779819527053,-39.89,9
04:00,795847804.0,22634.406192895654,-15.2,5
04:01,651756497.0,13428.74577118528,-8.61,7
04:03,287230540.0,1189.2503470409629,-28.5,8
04:04,534204159.0,6200.864099823866,-1.22,7
04:10,344219145.0,7529.66808124091,-3.87,2
04:16,897714622.0,8588.47559676071,-9.87,8
04:16,886921642.0,3489.3380150517955,-25.4,2
04:17,146909202.0,5950.667887832281,-67.27,5
04:21,496395938.0,12822.514467466106,-48.76,2
04:24,673025413.0,4070.6015446796,-47.75,5
04:25,383833857.0,24066.91545960923,-66.74,7
04:26,383625050.0,6051.0006993303095,-13.97,8
04:31,832564361.0,15749.159549833965,-33.4,2
04:35,601627384.0,4766.188391100799,-13.96,7
04:40,995615876.0,1959.3508896983883,-32.88,9
04:40,252760664.0,6907.284271217639,-4.7,8
04:41,984783496.0,14290.891106505263,-25.45,9
04:43,151968462.0,9059.297187717031,-23.75,2
04:46,679911053.0,2608.887069457645,-44.08,5
04:47,287480331.0,11143.957781716552,-27.53,9
04:52,366550080.0,25525.25691669805,-25.05,2
04:55,836110591.0,6960.925781741444,-9.48,2
04:58,679662108.0,15825.452199617872,-2.26,7
05:00,624500124.0,3609.3360282625777,-24.72,4
05:00,949032480.0,4802.112345146399,-21.33,5
05:01,203466392.0,2937.412457485167,-12.31,7
05:04,187111705.0,6765.07754647574,-50.97,8
05:07,738958551.0,9151.473135877675,-19.57,8
05:10,370521542.0,25600.614614385315,-1.7,2
05:13,500043411.0,13478.010581964316,-11.77,4
05:15,806358207.0,12239.718002636171,-4.99,7
05:25,719586818.0,17314.098907864198,-0.66,5
05:28,195895574.0,7426.659232016049,-11.62,2
05:29,264550521.0,9518.868122565043,-28.36,7
05:29,842682241.0,5460.228605518655,-12.82,4
05:29,769311479.0,7041.05544274957,-4.95,7
05:31,285220959.0,11512.466621965026,-20.42,2
05:37,116598243.0,2314.0313488188863,-24.45,7
05:39,355733816.0,4990.043989565093,-33.5,2
05:42,510101371.0,13061.166273433457,-34.04,9
05:46,699139822.0,1714.7108322587014,-42.46,8
05:49,730002588.0,12713.819989338634,-9.24,8
05:49,912705941.0,17948.196048899128,-11.4,2
05:50,558119802.0,32239.39011405252,-9.2,5
05:50,461990622.0,10351.882374213252,-49.17,5
05:51,315546581.0,27308.343233509942,-4.64,7
05:52,653640811.0,16505.453812401032,-9.08,2
05:53,581655972.0,39531.59693410655,-4.84,7
05:55,779946617.0,16522.855697645093,-63.39,2
05:56,245690309.0,9435.10929729827,-32.25,7
05:57,687135796.0,26522.66837517405,-18.35,8
06:00,851181128.0,4839.030892690852,-7.38,5
06:00,785749304.0,8423.429242302767,-13.45,9
06:05,788740658.0,3896.287175369665,-19.48,5
06:05,229205098.0,7517.857782303438,-3.34,7
06:07,108931112.0,13669.225056546671,-25.34,9
06:11,541639148.0,4896.011723161841,-4.48,7
06:14,683319988.0,7781.544829983084,-24.8,9
06:15,609939116.0,7523.578891969883,-4.85,8
06:20,647472692.0,24139.530621092825,-17.17,8
06:26,433917275.0,7608.202402396119,-16.5,7
06:28,549414742.0,7340.007126504678,-40.94,9
06:29,128033695.0,2045.4624453503416,-6.73,7
06:29,758160963.0,8177.564477461253,-7.66,2
06:32,992204045.0,12008.030670386095,-18.8,8
06:33,973086490.0,10273.596946501635,-14.2,9
06:35,534325901.0,6729.4028059142065,-8.77,5
06:39,108481285.0,8639.49450820072,-12.34,2
06:39,613729471.0,8936.247651729045,-42.86,5
06:42,108563213.0,23316.911304729987,-31.21,5
06:42,399144202.0,2594.466008204661,-31.3,9
06:45,858560423.0,12062.613784057645,-24.98,9
06:46,785749304.0,8418.086108664718,-5.34,2
06:47,683319988.0,7723.183416617901,-58.36,7
06:49,414805878.0,13268.347409014968,-39.79,9
06:51,187541224.0,2435.29000811304,-34.83,9
06:54,547010927.0,22787.57202420784,-19.0,9
06:54,899742927.0,12460.644162978322,-3.44,5
06:54,672913754.0,10708.343587719432,-6.51,5
06:56,226703987.0,1908.0071999999996,-14.89,9
07:01,985188462.0,469.1227887112247,-38.38,9
07:03,865748375.0,3733.6937181023154,-18.6,7
07:05,550169791.0,21025.432051390053,-6.11,2
07:05,822250278.0,7189.1169107517635,-5.15,7
07:06,305778936.0,11397.622481360557,-66.32,2
07:07,198946608.0,4057.1610243316823,-1.83,5
07:07,151916463.0,521.5275555991687,-28.14,9
07:07,706250160.0,11679.601015639708,-26.14,5
07:10,766941757.0,9746.241549961213,-26.69,9
07:16,570323670.0,4228.419769177775,-39.51,5
07:17,987656636.0,6070.631464037717,-50.88,2
07:18,494789005.0,3067.464825765998,-8.73,5
07:18,856147482.0,-621.9028485986248,-24.14,9
07:22,994214354.0,9853.526026211732,-8.86,2
07:24,259015404.0,1793.5245175305492,-39.85,9
07:24,322221939.0,4056.4324542842824,-36.77,5
07:39,213112754.0,6867.002969891178,-22.27,5
07:40,930277104.0,10383.030557685435,-4.05,7
07:44,322720763.0,7886.038843507357,-6.96,5
07:51,736340277.0,8655.90185592083,-16.72,7
07:54,308505160.0,14249.850239214276,-7.22,5
08:05,137822385.0,3731.996147768435,-24.94,2
08:06,510101371.0,13045.548300793324,-15.62,5
08:07,407574996.0,4795.634946871239,-2.01,8
08:10,668329719.0,8797.797627768816,-35.21,2
08:22,549414742.0,7296.19824129949,-43.81,5
08:35,655368335.0,4677.127303384687,-53.91,2
08:39,588565416.0,7492.137888410432,-0.57,2
08:48,973086490.0,10262.96883331752,-10.63,5
08:53,752362502.0,10065.289442116822,-31.06,8
08:59,851649498.0,10342.271604853637,-70.59,7
09:02,547010927.0,22768.776292867,-18.8,2
09:03,287480331.0,11129.079277710152,-14.88,7
09:07,647936800.0,619.7558161516342,-4.98,8
09:08,518474507.0,15024.610057789012,-18.5,7
09:14,215311171.0,6444.327340313616,-12.81,7
09:15,246753533.0,750.7900999999986,-46.48,4
09:21,668692488.0,2038.2934035639032,-109.97,4
09:21,836110591.0,6955.725781741444,-5.2,7
09:22,473820682.0,11287.106978818232,-118.26,2
09:22,245690309.0,9373.56954729827,-61.54,4
09:22,749378808.0,5610.758048530705,-133.69,2
09:23,187111705.0,6747.03754647574,-18.04,7
09:23,435984758.0,4533.613198748027,-26.02,1
09:24,511179916.0,6836.017141886959,-21.7,7
09:24,532478725.0,4867.072896354142,-44.88,5
09:24,179173981.0,6704.155085207675,-82.6,2
09:25,812692024.0,3744.682857948953,-19.99,4
09:26,912705941.0,17921.206048899126,-26.99,7
09:35,245690309.0,9366.48954729827,-7.08,7
09:36,547010927.0,22607.776292867,-161.0,2
09:36,749378808.0,5363.0000485307055,-247.76,2
09:37,127809299.0,1081.530253485056,-24.26,7
09:37,853907490.0,7071.120481203352,-66.55,6
09:41,421881811.0,3313.966663900447,-40.14,4
09:42,179173981.0,6422.055085207675,-282.1,2
09:44,975345315.0,34965.65854549698,-5.99,4
09:45,767447966.0,4719.4493255121115,-41.07,6
09:46,554792076.0,27001.724007461413,-60.97,5
09:48,454356905.0,2867.944461045909,-30.78,2
09:50,943829984.0,114.0504091134572,-35.0,2
09:52,151968462.0,9044.282187717032,-15.01,4
09:52,596171893.0,207.4217448255111,-20.97,7
09:53,473820682.0,11163.206978818233,-123.9,2
09:54,678330503.0,2933.9251097759384,-27.32,7
09:54,348525881.0,167.04162459493628,-9.99,7
09:54,548907062.0,82.1874887682886,-16.98,4
09:56,170637730.0,2991.680338236005,-3.67,2
09:57,534325901.0,6698.078505914206,-31.32,4
09:58,776431321.0,3466.048243370994,-13.98,1
10:00,179173981.0,6352.055085207675,-70.0,2
10:02,547010927.0,22537.776292867,-70.0,2
10:02,642015139.0,-128.44866253436174,-79.0,2
10:03,986774156.0,3818.286931625768,-32.95,7
10:06,943329213.0,1648.8477241813243,-19.05,7
10:10,143003091.0,21819.01992240584,-21.97,4
10:10,670427480.0,2197.0364500000014,-266.5,2
10:11,642015139.0,-230.94866253436177,-102.5,2
10:12,402438092.0,946.3868999999988,-97.12,2
10:12,194745206.0,643.7303720912431,-50.15,2
10:12,538003940.0,2056.4800000000087,-26.96,7
10:19,903663593.0,941.467055859541,-26.97,7
10:20,780463728.0,2904.75757094224,-31.99,2
10:20,500051919.0,1575.2545966505904,-33.95,1
10:22,618138606.0,1572.5143472714346,-35.0,2
10:23,534325901.0,6637.402505914206,-60.68,5
10:23,878989510.0,3916.4598861417903,-156.98,2
10:25,547010927.0,22350.876292866997,-186.9,2
10:25,653640811.0,16490.46381240103,-14.99,1
10:26,414454079.0,624.7278500000018,-83.28,2
10:26,116598243.0,2244.7213488188863,-69.31,2
10:28,570269025.0,2990.53983335989,-86.35,5
10:29,992204045.0,11977.034670386096,-31.0,5
10:29,887853850.0,10835.23454649475,-10.42,2
10:30,749378808.0,5139.014048530706,-223.99,2
10:32,179173981.0,6285.555085207675,-66.5,2
10:32,491392945.0,4825.675500000007,-20.43,5
10:36,480557476.0,11026.188144204463,-1.16,2
10:36,345582855.0,-15.691047179450695,-26.32,5
10:37,402438092.0,836.5418999999988,-109.84,2
10:37,925659248.0,-654.3081892295712,-152.4,5
10:38,896821055.0,-369.3051260602593,-5.73,7
10:38,355733816.0,4921.053989565094,-68.99,2
10:38,383625050.0,5917.419699330309,-133.58,5
10:39,331684336.0,-1608.8163699513211,-110.06,5
10:39,298007503.0,1556.6581036256334,-125.26,5
10:40,909676212.0,767.6989779858976,-37.59,5
10:40,145387690.0,5088.877285222662,-57.12,2
10:40,173335108.0,3678.304,-42.98,2
10:40,472995101.0,2224.0229505713655,-59.98,2
10:40,152616936.0,1174.7760078630647,-71.98,2
10:41,559995067.0,3865.6262334037033,-51.02,2
10:41,971129830.0,-2116.705649999999,-25.7,5
10:41,303843160.0,353.4265000000017,-5.99,1
10:41,547010927.0,22260.576292866997,-90.3,2
10:41,871200314.0,-76.88067575736164,-100.65,5
10:41,943829984.0,105.0804091134572,-8.97,7
10:41,642015139.0,-419.44866253436174,-188.5,2
10:42,108481285.0,8614.51450820072,-24.98,7
10:45,876890798.0,2885.772970699931,-5.99,2
10:46,822718326.0,11001.921921296396,-51.21,5
10:46,979892433.0,-1379.554700000001,-41.32,5
10:46,999752672.0,1342.3652435333345,-18.98,2
10:47,510101371.0,13037.058300793324,-8.49,4
10:48,639409800.0,34435.183576726915,-23.42,7
10:50,786879739.0,-2238.470794120557,-19.78,5
10:51,570269025.0,2945.5898333598902,-44.95,7
10:51,520447032.0,8291.286036446856,-23.63,7
10:52,792845450.0,798.0131500000011,-41.97,2
10:52,534204159.0,6198.817839823866,-2.05,4
10:53,315078351.0,7443.828458736247,-47.63,4
10:54,113747882.0,12210.880439285616,-35.94,2
10:54,631111289.0,-629.9115000000007,-20.82,5
10:55,124102251.0,3657.977062277304,-3.31,7
10:56,401293808.0,-75.07795000000084,-132.87,5
10:56,250895529.0,476.3378824692884,-116.79,5
10:58,905860285.0,10398.472398382915,-87.3,5
10:59,623156843.0,5734.373987429746,-177.98,2
11:00,450896297.0,13276.315990197756,-1.56,4
11:00,670427480.0,2090.0364500000014,-107.0,2
11:01,424397946.0,3753.604783605399,-44.0,2
11:01,987229118.0,4322.776568309697,-167.27,2
11:01,263882093.0,-1377.7588000000003,-103.07,5
11:02,749378808.0,4973.128048530705,-165.89,2
11:02,454129843.0,1629.1057715607594,-19.99,2
11:03,605116158.0,2378.0864000000015,-12.36,5
11:04,116598243.0,2141.6953488188865,-103.03,5
11:07,478412511.0,278.80777019746074,-19.99,2
11:07,315078351.0,7373.358458736247,-70.47,2
11:08,873693307.0,9847.177986993289,-55.68,5
11:09,752362502.0,9905.689442116822,-159.6,2
11:10,943829984.0,-18.419590886542807,-123.5,2
11:10,534204159.0,6143.137839823866,-55.68,2
11:12,538003940.0,2046.4900000000089,-9.99,2
11:12,364357875.0,7671.299447448547,-37.05,2
11:13,287230540.0,1079.2703470409629,-109.98,2
11:14,705848712.0,25750.546940990585,-52.27,2
11:16,987229118.0,4065.8765683096967,-256.9,2
11:18,785210466.0,2289.3786569695467,-39.98,4
11:18,781554833.0,2003.5406319437236,-40.99,2
11:18,223207876.0,863.9011000000002,-92.35,2
11:20,254853117.0,4403.661604308448,-10.0,1
11:22,652048867.0,62.94899999999899,-31.97,4
11:23,776431321.0,3456.058243370994,-9.99,4
11:23,511179916.0,6707.413141886958,-128.6,5
11:23,126929801.0,2155.639106340476,-78.0,7
11:23,558875206.0,2987.729594142862,-163.06,5
11:24,237493332.0,14192.516844043685,-34.68,5
11:24,264550521.0,9484.738122565044,-34.13,7
11:25,857997794.0,1035.7066651508871,-5.99,4
11:26,423208402.0,1191.7485500000023,-28.0,2
11:26,223207876.0,853.8711000000002,-10.03,2
11:27,179173981.0,6135.755085207675,-149.8,2
11:27,598793068.0,919.1603499999984,-61.98,2
11:28,943829984.0,-108.40959088654282,-89.99,2
11:28,531186970.0,7173.79255624362,-101.99,2
11:30,752362502.0,9877.689442116822,-28.0,2
11:31,421881811.0,3304.8466639004473,-9.12,4
11:31,749378808.0,4754.070048530705,-219.06,2
11:31,116169597.0,1020.8619499999996,-212.35,5
11:34,623156843.0,5571.938987429746,-162.44,5
11:37,315078351.0,7292.818458736247,-80.54,2
11:40,282837512.0,13655.609513080715,-30.95,7
11:40,630691258.0,32.71654487484129,-88.99,2
11:43,752362502.0,9773.389442116822,-104.3,2
11:43,859603181.0,4065.2381947545578,-32.15,2
11:46,179173981.0,5902.655085207674,-233.1,2
11:46,126929801.0,2069.350106340476,-86.29,5
11:46,887156614.0,-895.2733710407736,-44.47,5
11:48,192202372.0,536.5262062815809,-1.99,4
11:48,237684254.0,5780.713821641019,-16.32,2
11:52,558875206.0,2887.739594142862,-99.99,2
11:52,858560423.0,12025.275784057643,-37.34,5
11:52,670427480.0,2030.5364500000017,-59.5,2
11:54,250957494.0,635.0187999999988,-55.18,5
11:56,598793068.0,820.9065999999983,-98.25,5
11:58,540159353.0,11094.312368050434,-13.11,2
11:58,348325817.0,10148.0786132594,-2.16,4
11:58,914806976.0,2207.6532501854867,-15.98,1
12:00,441274121.0,12746.576849105664,-12.2,2
12:00,138609932.0,3441.005003294585,-23.94,4
12:01,403383649.0,1821.4777637323432,-17.99,1
12:01,749378808.0,4680.5980485307055,-73.47,2
12:01,626989363.0,792.6549633173752,-19.97,1
12:03,370757362.0,1711.7265898126757,-28.0,2
12:06,145387690.0,5058.297285222662,-30.58,9
12:09,718058208.0,2867.6754778984487,-2.75,7
12:11,414454079.0,602.2978500000019,-22.43,9
12:12,752362502.0,9738.389442116822,-35.0,2
12:12,987229118.0,3929.404568309697,-65.79,2
12:13,856957948.0,9411.70039333536,-19.97,4
12:14,796709231.0,-251.8642221037026,-25.18,9
12:16,736340277.0,8636.95185592083,-18.95,9
12:18,668329719.0,8701.057627768816,-96.74,5
12:18,859264768.0,271.93943378193836,-90.98,2
12:19,670427480.0,1883.0364500000017,-147.5,2
12:21,218795010.0,-983.9224500000004,-23.23,9
12:21,846550094.0,1720.0787405544086,-109.98,2
12:29,749378808.0,4559.5400485307055,-121.06,2
12:30,943829984.0,-231.3895908865428,-122.98,2
12:31,286484726.0,894.0346225793273,-28.0,2
12:31,287480331.0,11122.828747710151,-6.25,4
12:32,310375875.0,3968.636987015427,-228.2,2
12:33,540159353.0,11065.948368050436,-28.36,5
12:34,699139822.0,1678.830832258701,-35.88,9
12:34,532478725.0,4837.252896354143,-29.82,9
12:36,349614277.0,1338.0504499999995,-142.0,2
12:38,370757362.0,1611.7365898126757,-99.99,2
12:38,987229118.0,3785.218568309696,-144.19,2
12:39,987229118.0,3784.40716080866,-0.81,8
12:39,119993184.0,-2028.8069029108624,-7.56,5
12:40,179173981.0,5652.755085207675,-249.9,2
12:41,824916823.0,8753.379513906848,-6.14,4
12:41,261793952.0,366.3432602038149,-48.04,2
12:41,943829984.0,-373.8595908865428,-142.47,2
12:43,990894155.0,73.45645867884151,-82.99,2
12:44,433917275.0,7577.33240239612,-30.87,4
12:46,204855464.0,-1180.5467386396158,-109.41,5
12:46,749378808.0,4432.882048530705,-126.66,2
12:46,752362502.0,9578.089442116823,-160.3,2
12:50,252701364.0,-3585.966172677916,-11.99,5
12:51,494404688.0,-2498.888265336208,-16.63,5
12:53,237493332.0,14176.016844043685,-16.5,9
12:53,441274121.0,12726.686849105665,-19.89,9
12:54,670427480.0,1730.5364500000014,-152.5,2
12:54,572136270.0,306.0726115880232,-24.96,1
12:54,657139925.0,13635.288102934002,-5.19,5
12:55,642015139.0,-478.94866253436174,-59.5,2
12:55,706250160.0,11657.661015639707,-21.94,9
12:55,196289502.0,15467.449166194803,-27.46,4
12:56,331450202.0,7337.93927680633,-4.7,5
12:56,395284483.0,546.1203402113085,-52.06,5
12:58,993238248.0,-712.0654873928839,-197.04,5
12:59,384497904.0,626.1106499999992,-81.72,5
13:05,690523499.0,143.63120000000015,-5.0,7
13:06,585625048.0,1523.701183241531,-5.65,9
13:06,349614277.0,1251.0504499999995,-87.0,2
13:07,277562576.0,721.0682982249549,-5.1,9
13:07,982286721.0,-3330.87552401773,-40.9,5
13:08,151968462.0,8909.162187717031,-135.12,2
13:11,122884111.0,-2412.9585830729693,-29.9,5
13:12,340321732.0,1806.9628500000033,-7.6,9
13:14,812692024.0,3739.182857948953,-5.5,9
13:16,322221939.0,4048.9324542842824,-7.5,9
13:16,749378808.0,4260.010048530705,-172.87,2
13:17,179173981.0,5521.155085207674,-131.6,2
13:18,837876918.0,-2150.720291465421,-30.66,5
13:18,752362502.0,9522.789442116824,-55.3,2
13:18,374994043.0,-2192.5580500000005,-38.66,5
13:19,541639148.0,4872.471723161841,-23.54,1
13:20,642015139.0,-651.9486625343618,-173.0,2
13:20,407574996.0,4789.134946871239,-6.5,9
13:20,349614277.0,1156.0504499999995,-95.0,2
13:20,419084831.0,-195.72427552610307,-152.2,5
13:20,494156462.0,-1186.1863864817603,-142.08,5
13:22,603721739.0,1080.638899483184,-133.94,5
13:27,187111705.0,6742.33754647574,-4.7,9
13:28,703478110.0,4791.08695432897,-84.61,5
13:29,506618547.0,16980.707259159826,-50.43,6
13:29,690523499.0,-5.426799999999844,-149.06,2
13:30,179173981.0,5447.655085207674,-73.5,2
13:31,887853850.0,10812.30454649475,-22.93,9
13:31,448004226.0,2017.776560862856,-51.99,2
13:32,254853117.0,4349.255871541208,-54.41,8
13:36,873701090.0,1017.3027208676476,-33.6,5
13:39,752362502.0,9389.789442116824,-133.0,2
13:39,531186970.0,7009.50955624362,-164.28,5
13:40,586315521.0,11968.492125566632,-37.82,7
13:43,842682241.0,5356.425605518655,-103.8,5
13:46,667367404.0,9412.248184291087,-51.9,4
13:49,310375875.0,3850.336987015427,-118.3,2
13:50,131388684.0,21125.07313543233,-2.65,5
13:52,134847904.0,4073.952044386296,-16.98,4
13:52,435984758.0,4526.5991987480265,-7.01,4
13:53,417850087.0,16979.342624717832,-25.05,2
13:53,675231808.0,16484.833481391343,-16.49,4
13:55,943829984.0,-428.82959088654286,-54.97,2
13:55,690523499.0,-132.78479999999985,-127.36,2
13:56,667367404.0,9388.00252005956,-24.25,8
13:57,804317849.0,-3682.58163302052,-79.49,5
13:57,656812046.0,774.8357537325188,-70.2,2
14:03,215426302.0,-643.4895959743081,-32.16,5
14:05,417850087.0,16929.15244471783,-50.19,4
14:08,572384506.0,10873.016617577136,-11.27,4
14:11,626989363.0,747.9869133173752,-44.67,5
14:11,221868392.0,5338.971768774209,-37.27,7
14:11,943829984.0,-591.8095908865429,-162.98,2
14:14,402438092.0,747.2993999999989,-89.24,2
14:14,752362502.0,9307.189442116824,-82.6,2
14:19,310375875.0,3718.736987015427,-131.6,2
14:19,932820758.0,-2482.204066775554,-49.08,5
14:24,143061865.0,6868.651498500873,-24.98,4
14:26,214339619.0,330.9649508683563,-109.35,5
14:26,704517789.0,17026.535110801407,-111.19,2
14:27,704517789.0,17016.476484312814,-10.06,2
14:28,534583529.0,1389.5219880547652,-90.95,5
14:29,670427480.0,1527.0364500000014,-203.5,2
14:40,203466392.0,2870.9264574851672,-66.49,5
14:43,200080192.0,9308.658847037725,-52.6,5
14:43,961077907.0,78.15575000000001,-49.06,5
14:43,179173981.0,5186.555085207674,-261.1,2
14:44,449871732.0,10191.570801655227,-9.99,2
14:45,454356905.0,2826.134461045909,-41.81,9
14:46,143061865.0,6849.534046947964,-19.12,5
14:46,310375875.0,3512.9369870154273,-205.8,2
14:53,179173981.0,4959.055085207674,-227.5,2
14:54,987229118.0,3711.63516080866,-72.77,2
15:00,388862238.0,1228.825807474455,-6.99,4
15:06,987229118.0,3691.36316080866,-20.27,2
15:08,593191200.0,1407.033149999999,-31.44,5
15:12,846550094.0,1680.8328603693635,-39.25,2
15:14,670427480.0,1380.0364500000014,-147.0,2
15:14,829914501.0,936.370806570974,-9.99,7
15:14,987163717.0,6489.548480000006,-102.19,2
15:18,179173981.0,4760.955085207674,-198.1,2
15:18,821971408.0,1208.5277213748782,-10.98,7
15:21,496395938.0,12755.818467466106,-66.7,5
15:24,722971557.0,-270.2522791569244,-32.56,5
15:27,472995101.0,2167.2053505713657,-56.82,5
15:35,670427480.0,1174.0364500000014,-206.0,2
15:38,558875206.0,2862.739594142862,-25.0,2
15:39,752362502.0,9275.689442116824,-31.5,2
15:44,138609932.0,3356.0150032945853,-84.99,2
15:49,130154096.0,1403.9403820134182,-51.98,4
15:50,310375875.0,3322.5369870154273,-190.4,2
15:51,943829984.0,-746.7895908865429,-154.98,2
15:55,670427480.0,950.0364500000014,-224.0,2
16:00,857754342.0,2713.1023820993823,-31.99,2
16:04,752362502.0,9248.389442116824,-27.3,2
16:05,943829984.0,-905.7895908865428,-159.0,2
16:12,905860285.0,10297.482398382916,-100.99,2
16:22,187541224.0,2409.71000811304,-25.58,7
16:25,134847904.0,4038.952044386296,-35.0,2
16:28,752362502.0,9199.389442116824,-49.0,2
16:29,435313070.0,2818.372308622464,-184.1,2
16:30,673025413.0,4004.6915446796,-65.91,1
16:31,349614277.0,987.0504499999996,-169.0,2
16:32,846550094.0,1532.8528603693635,-147.98,2
16:32,198946608.0,4028.1410243316823,-29.02,7
16:34,943829984.0,-958.7795908865428,-52.99,2
16:39,613427466.0,6482.714956011863,-51.97,4
16:42,752362502.0,9115.389442116824,-84.0,2
16:43,435313070.0,2546.7863086224643,-271.59,2
16:43,873693307.0,9805.36798699329,-41.81,2
16:44,456246119.0,19686.769660963513,-40.97,4
16:44,670102069.0,3968.391232133419,-30.49,9
16:45,170637730.0,2919.851938236005,-71.83,4
16:57,349614277.0,915.5504499999996,-71.5,2
17:00,948558249.0,9343.76123347072,-27.99,2
17:08,475117511.0,7915.095195780393,-208.6,4
17:09,984783496.0,14279.492423182875,-11.4,5
17:23,435313070.0,2370.4003086224643,-176.39,2
17:27,690523499.0,-307.07079999999985,-174.29,2
17:31,675806859.0,6944.884346287809,-6.59,4
17:31,425964226.0,3558.4226500000022,-12.99,6
17:32,475117511.0,7714.195195780393,-200.9,7
17:47,272538745.0,15098.199900000029,-17.97,1
17:48,163470640.0,1151.9433,-46.97,4
17:54,310375875.0,3096.4369870154273,-226.1,2
17:55,435313070.0,2320.7283086224643,-49.67,2
17:56,690523499.0,-480.64279999999985,-173.57,2
18:10,256002321.0,6196.935064633519,-14.93,9
18:11,175452235.0,1372.8222500000002,-32.65,9
18:12,475117511.0,7533.595195780393,-180.6,2
18:12,587225252.0,7312.744094226143,-35.89,9
18:14,752362502.0,9006.889442116824,-108.5,2
18:16,940569402.0,6308.126566732811,-16.9,9
18:41,752362502.0,8909.589442116825,-97.3,2
18:47,414805878.0,13214.54749218235,-53.8,7
18:48,405945930.0,4655.18330688924,-10.88,7
18:55,752362502.0,8840.289442116826,-69.3,2
19:02,873693307.0,9794.36798699329,-11.0,9
19:20,687135796.0,26497.46837517405,-25.2,9
19:25,752362502.0,8684.889442116826,-155.4,2
19:31,399144202.0,2545.3542807530707,-49.11,7
19:40,305778936.0,11375.222481360555,-22.4,9
19:41,901432314.0,3789.416886746234,-45.36,7
19:59,752362502.0,8649.889442116826,-35.0,2
20:08,960208650.0,17231.422018006793,-2.35,2
20:12,885259672.0,4129.644936937089,-5.37,7
20:21,738958551.0,9123.133135877675,-28.34,9
20:34,195895574.0,7400.879232016049,-25.78,9
20:56,480198977.0,12846.433720897709,-37.42,2
21:34,749378808.0,4226.910048530704,-33.1,9
00:11,131388684.0,21122.056918316637,-3.02,8
00:12,718058208.0,2827.1005451766455,-40.57,2
00:25,880546403.0,-1396.3781500000018,-39.78,9
00:28,235881534.0,12850.65201657064,-17.15,4
00:29,887853850.0,10785.42454649475,-26.88,9
00:39,383625050.0,5888.319549783904,-29.1,5
00:41,221868392.0,5304.941768774209,-34.03,9
00:46,315078351.0,7291.67725148036,-1.14,7
00:48,910730524.0,7954.263684739065,-5.9,4
00:48,699139822.0,1678.3852892190089,-0.45,8
00:50,519644021.0,2956.828687162923,-0.92,2
00:55,705848712.0,25724.085286857902,-26.46,5
00:55,213112754.0,6817.789075889837,-49.21,5
00:55,108481285.0,8606.56445264879,-7.95,7
00:58,858989281.0,26428.95674607857,-12.25,9
01:01,639409800.0,34422.42709534272,-12.76,2
01:02,859603181.0,4050.520653682261,-14.72,2
01:09,897714622.0,8560.04078965087,-28.43,4
01:13,237684254.0,5760.508925013949,-20.2,2
01:14,633345190.0,7229.786101480143,-24.89,9
01:15,851181128.0,4818.090892690852,-20.94,9
01:17,116598243.0,2099.345060743188,-42.35,8
01:19,179173981.0,4754.392915320771,-6.56,8
01:27,815385232.0,10053.905782659454,-28.37,7
01:42,237493332.0,14171.824769486797,-4.19,2
01:42,858989281.0,26410.75221172175,-18.2,8
01:43,887853850.0,10712.348361165725,-73.08,7
01:44,315078351.0,7243.55725148036,-48.12,9
01:48,534325901.0,6624.012505914206,-13.39,9
01:52,146909202.0,5940.747752468274,-9.92,2
01:59,769311479.0,7019.47586308801,-21.58,4
02:00,668329719.0,8673.254980007558,-27.8,7
02:02,822135975.0,11066.536923050877,-17.15,2
02:09,572384506.0,10835.816617577137,-37.2,9
02:14,264550521.0,9481.846512220263,-2.89,2
02:17,315546581.0,27289.026474650927,-19.32,7
02:28,713641917.0,1148.5705352159157,-0.49,5
02:31,679662108.0,15764.400072281118,-61.05,5
02:33,256002321.0,6178.035064633519,-18.9,9
02:34,809499628.0,16571.327914677695,-10.79,9
02:48,196289502.0,15435.49721486446,-31.95,5
02:49,795847804.0,22629.213522505983,-5.19,7
02:53,842682241.0,5325.2009279082895,-31.22,2
02:56,433917275.0,7541.3824938132275,-35.95,5
02:58,899742927.0,12455.45566643614,-5.19,2
03:02,824916823.0,8729.786689125203,-23.59,4
03:05,970298834.0,3166.137213793015,-32.94,9
03:05,547010927.0,22239.886292867,-20.69,9
03:06,912705941.0,17919.117335549756,-2.09,5
03:08,824916823.0,8702.886689125204,-26.9,9
03:10,766941757.0,9720.761549961211,-25.48,9
03:14,730002588.0,12702.590645609793,-11.23,5
03:16,785749304.0,8398.888853687353,-19.2,2
03:25,938992364.0,265.0466437313995,-25.03,9
03:26,541639148.0,4816.34589850281,-56.13,5
03:28,704517789.0,16996.5270741897,-19.95,2
03:32,853907490.0,7035.701651769859,-35.42,2
03:32,120634201.0,4653.899500000007,-15.99,9
03:35,256002321.0,6129.438270587906,-48.6,4
03:37,386729293.0,30296.152291957973,-11.35,5
03:40,547010927.0,22227.92439341304,-11.96,7
03:40,229205098.0,7505.459466296037,-12.4,5
03:41,414805878.0,13174.39749218235,-40.15,9
03:42,985188462.0,429.9827887112247,-39.14,9
03:44,348325817.0,10114.2086132594,-33.87,9
03:44,383833857.0,24044.40159209983,-22.51,5
03:45,851649498.0,10311.034425896289,-8.23,2
03:45,473820682.0,11161.743304742064,-1.46,8
03:46,667367404.0,9357.140955797837,-30.86,7
03:51,874431242.0,8391.930569197464,-28.9,9
03:53,886921642.0,3469.6035997933277,-19.73,2
03:58,287480331.0,11083.608747710154,-39.22,9
03:59,419550103.0,18746.88670805983,-6.25,5
04:03,779236304.0,955.1475954795324,-36.7,9
04:05,706250160.0,11646.0630741008,-11.6,8
04:06,290818242.0,7058.7552023859635,-32.38,5
04:11,651756497.0,13417.530648592376,-11.22,2
04:12,399144202.0,2528.4142807530707,-16.94,9
04:13,414805878.0,13152.239755452923,-22.16,7
04:37,678851253.0,3484.905562224466,-14.35,5
04:40,549414742.0,7262.258241299491,-33.94,9
04:43,657139925.0,13624.263143136855,-11.02,2
04:46,187111705.0,6732.1680250689,-10.17,7
04:50,992204045.0,6043.721075210318,-63.31,2
04:59,252760664.0,6903.296739977549,-3.99,2
05:00,196289502.0,15422.14721486446,-13.35,9
05:01,558119802.0,32218.49011405252,-20.9,9
05:03,496395938.0,12722.034813689304,-33.78,7
05:05,366550080.0,25523.8478179504,-1.41,2
05:08,678330503.0,2901.91067242819,-32.01,2
05:20,604288474.0,2606.649945349259,-52.49,7
05:25,282837512.0,13652.154886627508,-3.45,5
05:25,802697323.0,15511.140614083057,-29.17,9
05:27,417850087.0,16915.544631973124,-13.61,2
05:28,809499628.0,16563.07624745635,-8.25,2
05:33,169006407.0,11730.65940392961,-7.78,7
05:35,259015404.0,1766.6445175305491,-26.88,9
05:36,450896297.0,13243.135990197756,-33.18,9
05:41,836110591.0,6952.69544994739,-3.03,7
05:44,905860285.0,10278.84599151444,-18.64,8
05:47,187541224.0,2367.43000811304,-42.28,9
05:48,134847904.0,4002.422044386295,-36.53,9
05:49,687135796.0,26481.818375174047,-15.65,9
05:51,613729471.0,8929.337705504064,-6.91,7
06:00,145387690.0,5056.5036073342935,-1.79,7
06:07,322221939.0,4047.6434978209018,-1.29,2
06:07,108931112.0,13628.975056546671,-40.25,9
06:09,683319988.0,7691.9634166179,-31.22,9
06:13,779946617.0,16513.696782720508,-9.16,7
06:17,108563213.0,23247.457521773464,-69.45,4
06:17,885259672.0,4095.4619068730926,-34.18,7
06:19,534325901.0,6619.168784301648,-4.84,7
06:19,408057540.0,4251.072248799229,-6.83,2
06:20,324224854.0,3048.050235231113,-14.88,2
06:20,822250278.0,7168.42059649105,-20.7,7
06:20,994214354.0,9820.496026211733,-33.03,9
06:20,687135796.0,26456.913534209903,-24.9,5
06:21,270374623.0,10137.3034783502,-44.68,5
06:23,558119802.0,32205.850588330868,-12.64,7
06:25,259015404.0,1705.5789536531076,-61.07,7
06:26,940569402.0,6283.676566732811,-24.45,9
06:29,195895574.0,7389.564361819847,-11.31,2
06:37,506618547.0,16979.942405398517,-0.76,5
06:38,489964679.0,20325.702247169753,-40.14,9
06:39,510101371.0,13001.318300793324,-35.74,9
06:39,480557476.0,10989.563806143527,-36.62,7
06:40,683319988.0,7690.530626852315,-1.43,5
06:42,647472692.0,24105.850621092824,-33.68,9
06:42,709608057.0,3078.7316013299696,-34.47,9
06:47,653640811.0,16458.407072762606,-32.06,7
06:49,532478725.0,4829.53250280422,-7.72,7
06:58,758160963.0,8158.417656347292,-19.15,5
07:00,609939116.0,7515.923148062809,-7.66,2
07:02,806358207.0,12231.251559849768,-8.47,5
07:04,940569402.0,6218.771707753858,-64.9,2
07:07,581655972.0,39511.78761512086,-19.81,7
07:08,550169791.0,20997.366262634252,-28.07,7
07:09,776108637.0,1009.3125536574958,-6.0,9
07:12,198946608.0,3996.742640735165,-31.4,5
07:12,520447032.0,8283.986695936266,-7.3,2
07:14,183888402.0,17956.80587751356,-46.98,9
07:18,675806859.0,6944.047087463667,-0.84,2
07:23,461990622.0,10335.5406216533,-16.34,8
07:30,873693307.0,9771.766853083933,-22.6,7
07:33,964702094.0,1951.8167876402888,-3.11,7
07:33,407574996.0,4787.6573507322855,-1.48,2
07:38,973086490.0,10201.854954163837,-61.11,5
07:39,647472692.0,24046.0513075824,-59.8,2
07:43,331450202.0,7314.716471490463,-23.22,5
07:44,719586818.0,17281.01842369717,-33.08,2
07:44,973086490.0,10189.874954163835,-11.98,9
07:48,930277104.0,10357.98338368908,-25.05,8
07:55,454129843.0,1622.0057715607595,-7.1,9
07:58,821971408.0,1142.5031534046047,-66.02,4
08:00,380228542.0,-298.0130581844345,-6.9,9
08:00,482513594.0,5906.476864454149,-0.64,2
08:01,585133606.0,4618.570429410899,-5.65,7
08:06,128033695.0,2015.3951350286345,-30.07,7
08:08,673025413.0,3988.928810830971,-15.76,5
08:09,241459011.0,913.2668132723472,-5.5,9
08:13,216285378.0,23258.68938463492,-43.68,9
08:15,558875206.0,2862.5793108989515,-0.16,7
08:20,308505160.0,14220.30413895832,-29.55,7
08:22,264550521.0,9435.499512220264,-46.35,5
08:23,474301748.0,-2144.479005683968,-7.56,5
08:24,478412511.0,273.4577701974607,-5.35,9
08:27,987656636.0,6056.457689259523,-14.17,7
08:29,654329190.0,-24.949399051480697,-56.82,5
08:29,749371623.0,-2548.7541535173427,-16.34,5
08:29,344522228.0,-2793.504488208393,-8.69,5
08:29,818552503.0,194.8942999999989,-126.7,5
08:30,344843570.0,-141.0393175093338,-14.24,5
08:30,522188082.0,8012.469219322102,-19.37,7
08:34,712474734.0,-1902.471831236004,-23.43,5
08:37,421475159.0,-387.47473732558745,-56.24,5
08:39,812692024.0,3644.0808579489526,-95.1,5
08:40,766692943.0,-1943.82925,-46.99,5
08:40,407323346.0,-2458.4254325553125,-40.3,5
08:41,435984758.0,4494.721198748027,-31.88,5
08:41,979122276.0,-922.3490377056712,-41.58,5
08:41,799453072.0,-364.7069000000011,-151.24,5
08:43,941285623.0,-176.53660093322975,-76.4,5
08:44,215311171.0,6412.218340313616,-32.11,5
08:44,621181115.0,-174.48624957077112,-96.45,5
08:44,993039226.0,-4119.064499999994,-63.92,5
08:44,491392945.0,4810.275500000007,-15.4,5
08:44,446720287.0,-114.67520918159444,-107.17,5
08:44,749378808.0,4214.195667477271,-12.71,8
08:47,370521542.0,25443.282614385316,-157.33,5
08:48,519935524.0,67.28490973751903,-13.39,5
08:49,857997794.0,976.6966651508872,-59.01,5
08:51,871866387.0,-181.56870000000072,-43.96,5
08:53,170637730.0,2828.249938236005,-91.6,5
08:54,270374623.0,10063.6074783502,-73.7,5
08:54,535804582.0,-1361.739250000001,-66.15,5
08:54,656389634.0,-2953.154340421986,-21.5,5
08:54,180616589.0,854.9747092146952,-60.73,5
08:55,285220959.0,11485.012041616954,-27.45,5
08:55,138969884.0,803.2898999999994,-120.34,5
08:55,898104045.0,-1610.743050000002,-146.27,5
08:56,285115279.0,-3022.4383607892873,-119.0,5
08:56,651372390.0,-3467.528249999999,-58.8,5
08:57,969804197.0,-330.3837500000007,-22.48,5
08:57,696758548.0,-3342.8003963201368,-49.72,5
09:00,290818242.0,7052.955202385963,-5.8,9
09:00,317161035.0,-3509.3400999999967,-97.34,5
09:01,971010829.0,217.3250564442453,-69.35,5
09:01,170637730.0,2824.169550367477,-4.08,7
09:01,624563756.0,-274.01657121644365,-5.6,9
09:02,964702094.0,1801.6930376402888,-150.12,5
09:02,962295212.0,-2073.655149999997,-107.95,5
09:03,449871732.0,10126.722801655227,-64.85,5
09:03,691789577.0,-760.9200000000001,-269.44,5
09:04,402438092.0,652.8294999999988,-94.47,5
09:04,715068825.0,-579.2930000000002,-105.33,5
09:05,851649498.0,10303.23442589629,-7.8,9
09:06,657528784.0,-25.268099999999308,-128.2,5
09:06,856147482.0,-744.6551985986248,-122.75,5
09:07,429556122.0,6176.892750000004,-50.59,5
09:07,700138124.0,5412.512208449118,-49.81,2
09:08,912584712.0,565.0296195447331,-63.8,5
09:08,690958123.0,20031.65843844166,-6.5,9
09:08,659008214.0,-3251.1026022904234,-62.23,5
09:09,248658670.0,-950.3033499999998,-12.2,5
09:09,554792076.0,26965.688007461413,-36.04,5
09:09,117308635.0,1004.67803700537,-51.33,5
09:12,666952234.0,-294.8367518755131,-79.7,5
09:12,999752672.0,1337.2652435333346,-5.1,9
09:12,554792076.0,26954.718460449378,-10.97,5
09:13,540159353.0,11060.548368050437,-5.4,9
09:14,899692478.0,-1761.4391435240072,-110.74,5
09:15,160166876.0,896.3900405862437,-45.43,5
09:16,383833857.0,24012.641592099833,-31.76,1
09:17,683319988.0,7682.730626852314,-7.8,9
09:18,280098744.0,582.9443778716657,-76.97,4
09:19,217540156.0,-3367.7273199999945,-42.4,5
09:20,586315521.0,11962.892125566632,-5.6,9
09:20,214765415.0,1019.6889011498648,-22.0,2
09:20,711045550.0,4324.608350000003,-81.99,2
09:21,506618547.0,16975.592405398518,-4.35,9
09:21,127809299.0,1071.540253485056,-9.99,2
09:21,417850087.0,16909.894631973122,-5.65,9
09:22,469330905.0,128.53006802921553,-94.97,2
09:22,117273481.0,9274.884917595087,-5.8,9
09:24,446720287.0,-213.65520918159444,-98.98,2
09:24,558875206.0,2856.5293108989513,-6.05,9
09:24,948558249.0,9303.25223347072,-40.51,5
09:25,984783496.0,14276.111473895307,-3.38,7
09:25,279149837.0,1619.1900499999986,-4.99,1
09:26,214339619.0,323.3649508683563,-7.6,9
09:26,916270283.0,2107.0582499999996,-88.75,5
09:28,550644516.0,-139.41020000000137,-88.04,5
09:28,494977194.0,755.1271205975781,-52.5,2
09:29,441274121.0,12720.886849105666,-5.8,9
09:29,128030172.0,-525.66957744985,-57.56,5
09:30,151916463.0,471.48755559916873,-50.04,2
09:31,364357875.0,7665.538779632044,-5.76,7
09:31,625658193.0,66.13837975621678,-22.02,4
09:31,895331556.0,-597.4493000000008,-49.05,5
09:32,762859681.0,476.7375999999989,-23.96,7
09:33,551755686.0,6554.6306558506485,-17.97,4
09:33,407574996.0,4670.057350732285,-117.6,2
09:33,446720287.0,-251.64520918159445,-37.99,2
09:34,175452235.0,1272.0322500000002,-100.79,2
09:34,473820682.0,11082.653304742063,-79.09,2
09:35,556992209.0,11553.99892812764,-8.0,4
09:36,828532554.0,321.3031013660719,-82.99,2
09:39,370521542.0,25385.84633022816,-57.44,7
09:39,930277104.0,10309.90338368908,-48.08,2
09:41,948558249.0,9282.978823414463,-20.27,7
09:42,603375739.0,1162.381063023267,-25.96,7
09:43,757115616.0,2253.9000000000037,-9.99,7
09:45,984783496.0,14242.141473895308,-33.97,1
09:46,868014990.0,-3261.221099999997,-52.16,5
09:47,595800644.0,-918.9550500000004,-84.13,5
09:47,478651121.0,-221.0493704015302,-144.14,5
09:48,779376323.0,2786.63376665494,-75.01,5
09:49,973388795.0,1565.7876761636217,-35.03,2
09:50,310620484.0,201.0171950921983,-53.28,5
09:50,386277162.0,417.0099999999994,-22.97,7
09:51,792845450.0,778.0231500000011,-19.99,4
09:53,886921642.0,3449.5135997933276,-20.09,2
09:54,454356905.0,2820.0461410459093,-6.09,4
09:54,305778936.0,11146.322481360556,-228.9,4
09:56,299871610.0,389.0331530587666,-20.3,5
09:57,527842638.0,1689.3193926329836,-76.98,2
09:58,849096144.0,2401.818020751341,-41.3,2
09:59,767447966.0,4682.335245512111,-37.11,4
10:00,613427466.0,6460.744956011863,-21.97,7
10:02,903953091.0,3368.1860389956637,-6.8,9
10:02,475117511.0,7499.625195780392,-33.97,4
10:05,407574996.0,4369.757350732285,-300.3,2
10:05,587225252.0,7229.444094226143,-83.3,7
10:06,812012103.0,-421.4593000000005,-123.75,2
10:08,575652395.0,3365.503319761828,-30.11,4
10:13,596171893.0,202.4317448255111,-4.99,1
10:13,527842638.0,1657.8293926329836,-31.49,4
10:17,535744551.0,1148.1624659956262,-48.49,2
10:18,849096144.0,2361.232020751341,-40.59,2
10:18,252760664.0,6837.118739977549,-66.18,5
10:18,151278285.0,-815.8973500000004,-112.52,5
10:19,587225252.0,7159.444094226143,-70.0,4
10:19,522188082.0,7841.149219322102,-171.32,4
10:19,305778936.0,11095.936481360555,-50.39,7
10:20,904154012.0,1165.9974581204322,-34.96,7
10:20,305778936.0,11094.533734637544,-1.4,5
10:21,399144202.0,2479.0718758250405,-49.34,7
10:23,924045955.0,1565.8700126586646,-51.41,5
10:24,475117511.0,7444.038195780393,-55.59,5
10:25,280200287.0,-1210.720453386949,-48.12,5
10:26,812012103.0,-502.8343000000005,-81.38,2
10:27,414454079.0,599.2578500000019,-3.04,4
10:27,310620484.0,169.84719509219832,-31.17,7
10:29,572384506.0,10796.416617577135,-39.4,2
10:30,663479159.0,5351.414541827709,-5.99,7
10:31,479456865.0,1578.417331489405,-281.95,5
10:32,873701090.0,969.3799111811284,-47.92,4
10:33,407574996.0,4125.457350732285,-244.3,2
10:34,960208650.0,17117.140018006794,-114.28,5
10:38,964702094.0,1759.7230376402888,-41.97,2
10:39,924045955.0,1529.8500126586646,-36.02,2
10:42,987656636.0,6006.117689259523,-50.34,2
10:44,133755851.0,862.8535416180115,-34.98,4
10:46,865748375.0,3719.951299927233,-13.74,4
10:47,479456865.0,1563.4473314894049,-14.97,4
10:47,550832673.0,3321.8731344744074,-66.99,2
10:48,572384506.0,10735.293181449042,-61.12,7
10:48,305778936.0,10964.347734637546,-130.19,7
10:49,587225252.0,6918.644094226142,-240.8,7
10:49,214765415.0,951.7189011498648,-67.97,2
10:49,414454079.0,548.4778500000019,-50.78,2
10:51,834383043.0,5513.264932435833,-49.99,4
10:51,228136274.0,1941.2608999999993,-35.0,2
10:55,475117511.0,7406.048195780393,-37.99,2
10:56,534204159.0,6125.957764942402,-17.18,5
10:56,849096144.0,2314.2820207513414,-46.95,7
10:59,272538745.0,15068.209900000027,-29.99,2
11:01,741903302.0,2167.966558740787,-71.48,4
11:02,290751280.0,343.0806966748256,-71.97,2
11:03,133755851.0,824.8635416180115,-37.99,2
11:06,550832673.0,3262.9631344744075,-58.91,1
11:09,305778936.0,10864.961734637543,-99.39,4
11:10,522188082.0,7831.099159322102,-10.05,4
11:11,549414742.0,7247.816897821136,-14.44,8
11:11,812012103.0,-581.5843000000004,-78.75,2
11:13,821971408.0,1026.5331534046047,-115.97,2
11:15,587225252.0,6849.344094226142,-69.3,4
11:18,727417797.0,5394.419500000011,-3.49,4
11:19,984783496.0,14102.971473895308,-139.17,2
11:25,467207141.0,486.4115670482637,-43.43,5
11:25,685959099.0,953.5268660992422,-49.99,2
11:26,494789005.0,2982.396347095092,-85.07,7
11:28,535744551.0,1035.7024659956262,-112.46,2
11:29,494977194.0,719.8771205975781,-35.25,2
11:32,214765415.0,878.7389011498647,-72.98,2
11:35,766812921.0,-89.81310000000066,-7.49,4
11:38,305778936.0,10674.575734637545,-190.39,4
11:45,812012103.0,-745.8343000000004,-164.25,2
11:45,696333897.0,487.001299999999,-107.0,2
11:51,407574996.0,3946.957350732285,-178.5,2
11:53,216286013.0,17.542806653940005,-30.0,2
11:55,741903302.0,2158.966558740787,-9.0,4
11:55,598793068.0,815.4065999999983,-5.5,4
11:56,214765415.0,788.7489011498647,-89.99,2
11:57,535744551.0,876.2124659956262,-159.49,2
12:01,886921642.0,3414.9895997933277,-34.52,5
12:01,475117511.0,7401.942771384517,-4.11,2
12:04,600585971.0,286.32654999999954,-39.9,9
12:04,812012103.0,-827.9593000000004,-82.12,2
12:06,587225252.0,6773.044094226142,-76.3,7
12:07,782013626.0,1472.5721993116283,-87.7,5
12:09,849096144.0,2217.6820207513415,-96.6,7
12:13,535744551.0,814.2124659956262,-62.0,2
12:20,480198977.0,12790.513720897708,-55.92,7
12:23,587225252.0,6543.444094226142,-229.6,4
12:23,305778936.0,10610.889734637543,-63.69,4
12:24,655368335.0,4585.057303384688,-92.07,2
12:24,407574996.0,3723.6573507322846,-223.3,2
12:28,815993333.0,6326.6856390614075,-6.0,1
12:28,128033695.0,1974.1151350286343,-41.28,9
12:28,849096144.0,2024.4820207513417,-193.2,4
12:32,259015404.0,1678.4889536531075,-27.09,7
12:35,670102069.0,3930.0207791574626,-38.37,8
12:35,535744551.0,791.2424659956262,-22.97,7
12:36,145387690.0,5026.523607334294,-29.98,9
12:37,588565416.0,7486.474436863777,-5.66,7
12:39,610450243.0,-866.2846,-7.39,5
12:45,572333122.0,-3516.2150499999966,-31.48,5
12:46,215311171.0,6374.228340313616,-37.99,2
12:47,551755686.0,6548.640655850649,-5.99,2
12:48,197050303.0,309.1894325634951,-22.0,2
12:49,535744551.0,778.2624659956261,-12.98,2
12:49,661295096.0,3254.225839904151,-77.91,5
12:50,189335192.0,-1019.0936517578602,-69.37,5
12:50,973388795.0,1560.7976761636216,-4.99,7
12:54,191992682.0,-2635.6464602920632,-70.59,5
12:55,670102069.0,3891.8307791574625,-38.19,9
12:57,655368335.0,4474.9673033846875,-110.09,2
12:58,849096144.0,2009.4920207513417,-14.99,4
13:05,703537476.0,701.1232499999991,-58.04,2
13:05,298000165.0,24904.092391718063,-29.99,4
13:06,849096144.0,2001.9920207513417,-7.5,9
13:07,518378868.0,-1380.1404000000002,-68.39,5
13:07,407574996.0,3521.3573507322844,-202.3,2
13:11,570410059.0,1963.4467467763104,-78.49,2
13:15,587225252.0,6266.244094226142,-277.2,4
13:16,494977194.0,550.3771205975781,-169.5,2
13:17,766941757.0,9712.926235060098,-7.84,7
13:17,688712152.0,6231.305044430708,-6.8,9
13:20,407574996.0,3244.8573507322844,-276.5,2
13:21,285873880.0,11425.289676210512,-13.53,7
13:26,738958551.0,9115.29940781939,-7.83,7
13:27,535744551.0,715.2724659956261,-62.99,2
13:29,812012103.0,-1000.4593000000004,-172.5,2
13:32,916270283.0,2072.0582499999996,-35.0,2
13:35,766812921.0,-299.58735000000064,-209.77,5
13:37,248142083.0,-333.69756529748327,-142.13,5
13:38,138351025.0,-997.8851500000004,-102.44,5
13:39,494977194.0,386.50212059757814,-163.88,2
13:41,587225252.0,5983.444094226142,-282.8,7
13:42,228136274.0,1914.3008999999993,-26.96,7
13:45,679943657.0,5348.2488724681325,-64.58,2
13:46,479456865.0,1424.4473314894049,-139.0,2
13:47,407574996.0,3113.2573507322845,-131.6,2
13:47,570410059.0,1839.4567467763104,-123.99,2
13:48,555804115.0,-1321.103547558703,-18.68,5
13:50,834383043.0,5489.304932435833,-23.96,7
13:51,812012103.0,-1064.2093000000004,-63.75,2
13:51,857455726.0,-1725.9396641243156,-226.01,5
13:54,339791565.0,-3498.156199999997,-57.69,5
13:55,520447032.0,8267.786695936265,-16.2,2
14:02,358836279.0,343.57219280758585,-51.05,5
14:08,587225252.0,5846.944094226142,-136.5,7
14:08,228136274.0,1844.4408999999991,-69.86,4
14:10,407574996.0,2994.9573507322843,-118.3,2
14:17,856957948.0,9403.781187619512,-7.92,5
14:21,479456865.0,1230.9473314894049,-193.5,2
14:21,605711527.0,-165.0664861674164,-116.91,5
14:32,414454079.0,546.4578500000019,-2.02,4
14:33,901432314.0,3776.216886746234,-13.2,9
14:41,891513205.0,591.9149796590691,-168.64,5
14:46,945054126.0,-304.5419,-22.08,5
14:47,703537476.0,575.879249999999,-125.24,5
14:47,587225252.0,5685.944094226142,-161.0,7
14:49,407574996.0,2855.657350732284,-139.3,2
14:50,282046994.0,-263.45264999999966,-36.12,9
14:56,587225252.0,5494.844094226141,-191.1,7
14:56,822250278.0,7151.72059649105,-16.7,9
14:58,279149837.0,1599.2100499999983,-19.98,1
15:01,828750680.0,1731.47454521368,-29.99,2
15:11,392270893.0,12437.686998978566,-7.29,7
15:11,441142605.0,2327.4090000000056,-5.5,4
15:14,587225252.0,5328.244094226141,-166.6,4
15:16,812012103.0,-1137.3343000000004,-73.12,2
15:17,960208650.0,17099.600396685782,-17.54,2
15:21,305778936.0,10527.603734637543,-83.29,4
15:22,901432314.0,3734.2904151099824,-41.93,5
15:35,409971170.0,2766.6426413800054,-6.2,2
15:37,964913066.0,-2230.9546999999993,-27.13,5
15:39,198946608.0,3940.652640735165,-56.09,2
15:47,120634201.0,4638.889500000007,-15.01,4
15:49,479456865.0,1192.9573314894049,-37.99,2
15:49,901037631.0,376.53932309640714,-17.43,5
15:52,398429109.0,993.0750500000012,-54.93,7
15:53,352899149.0,578.6750499999988,-6.99,4
15:54,494977194.0,266.12712059757814,-120.38,2
16:14,494977194.0,174.25212059757814,-91.88,2
16:15,407574996.0,2724.057350732284,-131.6,2
16:15,151916463.0,382.74155559916875,-88.75,5
16:17,492215823.0,2456.989333815444,-22.23,9
16:17,215311171.0,6361.238340313616,-12.99,2
16:21,709608057.0,3045.3260705270245,-33.41,7
16:25,838830098.0,843.8071420877843,-9.99,7
16:26,632065391.0,-2421.1836499999995,-66.31,5
16:26,303843160.0,346.4365000000017,-6.99,4
16:28,625281433.0,-739.0447573707568,-123.73,5
16:30,696333897.0,290.501299999999,-196.5,2
16:32,183186021.0,-260.91004999999893,-35.5,5
16:33,885259672.0,3983.3819068730927,-112.08,2
16:33,914806976.0,242.66325018548673,-54.99,2
16:35,641764023.0,-1190.9988037720043,-39.02,5
16:36,796709231.0,-322.6069221037026,-70.74,5
16:36,807714284.0,1073.094460736,-38.68,5
16:39,535744551.0,576.3024659956261,-138.97,2
16:39,297823329.0,764.1336999999992,-74.98,2
16:43,516051449.0,1767.673038940098,-71.48,4
16:43,779376323.0,2756.6437666549405,-29.99,6
17:03,386277162.0,402.0199999999994,-14.99,4
17:09,605116158.0,2362.9510000000014,-15.14,5
17:09,535744551.0,447.8324659956261,-128.47,2
17:10,494977194.0,48.25212059757814,-126.0,2
17:13,955035930.0,1535.813479171477,-1.99,4
17:13,683078800.0,1895.8110413499592,-32.96,7
17:14,305778936.0,10320.459734637545,-207.14,4
17:14,598793068.0,799.4265999999983,-15.98,4
17:15,448279144.0,1089.3323499999992,-9.99,4
17:16,885259672.0,3981.880406873093,-1.5,4
17:16,987163717.0,6451.828480000006,-37.72,9
17:16,551196328.0,3885.638133942313,-81.21,5
17:18,435984758.0,4491.478524184153,-3.24,2
17:19,949032480.0,4781.9223451463995,-20.19,9
17:21,736310094.0,-758.931124027426,-84.27,5
17:23,198051483.0,-1262.3919104088568,-31.18,5
17:23,213112754.0,6798.099075889837,-19.69,7
17:25,121858569.0,1627.5311500000023,-69.06,5
17:25,851181128.0,4805.835758471703,-12.26,7
17:26,860360312.0,-7.677591117319651,-66.99,2
17:27,322720763.0,7696.366843507358,-189.67,2
17:27,832564361.0,15708.121976670316,-41.04,2
17:27,494977194.0,10.75212059757814,-37.5,2
17:30,758160963.0,8097.713656347292,-60.7,5
17:31,647936800.0,390.91181615163424,-228.84,2
17:31,586315521.0,11958.016925077229,-4.88,5
17:31,518474507.0,14964.190057789012,-60.42,2
17:32,705848712.0,25684.3452868579,-39.74,2
17:32,812012103.0,-1211.9593000000004,-74.62,2
17:33,496395938.0,12706.024813689302,-16.01,7
17:34,534097839.0,-3515.833549999998,-19.18,5
17:34,355602925.0,1619.3179695597523,-44.99,2
17:35,235881534.0,12819.621016570638,-31.03,4
17:35,700138124.0,5380.4622084491175,-32.05,2
17:36,897592348.0,14827.85598632199,-182.0,2
17:36,532478725.0,4796.1025028042195,-33.43,9
17:36,752362502.0,8631.451442116826,-18.44,5
17:38,358846516.0,777.3790725272179,-28.0,2
17:38,518474507.0,14963.413460116271,-0.78,7
17:38,660874296.0,2406.017449960847,-79.97,4
17:41,450896297.0,13236.173922504611,-6.96,5
17:41,873693307.0,9758.326853083932,-13.44,9
17:42,824916823.0,8682.436689125203,-20.45,2
17:42,551196328.0,3859.27041862956,-26.37,7
17:42,954263768.0,-188.11660000000023,-52.06,5
17:42,500043411.0,13403.474581964316,-74.54,5
17:42,678330503.0,2794.28567242819,-107.62,5
17:43,355602925.0,1584.3179695597523,-35.0,2
17:44,203466392.0,2855.7521917617696,-15.17,2
17:44,407574996.0,2577.757350732284,-146.3,2
17:47,603721739.0,1024.638899483184,-56.0,2
17:47,423208402.0,1163.7485500000023,-28.0,2
17:48,480198977.0,12784.523720897709,-5.99,4
17:49,857754342.0,2604.1354820993824,-108.97,5
17:51,137913631.0,1520.4896499999998,-123.95,5
17:52,812012103.0,-1288.4593000000004,-76.5,2
17:53,500043411.0,13397.693315153354,-5.78,7
17:53,996042490.0,5718.681696170786,-11.97,4
17:55,511179916.0,6692.15500204187,-15.26,7
17:57,117273481.0,9263.90491759509,-10.98,7
17:57,147474476.0,4531.641165119361,-27.96,7
17:57,196289502.0,15388.57721486446,-33.57,2
17:57,558875206.0,2827.3093108989515,-29.22,9
17:58,518474507.0,14928.273460116272,-35.14,9
18:01,975200042.0,-2954.0426999999972,-28.19,9
18:01,656812046.0,637.6007537325188,-137.23,5
18:04,558119802.0,32156.96258833087,-48.89,5
18:04,749378808.0,4179.095667477271,-35.1,9
18:08,494977194.0,-56.74787940242186,-67.5,2
18:09,699139822.0,1649.615289219009,-28.77,9
18:09,113747882.0,12177.950439285614,-32.93,9
18:09,322720763.0,7622.894843507358,-73.47,2
18:10,897592348.0,14606.65598632199,-221.2,2
18:12,454129843.0,1470.0865215607596,-151.92,5
18:14,355602925.0,1529.8179695597523,-54.5,2
18:15,647936800.0,183.72581615163423,-207.19,2
18:24,743630833.0,211.8796632847012,-40.18,9
18:24,833899961.0,2593.939972838992,-28.68,9
18:27,246753533.0,693.6399999999986,-57.15,5
18:30,624500124.0,3606.786909926694,-2.55,7
18:31,348525881.0,111.46662459493628,-55.57,5
18:31,574548998.0,-138.67180000000076,-138.37,5
18:32,151968462.0,8840.813937210109,-68.35,2
18:33,601627384.0,4731.528391100799,-34.66,9
18:33,873701090.0,951.4899111811284,-17.89,9
18:33,466649401.0,515.9719113978914,-31.96,7
18:35,956717493.0,1239.0017776068375,-31.49,7
18:35,701070224.0,-626.7035999999999,-254.34,5
18:38,146909202.0,5875.547752468274,-65.2,4
18:41,221868392.0,5262.025550922073,-42.92,2
18:42,647936800.0,-46.56018384836577,-230.29,2
18:43,173335108.0,3661.324,-16.98,7
18:43,158414827.0,-1725.6800000000014,-26.06,5
18:44,845648250.0,253.93964999999943,-41.02,5
18:45,624563756.0,-287.95497121644365,-13.94,5
18:45,854513972.0,1234.39305,-121.44,5
18:47,213096759.0,-1368.5241082144396,-56.82,5
18:51,456221621.0,697.3875673026281,-63.0,5
18:54,202320275.0,-697.3420000000004,-107.69,5
18:55,651756497.0,13385.450648592376,-32.08,9
18:58,426474982.0,-3590.85475,-17.32,5
19:00,225210798.0,990.3937737592088,-75.97,7
19:04,280268430.0,4847.239287989451,-29.02,5
19:04,801500539.0,-3148.596199999999,-83.94,5
19:06,456221621.0,679.0875673026281,-18.3,9
19:06,752362502.0,8605.871848108167,-25.58,5
19:08,836110591.0,6923.84544994739,-28.85,9
19:08,345514953.0,-1893.3553000000009,-104.31,5
19:10,352291960.0,2832.3530533035732,-46.81,5
19:11,682194230.0,-2241.6483499999995,-53.9,5
19:12,858989281.0,26331.834211721747,-78.92,5
19:16,679662108.0,15739.510072281118,-24.89,9
19:16,989506909.0,-2434.274870759438,-49.66,5
19:20,187111705.0,6695.6560250689,-36.51,5
19:21,370521542.0,25375.86633022816,-9.98,9
19:26,630468201.0,-574.9828838897017,-50.41,5
19:27,817294757.0,-2597.8083,-57.49,5
19:28,719586818.0,17191.369423697168,-89.65,5
19:32,146909202.0,5853.6177524682735,-21.93,9
19:33,183888402.0,17926.92603847381,-29.88,7
19:35,290818242.0,6991.663202385963,-61.29,5
19:36,705848712.0,25671.3552868579,-12.99,9
19:41,891716230.0,542.158453688078,-146.91,5
19:44,482513594.0,5891.176864454149,-15.3,9
19:45,601627384.0,4731.092568257891,-0.44,7
19:46,296770890.0,1906.058010379083,-121.04,5
19:49,366550080.0,25456.5638179504,-67.28,5
19:53,736340277.0,8599.36185592083,-37.59,5
19:54,775790822.0,-3001.863419216068,-22.92,5
20:06,124102251.0,3647.131139471339,-10.85,7
20:09,559995067.0,3806.2939749431785,-59.33,7
20:09,285428103.0,9347.80949118738,-17.17,2
20:14,815385232.0,9940.351782659454,-113.55,5
20:16,214765415.0,700.2906011498646,-88.46,5
20:18,950234174.0,1135.3560599724933,-114.7,5
20:19,570323670.0,4213.789369987329,-14.63,5
20:23,287480331.0,11040.738251492538,-42.87,8
20:23,310375875.0,3066.5069870154275,-29.93,9
20:26,517190750.0,1595.3635899154126,-36.64,5
20:30,390747457.0,396.3691999999981,-77.65,5
20:36,653640811.0,16412.690072762605,-45.72,5
20:38,520239952.0,-1438.5307766547633,-128.36,5
20:45,659415300.0,3219.402540250704,-105.68,5
20:54,675231808.0,16473.962022288728,-10.87,4
20:54,822135975.0,10977.832923050875,-88.7,5
20:54,106601471.0,10264.521624976329,-8.53,8
20:56,720221651.0,-2356.7288665984343,-46.17,5
20:56,192202372.0,535.8269338887978,-0.7,7
21:02,956717493.0,1233.1368610230716,-5.86,5
00:32,899742927.0,12446.41289140115,-9.04,2
01:03,407574996.0,2572.7706228450593,-4.99,8
01:09,973086490.0,10174.619186504931,-15.26,2
01:28,550832673.0,3244.9231344744076,-18.04,9
01:41,588565416.0,7477.960204816498,-8.51,2
01:41,613729471.0,8886.676904545306,-42.66,5
02:25,709608057.0,3006.9960705270246,-38.33,9
02:38,853907490.0,7020.46165176986,-15.24,9
02:42,252964502.0,-727.6653224913006,-32.18,9
02:42,252760664.0,6828.717261173089,-8.4,2
02:45,414454079.0,511.88785000000195,-34.57,9
02:47,461990622.0,10333.53774297757,-2.0,7
02:47,550169791.0,20952.41053964686,-44.96,8
02:51,216285378.0,23218.85938463492,-39.83,9
02:55,822718326.0,10990.40967796188,-11.51,2
02:57,213112754.0,6748.986748162784,-49.11,7
02:58,145387690.0,5001.543607334294,-24.98,9
03:03,887853850.0,10683.478361165724,-28.87,9
03:03,987163717.0,6415.798480000006,-36.03,9
03:04,108481285.0,8575.613560965845,-30.95,2
03:06,873693307.0,9725.233991539248,-33.09,7
03:09,146909202.0,5808.223732049067,-45.39,2
03:16,500043411.0,13379.527255203742,-18.17,2
03:21,706250160.0,11634.05712051817,-12.01,7
03:31,183888402.0,17887.806038473813,-39.12,9
03:32,886921642.0,3411.2871596533396,-3.7,2
03:33,752362502.0,8602.76565740221,-3.11,5
03:34,853907490.0,7014.517756746766,-5.94,7
03:40,721393911.0,-498.3465425357166,-35.44,9
03:41,809499628.0,16548.786247456348,-14.29,9
03:46,822135975.0,10925.466531885137,-52.37,2
03:56,305778936.0,10252.262476696696,-68.2,5
03:59,749378808.0,4156.16566747727,-22.93,9
04:02,203466392.0,2809.150221360683,-46.6,5
04:05,383833857.0,23953.241688397273,-59.4,2
04:07,719586818.0,17156.82085627531,-34.55,7
04:12,704517789.0,16977.31694904515,-19.21,5
04:13,480557476.0,10949.453441065449,-40.11,5
04:14,473820682.0,11067.627662113038,-15.03,2
04:18,128033695.0,1908.9207122905768,-65.19,7
04:19,419550103.0,18740.083552346317,-6.8,2
04:19,994214354.0,9791.20602621173,-29.29,9
04:22,187111705.0,6694.002579625693,-1.65,2
04:27,364357875.0,7619.024823266612,-46.51,5
04:39,221868392.0,5233.625550922074,-28.4,9
04:46,940569402.0,6212.781707753858,-5.99,9
04:47,829914501.0,905.380806570974,-30.99,9
04:48,785749304.0,8383.988853687353,-14.9,9
04:51,237493332.0,14132.582836828258,-39.24,7
04:51,170637730.0,2818.2189378861895,-5.95,5
04:54,547010927.0,22218.20353606408,-9.72,7
04:54,264550521.0,9359.913820254937,-75.59,7
04:55,450896297.0,13205.483922504613,-30.69,9
04:56,912705941.0,17905.96618953016,-13.15,5
05:03,749378808.0,4141.755172487586,-14.41,7
05:03,510101371.0,12996.229810487564,-5.09,7
05:04,738958551.0,9099.660313445434,-15.64,2
05:07,802697323.0,15471.500614083056,-39.64,9
05:08,310375875.0,3046.8941494338087,-19.61,5
05:08,534325901.0,6582.439207312107,-36.73,4
05:09,308505160.0,14214.319641396569,-5.98,4
05:13,348325817.0,10108.920142735202,-5.29,7
05:14,679662108.0,15733.4928706996,-6.02,2
05:17,905860285.0,10270.90387519892,-7.94,7
05:18,195895574.0,7356.374361819848,-33.19,9
05:20,639409800.0,34418.57464060647,-3.85,5
05:24,399144202.0,2475.4853326954326,-3.59,2
05:24,766941757.0,9672.687560329348,-40.24,7
05:25,120634201.0,4624.699500000007,-14.19,9
05:26,409971170.0,2739.831211924208,-26.81,5
05:26,627622066.0,3234.5208047156616,-13.3,7
05:28,549414742.0,7219.636897821136,-28.18,9
05:31,187541224.0,2329.14000811304,-38.29,9
05:31,489964679.0,20296.682247169752,-29.02,9
05:36,887853850.0,10649.237471294153,-34.24,5
05:38,435984758.0,4433.666143696253,-57.81,2
05:41,113747882.0,12143.320439285617,-34.63,9
05:41,169006407.0,11710.676741611316,-19.98,7
05:44,245690309.0,9358.989942069791,-7.5,7
05:44,290818242.0,6987.298251746335,-4.36,7
05:46,832564361.0,15692.081464205932,-16.04,5
05:54,836110591.0,6892.99544994739,-30.85,9
05:55,456246119.0,19651.058815397515,-35.71,7
05:56,198946608.0,3923.598885558673,-17.05,7
05:58,705848712.0,25650.315286857895,-21.04,9
06:01,532478725.0,4770.712502804219,-25.39,9
06:02,489964679.0,20277.000958610235,-19.68,2
06:03,609939116.0,7465.639422866898,-50.28,2
06:05,822250278.0,7148.231516471168,-3.49,5
06:06,824916823.0,8653.166689125203,-29.27,9
06:08,851181128.0,4792.277461713507,-13.56,7
06:09,678851253.0,3414.3092246384035,-70.6,7
06:10,587225252.0,5281.514094226141,-46.73,9
06:13,779946617.0,16492.727422338794,-20.97,5
06:16,298000165.0,24899.461768399105,-4.63,2
06:20,460463595.0,-704.2379454185788,-28.86,9
06:20,408057540.0,4208.691220385124,-42.38,5
06:21,670102069.0,3855.2507791574626,-36.58,9
06:22,655368335.0,4415.203946148009,-59.76,7
06:22,730002588.0,12661.891029636066,-40.7,2
06:23,785749304.0,8316.65373307939,-67.34,7
06:25,806358207.0,12211.965331348028,-19.29,4
06:28,482513594.0,5857.6405684847905,-33.54,5
06:28,549414742.0,7191.865778819626,-27.77,8
06:32,558119802.0,32155.046130622504,-1.92,8
06:38,795847804.0,22603.63746294522,-25.58,7
06:41,683319988.0,7659.800626852314,-22.93,9
06:44,985188462.0,394.3427887112247,-35.64,9
06:46,518474507.0,14898.833460116271,-29.44,9
06:47,633345190.0,7193.946101480143,-35.84,9
06:49,601627384.0,4722.28005573317,-8.81,2
06:51,108563213.0,23238.645714520117,-8.81,7
06:54,851649498.0,10188.459383153666,-23.47,7
06:55,572384506.0,10707.543181449042,-27.75,9
06:56,930277104.0,10278.504543107068,-31.4,4
06:56,259015404.0,1654.2445055655633,-24.24,8
06:57,673025413.0,3977.051322045038,-11.88,7
07:01,506618547.0,16971.25708813276,-4.34,2
07:01,949032480.0,4762.4723451464,-19.45,9
07:03,699139822.0,1633.6575216351785,-15.96,7
07:03,287480331.0,11010.598251492538,-30.14,9
07:04,865748375.0,3715.406557398994,-4.54,4
07:06,270374623.0,10043.47445481992,-20.13,5
07:09,324224854.0,3032.2303723625714,-15.82,7
07:10,657139925.0,13600.413143136857,-23.85,9
07:11,776108637.0,1003.3125536574958,-6.0,9
07:13,541639148.0,4757.375866877613,-58.97,2
07:14,604288474.0,2585.450967686178,-21.2,8
07:17,256002321.0,6081.548853090095,-47.89,5
07:17,815385232.0,9917.034925133925,-23.32,8
07:17,897714622.0,8538.12781903288,-21.91,2
07:19,519644021.0,2947.872837315367,-8.96,2
07:19,496395938.0,12678.557063711203,-27.47,7
07:25,623156843.0,5545.739794033761,-26.2,2
07:25,885259672.0,3938.802262640279,-43.08,5
07:28,195895574.0,7320.429241508366,-35.95,7
07:29,414805878.0,13120.789755452925,-31.45,9
07:30,252701364.0,-3613.456172677916,-27.49,9
07:30,503575533.0,6350.81988693877,-18.09,7
07:31,235881534.0,12802.133210432772,-17.49,2
07:36,229205098.0,7474.193637566955,-31.27,5
07:37,842682241.0,5287.6215293056675,-37.58,2
07:40,285220959.0,11441.5933027807,-43.42,7
07:40,151968462.0,8820.252650223634,-20.56,7
07:42,511179916.0,6689.121034777625,-3.03,2
07:44,700138124.0,5379.922278086874,-0.54,7
07:45,987656636.0,5996.007785955375,-10.11,2
07:51,145387690.0,4982.008001214483,-19.54,2
07:55,454129843.0,1462.5865215607596,-7.5,9
07:56,992204045.0,6000.253237444383,-43.47,8
07:57,675806859.0,6919.41460824275,-24.63,2
07:58,287480331.0,10976.066988881616,-34.53,7
08:12,315546581.0,27245.71606466045,-43.31,5
08:13,586315521.0,11926.058403208724,-31.96,8
08:19,885259672.0,3930.902262640279,-7.9,9
08:20,395284483.0,541.3703402113085,-4.75,9
08:21,298000165.0,24862.277768399104,-37.18,5
08:23,726913482.0,-960.361348526476,-48.4,5
08:24,874506295.0,-1520.641756245572,-11.98,5
08:27,473820682.0,11037.695662113038,-29.93,5
08:28,380228542.0,-304.1630581844345,-6.15,9
08:28,978410962.0,-2830.5858395489727,-21.67,5
08:31,197865285.0,444.9696117312202,-105.83,5
08:33,556992209.0,11546.299394953585,-7.7,5
08:34,570323670.0,4194.812706637519,-18.98,8
08:34,366550080.0,25443.10954475393,-13.45,2
08:37,522188082.0,7824.643926049101,-6.46,7
08:37,331450202.0,7280.743003330787,-33.97,7
08:37,448004226.0,1964.549960862856,-53.23,5
08:38,709632525.0,-1557.4948500000007,-44.44,5
08:38,760704118.0,555.1183127174887,-73.71,5
08:42,403765849.0,-2368.980499999998,-28.76,5
08:43,744211756.0,-4071.678249999994,-48.09,5
08:44,322221939.0,4029.739482767626,-17.9,7
08:44,414805878.0,13054.088616021963,-66.7,2
08:46,370521542.0,25353.67633022816,-22.19,9
08:49,124102251.0,3618.053418700932,-29.08,7
08:49,504055745.0,-278.45733865823314,-77.34,5
08:50,824916823.0,8595.817248078974,-57.35,5
08:50,795847804.0,22509.809462945217,-93.83,5
09:02,762896656.0,-473.7050018481413,-21.57,5
09:04,687135796.0,26305.867534209905,-151.05,5
09:04,280990953.0,302.62969999999854,-70.56,5
09:05,290818242.0,6981.198251746335,-6.1,9
09:06,282837512.0,13616.177717012608,-35.98,7
09:07,923322792.0,-752.8193317536376,-52.3,5
09:08,142791593.0,-99.9688000000004,-67.53,5
09:08,293609137.0,-106.18050742550194,-116.15,5
09:09,197865285.0,439.1696117312202,-5.8,9
09:10,969697937.0,-4616.547765670551,-22.33,5
09:11,581655972.0,39505.98761512086,-5.8,9
09:14,624563756.0,-295.45497121644365,-7.5,9
09:14,675231808.0,16323.308022288727,-150.65,5
09:15,627917561.0,3477.1550500000044,-6.8,9
09:15,441274121.0,12715.886849105666,-5.0,9
09:16,198946608.0,3875.781885558673,-47.82,5
09:16,553734946.0,711.6369999999986,-26.96,5
09:16,999752672.0,1329.4652435333346,-7.8,9
09:16,984783496.0,14100.855325044002,-2.12,5
09:17,540159353.0,11055.148368050435,-5.4,9
09:18,550832673.0,3089.9431344744075,-154.98,2
09:18,690958123.0,20024.85843844166,-6.8,9
09:18,169006407.0,11703.876741611317,-6.8,9
09:19,117273481.0,9258.204917595089,-5.7,9
09:20,596171893.0,190.4517448255111,-11.98,7
09:21,586315521.0,11920.708403208724,-5.35,9
09:21,441142605.0,2319.4290000000055,-7.98,4
09:21,618138606.0,1560.8643472714346,-6.15,9
09:22,506618547.0,16965.607088132758,-5.65,9
09:23,398429109.0,953.0950500000012,-39.98,2
09:24,913127700.0,1035.7503380111164,-99.99,2
09:24,670102069.0,3854.351748097972,-0.9,5
09:24,435313070.0,2280.7483086224643,-39.98,2
09:26,899742927.0,12346.32289140115,-100.09,2
09:26,663479159.0,5330.444541827709,-20.97,7
09:26,621652856.0,119.90596961054008,-240.24,5
09:26,214339619.0,317.6649508683563,-5.7,9
09:28,414454079.0,508.83785000000194,-3.05,4
09:28,572136270.0,191.5726115880232,-114.5,2
09:30,298007503.0,1546.518103625633,-10.14,7
09:31,909669130.0,312.8778847367666,-14.98,4
09:34,588565416.0,7443.010204816498,-34.95,7
09:35,984783496.0,14093.421815044,-7.43,4
09:36,570323670.0,4138.716666637519,-56.1,4
09:37,929044080.0,613.2963915056283,-18.97,7
09:37,407574996.0,2547.700622845059,-25.07,7
09:38,652048867.0,-11.031000000001017,-73.98,2
09:38,554792076.0,26942.5517950115,-12.17,2
09:38,441142605.0,2287.4690000000055,-31.96,7
09:38,518466565.0,731.8112499999996,-119.98,2
09:39,254853117.0,4226.132871541208,-123.12,5
09:40,298007503.0,1379.932103625633,-166.59,2
09:40,609939116.0,7433.489422866898,-32.15,2
09:40,155867488.0,107.76869999999845,-112.98,2
09:41,769319491.0,-269.9180000000006,-27.95,1
09:41,524425303.0,-680.0279000000012,-65.24,5
09:42,639549973.0,7464.109543668736,-34.42,2
09:45,757115616.0,2238.9200000000037,-14.98,1
09:46,547010927.0,22180.85353606408,-37.35,2
09:48,679943657.0,5301.481872468133,-46.77,5
09:49,583558311.0,-704.5102152486677,-50.57,5
09:53,886921642.0,3384.197159653339,-27.09,7
09:54,266777719.0,714.7264337802395,-25.07,2
09:55,348325817.0,10053.564142735202,-55.36,5
09:59,534204159.0,6120.799938847322,-5.16,5
10:00,538003940.0,1901.4900000000089,-145.0,2
10:00,572136270.0,74.57261158802322,-117.0,2
10:01,718058208.0,2802.1205451766455,-24.98,7
10:03,298007503.0,1194.460103625633,-185.47,2
10:04,703588001.0,-48.78885000000046,-39.5,5
10:05,106601471.0,10257.521624976329,-7.0,1
10:06,639549973.0,7442.962543668736,-21.15,5
10:09,134461671.0,5572.0534900492985,-18.61,2
10:13,903953091.0,3362.486038995664,-5.7,9
10:13,340321732.0,1660.4101500000031,-146.55,5
10:15,494156986.0,-659.8669543276651,-42.89,5
10:18,659415300.0,3213.902540250704,-5.5,9
10:20,538003940.0,1833.9900000000089,-67.5,2
10:21,679943657.0,5291.87675069662,-9.61,7
10:22,287480331.0,10969.916988881618,-6.15,9
10:27,886921642.0,3264.6371596533395,-119.56,2
10:28,696333897.0,175.888549999999,-114.61,5
10:30,834383043.0,5414.324932435833,-74.98,2
10:34,564744955.0,450.6468585888419,-18.98,2
10:34,977899503.0,-357.75310641914746,-38.19,5
10:39,518746136.0,145.1052717630835,-39.2,5
10:42,152616936.0,1130.7760078630647,-44.0,7
10:45,933491926.0,3177.716300000002,-149.99,2
10:47,703537476.0,553.8592499999991,-22.02,2
10:55,538003940.0,1798.9900000000086,-35.0,2
10:57,180616589.0,808.4947092146951,-46.48,4
10:59,857997794.0,911.7766651508872,-64.92,7
11:00,183888402.0,17872.426803059865,-15.38,2
11:02,970298834.0,3099.017213793015,-67.12,2
11:05,788740658.0,3884.452274422581,-11.83,7
11:15,266777719.0,699.6589337802395,-15.07,5
11:15,657139925.0,13561.513143136855,-38.9,2
11:16,657139925.0,13542.08614389792,-19.43,5
11:17,355733816.0,4881.093989565094,-39.96,7
11:18,815993333.0,6306.675639061407,-20.01,2
11:20,479366718.0,2072.6614476324007,-6.99,4
11:27,613729471.0,8819.016904545306,-67.66,2
11:39,254853117.0,4216.132871541208,-10.0,7
11:44,403383649.0,1794.4877637323432,-26.99,1
11:44,556992209.0,11535.289394953585,-11.01,4
11:44,383833857.0,23932.75168839727,-20.49,1
12:01,767447966.0,4538.800245512111,-143.53,5
12:04,305778936.0,10217.912476696696,-34.35,9
12:07,553734946.0,698.6969999999985,-12.94,9
12:07,718058208.0,2732.0105051766454,-70.11,4
12:16,685959099.0,933.9868660992422,-19.54,9
12:17,652048867.0,-43.38100000000101,-32.35,9
12:31,564214408.0,-114.00691527427392,-15.96,5
12:31,621652856.0,94.41596961054007,-25.49,9
12:32,129018172.0,8627.858896282198,-75.97,2
12:36,494789005.0,2963.5003254933463,-18.9,5
12:50,718058208.0,2689.787792397873,-42.22,7
12:50,741903302.0,2108.9765587407874,-49.99,2
12:50,480557476.0,10908.733441065448,-40.72,7
12:53,828750680.0,1729.48454521368,-1.99,4
12:53,414454079.0,496.6778500000019,-12.16,4
12:53,902798190.0,-755.4236344310266,-45.32,5
12:54,901432314.0,3676.4004151099825,-57.89,5
13:01,816685391.0,-684.0561037084262,-81.06,5
13:06,849096144.0,1996.1920207513415,-5.8,9
13:07,901432314.0,3656.1295051099823,-20.27,4
13:13,158766229.0,-741.89398589347,-84.73,5
13:13,943829984.0,-1028.538090886543,-69.76,5
13:14,398429109.0,874.9509000000012,-78.14,5
13:15,538003940.0,1717.4900000000086,-81.5,2
13:16,256002321.0,6070.898853090095,-10.65,9
13:22,910730524.0,7948.163684739065,-6.1,9
13:23,688712152.0,6225.305044430708,-6.0,9
13:27,684284526.0,-3095.1188667457573,-34.27,5
13:32,556992209.0,11515.259384953584,-20.03,4
13:39,572136270.0,-24.42738841197678,-99.0,2
13:42,822250278.0,7139.883836471168,-8.35,4
13:43,119943495.0,-1402.220062112858,-45.12,5
13:50,538003940.0,1677.9900000000086,-39.5,2
13:50,399538448.0,7046.751843599437,-36.72,2
14:01,812692024.0,3564.1008579489526,-79.98,2
14:11,538003940.0,1582.9900000000086,-95.0,2
14:15,613427466.0,6419.206956011863,-41.54,5
14:19,527842638.0,1607.8393926329836,-49.99,2
14:27,407574996.0,2316.8106228450592,-230.89,2
14:33,909669130.0,289.9428847367666,-22.93,5
14:36,259015404.0,1618.6045055655632,-35.64,9
14:37,538003940.0,1547.9900000000086,-35.0,2
14:44,441142605.0,2236.4890000000055,-50.98,2
14:52,349107386.0,-3369.7209731945613,-81.68,5
15:11,444428189.0,1257.7593500000028,-30.95,1
15:13,779236304.0,920.8675954795324,-34.28,9
15:24,409370545.0,1347.5732755455203,-27.1,7
15:27,572136270.0,-123.92738841197678,-99.5,2
15:30,321372947.0,-359.6605507890994,-26.97,5
15:33,901432314.0,3592.0841822997963,-64.05,2
15:38,678330503.0,2774.218787806702,-20.07,8
15:42,867987292.0,4100.296517528466,-97.09,2
15:58,776108637.0,907.4265536574958,-95.89,2
15:59,700138124.0,5321.612278086874,-58.31,5
16:04,572136270.0,-285.4273884119768,-161.5,2
16:09,116598243.0,2093.9090033684456,-5.44,5
16:11,405416860.0,2188.2379669583715,-12.99,2
16:13,812692024.0,3535.130857948953,-28.97,4
16:18,192202372.0,427.8469338887978,-107.98,2
16:23,604334058.0,543.7838999999994,-36.98,4
16:33,477216513.0,-594.1399999999994,-28.51,5
16:34,924045955.0,1514.8350126586645,-15.01,4
16:35,492215823.0,2437.212563815444,-19.78,4
16:43,766941757.0,9640.597560329346,-32.09,9
16:43,345582855.0,-50.2444471794507,-34.55,5
17:04,973086490.0,10159.419186504932,-15.2,9
17:04,744968736.0,-1573.9318265694235,-7.89,5
17:08,510101371.0,12964.079810487565,-32.15,9
17:09,776108637.0,874.5405536574958,-32.89,2
17:10,224112146.0,443.3385999999986,-106.43,5
17:15,769311479.0,6956.184167740666,-63.29,2
17:15,196289502.0,15336.79155486446,-51.79,4
17:16,196289502.0,15323.983786246825,-12.81,8
17:17,836110591.0,6839.767237211235,-53.23,2
17:17,933491926.0,3142.766300000002,-34.95,7
17:18,376271050.0,1361.5728069057438,-31.72,9
17:19,221868392.0,5205.915550922074,-27.71,7
17:21,858989281.0,26314.934211721746,-16.9,9
17:24,971010829.0,162.33505644424525,-54.99,2
17:25,891716230.0,492.188453688078,-49.97,2
17:28,986267641.0,7431.023022672556,-13.04,4
17:28,914806976.0,221.17325018548672,-21.49,4
17:29,627622066.0,3222.5408047156616,-11.98,7
17:30,147474476.0,4506.641165119361,-25.0,2
17:30,241459011.0,907.2768132723472,-5.99,1
17:33,975345315.0,34933.668545496985,-31.99,2
17:35,822718326.0,10980.41967796188,-9.99,1
17:37,851181128.0,4761.077461713508,-31.2,9
17:37,683319988.0,7588.400626852314,-71.4,2
17:38,143061865.0,6834.046418817845,-15.49,4
17:38,776108637.0,747.8825536574958,-126.66,2
17:42,286484726.0,889.2084200631589,-4.83,5
17:43,241459011.0,797.3068132723472,-109.97,4
17:43,583579399.0,1331.3049499999993,-12.99,2
17:43,237493332.0,14109.832836828258,-22.75,2
17:44,832564361.0,15648.863464205931,-43.22,5
17:44,131388684.0,21109.31681297758,-12.74,5
17:46,835736339.0,1811.65035209188,-81.06,2
17:47,698076160.0,6173.862245982022,-1.99,4
17:49,675231808.0,16216.318022288728,-106.99,2
17:49,949032480.0,4761.967306222,-0.51,7
17:50,435984758.0,4361.370143696253,-72.3,5
17:50,462962606.0,-1327.775950000001,-47.51,5
17:51,478986718.0,-1060.7928000000006,-24.99,5
17:53,532478725.0,4748.103023155738,-22.61,5
17:54,280268430.0,4817.249287989452,-29.99,4
17:55,152488934.0,1533.9820573137306,-44.99,2
17:56,520447032.0,8258.127826144542,-9.66,2
17:57,200080192.0,9303.618847037722,-5.04,7
17:57,588565416.0,7403.030204816499,-39.98,4
17:57,999752672.0,1196.4952435333346,-132.97,2
17:59,639420537.0,-1551.11145,-50.58,5
18:02,113747882.0,12137.76154286123,-5.56,8
18:02,683319988.0,7380.514626852314,-207.89,2
18:04,535744551.0,423.86246599562605,-23.97,4
18:05,213112754.0,6735.986748162784,-13.0,9
18:05,471897866.0,8620.43506487863,-5.13,7
18:07,629078930.0,1028.3116906575533,-44.05,5
18:08,214339619.0,184.1649508683563,-133.5,2
18:11,687135796.0,26298.877534209903,-6.99,9
18:12,990894155.0,46.21645867884151,-27.24,9
18:12,308505160.0,14068.047641396566,-146.27,2
18:17,358846516.0,713.9979225272178,-63.38,5
18:19,285428103.0,9265.46149118738,-82.35,5
18:22,668329719.0,8662.067777523236,-11.19,7
18:24,494404688.0,-2538.225765336208,-39.34,5
18:24,491392945.0,4695.489500000007,-114.79,2
18:25,308505160.0,13921.047641396566,-147.0,2
18:26,559995067.0,3764.728627981227,-41.57,4
18:27,214339619.0,120.20495086835628,-63.96,2
18:28,815385232.0,9889.824925133924,-27.21,7
18:30,335698481.0,-2217.6254966949396,-12.05,5
18:30,461029994.0,7268.332299682366,-28.97,7
18:33,143061865.0,6802.7144188178445,-31.33,5
18:34,651756497.0,13361.799456183278,-23.65,5
18:36,510101371.0,12954.519810487564,-9.56,7
18:38,491392945.0,4678.549500000007,-16.94,5
18:41,786141370.0,-336.6870000000008,-16.39,9
18:41,844835978.0,9603.111938921003,-26.59,5
18:45,874431242.0,8359.66321884699,-32.27,5
18:47,601627384.0,4689.89005573317,-32.39,9
18:52,936917570.0,-2745.4249999999975,-27.05,5
18:52,982949451.0,-3574.7441670525086,-52.57,5
18:52,838415080.0,-3389.668999999999,-36.88,5
18:53,633345190.0,7175.370416576238,-18.58,7
18:55,578131296.0,602.7345694440438,-94.88,5
18:55,675398089.0,-680.985590774651,-123.79,5
18:56,758160963.0,8090.179603122238,-7.53,4
19:01,340680761.0,-2981.2605999999973,-13.48,5
19:02,433917275.0,7513.284227791321,-28.1,5
19:04,873701090.0,949.1170458643812,-2.37,2
19:12,824218857.0,-3510.9461608454285,-97.62,5
19:14,986267641.0,7424.059405068086,-6.96,7
19:15,859603181.0,4031.569781265208,-18.95,5
19:15,776108637.0,732.6008536574958,-15.28,5
19:18,433917275.0,7487.804227791322,-25.48,9
19:21,336171116.0,-630.8014500000005,-152.86,5
19:22,668692488.0,1817.107753563903,-221.19,5
19:23,612304466.0,-2067.8432500000004,-17.68,5
19:24,180719578.0,-4211.387749999995,-59.27,5
19:26,687135796.0,26285.695733619392,-13.18,8
19:28,518474507.0,14839.534103506405,-59.3,7
19:30,999752672.0,1085.4535435333346,-111.04,5
19:31,627723633.0,-2026.6813280037627,-103.57,5
19:33,215311171.0,6352.5117206807645,-8.73,2
19:35,858989281.0,26311.54149421476,-3.39,4
19:42,705848712.0,25630.641751535557,-19.67,7
19:45,540159353.0,11006.764368050435,-48.38,5
19:47,785749304.0,8288.27573307939,-28.38,5
19:49,370521542.0,25326.46453516636,-27.21,2
19:49,124102251.0,3537.889418700932,-80.16,5
19:52,255814263.0,3506.0429467005456,-50.61,5
19:52,383625050.0,5832.28986845391,-56.03,5
20:00,435313070.0,2260.7983086224644,-19.95,9
20:16,221868392.0,5147.992773243956,-57.92,8
20:23,146686559.0,-579.9228111734778,-35.99,5
20:23,815993333.0,6250.941639061407,-55.73,5
20:25,975345315.0,34928.20524301254,-5.46,2
20:27,951817450.0,9771.289933522528,-28.67,5
20:28,417850087.0,16885.162295932478,-24.73,2
20:30,200080192.0,9294.064606447231,-9.55,5
20:32,887156614.0,-943.6720710407736,-48.4,5
20:47,282837512.0,13581.927717012608,-34.25,9
20:52,355602925.0,1503.4779695597524,-26.34,9
20:52,550169791.0,20939.41053964686,-13.0,9
20:53,605116158.0,2314.0336000000016,-48.92,5
20:56,624500124.0,3529.2969099266943,-77.49,5
02:34,809499628.0,16530.336247456347,-18.45,9
02:41,950234174.0,1100.9760599724932,-34.38,9
02:43,678330503.0,2773.7110620406997,-0.51,4
02:44,961077907.0,47.65575000000001,-30.5,9
02:50,547010927.0,22135.79051279952,-45.06,5
02:52,187111705.0,6676.929383970633,-17.07,2
02:57,270374623.0,9997.526502891733,-45.95,7
03:05,183888402.0,17838.996803059865,-33.43,9
03:07,549414742.0,7168.075778819626,-23.79,9
03:16,282837512.0,13572.658959680572,-9.27,5
03:19,414805878.0,13019.148616021965,-34.94,9
03:20,836110591.0,6805.087237211234,-34.68,9
03:29,170637730.0,2771.3333827803353,-46.89,5
03:29,822135975.0,10900.9986509443,-24.47,7
03:36,699139822.0,1633.623232590407,-0.03,7
03:38,549414742.0,7152.663531813681,-15.41,5
03:39,454356905.0,1150.558574530483,-29.49,2
03:39,853907490.0,7002.577756746767,-11.94,9
03:41,858989281.0,26299.29149421476,-12.25,9
03:43,940569402.0,6196.551707753859,-16.23,9
03:46,510101371.0,12911.849810487563,-42.67,9
03:46,496395938.0,12672.693900424134,-5.86,7
03:47,534204159.0,6054.441810235096,-66.36,5
03:52,886921642.0,3262.1005787002,-2.54,2
03:53,930277104.0,10255.354543107069,-23.15,9
03:53,769311479.0,6949.763535543682,-6.42,2
03:55,108931112.0,13589.595056546674,-39.38,9
03:55,384497904.0,595.6606499999991,-30.45,9
03:59,187541224.0,2303.30000811304,-25.84,9
04:00,949032480.0,4747.327306222,-14.64,9
04:09,779946617.0,16457.77839976596,-34.95,2
04:10,897714622.0,8530.545445320617,-7.58,2
04:10,802697323.0,15449.260614083058,-22.24,9
04:10,842682241.0,5271.9206329422705,-15.7,7
04:10,853907490.0,6985.423598791165,-17.15,2
04:14,229205098.0,7466.377150789967,-7.82,8
04:15,518474507.0,14806.214103506403,-33.32,9
04:16,639409800.0,34373.05681717362,-45.52,2
04:18,124102251.0,3525.7729935928674,-12.12,8
04:19,673025413.0,3949.4862658300112,-27.57,5
04:22,809499628.0,16527.71862185734,-2.62,8
04:22,532478725.0,4708.723023155738,-39.38,9
04:24,930277104.0,10239.381037389168,-15.97,8
04:24,287480331.0,10949.986988881616,-19.93,9
04:32,683319988.0,7351.834626852314,-28.68,9
04:35,315546581.0,27231.535018740666,-14.18,8
04:35,776431321.0,3453.049470401984,-3.01,2
04:39,795847804.0,22442.61353473148,-67.2,8
04:42,285220959.0,11432.670070055432,-8.92,5
04:43,940569402.0,6128.804878340165,-67.75,2
04:45,601627384.0,4657.06005573317,-32.83,9
04:46,531186970.0,6956.6848816342235,-52.82,5
04:47,196289502.0,15304.793786246824,-19.19,9
04:49,984783496.0,14084.021815044,-9.4,9
04:49,973086490.0,10152.169186504932,-7.25,9
04:52,348325817.0,10032.084874525874,-21.48,5
04:52,450896297.0,13166.843922504611,-38.64,9
04:53,766941757.0,9607.367560329349,-33.23,9
04:58,520447032.0,8225.047826144542,-33.08,9
04:58,709608057.0,2963.4660705270244,-43.53,9
05:01,108563213.0,23209.028916873183,-29.62,4
05:02,749378808.0,4125.876561333597,-15.88,2
05:05,215311171.0,6314.881720680764,-37.63,9
05:07,146909202.0,5776.010531328095,-32.21,4
05:10,887853850.0,10622.807471294152,-26.43,9
05:13,788740658.0,3882.544162330024,-1.91,8
05:24,766941757.0,9602.00590579314,-5.36,7
05:25,116598243.0,2075.999215347622,-17.91,7
05:27,450896297.0,13156.621112585271,-10.22,2
05:28,815385232.0,9873.131436774996,-16.69,2
05:30,833899961.0,1955.9131442498697,-8.03,4
05:33,670102069.0,3821.781748097972,-32.57,9
05:34,331450202.0,7248.176763000575,-32.57,4
05:39,873701090.0,939.4398212469458,-9.68,7
05:39,949032480.0,4714.354624905076,-32.97,7
05:40,994214354.0,9750.01602621173,-41.19,9
05:41,383625050.0,5801.08986845391,-31.2,9
05:44,887853850.0,10619.526794243937,-3.28,8
05:48,836110591.0,6803.310599406696,-1.78,5
05:49,213112754.0,6712.495761700376,-23.49,5
05:50,705848712.0,25617.70175153556,-12.94,9
05:52,899742927.0,12310.81059272685,-35.51,2
05:52,960208650.0,17080.492776736264,-19.11,2
05:58,143003091.0,21806.952515372697,-12.07,4
05:58,679662108.0,15675.632836849269,-57.86,5
05:59,874431242.0,8332.79229971568,-26.87,5
06:02,706250160.0,11623.443185017231,-10.61,2
06:05,417850087.0,16881.445820250352,-3.72,2
06:05,532478725.0,4701.2989251943,-7.42,7
06:10,651756497.0,13356.877491223007,-4.92,7
06:11,633345190.0,7138.680416576239,-36.69,9
06:12,383625050.0,5782.419787626433,-18.67,2
06:15,203466392.0,2797.54647308623,-11.6,2
06:16,609939116.0,7407.479314835753,-26.01,7
06:30,865748375.0,3683.859363881268,-31.55,2
06:31,264550521.0,9355.390416839751,-4.52,8
06:34,667367404.0,9324.757156701831,-32.38,7
06:35,587225252.0,5245.4740942261415,-36.04,9
06:37,407574996.0,2286.370622845059,-30.44,9
06:39,489964679.0,20242.430958610235,-34.57,9
06:40,216285378.0,23184.069384634917,-34.79,9
06:41,252760664.0,6794.67369391845,-34.04,5
06:43,108931112.0,13584.432896656974,-5.16,8
06:47,550169791.0,20884.445554401667,-54.96,5
06:56,719586818.0,17085.006878318538,-71.81,5
06:57,730002588.0,12605.487133887837,-56.4,2
06:58,683319988.0,7298.335434973581,-53.5,2
06:59,324224854.0,2995.4085613282714,-36.82,5
06:59,383833857.0,23925.915033941765,-6.84,7
07:00,259015404.0,1587.464505565563,-31.14,9
07:02,858989281.0,26294.999503393105,-4.29,5
07:02,675806859.0,6908.808573582756,-10.61,2
07:02,128033695.0,1883.4907122905763,-25.43,9
07:04,678851253.0,3383.578648156371,-30.73,7
07:06,851649498.0,10125.663632950624,-62.8,2
07:10,987656636.0,5944.936902732748,-51.07,2
07:10,822250278.0,7123.803418259217,-16.08,8
07:11,522188082.0,7786.782912451576,-37.86,2
07:15,670102069.0,3817.223377184679,-4.56,5
07:20,678330503.0,2768.3610620407,-5.35,9
07:23,305778936.0,10199.531450496206,-18.38,8
07:24,596171893.0,159.5717448255111,-30.88,9
07:28,433917275.0,7477.286085485541,-10.52,5
07:29,832564361.0,15638.91346420593,-9.95,9
07:31,558119802.0,32117.846130622504,-37.2,9
07:36,758160963.0,8032.117946360483,-58.06,2
07:44,506618547.0,16946.121874807497,-19.49,2
07:45,604288474.0,2566.511980881347,-18.94,7
07:45,366550080.0,25388.95430486626,-54.16,7
07:54,698076160.0,6107.234467900685,-66.63,8
07:56,519644021.0,2943.3550994774864,-4.52,7
07:57,541639148.0,4736.2961405653905,-21.08,4
08:00,290818242.0,6943.012870768567,-38.19,2
08:00,885259672.0,3923.1022626402782,-7.8,9
08:01,824916823.0,8557.897248078974,-37.92,9
08:01,454129843.0,1456.4865215607597,-6.1,9
08:02,399538448.0,7041.051843599437,-5.7,9
08:04,520447032.0,8169.982627192443,-55.07,2
08:05,564744955.0,444.1468585888419,-6.5,9
08:13,480557476.0,10883.605525659415,-25.13,5
08:15,241459011.0,791.6068132723472,-5.7,9
08:21,101531259.0,-298.7070500000004,-65.2,5
08:24,890196840.0,-2828.48631667513,-19.19,5
08:24,195895574.0,7313.184927506813,-7.24,8
08:26,322720763.0,7545.866843507358,-77.03,5
08:27,691843653.0,-2983.2558999999937,-8.62,5
08:28,785749304.0,8259.10826747503,-29.17,7
08:28,519935524.0,59.48490973751903,-7.8,9
08:30,425730826.0,1645.1994093887197,-14.84,5
08:31,540159353.0,11001.85859487148,-4.91,7
08:31,752362502.0,8547.35891566476,-55.41,5
08:32,992204045.0,5923.8552374443825,-76.4,5
08:32,519933553.0,-354.79149584927154,-18.22,5
08:34,310171581.0,-2156.3762043409197,-40.53,5
08:35,199016328.0,6419.059979675477,-8.73,4
08:36,907987693.0,-2474.8344999999986,-44.31,5
08:37,441274121.0,12690.516915578915,-25.37,5
08:38,668175891.0,394.78072315849903,-27.91,5
08:39,215832575.0,-1473.5019637442197,-14.24,5
08:39,556992209.0,11456.907384953583,-58.35,5
08:39,214339619.0,114.55495086835629,-5.65,9
08:39,152616936.0,981.3820078630648,-149.39,5
08:41,905860285.0,10253.82174565834,-17.08,7
08:41,143606916.0,264.0734540291897,-173.98,5
08:42,851181128.0,4730.908785557244,-30.17,4
08:42,482513594.0,5812.056568484791,-45.58,5
08:44,598586358.0,-3334.157449999996,-53.94,5
08:46,588565416.0,7288.286204816499,-114.74,5
08:47,623156843.0,5534.233484924812,-11.51,2
08:48,226703987.0,1783.6588499999996,-124.35,5
08:49,532525712.0,-695.3518000000004,-34.56,5
08:49,200080192.0,9227.81786984196,-66.25,7
08:52,683078800.0,1810.0659413499593,-85.75,5
08:53,482513594.0,5738.458737483866,-73.6,2
08:53,151968462.0,8767.823759407307,-52.43,8
08:55,141521177.0,7139.559900000015,-30.88,5
08:57,833899961.0,1917.4096442498696,-38.5,5
08:59,188263947.0,27.7394000000005,-73.32,5
08:59,973086490.0,10109.97667097722,-42.19,7
09:02,581655972.0,39500.58761512086,-5.4,9
09:03,667367404.0,9319.357156701832,-5.4,9
09:03,683078800.0,1803.9659413499592,-6.1,9
09:04,761272540.0,21.35949999999883,-142.12,5
09:04,441274121.0,12685.316915578916,-5.2,9
09:05,117273481.0,9253.204917595089,-5.0,9
09:06,872286364.0,-1148.9130958130995,-61.81,5
09:07,475277431.0,1255.7731369436194,-124.68,5
09:07,169006407.0,11698.476741611315,-5.4,9
09:08,423208402.0,1134.9008500000025,-28.85,5
09:11,540159353.0,10995.75859487148,-6.1,9
09:11,586315521.0,11914.208403208724,-6.5,9
09:12,215426302.0,-662.0955959743081,-18.61,5
09:12,503575533.0,6315.60288693877,-35.22,5
09:13,999752672.0,1079.0035435333346,-6.45,9
09:13,214339619.0,108.85495086835628,-5.7,9
09:13,613729471.0,8813.216904545307,-5.8,9
09:14,683319988.0,7292.135434973581,-6.2,9
09:15,162162212.0,-715.5519566726912,-113.97,5
09:15,618138606.0,1255.0643472714346,-5.8,9
09:15,383833857.0,23919.865033941765,-6.05,9
09:17,322221939.0,4009.629482767626,-20.11,2
09:18,558875206.0,2822.2093108989516,-5.1,9
09:18,417850087.0,16876.095820250353,-5.35,9
09:19,766941757.0,9572.56590579314,-29.44,7
09:19,741903302.0,2104.0265587407876,-4.95,9
09:21,425730826.0,1615.2094093887197,-29.99,2
09:21,179173981.0,4727.100402178213,-27.29,2
09:21,624563756.0,-300.70497121644365,-5.25,9
09:23,473820682.0,11014.696788178935,-23.0,7
09:24,506618547.0,16939.621874807497,-6.5,9
09:27,194745206.0,618.6603720912431,-25.07,2
09:27,609939116.0,7106.171314835753,-301.31,5
09:31,779376323.0,2741.6937666549406,-14.95,4
09:34,266777719.0,677.6189337802396,-22.04,1
09:34,333054026.0,-50.98010597681001,-53.18,2
09:35,145387690.0,4957.558001214483,-24.45,9
09:36,108931112.0,13550.174396656974,-34.26,4
09:40,398429109.0,722.4809000000012,-152.47,2
09:40,235663459.0,323.4024298120152,-76.97,2
09:44,687135796.0,26254.47573361939,-31.22,1
09:44,985188462.0,359.71278871122473,-34.63,7
09:45,933491926.0,3091.286300000002,-51.48,4
09:48,479366718.0,2050.6614476324007,-22.0,2
09:48,259015404.0,1543.852546743047,-43.61,2
09:51,175452235.0,1120.84225,-151.19,2
09:51,873701090.0,929.3897612469458,-10.05,4
09:53,762896656.0,-39.70500184814131,-6.0,2
09:56,856957948.0,9317.324187619512,-86.46,5
09:58,373875019.0,16143.302523365684,-12.98,1
09:59,165045150.0,-213.99893859714416,-49.99,2
10:04,490868147.0,-206.4482208786985,-61.07,5
10:04,237684254.0,5752.784651660482,-7.72,7
10:04,475277431.0,1223.8231369436194,-31.95,7
10:05,287480331.0,10942.836988881618,-7.15,9
10:07,170637730.0,2742.2033827803352,-29.13,7
10:08,996042490.0,5694.711696170786,-23.97,4
10:09,700138124.0,5311.109807331095,-10.5,2
10:09,776431321.0,3427.079470401984,-25.97,1
10:09,235663459.0,23.8164298120152,-299.59,2
10:10,398429109.0,656.0009000000011,-66.48,2
10:11,572384506.0,7247.703181449042,-39.84,9
10:12,711045550.0,4216.794350000003,-107.81,5
10:15,127809299.0,1036.540253485056,-35.0,2
10:17,929044080.0,568.2963915056283,-45.0,2
10:18,264550521.0,9347.33031683975,-8.06,4
10:18,246753533.0,688.6899999999986,-4.95,9
10:19,421881811.0,3249.774794689407,-55.07,5
10:19,282837512.0,13567.258959680572,-5.4,9
10:30,183888402.0,17792.206803059864,-46.79,2
10:31,422955974.0,-224.57826500095007,-23.52,5
10:33,398429109.0,534.5309000000011,-121.47,2
10:34,165045150.0,-258.93893859714416,-44.94,1
10:37,929044080.0,437.0463915056283,-131.25,2
10:38,987390838.0,-2906.0312412103785,-39.49,5
10:44,637649383.0,368.1144999999982,-39.1,5
10:48,929044080.0,393.9213915056283,-43.12,2
10:49,737547541.0,-57.21240043222576,-88.72,5
10:51,475277431.0,1212.8331369436194,-10.99,4
10:54,570269025.0,2925.5998333598905,-19.99,6
10:57,165045150.0,-353.9189385971442,-94.98,2
11:03,929044080.0,252.54639150562832,-141.38,2
11:03,298000165.0,24852.287768399103,-9.99,2
11:19,821971408.0,962.7351534046048,-63.8,5
11:19,618514666.0,20665.635450858175,-149.09,2
11:23,472995101.0,2143.235350571366,-23.97,4
11:27,145387690.0,4941.186683100563,-16.37,7
11:31,424927189.0,-137.38466725589467,-53.41,5
11:37,618514666.0,20516.577450858174,-149.06,2
11:42,364357875.0,7600.426196819639,-18.6,7
11:49,280098744.0,575.4543778716657,-7.49,4
11:52,618514666.0,20489.597450858175,-26.98,4
11:57,165045150.0,-383.9089385971442,-29.99,2
11:59,687135796.0,26243.93150418657,-10.54,5
12:00,625658193.0,-31.133620243783227,-97.27,2
12:03,370521542.0,25224.07453516636,-102.39,2
12:15,970298834.0,3093.4565483210545,-5.56,7
12:16,165045150.0,-413.8989385971442,-29.99,2
12:24,625658193.0,-158.50562024378323,-127.37,2
12:27,718058208.0,2604.822718311473,-84.97,5
12:28,618514666.0,20407.725450858175,-81.87,2
12:34,308505160.0,13920.597249923216,-0.45,7
12:40,133755851.0,782.0585416180114,-39.98,4
12:43,588565416.0,7218.316204816499,-69.97,2
12:43,753525749.0,-2317.7158999999992,-37.99,5
12:45,856461967.0,-196.14164647050745,-37.74,5
12:51,909676212.0,709.7189779858976,-57.98,2
12:57,879091637.0,-253.31147626202304,-124.82,5
13:03,722358036.0,914.2209906270828,-8.3,9
13:04,348325817.0,10029.915434525874,-2.17,4
13:06,340321732.0,1655.6601500000031,-4.75,9
13:09,224215364.0,-1692.4625920882788,-9.0,5
13:09,277562576.0,715.3182982249549,-5.75,9
13:10,929044080.0,118.29639150562832,-134.25,2
13:10,711140907.0,841.4484999999993,-94.92,5
13:11,311467864.0,-846.755850000001,-131.93,5
13:13,165045150.0,-448.8989385971442,-35.0,2
13:14,687135796.0,26229.03150418657,-14.9,9
13:15,322221939.0,3925.881482767626,-83.75,5
13:19,688712152.0,6220.355044430708,-4.95,9
13:20,849096144.0,1989.8420207513416,-6.35,9
13:21,407574996.0,2280.0206228450593,-6.35,9
13:21,322221939.0,3920.181482767626,-5.7,9
13:23,929044080.0,63.92139150562832,-54.38,2
13:27,187111705.0,6670.4793839706335,-6.45,9
13:28,618514666.0,20315.171450858175,-92.55,5
13:29,499244466.0,-381.4886312834222,-108.01,5
13:30,895750759.0,-770.8204380756658,-79.66,5
13:33,625658193.0,-231.3056202437832,-72.8,2
13:36,370521542.0,25216.59375380553,-7.48,2
13:37,618514666.0,20207.371450858176,-107.8,2
13:48,165045150.0,-520.8889385971441,-71.99,2
13:48,625658193.0,-260.6776202437832,-29.37,2
13:51,554792076.0,26851.0897950115,-91.46,5
13:54,429235692.0,-1308.6045,-56.75,5
14:04,615144184.0,646.3269991255189,-51.61,5
14:19,909669130.0,271.9828847367666,-17.96,4
14:23,929044080.0,-68.45360849437168,-132.38,2
14:34,857997794.0,886.7966651508872,-24.98,4
14:37,192202372.0,99.63793388879787,-328.21,5
15:00,929044080.0,-228.57860849437168,-160.12,2
15:05,618514666.0,19984.785450858177,-222.59,2
15:11,647472692.0,24037.454643727873,-8.6,2
15:16,117308635.0,858.4550370053702,-146.22,5
15:18,388862238.0,1188.9058074744548,-39.92,4
15:24,618514666.0,19922.485450858178,-62.3,2
15:25,929044080.0,-269.4536084943717,-40.88,2
15:41,448279144.0,1077.3523499999992,-11.98,2
15:43,625658193.0,-488.1636202437832,-227.49,2
15:55,352899149.0,521.7450499999989,-56.93,1
16:27,867987292.0,4071.271509120499,-29.03,2
16:28,738958551.0,8870.060313445434,-229.6,2
16:31,605116158.0,2256.0636000000018,-57.97,4
16:34,286484726.0,849.2284200631589,-39.98,2
16:36,297823329.0,707.1436999999992,-56.99,2
16:40,738958551.0,8786.060313445434,-84.0,2
16:42,679911053.0,2565.30327156377,-43.58,7
16:51,170233640.0,104.70308994989723,-9.99,4
16:52,570323670.0,4093.6866666375186,-45.03,2
16:53,892354433.0,-1138.4299606343386,-49.97,5
16:57,128033695.0,1877.3667195546177,-6.12,7
17:00,297823329.0,646.1536999999992,-60.99,2
17:03,564744955.0,411.4288585888419,-32.72,5
17:07,478986718.0,-1081.9428000000007,-21.15,9
17:07,471897866.0,8585.164202704518,-35.27,2
17:09,221868392.0,5107.012773243957,-40.98,9
17:09,929044080.0,-314.0786084943717,-44.62,2
17:10,554792076.0,26825.535669195644,-25.55,5
17:11,581655972.0,39462.07434217525,-38.51,7
17:12,399144202.0,2457.7953326954325,-17.69,9
17:12,256045540.0,-3403.096399999999,-28.7,5
17:14,336557504.0,1273.307695019486,-13.98,1
17:14,310375875.0,3039.2053694495025,-7.69,8
17:14,670102069.0,3811.103377184679,-6.12,7
17:16,548907062.0,-32.046211231711396,-114.23,5
17:16,500043411.0,13349.77532731422,-29.75,2
17:18,108481285.0,8567.280584542714,-8.33,2
17:19,647472692.0,23998.67576372787,-38.78,4
17:19,558119802.0,32099.626494886536,-18.22,2
17:21,624500124.0,3498.2173699266946,-31.08,4
17:25,822135975.0,10894.9386509443,-6.06,4
17:26,929044080.0,-481.3286084943717,-167.25,2
17:27,519935524.0,28.082409737519036,-31.4,5
17:27,297823329.0,534.1636999999992,-111.99,2
17:28,901432314.0,3566.954182299796,-25.13,7
17:30,169006407.0,11693.476741611315,-5.0,7
17:33,610450243.0,-902.3346,-36.05,5
17:34,822718326.0,10952.01367796188,-28.41,5
17:34,405945930.0,4610.203306889241,-44.98,2
17:35,838830098.0,475.8071420877843,-28.0,6
17:36,572136270.0,-347.4718884119768,-62.04,5
17:36,687135796.0,26220.701504186567,-8.33,4
17:38,531186970.0,6946.694881634224,-9.99,4
17:39,822135975.0,10884.798650944302,-10.14,2
17:40,987163717.0,6145.348480000006,-233.8,2
17:41,519935524.0,-62.06759026248097,-90.15,2
17:42,834581602.0,419.83304999999905,-49.98,2
17:42,138609932.0,3344.0750032945853,-11.94,4
17:42,550832673.0,3065.9731344744077,-23.97,4
17:43,613729471.0,8787.347547337446,-25.87,7
17:43,886837068.0,624.5480999999994,-5.99,4
17:44,420109571.0,548.1538107166796,-29.99,2
17:46,690958123.0,19899.00543844166,-125.85,5
17:46,893134725.0,781.7540819367791,-61.25,5
17:49,886921642.0,3229.5085787002,-32.59,5
17:49,956717493.0,1164.0167610230717,-69.12,5
17:55,912705941.0,17890.456438127207,-15.51,5
17:56,370521542.0,25182.853753805524,-33.74,7
17:56,987163717.0,6092.848480000006,-52.5,2
17:57,303843160.0,205.5629000000017,-140.87,5
17:58,999752672.0,944.5035435333346,-134.5,2
17:58,237493332.0,14089.382836828256,-20.45,9
18:00,629078930.0,916.3116906575532,-112.0,2
18:00,399144202.0,2396.3703326954324,-61.42,5
18:00,868377987.0,2682.3654958778507,-117.38,2
18:00,802697323.0,15394.770614083058,-54.49,2
18:01,929044080.0,-634.3286084943717,-153.0,2
18:01,613729471.0,8774.747547337445,-12.6,5
18:03,297823329.0,367.6936999999991,-166.47,2
18:07,624563756.0,-324.33907121644364,-23.63,5
18:10,131388684.0,21077.28481297758,-32.03,5
18:10,373875019.0,16138.41201254814,-4.89,2
18:11,806358207.0,12147.861585998086,-64.1,8
18:12,610645022.0,-736.3918626449183,-72.15,5
18:15,252701364.0,-3656.791172677916,-43.34,5
18:15,629078930.0,778.4116906575533,-137.9,2
18:17,297823329.0,233.69369999999913,-134.0,2
18:19,675806859.0,6797.382573582756,-111.43,5
18:21,113747882.0,12115.391542861227,-22.37,9
18:24,975345315.0,34906.90524301254,-21.3,9
18:25,623156843.0,5489.253484924812,-44.98,7
18:25,409971170.0,2729.894392484895,-9.94,7
18:27,315546581.0,27155.106418740663,-76.43,7
18:27,897592348.0,14560.706382171067,-45.95,7
18:31,419550103.0,18737.578073848243,-2.51,5
18:32,256002321.0,6049.968853090095,-20.93,9
18:35,868377987.0,2582.2404958778507,-100.12,2
18:35,845648250.0,197.93999999999943,-56.0,5
18:37,461990622.0,10328.239227758691,-5.3,2
18:37,624500124.0,3497.264942647887,-0.95,2
18:40,221868392.0,5096.752773243957,-10.26,7
18:42,713057426.0,-102.64175000000024,-5.0,7
18:43,493571342.0,-2431.648380907048,-33.77,5
18:45,546760202.0,-1842.508027675968,-53.14,5
18:46,994214354.0,9726.215146831117,-23.8,2
18:49,234952520.0,-2087.636100000001,-34.39,5
18:49,215311171.0,6312.682141780796,-2.2,4
18:52,521611005.0,-221.42463585104647,-14.24,9
18:54,158414827.0,-1742.6100000000015,-16.93,5
18:59,510101371.0,12910.251154403924,-1.6,7
19:02,169006407.0,11679.78678327912,-13.69,7
19:03,256002321.0,6048.602449284306,-1.37,5
19:04,873693307.0,9707.783991539249,-17.45,9
19:04,885259672.0,3845.444262640279,-77.66,5
19:04,628470485.0,971.0530299001232,-246.79,5
19:05,586315521.0,11905.73957408027,-8.47,8
19:05,534325901.0,6580.155217946087,-2.28,7
19:07,785749304.0,8243.20826747503,-15.9,9
19:08,235881534.0,12656.540210432771,-145.59,5
19:09,941285623.0,-323.85160093322975,-147.31,5
19:09,340680761.0,-3043.0305999999973,-61.77,5
19:11,807714284.0,1053.184360736,-19.91,5
19:12,859603181.0,3976.843781265208,-54.73,5
19:14,985188462.0,319.4827887112247,-40.23,9
19:18,370757362.0,1508.7315898126758,-103.0,5
19:21,653640811.0,16391.970983359202,-20.72,2
19:22,535744551.0,332.79071599562604,-91.07,5
19:23,764450279.0,19602.691348494995,-124.26,5
19:23,287480331.0,10932.443965927909,-10.39,5
19:23,399144202.0,2395.715301869563,-0.66,5
19:25,120634201.0,4535.211500000007,-89.49,5
19:25,630468201.0,-610.8330338897017,-35.85,5
19:32,680773155.0,293.4509833310917,-49.86,5
19:33,131388684.0,21062.449681322192,-14.84,2
19:34,518474507.0,14793.56128585693,-12.65,5
19:41,668692488.0,1783.9963285738093,-33.11,7
19:44,873693307.0,9703.48817882464,-4.3,2
19:47,832564361.0,15617.31714406567,-21.6,7
19:55,426474982.0,-3604.33225,-13.48,5
19:56,455052690.0,-295.8412600513724,-76.69,5
19:59,556992209.0,11392.414915596575,-64.49,2
19:59,169006407.0,11570.93678327912,-108.85,5
20:00,736340277.0,8536.364934853358,-63.0,7
20:00,672913754.0,10566.551587719432,-141.79,5
20:02,435984758.0,4324.924345377467,-36.45,2
20:03,229205098.0,7375.363150789967,-91.01,5
20:05,113747882.0,12080.394607697266,-35.0,2
20:08,500051919.0,1478.5768966505905,-96.68,5
20:12,833499132.0,2112.657700000001,-50.85,5
20:18,245690309.0,9345.027205388486,-13.96,2
20:30,930271460.0,174.51219753577624,-85.86,5
20:33,851181128.0,4701.4587855572445,-29.45,9
20:38,408057540.0,4123.914220385124,-84.78,5
20:41,237493332.0,14087.50012743383,-1.88,2
20:48,264208990.0,287.60569999999876,-118.2,5
20:48,516051449.0,1690.078038940098,-77.59,5
20:50,919185264.0,3489.4172239131235,-96.91,5
20:51,414805878.0,12987.887799636386,-31.26,5
20:53,408057540.0,4120.9976230709835,-2.92,7
20:54,409971170.0,2645.7473924848955,-84.15,5
20:54,871866387.0,-205.6284000000007,-24.06,5
20:57,491392945.0,4668.343500000007,-10.21,5
21:20,705848712.0,25604.87672347685,-12.83,7
00:30,494789005.0,2926.3795082698557,-37.12,8
01:24,547010927.0,22083.061826793353,-52.73,2
01:35,809499628.0,16503.56862185734,-24.15,9
01:52,987656636.0,5928.248530347204,-16.69,7
02:34,348325817.0,9997.265434525874,-32.65,9
02:38,749378808.0,4099.8865613335975,-25.99,9
02:56,482513594.0,5728.228443260187,-10.23,2
02:58,187541224.0,2277.62000811304,-25.68,9
02:59,310375875.0,3012.6353694495024,-26.57,9
03:01,779946617.0,16422.98493356078,-34.79,7
03:02,235881534.0,12630.900210432772,-25.64,9
03:09,749378808.0,4048.537236718916,-51.35,2
03:13,633345190.0,7121.772524406042,-16.91,2
03:16,252760664.0,6788.92474223959,-5.75,2
03:19,213112754.0,6668.3992595318805,-44.1,8
03:26,709608057.0,2929.1560705270244,-34.31,9
03:30,285220959.0,11410.78401576628,-21.89,7
03:41,366550080.0,25353.207431048675,-35.75,4
03:42,822135975.0,10842.737295830975,-42.06,4
03:42,558119802.0,32077.386494886538,-22.24,9
03:46,532478725.0,4666.9089251943,-34.39,9
03:47,678851253.0,3359.448648156371,-24.13,9
03:48,151968462.0,8753.254339761772,-14.57,7
03:48,824916823.0,8544.503947997178,-13.39,2
03:49,985188462.0,281.89278871122474,-37.59,9
03:50,687135796.0,26188.212190806607,-32.49,7
03:51,490868147.0,-229.18822087869847,-22.74,9
03:53,421881811.0,3221.4612750349233,-28.31,2
03:53,408057540.0,4096.075833465803,-24.92,2
03:55,145387690.0,4902.286683100563,-38.9,9
03:57,657139925.0,13523.59614389792,-18.49,9
04:00,994214354.0,9693.515146831116,-32.7,9
04:06,187111705.0,6640.497041213694,-29.98,5
04:07,699139822.0,1617.7030624646254,-15.92,5
04:08,779236304.0,884.2875954795323,-36.58,9
04:10,885259672.0,3837.3470674734735,-8.1,7
04:11,433917275.0,7436.596085485541,-40.69,9
04:13,752362502.0,8540.906841521786,-6.45,2
04:15,399144202.0,2373.9753018695633,-21.74,9
04:16,256002321.0,6025.222449284306,-23.38,9
04:17,705848712.0,25596.636723476844,-8.24,9
04:18,822250278.0,7118.488823904604,-5.31,7
04:18,836110591.0,6772.380599406696,-30.93,9
04:20,940569402.0,6111.874878340164,-16.93,9
04:21,541639148.0,4727.251297882284,-9.04,2
04:26,324224854.0,2984.7518062652475,-10.66,2
04:26,145387690.0,4850.666560268324,-51.62,7
04:27,203466392.0,2767.499556258802,-30.05,2
04:31,766941757.0,9548.97590579314,-23.59,9
04:33,480557476.0,10866.102237913885,-17.5,7
04:34,179173981.0,4711.909600127138,-15.19,2
04:35,887853850.0,10600.186794243937,-19.34,9
04:35,534325901.0,6567.155217946087,-13.0,9
04:38,196289502.0,15298.991281813724,-5.8,7
04:40,785749304.0,8233.25826747503,-9.95,9
04:40,146909202.0,5753.4988802967755,-22.51,8
04:41,858989281.0,26281.209503393104,-13.79,9
04:41,195895574.0,7285.494927506814,-27.69,9
04:42,370521542.0,25163.981890727533,-18.87,2
04:46,399144202.0,2301.6172583285497,-72.36,8
04:46,949032480.0,4677.224913001378,-37.13,8
04:46,108931112.0,13518.064396656971,-32.11,9
04:47,873693307.0,9685.57496060594,-17.91,5
04:48,851649498.0,10094.823254310071,-30.84,7
04:48,705848712.0,25576.636925232357,-20.0,5
04:52,518474507.0,14754.43128585693,-39.13,9
05:00,960208650.0,17061.812674125096,-18.68,2
05:00,117273481.0,9233.936287205384,-19.27,8
05:02,461990622.0,10317.010831141824,-11.23,2
05:04,441274121.0,12684.654922400658,-0.66,7
05:05,613729471.0,8704.15184638255,-70.6,8
05:05,940569402.0,6029.2911873488965,-82.58,2
05:09,874431242.0,8300.55229971568,-32.24,9
05:11,290818242.0,6914.627135340041,-28.39,8
05:12,195895574.0,7218.0679747082,-67.43,2
05:13,647472692.0,23972.31227579779,-26.36,8
05:21,506618547.0,16899.709943248963,-39.91,5
05:22,886921642.0,3219.8015663290557,-9.71,2
05:23,518474507.0,14742.065703910528,-12.37,7
05:24,586315521.0,11888.608805191154,-17.13,2
05:25,558119802.0,32038.67611733311,-38.71,8
05:25,832564361.0,15611.252325717453,-6.06,5
05:25,604288474.0,2564.0153619007315,-2.5,7
05:26,409971170.0,2639.801381101066,-5.95,8
05:28,639409800.0,34362.36186876512,-10.69,4
05:28,550169791.0,20867.69009893498,-16.76,4
05:29,310375875.0,3001.598632474123,-11.04,5
05:34,534204159.0,6042.607519799206,-11.83,4
05:37,511179916.0,6679.951559861789,-9.17,5
05:38,897714622.0,8523.255382430956,-7.29,8
05:40,874431242.0,8300.049576636971,-0.5,2
05:40,887853850.0,10588.614599145109,-11.57,7
05:41,108563213.0,23171.7761581075,-37.25,5
05:43,788740658.0,3878.3215233936576,-4.22,7
05:44,678851253.0,3344.376257849642,-15.07,7
05:55,519644021.0,2909.508188377969,-33.85,2
05:59,618514666.0,19886.17808321062,-36.31,7
05:59,973086490.0,10099.98667097722,-9.99,9
06:03,216285378.0,23146.639384634916,-37.43,9
06:04,383625050.0,5767.899397465534,-14.52,2
06:06,183888402.0,17751.556803059862,-40.65,9
06:06,846550094.0,1524.607464472557,-8.25,8
06:07,905860285.0,10241.685384417531,-12.14,5
06:08,305778936.0,10157.377089099826,-42.15,8
06:10,282837512.0,13543.968959680573,-23.29,9
06:13,473820682.0,10989.889477246636,-24.81,2
06:14,730002588.0,12585.799561389138,-19.69,2
06:15,170637730.0,2729.9771307152,-12.23,7
06:23,489964679.0,20211.400958610237,-31.03,9
06:26,245690309.0,9343.300622388586,-1.73,7
06:28,128033695.0,1848.2167195546176,-29.15,9
06:31,237684254.0,5742.063487726737,-10.72,7
06:32,572384506.0,7207.373181449042,-40.33,9
06:32,700138124.0,5261.136338715381,-49.97,5
06:33,899742927.0,12288.583426815963,-22.23,5
06:38,859603181.0,3928.896897605991,-47.95,8
06:39,264550521.0,9266.495359666487,-80.83,7
06:40,675806859.0,6727.898383031202,-69.48,8
06:43,113747882.0,12049.454607697266,-30.94,9
06:43,510101371.0,12867.601154403925,-42.65,9
06:44,601627384.0,4630.02005573317,-27.04,9
06:44,718058208.0,2587.345403118164,-17.48,8
06:45,679662108.0,15628.480574134204,-47.15,2
06:47,670102069.0,3775.2733771846792,-35.83,9
06:47,287480331.0,10891.826443303962,-40.62,7
06:48,450896297.0,13131.371112585271,-25.25,9
06:49,809499628.0,16484.467528232955,-19.1,2
06:50,116598243.0,2064.71081956014,-11.29,8
06:55,496395938.0,12625.997636352931,-46.7,8
06:56,802697323.0,15357.630614083058,-37.14,9
06:56,678330503.0,2743.9018223248204,-24.46,2
06:57,556992209.0,11321.209025558765,-71.21,7
07:02,667367404.0,9262.72069375396,-56.64,8
07:02,651756497.0,13338.620073259066,-18.26,2
07:06,930277104.0,10199.301037389168,-40.08,9
07:07,417850087.0,16869.621023645712,-6.47,8
07:08,690958123.0,19889.008459480676,-10.0,2
07:09,522188082.0,7763.154940886188,-23.63,2
07:14,308505160.0,13881.246915027436,-39.35,5
07:15,575652395.0,3321.084651984503,-44.42,2
07:16,853907490.0,6975.443542990507,-9.98,7
07:17,322221939.0,3852.431512062788,-67.75,2
07:18,383833857.0,23906.47503394177,-13.39,9
07:18,670102069.0,3768.3576287852434,-6.92,5
07:18,659415300.0,3174.052540250704,-39.85,9
07:25,858989281.0,26280.050721754596,-1.16,5
07:26,992204045.0,5908.960105739997,-14.9,5
07:27,407574996.0,2260.732628375982,-19.29,5
07:28,683319988.0,7255.895434973581,-36.24,9
07:35,124102251.0,3495.019305575262,-30.75,8
07:38,364357875.0,7578.007548471907,-22.42,5
07:39,851181128.0,4668.832766381981,-32.63,2
07:44,836110591.0,6757.236269447773,-15.14,2
07:45,704517789.0,16970.334067116306,-6.98,7
07:46,229205098.0,7358.988837863538,-16.37,7
07:49,315546581.0,27145.243217762272,-9.86,7
07:50,776431321.0,3413.795686152313,-13.28,5
07:51,984783496.0,14083.282598146638,-0.74,7
07:51,315078351.0,7219.061591431591,-24.5,7
07:52,806358207.0,12145.397015045182,-2.46,5
07:55,829914501.0,898.2308065709741,-7.15,9
07:59,554792076.0,26779.85781804702,-45.68,2
08:04,454129843.0,1450.9865215607597,-5.5,9
08:05,399538448.0,7035.951843599437,-5.1,9
08:08,456221621.0,672.2875673026282,-6.8,9
08:11,241459011.0,785.5568132723472,-6.05,9
08:17,842682241.0,5249.815499663939,-22.11,7
08:17,256002321.0,5969.0491590795045,-56.17,7
08:18,331450202.0,7216.606763000576,-31.57,5
08:19,358846516.0,708.5979225272179,-5.4,9
08:21,519935524.0,-67.46759026248097,-5.4,9
08:22,380228542.0,-310.6630581844345,-6.5,9
08:22,564214408.0,-121.32191527427392,-7.32,5
08:22,426466211.0,-3221.63575,-15.58,5
08:22,690523499.0,-536.7022999999998,-56.06,5
08:23,616924659.0,-61.49292017691472,-31.98,5
08:23,885259672.0,3829.7470674734736,-7.6,9
08:25,491392945.0,4635.765500000007,-32.58,5
08:27,169006407.0,11485.114088227228,-85.82,2
08:31,604288474.0,2532.4033619007314,-31.61,5
08:32,648644594.0,-238.01895000000087,-94.28,5
08:34,662610817.0,-1217.882281324928,-95.7,5
08:37,734161378.0,-2655.4101694342125,-36.05,5
08:38,245690309.0,9289.750622388588,-53.55,5
08:38,163470640.0,1123.6275999999998,-28.32,5
08:41,262767079.0,-1151.3190500000003,-100.25,5
08:43,235663459.0,-15.896070187984805,-39.71,5
08:44,131388684.0,21009.62385273027,-52.83,5
08:44,473820682.0,10946.097477246636,-43.79,5
08:45,212560376.0,-266.19787422089786,-48.45,5
08:50,822718326.0,10939.881096823465,-12.13,7
08:55,490790931.0,177.06499999999858,-115.79,5
09:01,169006407.0,11478.914088227228,-6.2,9
09:01,414805878.0,12855.314799636386,-132.57,5
09:01,166019891.0,7736.608109021355,-28.38,5
09:02,417850087.0,16864.121023645712,-5.5,9
09:04,779946617.0,16375.77693356078,-47.21,5
09:05,581655972.0,39456.87434217525,-5.2,9
09:09,979892433.0,-1411.1821000000011,-31.63,5
09:11,999752672.0,937.7035435333346,-6.8,9
09:13,165691047.0,-341.620200000001,-59.56,5
09:15,618138606.0,1249.5643472714346,-5.5,9
09:16,834383043.0,5388.354932435833,-25.97,4
09:18,540159353.0,10988.60859487148,-7.15,9
09:19,690958123.0,19883.35845948067,-5.65,9
09:19,479366718.0,1985.6814476324007,-64.98,4
09:20,941285623.0,1526.1783990667702,-29.97,7
09:20,854895960.0,3125.2805824849147,-79.98,2
09:20,514362267.0,-409.9101808929397,-55.98,4
09:21,117273481.0,9228.836287205384,-5.1,9
09:21,506618547.0,16893.609943248965,-6.1,9
09:22,815993333.0,6219.961639061407,-30.98,1
09:22,187111705.0,6630.457041213694,-10.04,7
09:24,688712152.0,6197.395044430708,-22.96,1
09:25,985188462.0,203.3627887112247,-78.53,2
09:25,214339619.0,101.25495086835627,-7.6,9
09:27,385685918.0,400.5999408415523,-22.0,2
09:29,308897841.0,951.2338999999988,-62.86,5
09:29,642015139.0,-698.3061625343618,-46.36,5
09:30,673025413.0,3915.2061046996305,-34.28,5
09:33,414454079.0,490.5778500000019,-6.1,4
09:34,348525881.0,95.48662459493627,-15.98,2
09:38,601627384.0,4602.44005573317,-27.58,1
09:40,407574996.0,2236.672628375982,-24.06,1
09:42,896821055.0,-405.2551260602593,-35.95,1
09:42,919185264.0,3462.4572239131235,-26.96,7
09:44,639549973.0,7421.585093169843,-21.38,7
09:45,954263768.0,-203.81060000000025,-15.69,5
09:49,280098744.0,460.4843778716656,-114.97,4
09:51,570323670.0,4043.556125541092,-50.13,2
09:51,873701090.0,835.5569684511808,-36.54,7
09:52,472995101.0,2056.612450571366,-86.62,5
09:53,956717493.0,1154.0267610230717,-9.99,1
09:56,977899503.0,-417.30910641914744,-59.56,5
10:00,553734946.0,657.7069999999985,-40.99,2
10:02,304455868.0,2717.0771597158314,-100.18,2
10:03,259015404.0,1509.1473420057357,-34.71,2
10:09,549414742.0,7135.962661805197,-16.7,2
10:12,930277104.0,10183.3550481786,-15.95,5
10:16,386277162.0,376.05999999999943,-25.96,1
10:26,298007503.0,1172.1701036256334,-22.29,1
10:30,121113546.0,43.402156069869704,-134.9,5
10:37,609939116.0,7070.966222943174,-35.21,5
10:39,364357875.0,7476.724548471907,-101.28,5
10:41,348525881.0,70.5266245949363,-24.96,7
10:46,534204159.0,5956.677519799206,-85.93,4
10:46,767447966.0,4488.610065512112,-50.19,4
10:49,757115616.0,2226.9400000000037,-11.98,7
10:59,643610517.0,-2936.501190729657,-19.32,5
11:09,904154012.0,1155.9974581204322,-10.0,4
11:09,945054126.0,-379.8819,-75.34,5
11:09,494789005.0,2885.757108269856,-40.62,4
11:11,910730524.0,7936.82323942012,-11.34,7
11:22,287480331.0,10870.783183303962,-21.04,4
11:26,475277431.0,1207.3331369436194,-5.5,4
11:26,134461671.0,5570.974916111999,-1.08,2
11:40,116169597.0,950.8919499999996,-69.97,4
11:42,538003940.0,1523.9900000000086,-24.0,4
12:02,414454079.0,457.9378500000019,-32.64,9
12:03,598793068.0,777.4465999999983,-21.98,4
12:03,248142083.0,-366.8775652974833,-33.18,9
12:05,534204159.0,5946.557519799206,-10.12,7
12:06,310620484.0,142.55719509219833,-27.29,9
12:07,941285623.0,1502.1783990667702,-24.0,7
12:12,843537309.0,-1011.5597177916318,-22.68,9
12:15,364357875.0,7221.224548471907,-255.5,2
12:19,549414742.0,7121.072661805197,-14.89,9
12:27,538003940.0,1502.5000000000086,-21.49,4
12:28,433837402.0,-266.25586846418815,-30.18,9
12:30,604288474.0,2456.5133619007315,-75.89,2
12:32,348325817.0,9991.609172379664,-5.66,5
12:35,726913482.0,-998.0269485264762,-37.67,5
12:40,973086490.0,10049.18667097722,-50.8,6
12:44,364357875.0,7103.624548471907,-117.6,2
12:44,722971557.0,-305.79827915692437,-35.55,5
13:00,639549973.0,7353.839093169843,-67.75,5
13:01,910730524.0,7931.32323942012,-5.5,9
13:04,749378808.0,4042.737236718916,-5.8,9
13:04,909676212.0,630.1289779858976,-79.59,5
13:04,298000165.0,24777.5837683991,-74.7,5
13:04,948069469.0,-708.2715000000011,-11.2,9
13:05,280098744.0,418.4943778716656,-41.99,2
13:08,187111705.0,6624.407041213693,-6.05,9
13:09,259015404.0,1503.4473420057357,-5.7,9
13:11,644751433.0,-1450.1481584655382,-76.14,5
13:11,407574996.0,2230.672628375982,-6.0,9
13:12,277562576.0,707.4182982249549,-7.9,9
13:12,569687509.0,-2119.1154,-58.53,5
13:14,703537476.0,431.74924999999905,-122.11,2
13:15,849096144.0,1984.3420207513416,-5.5,9
13:15,688712152.0,6191.295044430708,-6.1,9
13:17,518466565.0,579.2934999999995,-152.52,5
13:23,902798190.0,-862.6076344310266,-107.18,5
13:29,538003940.0,1476.5200000000086,-25.98,6
13:40,998405607.0,-695.311499999998,-23.14,5
14:02,395654270.0,-2037.5187028122004,-41.27,5
14:12,639549973.0,7299.699093169843,-54.14,2
14:37,941285623.0,1495.1883990667702,-6.99,4
14:38,874506295.0,-1558.771756245572,-38.13,5
14:42,596171893.0,134.6017448255111,-24.97,7
15:04,783650950.0,-971.5666434110116,-130.43,5
15:11,132400709.0,530.7362851539398,-66.91,5
15:24,321372947.0,-377.0835507890994,-17.42,5
15:25,547010927.0,22055.76182679335,-27.3,9
15:32,744968736.0,-1583.1818265694235,-9.25,5
15:35,762859681.0,457.3950999999988,-19.34,5
15:35,990894155.0,32.67040867884151,-13.55,5
15:36,409971170.0,2629.325861101066,-10.48,4
16:23,570323670.0,4017.520115541092,-26.04,4
16:24,208381936.0,534.5144217782549,-99.99,2
16:25,679911053.0,2431.68027156377,-133.62,5
16:30,376271050.0,1346.6028069057438,-14.97,4
16:35,788740658.0,3867.331523393658,-10.99,7
16:36,345582855.0,-93.58914717945072,-43.34,5
16:38,340295966.0,-1538.6669500000005,-18.43,5
16:40,298007503.0,1088.960103625633,-83.21,2
16:42,679911053.0,2413.1566072562405,-18.52,7
16:42,104832000.0,-2874.477358905844,-11.84,5
16:43,296972867.0,-855.953600000001,-59.01,5
16:45,742223719.0,806.4816073048027,-117.17,5
16:49,399144202.0,2128.03125832855,-173.59,4
16:50,575652395.0,3293.4995919845032,-27.59,4
16:51,151916463.0,304.67155559916876,-78.07,2
16:55,294474095.0,-2272.3012864992393,-25.32,5
17:04,435313070.0,2209.8783086224644,-50.92,1
17:09,785749304.0,8228.51972814964,-4.74,5
17:10,500043411.0,13306.365945819212,-43.41,4
17:12,441142605.0,2231.4990000000057,-4.99,4
17:12,399144202.0,2065.77325832855,-62.26,7
17:15,957821152.0,-1540.4639035715495,-47.06,5
17:16,414805878.0,12828.574799636386,-26.74,9
17:17,208381936.0,515.5444217782549,-18.97,1
17:21,891716230.0,460.2084536880779,-31.98,4
17:22,245690309.0,9228.210872388589,-61.54,4
17:22,846550094.0,1490.637464472557,-33.97,4
17:24,491392945.0,4562.785500000007,-72.98,2
17:24,361201224.0,3230.6542320678923,-6.01,7
17:25,660874296.0,2306.0474499608476,-99.97,4
17:26,833899961.0,1817.9096442498696,-99.5,2
17:26,229205098.0,7305.868837863538,-53.12,2
17:26,698955014.0,1208.8668169516668,-50.98,2
17:27,196289502.0,15282.591281813726,-16.4,9
17:28,531186970.0,6896.704881634224,-49.99,2
17:29,228136274.0,1764.0822999999991,-80.36,5
17:29,893134725.0,747.7940819367791,-33.96,1
17:29,399144202.0,1945.3872583285504,-120.39,7
17:32,255814263.0,3504.052946700546,-1.99,4
17:32,587225252.0,5211.774094226142,-33.7,9
17:32,500043411.0,13232.145945819211,-74.22,4
17:33,699997811.0,1889.7361500000036,-30.96,7
17:33,314980178.0,3130.6588500000057,-44.98,2
17:33,949032480.0,4645.384913001378,-31.84,2
17:34,331450202.0,7159.303017281509,-57.3,5
17:34,532478725.0,4646.8725276289015,-20.04,5
17:34,684988568.0,-556.0384734272014,-62.94,5
17:35,647936800.0,3332.329816151634,-41.11,2
17:36,576188756.0,-3475.6064999999994,-19.78,5
17:36,836110591.0,6722.856269447773,-34.38,7
17:36,683078800.0,1794.021018035628,-9.94,2
17:37,758885184.0,654.8771822743447,-99.99,2
17:38,180616589.0,802.5047092146951,-5.99,2
17:39,228136274.0,1714.112299999999,-49.97,4
17:40,971010829.0,121.38505644424524,-40.95,7
17:42,668329719.0,8421.981777523237,-240.09,2
17:42,365608668.0,487.3250848377233,-90.3,2
17:44,229205098.0,7295.658837863538,-10.21,1
17:44,624563756.0,-381.7285712164437,-57.39,5
17:44,624500124.0,3469.8087974238133,-27.46,7
17:45,131388684.0,20958.41185273027,-51.21,5
17:46,618138606.0,1177.5743472714346,-71.99,2
17:46,833899961.0,1638.9096442498696,-179.0,2
17:48,214339619.0,81.2649508683563,-19.99,4
17:48,822135975.0,10823.487295830975,-19.25,7
17:48,887853850.0,10565.654599145108,-22.96,7
17:49,795847804.0,22386.823534731477,-55.79,2
17:51,651756497.0,13319.680073259064,-18.94,9
17:52,414805878.0,12800.020891595594,-28.55,2
17:53,785210466.0,2267.408656969547,-21.97,1
17:53,836110591.0,6626.896269447773,-95.96,2
17:53,690958123.0,19828.058459480675,-55.3,2
17:55,970298834.0,3076.949190889297,-16.51,7
17:55,668329719.0,8252.609777523237,-169.37,2
17:56,365608668.0,334.73908483772334,-152.59,2
17:57,698955014.0,1166.3768169516668,-42.49,2
17:57,506618547.0,16757.419943248966,-136.19,2
17:59,540159353.0,10987.10859487148,-1.5,4
18:04,241459011.0,772.5361132723472,-13.02,5
18:05,558119802.0,31818.17611733311,-220.5,2
18:05,631111289.0,-648.4965000000008,-18.59,5
18:06,399144202.0,1867.0012583285504,-78.39,4
18:06,117273481.0,9087.870287205384,-140.97,5
18:07,769311479.0,6949.608218902504,-0.16,2
18:09,518466565.0,543.0634999999995,-36.23,9
18:10,519935524.0,-92.54765026248096,-25.08,4
18:13,668329719.0,8107.009777523237,-145.6,2
18:14,616924659.0,-143.2429201769147,-81.75,2
18:14,173335108.0,3627.334,-33.99,9
18:14,613427466.0,6287.634956011863,-131.57,2
18:15,912705941.0,17853.88470298038,-36.57,4
18:17,237493332.0,14073.30012743383,-14.2,9
18:19,698076160.0,6034.847467900685,-72.39,5
18:20,558119802.0,31609.576117333112,-208.6,2
18:20,687135796.0,26175.97219080661,-12.24,9
18:21,719586818.0,17042.717047487244,-42.29,5
18:23,641764023.0,-1208.9488037720046,-17.95,9
18:25,698955014.0,1070.3868169516668,-95.99,2
18:27,365608668.0,307.4390848377233,-27.3,2
18:27,683319988.0,7240.593136246463,-15.3,7
18:28,949032480.0,4627.144913001378,-18.24,9
18:28,874431242.0,8293.801056636972,-6.25,7
18:28,795847804.0,22379.473220015003,-7.35,7
18:29,315546581.0,27127.193217762273,-18.05,4
18:29,690958123.0,19737.758459480676,-90.3,2
18:31,785210466.0,2192.769056969547,-74.64,5
18:32,180616589.0,765.0267092146952,-37.48,5
18:34,613427466.0,6066.448956011864,-221.19,2
18:36,108812033.0,581.6988499999984,-56.84,5
18:38,933491926.0,3006.096300000002,-85.19,5
18:39,628470485.0,961.0630299001232,-9.99,7
18:40,780463728.0,2868.28897094224,-36.47,5
18:40,706250160.0,11563.611956681623,-59.83,7
18:40,189757473.0,-2148.3986499999996,-20.98,5
18:41,639409800.0,34359.34186876512,-3.02,7
18:42,308505160.0,13841.157915027436,-40.09,5
18:42,305778936.0,10134.447089099824,-22.93,9
18:42,737645298.0,-2649.4991999999984,-34.03,5
18:46,642924505.0,244.76187018352613,-23.89,9
18:46,690958123.0,19642.603399480675,-95.16,4
18:49,461029994.0,7191.948299682366,-76.38,5
18:51,633345190.0,7088.466124406043,-33.31,7
18:51,237493332.0,14031.062774026075,-42.24,5
18:51,586041848.0,360.8786999999989,-60.63,5
18:52,282102606.0,-88.36628757717361,-78.5,5
18:57,452974357.0,-3104.6064499999948,-11.25,5
18:57,604870380.0,-1843.5090529005531,-40.84,5
18:58,736340277.0,8513.292934853358,-23.07,5
18:58,220183538.0,919.5739999999996,-141.53,5
19:00,365608668.0,252.88108483772336,-54.56,2
19:02,314980178.0,2962.3438500000057,-168.31,5
19:05,235310449.0,1831.3131848303096,-155.46,5
19:06,987163717.0,6050.298480000006,-42.55,9
19:07,601627384.0,4566.3942057482345,-36.05,2
19:09,486495235.0,1914.7246393887165,-30.84,9
19:11,383833857.0,23831.928510961552,-74.55,5
19:11,246753533.0,623.6795999999986,-65.01,5
19:14,596463612.0,-958.2126047251388,-40.31,5
19:15,200080192.0,9167.99586984196,-59.82,5
19:15,344219145.0,7439.311788764475,-72.98,5
19:16,108563213.0,23011.9241581075,-159.85,5
19:23,475117511.0,7397.147905789157,-4.79,7
19:26,256002321.0,5928.351159079504,-40.7,5
19:27,844835978.0,9550.933938921004,-52.18,5
19:29,551755686.0,6408.087655850649,-140.55,5
19:32,851181128.0,4648.802766381981,-20.03,9
19:41,198946608.0,3872.7813694690894,-3.0,5
19:41,213112754.0,6654.199259531881,-14.2,9
19:43,373163757.0,10005.163721725978,-259.14,5
19:47,108481285.0,8566.22522532138,-1.06,2
19:48,668329719.0,8087.554085171437,-19.46,8
19:49,633345190.0,7057.026124406043,-31.44,9
19:54,419550103.0,18736.18839390601,-1.39,7
19:57,280098744.0,386.4063778716656,-32.09,5
19:57,141521177.0,7039.585900000015,-99.97,5
20:02,771125520.0,1633.3670499999996,-51.45,5
20:05,860360312.0,-136.05584111731963,-128.38,5
20:06,282837512.0,13513.309175752906,-30.66,2
20:10,613729471.0,8644.13384638255,-60.02,5
20:14,200080192.0,9104.221831301656,-63.77,7
20:15,203466392.0,2715.629556258802,-51.87,5
20:20,435984758.0,4255.166756888641,-69.76,5
20:29,170233640.0,81.76058994989725,-22.94,5
20:33,865748375.0,3647.7344125503687,-26.45,9
20:33,386729293.0,30254.2323013189,-41.92,7
20:41,660789920.0,-2407.3733473823727,-29.05,5
20:41,559995067.0,3727.396260884707,-37.33,2
20:50,550832673.0,2984.717134474408,-81.26,5
20:51,315546581.0,27040.96721776227,-86.23,5
21:16,285873880.0,11400.405613409355,-24.88,7
00:14,683319988.0,7220.619108270834,-19.97,7
00:45,822250278.0,7117.293681457213,-1.2,5
01:28,541639148.0,4651.200299023006,-76.05,7
01:30,370521542.0,25116.29112347447,-47.69,4
01:44,699139822.0,1605.5430302157954,-12.16,5
02:26,985188462.0,160.72278871122472,-42.64,9
02:38,885259672.0,3787.653344706093,-42.09,5
02:40,679662108.0,15582.739914121856,-45.74,8
02:40,779946617.0,16369.434640578083,-6.34,5
02:42,851649498.0,10089.219553358642,-5.6,2
02:43,116598243.0,2032.61081956014,-32.1,9
02:49,547010927.0,22029.361826793353,-26.4,9
02:55,572384506.0,7169.523181449042,-37.85,9
02:56,170637730.0,2718.3956365789763,-11.58,5
02:58,287480331.0,10848.34318330396,-22.44,9
03:07,587225252.0,5170.624094226142,-41.15,9
03:17,853907490.0,6964.581146078874,-10.86,5
03:21,905860285.0,10232.56854948175,-9.12,2
03:31,433917275.0,7384.832781621348,-51.76,8
03:32,687135796.0,26119.393228215176,-56.58,2
03:32,195895574.0,7201.620039607745,-16.45,2
03:34,887853850.0,10547.614599145109,-18.04,9
03:40,549414742.0,7091.132661805197,-29.94,9
03:40,551196328.0,3823.94041862956,-35.33,9
03:41,414805878.0,12770.070891595591,-29.95,9
03:43,949032480.0,4595.694913001378,-31.45,9
03:43,116598243.0,2032.3358259949853,-0.27,8
03:44,601627384.0,4534.1442057482345,-32.25,9
03:44,824916823.0,8522.013947997179,-22.49,9
03:48,532478725.0,4624.932527628902,-21.94,9
03:49,134461671.0,5568.797533944539,-2.18,5
03:54,409971170.0,2622.611769668432,-6.71,2
03:55,633345190.0,7029.926124406043,-27.1,9
03:58,511179916.0,6674.010071761009,-5.94,2
04:05,324224854.0,2956.1736298575215,-28.58,2
04:05,256002321.0,5911.151159079504,-17.2,9
04:10,769311479.0,6922.011415121536,-27.6,2
04:12,203466392.0,2696.3547409327275,-19.27,7
04:14,949032480.0,4568.718875084349,-26.98,2
04:15,678851253.0,3339.0636553945956,-5.31,7
04:16,609939116.0,7066.357548632031,-4.61,2
04:20,899742927.0,12272.05411232957,-16.53,7
04:20,252760664.0,6776.356329654168,-12.57,8
04:27,910730524.0,7925.484478857033,-5.84,2
04:28,473820682.0,10914.11163296391,-31.99,7
04:29,873693307.0,9656.698806948223,-28.88,7
04:30,994214354.0,9668.625146831117,-24.89,9
04:31,187111705.0,6592.935182246838,-31.47,5
04:35,399144202.0,1831.7612583285504,-35.24,9
04:45,124102251.0,3488.6965024491656,-6.32,7
04:49,237684254.0,5719.064556393939,-23.0,8
04:51,730002588.0,12564.797303734931,-21.0,4
04:57,169006407.0,11473.326201836617,-5.59,2
04:59,586315521.0,11878.902627880045,-9.71,2
05:02,727417797.0,5360.019500000011,-34.4,9
05:02,675806859.0,6710.591356675223,-17.31,5
05:03,550169791.0,20849.66213532848,-18.03,8
05:06,613729471.0,8642.183097559871,-1.95,7
05:09,703478110.0,4765.502209495413,-25.58,2
05:12,216285378.0,23110.71938463492,-35.92,9
05:13,992204045.0,5862.432655003945,-46.53,5
05:15,489964679.0,20172.21095861024,-39.19,9
05:15,887853850.0,10545.18215746625,-2.43,7
05:15,108563213.0,23000.281328433637,-11.64,8
05:17,450896297.0,13103.301112585272,-28.07,9
05:19,506618547.0,16708.606506339715,-48.81,7
05:20,187541224.0,2244.69000811304,-32.93,9
05:21,183888402.0,17719.626803059862,-31.93,9
05:25,204855464.0,-1207.0267386396158,-26.48,9
05:25,994214354.0,9665.058533201098,-3.57,2
05:26,240643705.0,362.3057673739808,-15.72,2
05:27,752362502.0,8508.605709370218,-32.3,2
05:35,709608057.0,2892.5260705270243,-36.63,9
05:38,704517789.0,16963.991923100562,-6.34,2
05:40,785749304.0,8209.56972814964,-18.95,9
05:40,940569402.0,6016.201187348896,-13.09,9
05:45,806358207.0,12138.192160214892,-7.2,7
05:46,667367404.0,9202.851319237856,-59.87,7
05:47,424927189.0,-171.3646672558947,-33.98,9
05:47,241459011.0,752.7961132723472,-19.74,9
05:49,399144202.0,1828.457212737664,-3.3,8
05:49,417850087.0,16794.008313363167,-70.11,5
05:50,670102069.0,3736.7276287852433,-31.63,9
05:50,146909202.0,2693.1981730409984,-0.3,2
05:50,518474507.0,14718.575703910528,-23.49,9
05:52,285220959.0,11380.864553710047,-29.92,2
05:53,221868392.0,5065.1627732439565,-31.59,9
05:56,414805878.0,12757.263074919258,-12.81,7
05:59,558119802.0,31598.4051741688,-11.17,2
06:01,749378808.0,4015.2192254671063,-27.52,5
06:01,256002321.0,5898.986045147988,-12.17,8
06:03,802697323.0,15308.440614083058,-49.19,9
06:06,766941757.0,9517.25590579314,-31.72,9
06:10,832564361.0,15576.440220877186,-34.81,7
06:13,984783496.0,14040.303716412913,-42.98,7
06:13,639409800.0,34336.09768442362,-23.24,7
06:16,482513594.0,5728.069886124294,-0.16,5
06:19,738958551.0,8776.59711867185,-9.46,7
06:25,290818242.0,6891.758119844396,-22.87,2
06:27,522188082.0,7735.80383788433,-27.35,5
06:31,534325901.0,6558.973396306324,-8.18,7
06:33,960208650.0,17057.417083346107,-4.4,8
06:34,842682241.0,5246.521574280376,-3.29,2
06:34,719586818.0,17017.22809695163,-25.49,2
06:35,310375875.0,2963.162344778724,-38.44,2
06:38,859603181.0,3879.915937645607,-48.98,8
06:39,421881811.0,3173.4610784611764,-48.0,5
06:41,705848712.0,25555.81990820373,-20.82,5
06:42,912705941.0,17838.02199692941,-15.86,8
06:42,909676212.0,596.2350585311093,-33.89,2
06:43,892354433.0,-1149.4199606343386,-10.99,9
06:46,461990622.0,10310.630930557963,-6.38,7
06:47,308505160.0,13810.261666447526,-30.9,8
06:48,215311171.0,6274.446831952281,-38.24,8
06:48,322720763.0,7498.940850316114,-46.93,5
06:49,245690309.0,9159.408235520155,-68.8,7
06:50,822135975.0,10811.02066429802,-12.47,5
06:51,435984758.0,4228.955904314907,-26.21,5
06:51,305778936.0,10116.781958829264,-17.67,5
06:52,441274121.0,12683.12163849237,-1.53,5
06:52,270374623.0,9954.85041051881,-42.68,2
06:57,128033695.0,1846.9686295558552,-1.25,7
06:57,824916823.0,8509.418486391798,-12.6,5
07:02,510101371.0,12838.411154403922,-29.19,9
07:05,718058208.0,2570.49554849044,-16.85,5
07:13,858989281.0,26274.291605012513,-5.76,2
07:16,611143859.0,1379.8135000000111,-38.44,9
07:22,897714622.0,8474.725032205493,-48.53,8
07:23,736340277.0,8496.563455991081,-16.73,8
07:25,519644021.0,2908.9937045234615,-0.51,5
07:26,547010927.0,22017.7848417468,-11.58,2
07:27,383625050.0,5767.289961659379,-0.61,7
07:32,213112754.0,6635.754575855685,-18.44,2
07:39,940569402.0,6010.1818714049505,-6.02,8
07:40,383833857.0,23808.871238320735,-23.06,2
07:44,235881534.0,12583.053499577112,-5.25,5
07:44,166019891.0,7686.9944794539615,-49.61,2
07:46,264550521.0,9254.385037036094,-12.11,2
07:46,259015404.0,1462.0573420057356,-41.39,9
07:53,785749304.0,8175.263572736763,-34.31,8
07:56,987656636.0,5924.721802081657,-3.53,7
07:56,179173981.0,4704.913348134607,-7.0,7
07:57,930277104.0,10176.358391642145,-7.0,5
07:58,549414742.0,7063.9088278752115,-27.22,5
07:58,380228542.0,-315.6630581844345,-5.0,9
08:01,200080192.0,9071.097068174144,-33.12,7
08:02,604288474.0,2395.806084497802,-60.71,2
08:03,575652395.0,3283.9726495830932,-9.53,2
08:09,364357875.0,7102.945503003317,-0.68,2
08:10,795847804.0,22349.726593014067,-29.75,5
08:12,146909202.0,2688.1481730409982,-5.05,9
08:12,196289502.0,15267.841281813726,-14.75,9
08:12,395284483.0,535.7703402113085,-5.6,9
08:15,336557504.0,1266.4076950194858,-6.9,9
08:15,851181128.0,4599.210297086673,-49.59,2
08:16,455831435.0,-1763.4196048014944,-12.81,5
08:16,581655972.0,39437.02859266016,-19.85,8
08:16,456221621.0,666.1375673026282,-6.15,9
08:17,399538448.0,7028.8518435994365,-7.1,9
08:19,885259672.0,3781.153344706093,-6.5,9
08:20,527842638.0,-7.560607367016383,-5.4,9
08:24,987656636.0,5821.485802081657,-103.24,5
08:25,358846516.0,702.1979225272179,-6.4,9
08:25,873701090.0,808.4104221787945,-27.15,8
08:25,812839908.0,-1682.3498500000003,-21.35,5
08:25,519935524.0,-98.99765026248096,-6.45,9
08:27,151968462.0,6778.099339761772,-85.15,5
08:28,603375739.0,1116.013063023267,-46.37,5
08:30,155317149.0,44.90004999999914,-68.19,5
08:33,555804115.0,-1331.238547558703,-10.13,5
08:35,298000165.0,24776.66319978731,-0.92,2
08:35,954263768.0,-227.87030000000024,-24.06,5
08:37,775790822.0,-3053.538419216068,-51.68,5
08:37,279149837.0,1552.4010499999986,-46.81,5
08:37,550169791.0,20777.73013532848,-71.93,5
08:37,175452235.0,1114.84225,-6.0,9
08:38,668329719.0,8068.344428037391,-19.21,2
08:39,480557476.0,10864.939360657898,-1.16,2
08:42,290751280.0,210.5927466748256,-132.49,5
08:43,835736339.0,1778.4913520918797,-33.16,5
08:44,237493332.0,14013.502770776216,-17.56,5
08:45,225210798.0,870.0007737592086,-120.39,5
08:47,984783496.0,13943.815716412912,-96.49,5
08:50,836110591.0,6588.90511433322,-37.99,7
08:51,647472692.0,23940.875275797793,-31.44,5
08:52,822718326.0,10921.975096823464,-17.91,5
08:52,429556122.0,6127.254741187455,-49.64,7
08:53,762785862.0,-176.5013000000006,-134.5,5
08:56,215311171.0,6226.167831952282,-48.28,5
08:58,920830317.0,-207.19847936251875,-153.12,5
08:59,500843551.0,804.1738999999995,-139.33,5
09:01,344522228.0,-2798.004488208393,-4.5,5
09:02,187111705.0,6560.203182246838,-32.73,5
09:02,673025413.0,3858.7363920075463,-56.47,5
09:05,117273481.0,9081.670287205385,-6.2,9
09:06,743630833.0,173.39611328470122,-38.48,5
09:07,613729471.0,8636.783097559872,-5.4,9
09:07,558875206.0,2816.5593108989515,-5.65,9
09:08,290818242.0,6886.758119844396,-5.0,9
09:11,287480331.0,10829.064541859983,-19.28,2
09:11,383833857.0,23803.571238320736,-5.3,9
09:13,586315521.0,11872.402627880045,-6.5,9
09:15,683319988.0,7214.119108270834,-6.5,9
09:15,999752672.0,932.3035435333346,-5.4,9
09:15,575652395.0,3273.962649583093,-10.01,2
09:16,494789005.0,2847.187108269856,-38.57,5
09:18,414454079.0,447.7978500000019,-10.14,4
09:18,950234174.0,1098.4560599724932,-2.52,4
09:19,690958123.0,19634.803399480676,-7.8,9
09:19,581655972.0,39431.32859266016,-5.7,9
09:20,215426302.0,-683.7815959743082,-21.69,5
09:21,853907490.0,6924.0091460788735,-40.57,5
09:21,941285623.0,1462.2083990667702,-32.98,2
09:22,409370545.0,1312.4532755455205,-35.12,7
09:22,540159353.0,10981.35859487148,-5.75,9
09:23,534204159.0,5887.4468892517725,-59.11,5
09:23,358836279.0,218.0268428075859,-125.55,5
09:24,767447966.0,4458.560065512112,-30.05,2
09:25,192202372.0,-82.34206611120213,-31.98,4
09:25,169006407.0,11465.826201836617,-7.5,9
09:25,548907062.0,-102.0262112317114,-69.98,4
09:28,812692024.0,3500.130857948953,-35.0,2
09:28,223207876.0,785.6211000000002,-68.25,2
09:31,279149837.0,1532.4310499999983,-19.97,1
09:31,987229118.0,3667.382019293243,-23.98,2
09:33,145387690.0,4845.033825179436,-5.63,7
09:37,973388795.0,1516.0116761636216,-44.79,2
09:37,663479159.0,5134.458541827709,-195.99,2
09:39,639549973.0,7254.579093169843,-45.12,2
09:39,214765415.0,593.7906011498646,-106.5,2
09:40,385685918.0,342.6099408415523,-57.99,2
09:40,409370545.0,1251.8262755455205,-60.63,5
09:40,553734946.0,612.1278999999985,-45.58,5
09:45,322221939.0,3789.717472062788,-62.71,4
09:46,473820682.0,10910.52207296391,-3.59,4
09:46,663479159.0,5009.158541827709,-125.3,2
09:47,270374623.0,9946.72041051881,-8.13,4
09:48,405416860.0,2171.2579669583715,-16.98,7
09:50,657139925.0,13509.25766114334,-14.34,7
09:52,407574996.0,532.7076283759822,-307.97,5
09:57,143003091.0,21804.646440500856,-2.31,4
09:58,338022396.0,530.6482393757391,-82.0,2
10:00,246753533.0,587.7095999999985,-35.97,4
10:03,259015404.0,1430.4032711055213,-31.65,2
10:04,135937041.0,-1613.5610482684117,-124.47,5
10:07,172084472.0,-21.39072159571853,-131.97,2
10:10,700138124.0,5249.892545404014,-11.24,7
10:12,391688371.0,248.67329956852308,-60.46,5
10:16,280098744.0,336.4163778716656,-49.99,4
10:16,427909748.0,694.5632000000132,-55.98,4
10:17,479456865.0,1184.9673314894048,-7.99,4
10:17,663479159.0,4813.186541827709,-195.97,2
10:17,214765415.0,420.79060114986464,-173.0,2
10:34,764450279.0,19542.721348494993,-59.97,2
10:35,950234174.0,1063.1860599724932,-35.27,2
10:39,570323670.0,3998.505579479845,-19.01,7
10:40,663479159.0,4584.28654182771,-228.9,2
10:41,366550080.0,25335.29081962156,-17.92,2
10:43,541639148.0,4637.870299023006,-13.33,2
10:45,214765415.0,197.79060114986464,-223.0,2
10:46,985188462.0,138.28278871122473,-22.44,2
10:51,588565416.0,7179.471603661728,-38.84,8
10:51,254853117.0,2485.9328715412084,-270.2,2
10:54,282046994.0,-373.9546499999997,-110.5,5
10:59,857997794.0,861.8166651508872,-24.98,4
11:04,985188462.0,-25.503211288775248,-163.79,2
11:09,456246119.0,19648.068815397513,-2.99,4
11:10,857997794.0,676.8366651508871,-184.98,2
11:18,601627384.0,4531.287612901393,-2.86,2
11:22,214765415.0,143.29060114986464,-54.5,2
11:24,821971408.0,945.7551534046048,-16.98,7
11:25,970298834.0,3057.3453072555026,-19.6,7
11:27,254853117.0,2331.9328715412084,-154.0,2
11:29,776431321.0,3403.805686152313,-9.99,4
11:30,657139925.0,13494.05766114334,-15.2,9
11:34,973086490.0,10020.606507626064,-28.58,7
11:37,290751280.0,120.5927466748256,-90.0,2
11:39,519644021.0,2878.8837045234613,-30.11,2
11:39,322221939.0,3774.847825387285,-14.87,2
11:46,214765415.0,73.29060114986464,-70.0,2
11:49,519644021.0,2823.6837045234615,-55.2,2
11:49,593191200.0,1360.533149999999,-46.5,2
11:55,254853117.0,2220.6328715412083,-111.3,2
11:56,603375739.0,1101.033063023267,-14.98,7
12:00,290751280.0,-92.9072533251744,-213.5,2
12:01,421881811.0,3151.1310784611765,-22.33,4
12:03,593191200.0,1158.408149999999,-202.12,2
12:03,214765415.0,-36.20939885013536,-109.5,2
12:04,143606916.0,234.8834540291897,-29.19,9
12:07,779946617.0,16318.104640578083,-51.33,2
12:10,895331556.0,-657.9111000000008,-60.46,5
12:12,348525881.0,-19.4633754050637,-89.99,2
12:14,973086490.0,9996.166507626063,-24.44,9
12:14,214765415.0,-118.70939885013536,-82.5,2
12:15,280990953.0,264.1496999999985,-38.48,9
12:19,520447032.0,8163.354888597124,-6.63,2
12:21,290751280.0,-256.9072533251744,-164.0,2
12:24,598793068.0,673.1878999999983,-104.26,5
12:28,688712152.0,6183.742644863439,-7.55,8
12:31,593191200.0,1093.158149999999,-65.25,2
12:40,214765415.0,-197.20939885013536,-78.5,2
12:43,405416860.0,2059.7879669583717,-111.47,2
12:43,583558311.0,-753.4402152486676,-48.93,5
12:47,585133606.0,4613.4414181394695,-5.13,5
12:52,172084472.0,-38.370721595718535,-16.98,1
12:53,593191200.0,1037.658149999999,-55.5,2
12:53,948069469.0,-779.2270000000011,-70.96,5
12:54,915666111.0,-4186.852074772038,-37.29,5
12:58,695607232.0,-536.4015053894401,-58.32,5
12:59,310620484.0,55.97719509219833,-86.58,2
13:01,187111705.0,6552.703182246838,-7.5,9
13:03,764450279.0,19466.751348494992,-75.97,2
13:03,414454079.0,412.8178500000019,-34.98,9
13:04,718058208.0,2531.95554849044,-38.54,4
13:04,480557476.0,10859.839360657896,-5.1,9
13:05,564214408.0,-157.23191527427392,-35.91,5
13:07,322221939.0,3768.847825387285,-6.0,9
13:07,754141345.0,-2879.897835115761,-54.46,5
13:08,254853117.0,2040.0328715412084,-180.6,2
13:08,593191200.0,985.5331499999992,-52.12,2
13:10,469561218.0,-238.89890000000085,-151.62,5
13:11,585625048.0,1517.351183241531,-6.35,9
13:12,987656636.0,5781.225802081657,-40.26,2
13:15,259015404.0,1422.9032711055213,-7.5,9
13:16,407574996.0,524.8076283759822,-7.9,9
13:17,412823730.0,-41.119674149510274,-109.57,5
13:19,812692024.0,3493.3308579489526,-6.8,9
13:20,910730524.0,7920.784478857033,-4.7,9
13:21,405416860.0,1885.3079669583717,-174.48,2
13:22,688712152.0,6175.842644863439,-7.9,9
13:25,621181115.0,-310.20924957077114,-135.72,5
13:33,214765415.0,-364.20939885013536,-167.0,2
13:44,985188462.0,-79.38921128877524,-53.89,2
13:49,744398361.0,543.9889999999998,-149.97,2
13:52,593191200.0,916.1581499999992,-69.38,2
13:55,331048953.0,-148.18763202150635,-64.81,5
13:55,497772347.0,989.495599999998,-56.98,4
14:04,595800644.0,-1047.3333000000002,-128.38,5
14:05,985188462.0,-227.0472112887752,-147.66,2
14:08,425730826.0,1566.6619093887198,-48.55,5
14:08,593191200.0,755.2831499999991,-160.88,2
14:09,214765415.0,-434.20939885013536,-70.0,2
14:18,593191200.0,612.0331499999991,-143.25,2
14:24,973388795.0,1319.3396761636216,-196.67,2
14:38,973388795.0,990.3396761636216,-329.0,2
14:47,593191200.0,530.2831499999991,-81.75,2
14:53,828750680.0,1719.49454521368,-9.99,4
15:06,593191200.0,481.90814999999907,-48.38,2
15:16,762859681.0,442.4150999999988,-14.98,7
15:27,678330503.0,2695.252637389626,-48.65,7
15:29,762859681.0,422.4150999999988,-20.0,4
15:33,593191200.0,422.65814999999907,-59.25,2
15:35,538003940.0,1351.5300000000086,-124.99,2
15:38,163470640.0,1008.6475999999998,-114.98,2
15:46,593191200.0,268.90814999999907,-153.75,2
15:49,321372947.0,-386.3669507890994,-9.28,5
15:50,973388795.0,816.0676761636216,-174.27,2
15:53,214765415.0,-620.7093988501354,-186.5,2
16:11,985188462.0,-418.81921128877514,-191.77,2
16:13,163470640.0,935.2847999999998,-73.36,5
16:13,514362267.0,-419.9001808929397,-9.99,4
16:14,517934629.0,1140.8876787084264,-115.97,2
16:16,973388795.0,752.3676761636216,-63.7,2
16:17,698076160.0,6032.503982137873,-2.34,5
16:22,593191200.0,149.65814999999907,-119.25,2
16:22,534097839.0,-3523.701049999998,-7.87,5
16:24,214765415.0,-759.7093988501354,-139.0,2
16:27,585133606.0,4603.45141813947,-9.99,4
16:29,785210466.0,2153.799056969547,-38.97,4
16:31,985188462.0,-546.9192112887752,-128.1,2
16:32,516051449.0,1660.118038940098,-29.96,7
16:36,603721739.0,1007.668899483184,-16.97,7
16:37,886921642.0,3210.5846621635847,-9.22,5
16:38,880546403.0,-1449.8042500000015,-53.43,5
16:43,948558249.0,9086.278823414465,-196.7,2
16:43,912584712.0,425.7296195447332,-139.3,2
16:43,532478725.0,4558.407547034879,-66.52,5
16:46,993663752.0,165.95609241039654,-94.92,5
16:47,973388795.0,627.0816761636216,-125.29,2
16:47,158766229.0,-782.59198589347,-40.7,5
16:49,587225252.0,5133.359645817039,-37.26,8
16:49,467207141.0,355.2403170482637,-131.17,5
16:50,995615876.0,1941.8347896983885,-17.52,5
16:50,593191200.0,0.7831499999990683,-148.88,2
16:52,252760664.0,6696.766329654168,-79.59,5
16:54,785210466.0,2055.549056969547,-98.25,2
16:55,214765415.0,-884.2093988501354,-124.5,2
17:00,146909202.0,2616.790173040998,-71.36,4
17:01,208381936.0,430.5544217782549,-84.99,2
17:01,564744955.0,371.3160585888419,-40.11,5
17:02,303843160.0,178.59290000000166,-26.97,1
17:02,380228542.0,-390.1630581844345,-74.5,2
17:03,131388684.0,20952.334759509136,-6.08,7
17:07,776108637.0,678.3767536574958,-54.22,5
17:08,796709231.0,-441.4291221037026,-118.82,5
17:10,948558249.0,8820.978823414463,-265.3,2
17:11,581618317.0,-4844.916701873206,-19.71,5
17:14,214765415.0,-933.2093988501354,-49.0,2
17:14,836110591.0,6551.33511433322,-37.57,9
17:14,593191200.0,-51.71685000000093,-52.5,2
17:15,500043411.0,13227.208138546232,-4.94,8
17:15,788740658.0,3862.2811504199512,-5.05,2
17:17,705848712.0,25537.379908203733,-18.44,9
17:18,653640811.0,16328.910983359205,-63.06,2
17:18,992204045.0,5832.392645003945,-30.04,4
17:19,486495235.0,1839.7546393887164,-74.97,2
17:20,478412511.0,159.6629701974607,-113.79,5
17:20,454129843.0,1429.0165215607597,-21.97,7
17:21,973388795.0,407.3096761636216,-219.77,2
17:24,613729471.0,8629.713097559872,-7.07,7
17:25,994214354.0,9638.143193201098,-26.92,4
17:25,220183538.0,903.0739999999996,-16.5,7
17:27,815385232.0,9870.02823173207,-3.1,8
17:28,857754342.0,2554.1454820993827,-49.99,4
17:29,984783496.0,13890.492256412912,-53.32,4
17:29,858560423.0,11941.275784057643,-84.0,2
17:31,833899961.0,1602.9696442498696,-35.94,7
17:32,951817450.0,9722.443933522529,-48.85,5
17:32,785210466.0,1909.299056969547,-146.25,2
17:32,344219145.0,7337.321788764475,-101.99,2
17:33,146909202.0,2520.932173040998,-95.86,7
17:33,425964226.0,3535.4526500000024,-22.97,7
17:34,973388795.0,296.70967616362157,-110.6,2
17:36,417850087.0,16758.948313363166,-35.06,7
17:38,713910252.0,-217.8897242714588,-122.37,5
17:38,948558249.0,8601.878823414463,-219.1,2
17:39,703478110.0,4755.512209495413,-9.99,7
17:41,245690309.0,9138.148235520155,-21.26,7
17:43,365608668.0,248.89108483772333,-3.99,4
17:44,516051449.0,1508.2180389400978,-151.9,2
17:44,414805878.0,12702.993074919255,-54.27,2
17:45,452974357.0,-3126.8514499999947,-22.25,5
17:45,441274121.0,12680.94803849237,-2.17,4
17:46,824916823.0,8494.088486391798,-15.33,7
17:46,858560423.0,11783.775784057643,-157.5,2
17:49,593191200.0,-136.09185000000093,-84.38,2
17:49,199016328.0,6172.659979675477,-246.4,2
17:50,769311479.0,6892.851415121536,-29.16,7
17:51,450896297.0,12999.099112585272,-104.2,5
17:51,583579399.0,1268.3349499999993,-62.97,4
17:52,738958551.0,8705.777118671851,-70.82,2
17:54,719586818.0,16917.03809695163,-100.19,2
17:55,517190750.0,1541.3235899154126,-54.04,2
17:55,228136274.0,1654.1322999999993,-59.98,2
17:57,386729293.0,30193.252301318906,-60.98,2
18:00,117273481.0,9059.690287205383,-21.98,4
18:01,471897866.0,8542.324202704518,-42.84,5
18:03,985188462.0,-808.6912112887751,-261.77,2
18:08,994214354.0,9589.157193201096,-48.99,2
18:09,973388795.0,203.6236761636216,-93.09,2
18:09,558119802.0,31572.0651741688,-26.34,9
18:11,891716230.0,423.67665139261624,-36.53,7
18:14,290818242.0,6856.266119844396,-30.49,5
18:16,315546581.0,27028.352505250296,-12.61,5
18:17,587202562.0,168.52604941706863,-92.49,5
18:20,516051449.0,1340.918038940098,-167.3,2
18:25,298007503.0,1051.3201036256332,-37.64,9
18:25,147474476.0,4339.659665119361,-166.98,5
18:26,896821055.0,-441.88854073291753,-36.63,5
18:31,899742927.0,12149.51911232957,-122.53,5
18:31,985188462.0,-912.2632112887752,-103.57,2
18:32,450896297.0,12988.140111983734,-10.96,7
18:38,429556122.0,6043.170741187455,-84.08,5
18:40,687135796.0,26107.933228215177,-11.46,7
18:42,806358207.0,11971.137160214892,-167.05,5
18:49,558119802.0,31555.789134168797,-16.28,7
18:50,691012931.0,-1698.587250000001,-39.57,5
18:51,516051449.0,1277.918038940098,-63.0,2
18:51,779620857.0,-235.75634638517587,-29.99,9
18:53,518378868.0,-1454.6935500000002,-74.55,5
18:54,196289502.0,15261.075865057966,-6.77,7
19:00,807714284.0,966.242260736,-86.94,5
19:00,758160963.0,7953.815946360483,-78.3,5
19:00,252419513.0,-2118.408685813416,-113.24,5
19:01,426474982.0,-3641.72725,-37.39,5
19:04,195895574.0,7157.982039607745,-43.64,5
19:04,140893085.0,5784.049056365462,-235.18,5
19:06,383833857.0,23697.717238320736,-105.85,5
19:07,486495235.0,1752.8324893887163,-86.92,5
19:10,374994043.0,-2253.7505500000007,-61.19,5
19:13,655450953.0,-2729.1023784555296,-20.3,5
19:15,252964502.0,-761.1613724913005,-33.5,5
19:16,873693307.0,9641.708806948223,-14.99,9
19:16,518474507.0,14717.028856175217,-1.55,8
19:18,586315521.0,11789.095627880042,-83.31,5
19:19,842682241.0,5106.388574280376,-140.13,5
19:23,786141370.0,-433.9100000000008,-97.22,5
19:32,242218612.0,397.4388000000006,-16.84,5
19:32,706250160.0,11532.143378702727,-31.47,7
19:34,282837512.0,13484.159175752906,-29.15,9
19:38,482513594.0,5717.369886124294,-10.7,9
19:41,984783496.0,13867.302256412911,-23.19,9
19:42,720742759.0,1443.2578308830075,-103.5,5
19:49,336557504.0,1254.060437201019,-12.35,4
19:54,874431242.0,8261.179206022796,-32.62,2
19:56,119943495.0,-1465.625062112858,-63.41,5
19:57,951817450.0,9691.276469557217,-31.17,7
20:00,554792076.0,26735.352490437537,-44.51,8
20:00,874431242.0,8232.479206022796,-28.7,9
20:01,871866387.0,-244.5176000000007,-38.89,5
20:09,709142813.0,895.3390999999992,-59.57,5
20:12,535744551.0,298.30071599562604,-34.49,9
20:21,478986718.0,-1139.3722000000007,-57.43,5
20:28,550169791.0,20769.09013532848,-8.64,9
20:30,496395938.0,12546.253636352933,-79.74,5
20:33,670102069.0,3702.6572010593018,-34.07,7
20:46,195895574.0,7131.042039607745,-26.94,9
00:53,678851253.0,3306.9638772760172,-32.1,4
01:06,134461671.0,5563.212794012593,-5.58,5
02:22,270374623.0,9922.83997770466,-23.88,4
02:34,169006407.0,11464.259761947747,-1.57,2
02:48,623156843.0,5475.363074474428,-13.89,2
02:49,259015404.0,1383.8032711055214,-39.1,9
02:52,196289502.0,15248.845865057969,-12.23,9
02:54,534583529.0,1375.9819880547652,-13.54,9
02:58,305778936.0,10099.677630916858,-17.1,8
02:58,639409800.0,34318.09053541562,-18.01,8
02:59,145387690.0,4803.983825179435,-41.05,9
03:00,613729471.0,8628.993426180938,-0.72,5
03:11,489964679.0,20137.04095861024,-35.17,9
03:12,874431242.0,8214.512065118894,-17.97,2
03:15,120634201.0,4516.281500000006,-18.93,9
03:23,196289502.0,15210.30997761749,-38.54,2
03:24,899742927.0,12142.180639379108,-7.34,5
03:27,609939116.0,7065.37497085488,-0.98,7
03:29,370521542.0,25083.0538792606,-33.24,7
03:38,500043411.0,13213.665123646488,-13.54,5
03:39,187541224.0,2207.0500081130403,-37.64,9
03:43,510101371.0,12807.331154403922,-31.08,9
03:46,383833857.0,23614.21196282256,-83.51,5
03:48,496395938.0,12544.624778436735,-1.63,7
03:50,885259672.0,3779.3773576479775,-1.78,8
03:59,704517789.0,16936.395171645236,-27.6,8
04:00,949032480.0,4537.318875084349,-31.4,9
04:00,973086490.0,9979.166507626063,-17.0,9
04:02,108563213.0,22979.74144122474,-20.54,5
04:02,461990622.0,10238.36193130283,-72.27,8
04:03,705848712.0,25514.22990820373,-23.15,9
04:06,766941757.0,9469.375905793142,-47.88,9
04:07,108931112.0,13483.774396656972,-34.29,9
04:07,930277104.0,10145.478391642144,-30.88,9
04:08,473820682.0,10898.452311696596,-12.07,7
04:11,987163717.0,6017.318480000006,-32.98,9
04:17,324224854.0,2951.1669152579425,-5.01,7
04:18,414805878.0,12674.773074919258,-28.22,9
04:21,532478725.0,4528.717547034879,-29.69,9
04:21,145387690.0,4770.687472970494,-33.3,2
04:25,259015404.0,1370.363476935905,-13.44,4
04:29,138969884.0,779.3398999999994,-23.95,9
04:31,973086490.0,9945.84654008597,-33.32,2
04:32,815385232.0,9856.98823173207,-13.04,9
04:40,282837512.0,13463.209175752903,-20.95,9
04:40,887853850.0,10515.50215746625,-29.68,9
04:42,187111705.0,6552.450432191918,-0.25,4
04:43,450896297.0,12968.200111983731,-19.94,9
04:43,706250160.0,11493.027219245869,-39.12,8
04:45,482513594.0,5650.242776856712,-67.13,5
04:48,113747882.0,12017.134607697266,-32.32,9
04:48,683319988.0,7185.239108270834,-28.88,9
04:54,310375875.0,2945.975101819453,-17.19,8
04:58,851181128.0,4573.230297086673,-25.98,9
04:59,824916823.0,8462.198486391799,-31.89,9
05:00,383625050.0,5767.1984801398485,-0.09,7
05:03,930277104.0,10143.270972560744,-2.21,7
05:03,815385232.0,9840.02497980091,-16.96,5
05:04,550169791.0,20745.217257671397,-23.87,5
05:06,670102069.0,3669.167201059302,-33.49,9
05:07,985188462.0,-944.0032112887752,-31.74,9
05:09,785749304.0,8162.3135727367635,-12.95,9
05:09,421881811.0,3116.483283329296,-34.65,2
05:11,203466392.0,2679.800101252148,-16.55,2
05:14,992204045.0,5822.586123147318,-9.81,7
05:15,221868392.0,5053.174156082015,-11.99,5
05:15,532478725.0,4515.6864155567155,-13.03,7
05:16,752362502.0,8501.302447494028,-7.3,2
05:17,518474507.0,14680.188856175217,-36.84,9
05:19,887853850.0,10511.875749089812,-3.63,7
05:31,547010927.0,21986.7948417468,-30.99,9
05:32,558119802.0,31529.3091341688,-26.48,9
05:34,264550521.0,9235.515687127683,-18.87,5
05:36,108481285.0,8483.971438064054,-19.37,2
05:37,851181128.0,4532.351339157664,-40.88,7
05:38,715068825.0,-607.1330000000003,-27.84,9
05:38,399144202.0,1794.287212737664,-34.17,9
05:39,441274121.0,12644.295264996616,-36.65,5
05:39,719586818.0,16898.909609020022,-18.13,7
05:39,308505160.0,13798.08044568023,-12.18,2
05:39,858989281.0,26231.521605012513,-12.45,9
05:40,788740658.0,3845.014852770457,-17.27,7
05:42,769311479.0,6891.795990333397,-1.06,7
05:42,285220959.0,11370.054297933251,-10.81,7
05:44,601627384.0,4494.597612901393,-36.69,9
05:47,675806859.0,6650.74551626681,-59.85,7
05:48,108931112.0,13483.18283243921,-0.59,5
05:50,237493332.0,14004.737744707238,-8.77,8
05:52,730002588.0,12550.19205500771,-14.61,5
05:54,433917275.0,7344.837282979584,-40.0,4
05:57,198946608.0,3844.8358419399033,-27.95,2
05:58,709608057.0,2864.726070527024,-27.8,9
06:04,151968462.0,6720.618516398897,-57.48,2
06:05,435984758.0,4216.341618000113,-12.61,5
06:06,183888402.0,17680.666803059863,-38.96,9
06:07,450896297.0,12965.95603112906,-2.24,7
06:07,699139822.0,1574.1392742557618,-31.4,7
06:08,949032480.0,4515.301796221099,-22.02,5
06:08,195895574.0,7105.752039607745,-25.29,9
06:13,593378953.0,673.9696500000051,-38.39,9
06:14,795847804.0,22334.0614496413,-15.67,5
06:17,229205098.0,7230.530432248891,-65.13,8
06:17,858989281.0,26200.13388752394,-31.39,2
06:21,549414742.0,7037.178827875212,-26.73,9
06:24,143003091.0,21799.147359285216,-5.5,8
06:26,128033695.0,1812.3578246079553,-34.61,8
06:28,216285378.0,23075.78938463492,-34.93,9
06:30,802697323.0,15270.860614083058,-37.58,9
06:31,633345190.0,6993.236124406043,-36.69,9
06:32,683319988.0,7152.9952967622685,-32.24,2
06:32,518474507.0,14677.195416629138,-2.99,4
06:38,604288474.0,2389.7918412577556,-6.01,5
06:42,836110591.0,6521.29511433322,-30.04,9
06:43,853907490.0,6911.7591460788735,-12.25,9
06:52,549414742.0,7019.952748060083,-17.23,5
06:56,124102251.0,3477.5230782667495,-11.17,8
06:57,718058208.0,2531.1418126507274,-0.81,7
07:02,651756497.0,13295.287710816438,-24.39,7
07:02,534325901.0,6551.983396306324,-6.99,9
07:02,624500124.0,3465.6919201874944,-4.12,7
07:02,480557476.0,10857.191269007051,-2.65,2
07:03,668329719.0,8043.534510350957,-24.81,7
07:03,912705941.0,17828.05589490888,-9.97,2
07:05,252760664.0,6627.022091230476,-69.74,7
07:05,417850087.0,16754.10192734417,-4.85,5
07:08,940569402.0,5991.741871404951,-18.44,9
07:10,905860285.0,10222.942320712373,-9.63,8
07:10,785749304.0,8139.123662814483,-23.19,7
07:11,256002321.0,5866.485009210488,-32.5,2
07:12,673025413.0,3825.131351692175,-33.61,7
07:13,836110591.0,6469.947940769815,-51.35,5
07:15,315546581.0,27008.139251761513,-20.21,2
07:15,687135796.0,26084.003228215177,-23.93,9
07:29,408057540.0,3997.4768831095353,-60.42,5
07:29,806358207.0,11959.48944424456,-11.65,7
07:31,679911053.0,2399.4719722793448,-13.68,7
07:39,454356905.0,1122.4285745304828,-28.13,9
07:40,897714622.0,8470.056443341882,-4.67,7
07:41,679662108.0,15564.945310186544,-17.79,8
07:42,853907490.0,6911.640287959592,-0.12,2
07:47,541639148.0,4629.50486715009,-8.37,7
07:53,519644021.0,2801.6429039410887,-22.04,8
08:02,290818242.0,6840.7146745024775,-15.55,2
08:04,519935524.0,-106.09765026248095,-7.1,9
08:09,558119802.0,31507.368324640574,-21.94,5
08:09,749378808.0,3929.516310507341,-85.7,7
08:15,679943657.0,5233.370447816685,-58.51,8
08:17,522188082.0,7691.585663810149,-44.22,7
08:19,744398361.0,530.3389999999998,-13.65,5
08:21,527842638.0,-14.160607367016382,-6.6,9
08:21,822135975.0,10799.61688613219,-11.4,5
08:21,399538448.0,7022.801843599436,-6.05,9
08:25,873701090.0,737.6233312724798,-70.79,5
08:26,245198540.0,-174.27360119822052,-7.14,5
08:27,321372947.0,-402.0476507890994,-15.68,5
08:32,237493332.0,13988.945744707238,-15.79,5
08:32,504055745.0,-357.81843865823316,-79.36,5
08:33,699313649.0,-2198.1133991419056,-19.41,5
08:34,897714622.0,8446.158443341883,-23.9,5
08:34,175452235.0,1020.57325,-94.27,5
08:34,424397946.0,3667.609783605399,-86.0,5
08:35,215832575.0,-1525.3419637442196,-51.84,5
08:35,820686957.0,-846.8623163111959,-27.05,5
08:36,422955974.0,-292.5080150009501,-67.93,5
08:36,116598243.0,2013.64817009894,-18.69,2
08:36,373875019.0,16090.15401254814,-48.26,5
08:38,494156986.0,-683.9000543276651,-24.03,5
08:39,229502829.0,-3562.9233741862477,-133.03,5
08:39,547010927.0,21983.249755628414,-3.55,7
08:43,104832000.0,-2907.897358905844,-33.42,5
08:43,237684254.0,5707.0383152812765,-12.03,2
08:43,346874167.0,106.80164999999904,-48.58,5
08:46,213112754.0,6600.068575855686,-35.69,5
08:47,822718326.0,10891.749096823463,-30.23,5
08:47,572384506.0,7137.823181449042,-31.7,9
08:47,213112754.0,6539.875805382409,-60.19,8
08:51,355733816.0,4872.724913842311,-8.37,8
08:52,191161970.0,-3646.319999999996,-81.19,5
08:52,195895574.0,7094.177144490169,-11.57,2
08:55,111137699.0,-222.82389999999955,-87.3,5
09:00,691843653.0,-3007.675899999994,-24.42,5
09:03,564744955.0,365.8660585888419,-5.45,9
09:06,235881534.0,12541.837457947262,-41.22,5
09:06,423208402.0,1083.0707500000026,-51.83,5
09:08,284905540.0,7534.986176042516,-159.4,5
09:11,979892433.0,-1474.942300000001,-63.76,5
09:13,635679314.0,-2898.9783291195185,-35.3,5
09:14,750094757.0,-2024.4943000000003,-68.77,5
09:15,383833857.0,23608.56196282256,-5.65,9
09:16,613729471.0,8623.943426180938,-5.05,9
09:17,663479159.0,4571.30654182771,-12.98,7
09:17,361201224.0,3220.624232067892,-10.03,2
09:18,903468956.0,413.5359999999994,-62.06,5
09:20,741903302.0,2098.6265587407875,-5.4,9
09:20,138609932.0,3334.1250032945854,-9.95,4
09:21,752362502.0,8474.292447494028,-27.01,7
09:21,690958123.0,19528.713399480675,-106.09,2
09:22,627622066.0,3174.5608047156616,-47.98,2
09:22,322720763.0,7492.940850316114,-6.0,7
09:23,709935470.0,-158.0192623002276,-22.61,5
09:24,833499132.0,2095.677700000001,-16.98,7
09:24,188263947.0,-22.2505999999995,-49.99,2
09:27,365608668.0,239.80695202418875,-9.08,5
09:28,242218612.0,372.4388000000006,-25.0,2
09:28,117273481.0,9042.720287205384,-16.97,7
09:28,405416860.0,1857.3079669583717,-28.0,2
09:29,235310449.0,1727.7131848303095,-103.6,2
09:29,822250278.0,7078.625359373034,-38.67,5
09:30,678330503.0,2687.346212974471,-7.91,8
09:32,624563756.0,-416.7285712164437,-35.0,2
09:32,322221939.0,3746.314957169024,-22.53,2
09:33,196289502.0,15086.43797761749,-123.87,2
09:33,259015404.0,1338.073476935905,-32.29,7
09:34,627917561.0,3452.1550500000044,-25.0,2
09:35,667367404.0,9181.372968968188,-13.58,2
09:35,425730826.0,1516.6719093887198,-49.99,2
09:35,441274121.0,12437.823264996616,-206.47,2
09:37,512989907.0,-2340.089403975366,-42.56,5
09:38,511179916.0,6610.901873683573,-63.11,7
09:38,553734946.0,567.1478999999985,-44.98,2
09:39,108481285.0,8423.921438064055,-60.05,2
09:39,179173981.0,4666.461179962455,-38.45,7
09:39,482513594.0,5627.6727768567125,-22.57,2
09:40,361201224.0,3215.614232067892,-5.01,7
09:41,856461967.0,-307.0636464705075,-110.92,5
09:41,213112754.0,6474.445805382409,-65.43,2
09:42,802697323.0,15210.038629948484,-60.82,5
09:42,282837512.0,13459.395582684869,-3.81,4
09:42,639549973.0,7238.925578281506,-15.65,2
09:42,480557476.0,10778.497269007054,-78.69,5
09:43,235310449.0,1566.7131848303095,-161.0,2
09:45,450896297.0,12860.58124112906,-105.37,4
09:46,196289502.0,15028.40797761749,-58.03,2
09:47,310620484.0,35.847195092198334,-20.13,2
09:48,601627384.0,4446.537612901393,-48.06,2
09:48,194745206.0,573.5403720912431,-45.12,2
09:49,254853117.0,2002.0428715412083,-37.99,7
09:51,832564361.0,15543.330220877186,-33.11,2
09:53,586315521.0,11776.595627880042,-12.5,7
09:53,500051919.0,1408.5968966505905,-69.98,2
09:54,699139822.0,1513.4592742557618,-60.68,4
09:55,713641917.0,1120.5705352159157,-28.0,2
09:55,461990622.0,9952.76193130283,-285.6,2
09:55,403383649.0,1759.5077637323432,-34.98,1
09:56,821971408.0,897.7651534046047,-47.99,2
09:56,134461671.0,5525.142794012593,-38.07,6
09:56,975345315.0,34759.91524301254,-146.99,2
09:57,570269025.0,2915.8526570451277,-9.75,7
09:57,124102251.0,3445.6030782667494,-31.92,4
09:58,633345190.0,6982.946152575138,-10.29,8
09:59,220183538.0,822.5839999999996,-80.49,2
10:00,282837512.0,13426.475582684869,-32.92,2
10:02,510101371.0,12780.681154403925,-26.65,4
10:02,285428103.0,9173.117491187382,-92.34,5
10:02,187111705.0,6546.420432191918,-6.03,7
10:02,405945930.0,4477.253306889241,-106.98,2
10:05,449387287.0,476.3416938351015,-32.95,7
10:06,322720763.0,7469.76035622892,-23.18,5
10:06,520447032.0,8143.533159821996,-19.82,7
10:07,146909202.0,2487.1349015466267,-33.8,8
10:09,315546581.0,26922.89925176151,-85.24,2
10:09,496395938.0,12451.538778436738,-93.09,2
10:10,842682241.0,5106.2823631879855,-0.11,2
10:12,223207876.0,572.8211000000002,-212.8,2
10:14,706361191.0,105.068648494078,-84.31,5
10:15,851649498.0,10079.913963932648,-9.31,2
10:15,678330503.0,2535.406212974471,-151.94,2
10:15,248658670.0,308.7066500000002,-40.99,2
10:16,348525881.0,-153.3233754050637,-133.86,2
10:16,975345315.0,34738.93524301254,-20.98,4
10:16,835736339.0,1721.4413520918797,-57.05,2
10:19,491392945.0,4546.815500000007,-15.97,1
10:24,235310449.0,1321.7131848303095,-245.0,2
10:24,287480331.0,7583.820285687398,-15.24,2
10:26,208381936.0,380.5544217782549,-50.0,2
10:26,857754342.0,2494.1454820993827,-60.0,2
10:27,730002588.0,12541.51767500771,-8.67,4
10:27,478412511.0,142.68297019746072,-16.98,7
10:27,441142605.0,2110.602000000006,-120.9,5
10:29,441274121.0,12341.251264996616,-96.57,2
10:30,779946617.0,16307.99799978503,-10.11,2
10:32,496395938.0,12322.094778436738,-129.44,2
10:32,583579399.0,1248.3449499999992,-19.99,2
10:33,433917275.0,7310.717282979584,-34.12,4
10:33,220183538.0,734.1139999999996,-88.47,2
10:34,449387287.0,456.3516938351015,-19.99,2
10:36,143061865.0,6713.7724188178445,-88.94,5
10:37,223207876.0,460.82110000000023,-112.0,2
10:38,690958123.0,19472.683399480677,-56.03,2
10:39,421881811.0,3080.374643329296,-36.11,4
10:39,315078351.0,7198.750391431591,-20.31,4
10:39,365608668.0,226.81695202418877,-12.99,2
10:40,331450202.0,7150.855367973418,-8.45,5
10:40,832564361.0,15512.81717214514,-30.51,5
10:44,893134725.0,706.8040819367791,-40.99,2
10:47,124102251.0,3319.6330782667496,-125.97,2
10:47,715068825.0,1234.8869999999995,-87.98,2
10:52,235310449.0,1166.3131848303096,-155.4,2
10:52,414454079.0,408.7778500000019,-4.04,4
10:54,441274121.0,12125.679264996616,-215.57,2
10:55,500043411.0,13182.745123646488,-30.92,7
10:57,220183538.0,662.6239999999996,-71.49,2
10:59,990461108.0,208.45796862061104,-37.95,1
11:00,187541224.0,2078.2780081130404,-128.77,2
11:00,596171893.0,107.6417448255111,-26.96,1
11:01,475277431.0,1190.8331369436194,-16.5,4
11:01,699997811.0,1727.2361500000036,-162.5,2
11:03,822718326.0,10769.949096823464,-121.8,2
11:05,657139925.0,13487.288286569954,-6.77,8
11:06,916270283.0,1999.0782499999996,-72.98,2
11:06,605116158.0,2226.073600000002,-29.99,4
11:07,266777719.0,658.8689337802396,-18.75,2
11:09,913801979.0,229.6506299144939,-91.89,5
11:09,245690309.0,9124.695206157035,-13.45,5
11:10,627917561.0,3447.1650500000046,-4.99,7
11:12,143061865.0,6678.782418817845,-34.99,2
11:12,792845450.0,752.0531500000011,-25.97,1
11:14,588565416.0,7174.443816557443,-5.03,5
11:17,471897866.0,8453.344202704518,-88.98,4
11:18,441274121.0,12020.007264996617,-105.67,2
11:18,736340277.0,8492.922256069696,-3.64,2
11:20,653640811.0,16287.920983359203,-40.99,1
11:20,986774156.0,3811.2969316257686,-6.99,7
11:20,366550080.0,25328.580140220536,-6.71,5
11:21,699997811.0,1612.2361500000036,-115.0,2
11:22,461990622.0,9824.66193130283,-128.1,2
11:23,628470485.0,913.0630299001232,-48.0,4
11:24,570410059.0,1666.68974677631,-172.77,5
11:26,715068825.0,1150.9069999999997,-83.98,2
11:28,166019891.0,7656.168879453961,-30.83,4
11:29,220183538.0,606.6539999999995,-55.97,2
11:29,874431242.0,8048.102065118894,-166.41,2
11:29,822718326.0,10565.563096823464,-204.39,2
11:30,904154012.0,1121.047458120432,-34.95,7
11:30,859603181.0,3872.915937645607,-7.0,1
11:30,559995067.0,3685.9024715298583,-41.49,5
11:31,792845450.0,729.0831500000011,-22.97,4
11:31,435984758.0,4190.259558000113,-26.08,4
11:34,266777719.0,574.4939337802396,-84.38,2
11:35,506618547.0,16705.379993676706,-3.23,8
11:37,461990622.0,9636.36193130283,-188.3,2
11:37,187541224.0,1861.2920081130403,-216.99,2
11:38,370757362.0,1428.7515898126758,-79.98,2
11:40,586315521.0,11776.086829107291,-0.51,8
11:42,878989510.0,3728.77588614179,-187.68,5
11:42,220183538.0,433.16399999999953,-173.49,2
11:46,916270283.0,1972.1182499999995,-26.96,1
11:48,973388795.0,186.6236761636216,-17.0,7
11:48,742223719.0,724.5016073048026,-81.98,2
11:49,223207876.0,58.32110000000023,-402.5,2
11:50,802697323.0,15203.450909948486,-6.59,4
11:54,235310449.0,967.5131848303096,-198.8,2
11:55,627622066.0,3049.374554715662,-125.19,5
11:55,348525881.0,-250.0508754050637,-96.73,2
11:55,540159353.0,10968.07259487148,-13.29,7
11:56,822718326.0,10377.291096823465,-188.27,2
11:56,266777719.0,530.2439337802396,-44.25,2
11:57,441274121.0,11813.563264996616,-206.44,2
11:58,909676212.0,582.4194045320274,-13.82,5
11:58,823208989.0,1974.1747138695312,-29.43,4
11:59,601627384.0,4400.504303763086,-46.03,5
12:01,844835978.0,9513.963938921004,-36.97,4
12:02,196289502.0,14994.807977617487,-33.6,4
12:03,429556122.0,5737.270741187455,-305.9,2
12:04,699997811.0,1385.2361500000036,-227.0,2
12:04,586315521.0,11742.756829107291,-33.33,2
12:04,134847904.0,3911.442044386295,-90.98,2
12:06,223207876.0,-157.27889999999977,-215.6,2
12:10,433917275.0,7286.827282979584,-23.89,9
12:10,143061865.0,6636.133336922142,-42.65,7
12:11,235310449.0,768.7131848303097,-198.8,2
12:14,348525881.0,-280.04337540506367,-29.99,2
12:16,310375875.0,2944.369301819453,-1.61,4
12:17,844835978.0,9499.19773620515,-14.77,5
12:19,520447032.0,8114.673159821997,-28.86,9
12:20,925659248.0,-690.9381892295712,-36.63,9
12:20,237493332.0,13978.905744707235,-10.04,9
12:22,187541224.0,1687.6920081130406,-173.6,2
12:24,235310449.0,639.9131848303098,-128.8,2
12:24,441274121.0,11646.305264996616,-167.26,2
12:28,134461671.0,5492.172794012593,-32.97,9
12:28,540159353.0,10781.88659487148,-186.19,4
12:29,225210798.0,848.0207737592086,-21.98,4
12:29,417850087.0,16553.22992734417,-200.87,2
12:30,266777719.0,498.7439337802395,-31.5,2
12:33,736340277.0,8476.932256069696,-15.99,9
12:33,310375875.0,2907.529301819453,-36.84,9
12:35,441274121.0,11466.433264996616,-179.87,2
12:35,196289502.0,14942.91797761749,-51.89,1
12:35,766941757.0,9427.195006751866,-42.18,5
12:36,943329213.0,1633.8077241813244,-15.04,7
12:37,885259672.0,3739.3173376479776,-40.06,4
12:37,598793068.0,633.2378999999983,-39.95,7
12:40,758160963.0,7942.795946360483,-11.02,7
12:42,494789005.0,2817.563895874934,-29.62,2
12:43,331450202.0,7138.915367973418,-11.94,9
12:44,586315521.0,11729.256829107291,-13.5,9
12:44,423208402.0,1061.0907500000026,-21.98,4
12:44,843174694.0,-4789.715999999998,-14.3,5
12:45,235310449.0,541.9131848303098,-98.0,2
12:45,572384506.0,7106.693181449042,-31.13,7
12:46,187541224.0,1582.7200081130406,-104.97,2
12:46,315078351.0,7111.060391431592,-87.69,2
12:47,348525881.0,-343.4033754050637,-63.36,2
12:48,461990622.0,9420.76193130283,-215.6,2
12:50,496395938.0,12080.608778436736,-241.49,2
12:51,441142605.0,2105.612000000006,-4.99,4
12:51,500843551.0,704.1938999999995,-99.98,4
12:52,823208989.0,1856.254713869531,-117.92,2
12:52,348325817.0,9981.169172379665,-10.44,2
12:52,496674181.0,-1292.0160723307224,-54.44,5
12:56,213096759.0,-1415.1291082144396,-46.61,5
12:57,248625662.0,-1131.7919157151475,-53.51,5
12:57,806358207.0,11884.30944424456,-75.18,2
12:58,572384506.0,7092.2231814490415,-14.47,4
12:59,661295096.0,3246.7358399041514,-7.49,4
12:59,540159353.0,10656.60059487148,-125.29,2
13:00,417850087.0,16357.24392734417,-195.99,2
13:01,277562576.0,699.9182982249549,-7.5,9
13:02,698955014.0,1005.4068169516668,-64.98,4
13:02,266777719.0,394.4939337802395,-104.25,2
13:02,480557476.0,10773.547269007053,-4.95,9
13:05,858560423.0,11718.795784057646,-64.98,2
13:05,429556122.0,5653.270741187455,-84.0,2
13:06,187111705.0,6539.620432191918,-6.8,9
13:07,220183538.0,314.6939999999995,-118.47,2
13:07,998390769.0,-389.0269490594758,-153.54,5
13:07,496395938.0,12002.250778436735,-78.36,2
13:07,585625048.0,1511.2511832415312,-6.1,9
13:07,348525881.0,-373.3958754050637,-29.99,2
13:07,672913754.0,10550.658602804551,-15.89,2
13:09,859603181.0,3759.116937645607,-113.8,5
13:09,806358207.0,11860.99024424456,-23.32,4
13:09,441274121.0,11316.661264996616,-149.77,2
13:10,200080192.0,9049.917068174143,-21.18,1
13:10,792845450.0,704.0831500000011,-25.0,2
13:11,503575533.0,6302.60288693877,-13.0,2
13:11,866941383.0,1455.8560500000062,-46.0,5
13:17,189335192.0,-1088.0608017578602,-68.97,5
13:17,270374623.0,9890.93397770466,-31.91,5
13:20,220183538.0,207.2039999999995,-107.49,2
13:20,749371623.0,-2566.3716535173426,-17.62,5
13:20,749378808.0,3924.016310507341,-5.5,9
13:21,204855464.0,-1490.416488639616,-283.39,5
13:22,572333122.0,-3582.1250499999965,-65.91,5
13:22,433917275.0,7190.677282979585,-96.15,2
13:24,699997811.0,1172.2361500000036,-213.0,2
13:26,540159353.0,10635.62859487148,-20.97,2
13:28,672913754.0,10523.698602804552,-26.96,7
13:28,531186970.0,6648.246881634224,-248.46,2
13:29,143061865.0,6569.153336922142,-66.98,2
13:31,858560423.0,11715.305784057646,-3.49,4
13:32,575652395.0,3250.319687459238,-23.64,8
13:32,994214354.0,9556.817193201096,-32.34,9
13:33,496395938.0,11777.564778436736,-224.69,2
13:34,138609932.0,3292.5450032945855,-41.58,5
13:35,949032480.0,4489.831796221099,-25.47,1
13:42,221356538.0,399.8018999999997,-179.59,5
13:43,441274121.0,11269.651264996615,-47.01,2
13:46,461990622.0,9364.76193130283,-56.0,2
13:47,143061865.0,6556.163336922143,-12.99,2
13:48,986267641.0,7394.289093942687,-29.77,8
13:49,690523499.0,-665.6391499999997,-128.94,5
13:49,699997811.0,1075.2361500000036,-97.0,2
13:50,534204159.0,5863.311914886649,-24.13,5
13:51,235310449.0,485.9131848303098,-56.0,2
13:52,471897866.0,8411.495067379685,-41.85,5
13:53,969697937.0,-4656.567765670551,-40.02,5
13:56,487051121.0,871.4605121466681,-12.43,7
13:56,531186970.0,6514.574881634225,-133.67,2
13:57,449387287.0,359.2476938351015,-97.1,5
13:59,975345315.0,34708.84924301253,-30.09,5
14:00,348525881.0,-439.3883754050637,-65.99,2
14:01,741269136.0,3295.9884500000007,-9.99,1
14:01,220183538.0,96.73399999999953,-110.47,2
14:03,390747457.0,325.373799999998,-71.0,5
14:03,605116158.0,2173.073600000002,-53.0,2
14:03,496395938.0,11715.292778436737,-62.27,2
14:06,690958123.0,19450.663399480676,-22.02,2
14:06,223207876.0,-397.37889999999976,-240.1,2
14:06,878989510.0,3694.79588614179,-33.98,2
14:08,392790315.0,-4354.991394372066,-63.47,5
14:08,441274121.0,11208.065264996616,-61.59,2
14:09,461990622.0,9122.56193130283,-242.2,2
14:09,994214354.0,9522.35586349604,-34.46,2
14:09,241459011.0,697.1223132723471,-55.67,5
14:10,387957305.0,-2617.708605980079,-57.78,5
14:13,782013626.0,1393.5721993116283,-79.0,6
14:13,699997811.0,985.7361500000036,-89.5,2
14:14,348525881.0,-515.5058754050638,-76.12,2
14:17,235310449.0,342.4131848303098,-143.5,2
14:20,986267641.0,7307.622093942687,-86.67,5
14:24,373163757.0,9997.163721725978,-8.0,4
14:25,868033067.0,-2288.758286451082,-36.27,5
14:26,235310449.0,238.11318483030976,-104.3,2
14:26,454356905.0,1102.117374530483,-20.31,4
14:28,699997811.0,864.2361500000036,-121.5,2
14:32,200080192.0,9042.03734292091,-7.88,2
14:32,489964679.0,20116.03095861024,-21.01,2
14:32,221868392.0,4986.314156082015,-66.86,2
14:36,496395938.0,11545.920778436735,-169.37,2
14:36,223207876.0,-549.9788999999997,-152.6,2
14:37,657139925.0,13429.076286569954,-58.21,5
14:38,859603181.0,3716.722494022909,-42.39,7
14:44,461990622.0,8920.961931302829,-201.6,2
14:49,235310449.0,80.61318483030976,-157.5,2
14:58,828750680.0,1578.51454521368,-140.98,2
15:13,828750680.0,1540.0445452136798,-38.47,2
15:14,235310449.0,-120.98681516969025,-201.6,2
15:17,223207876.0,-660.5788999999997,-110.6,2
15:27,699997811.0,754.7361500000036,-109.5,2
15:36,287480331.0,7548.600285687397,-35.22,9
15:39,581655972.0,39337.64059266016,-93.69,5
15:40,223207876.0,-898.5788999999997,-238.0,2
15:40,673025413.0,3799.322351692175,-25.81,5
15:43,235310449.0,-419.8868151696902,-298.9,2
15:46,699997811.0,704.7361500000036,-50.0,2
16:15,699997811.0,591.2361500000036,-113.5,2
16:17,587225252.0,5094.139645817038,-39.22,9
16:19,348525881.0,-593.8658754050638,-78.36,2
16:25,229205098.0,7190.720432248891,-39.81,7
16:26,613427466.0,6032.798956011864,-33.65,9
16:27,709608057.0,2833.5269012872545,-31.2,2
16:28,574548998.0,-171.01180000000076,-32.34,9
16:28,699997811.0,472.2361500000036,-119.0,2
16:28,867987292.0,4006.426657382282,-64.84,5
16:32,392270893.0,12431.272923210365,-6.41,7
16:37,461990622.0,8829.961931302829,-91.0,2
16:38,180616589.0,741.8767092146952,-23.15,9
16:41,348525881.0,-609.6008754050638,-15.73,2
16:41,235310449.0,-604.6868151696901,-184.8,2
16:43,223207876.0,-1149.1788999999997,-250.6,2
16:48,699997811.0,347.7361500000036,-124.5,2
16:49,517934629.0,1086.8976787084264,-53.99,2
16:51,995615876.0,1873.2466896983883,-68.59,5
16:55,348525881.0,-679.3358754050638,-69.73,2
16:59,489964679.0,20108.306108610243,-7.72,4
16:59,235310449.0,-868.5868151696901,-263.9,2
16:59,399144202.0,1783.319854791196,-10.97,5
17:14,699997811.0,277.7361500000036,-70.0,2
17:17,673818591.0,1159.156775375841,-139.0,2
17:22,912584712.0,410.7496195447331,-14.98,1
17:23,386729293.0,30186.90206774088,-6.35,8
17:25,809499628.0,16416.896654529035,-22.15,9
17:27,235310449.0,-965.88681516969,-97.3,2
17:29,187541224.0,1425.2340081130403,-157.49,2
17:29,256002321.0,5855.585009210488,-10.9,9
17:30,348525881.0,-701.8283754050638,-22.49,2
17:33,828750680.0,1432.5545452136798,-107.49,2
17:38,613427466.0,5984.981956011864,-47.82,5
17:42,673818591.0,1114.156775375841,-45.0,2
17:43,348525881.0,-746.0783754050638,-44.25,2
17:46,461990622.0,8675.961931302829,-154.0,2
17:46,581655972.0,39311.67059266016,-25.97,7
17:48,703478110.0,4720.562209495413,-34.95,7
17:51,675806859.0,6590.52551626681,-60.22,2
17:56,912584712.0,348.48461954473316,-62.27,5
17:56,373875019.0,15831.85401254814,-258.3,4
18:08,348525881.0,-845.0783754050638,-99.0,2
18:08,454356905.0,1070.5937918905488,-31.52,2
18:09,235310449.0,-1266.8868151696902,-301.0,2
18:09,886921642.0,3181.7726621635848,-28.81,5
18:13,865748375.0,3621.249229718812,-26.49,5
18:22,461990622.0,8547.861931302828,-128.1,2
18:25,106601471.0,10046.12162497633,-211.4,2
18:26,376271050.0,1329.6228069057438,-16.98,7
18:31,373875019.0,15679.25401254814,-152.6,7
18:32,235310449.0,-1429.98681516969,-163.1,2
18:32,943329213.0,1624.9027252610515,-8.9,2
18:36,996042490.0,5560.059696170786,-134.65,5
18:40,338022396.0,488.6135893757391,-42.03,5
18:42,551755686.0,6399.097655850649,-8.99,7
18:42,151968462.0,6713.611516398897,-7.01,7
18:44,719742742.0,-1087.1800077779633,-22.69,5
18:45,741903302.0,2065.1504587407876,-33.48,5
18:45,348525881.0,-902.0483754050638,-56.97,2
18:48,984783496.0,13857.28201127924,-10.02,8
18:48,403902116.0,368.2793999999992,-32.88,9
18:54,550832673.0,2956.747134474408,-27.97,7
19:02,932820758.0,-2499.506566775554,-17.3,5
19:04,604288474.0,2336.8998412577557,-52.89,5
19:04,687135796.0,26060.23610650244,-23.77,2
19:18,768271776.0,-598.8309967665795,-93.39,5
19:45,654329190.0,-117.8365990514807,-92.89,5
19:58,129018172.0,8366.786896282198,-261.07,5
20:09,213112754.0,6461.105805382409,-13.34,9
20:10,398429109.0,507.6582500000011,-26.87,5
20:10,285873880.0,11382.175613409356,-18.23,9
20:13,581655972.0,39277.61692649432,-34.05,2
20:14,738958551.0,8705.198062074738,-0.58,8
20:15,762700245.0,-385.0072999999975,-43.03,5
20:20,348525881.0,-942.9833754050636,-40.94,5
20:20,678330503.0,2347.645212974471,-187.76,5
20:22,472213568.0,-495.99044420605327,-66.95,5
20:25,741269136.0,3208.8384500000006,-87.15,5
20:27,984783496.0,13846.28201127924,-11.0,9
20:31,170233640.0,55.28693994989725,-26.47,5
20:54,762859681.0,398.3100999999988,-24.11,5
00:11,795847804.0,22319.87469762769,-14.19,7
00:13,324224854.0,2928.726225684554,-22.44,5
00:15,704517789.0,16929.83794321939,-6.56,4
00:17,905860285.0,10175.81235853182,-47.13,8
00:26,878989510.0,3678.56588614179,-16.23,9
00:31,885259672.0,3739.257860115035,-0.06,2
00:31,940569402.0,5969.1418714049505,-22.6,9
00:39,815385232.0,9791.36070435903,-48.66,5
00:41,601627384.0,4376.264303763086,-24.24,9
00:47,482513594.0,5595.122655266465,-32.55,7
00:49,719586818.0,16887.70578322069,-11.2,5
00:56,802697323.0,15193.657823106723,-9.79,5
00:57,806358207.0,11839.853146318148,-21.14,2
00:59,473820682.0,10891.377778503553,-7.07,7
00:59,433837402.0,-312.59586846418813,-46.34,9
01:01,200080192.0,8968.059819364682,-73.98,7
01:04,887853850.0,10508.140246156345,-3.74,5
01:05,414454079.0,374.0178500000019,-34.76,9
01:05,873693307.0,9587.868191395572,-19.2,9
01:09,858989281.0,26189.75388752394,-10.38,9
01:11,417850087.0,16336.268234457091,-20.98,4
01:11,874431242.0,8023.162065118894,-24.94,9
01:19,853907490.0,6893.694524898728,-17.95,8
01:20,196289502.0,14924.717977617487,-18.2,9
01:31,450896297.0,12822.49124112906,-38.09,9
01:32,851181128.0,4510.553968263858,-21.8,5
01:41,433917275.0,7170.737282979585,-19.94,9
01:43,471897866.0,8399.906768403602,-11.59,7
01:45,290818242.0,6820.670930256929,-20.04,2
01:46,235881534.0,12539.885304663872,-1.95,5
01:47,421881811.0,3066.8551037230773,-13.52,5
01:48,454129843.0,1385.54889516656,-43.47,5
01:50,169006407.0,11457.666814236049,-6.59,5
02:01,519644021.0,2788.016841664451,-13.63,8
02:06,832564361.0,15502.77717214514,-10.04,9
02:09,651756497.0,11562.940794017142,-62.35,7
02:13,145387690.0,4765.484862034968,-5.2,7
02:17,441274121.0,11200.179339837288,-7.89,2
02:22,518474507.0,14652.825416629135,-24.37,9
02:24,506618547.0,16627.779430747563,-77.6,5
02:36,572384506.0,7049.123181449041,-43.1,9
02:36,836110591.0,6430.467940769816,-39.48,9
02:37,832564361.0,15489.11101211931,-13.67,2
02:41,534325901.0,6532.533396306324,-19.45,9
02:45,873693307.0,9517.27966272722,-70.59,2
02:47,433917275.0,7128.707688884316,-42.03,8
02:48,237493332.0,13974.574738546256,-4.33,2
02:48,633345190.0,6949.376152575138,-33.57,9
02:50,653640811.0,16274.00572694858,-13.92,7
02:54,570269025.0,2896.1026570451277,-19.75,9
02:57,705848712.0,25507.563215778653,-6.67,2
03:04,940569402.0,5962.16537213229,-6.98,2
03:05,435984758.0,4177.9448072397645,-12.31,2
03:13,518474507.0,14645.10727602811,-7.72,2
03:14,824916823.0,8453.538935958122,-8.66,7
03:18,496395938.0,11537.322499718764,-8.6,5
03:19,587225252.0,5060.399645817039,-33.74,9
03:23,987656636.0,5761.84627230067,-19.38,7
03:23,497772347.0,966.345599999998,-23.15,9
03:25,730002588.0,12465.37910071262,-76.14,2
03:29,151968462.0,6677.075584740583,-36.54,5
03:33,575652395.0,3236.7725750440945,-13.55,8
03:37,586315521.0,11719.312159386776,-9.94,7
03:37,897592348.0,14540.271968797628,-20.43,7
03:37,179173981.0,4655.000883749662,-11.46,7
03:40,108931112.0,13476.799956139534,-6.38,2
03:43,146909202.0,2474.1858625645327,-12.95,7
03:46,601627384.0,4367.357921976346,-8.91,7
03:48,780463728.0,2829.8489709422397,-38.44,9
03:55,912705941.0,17771.06921623891,-56.99,5
03:57,822135975.0,10770.499083871267,-29.12,5
03:57,699139822.0,1506.7104198685654,-6.75,5
04:01,851181128.0,4468.683968263858,-41.87,9
04:01,541639148.0,4622.507657668172,-7.0,2
04:06,305778936.0,10072.19763091686,-27.48,9
04:13,802697323.0,15147.717823106725,-45.94,9
04:16,106601471.0,10007.04162497633,-39.08,9
04:17,256002321.0,5849.637733370626,-5.95,5
04:19,308505160.0,13797.474752253242,-0.61,5
04:20,187541224.0,1385.1440081130406,-40.09,9
04:24,282837512.0,13404.24774603716,-22.23,7
04:28,532478725.0,4478.4364155567155,-37.25,9
04:33,559995067.0,3657.3024715298584,-28.6,9
04:34,264550521.0,9227.893150795191,-7.62,7
04:36,348325817.0,9953.719172379662,-27.45,9
04:36,547010927.0,21951.059755628416,-32.19,9
04:38,456246119.0,19631.112066565147,-16.96,5
04:38,706250160.0,11475.946508492263,-17.08,5
04:39,255814263.0,3497.1578815504904,-6.9,7
04:39,216285378.0,23049.61938463492,-26.17,9
04:43,203466392.0,2626.8040497513907,-53.0,5
04:46,687135796.0,26051.59610650244,-8.64,9
04:47,657139925.0,13413.776286569955,-15.3,9
04:53,776431321.0,3398.8549671072524,-4.95,8
04:57,116598243.0,2010.1985647487816,-3.45,2
05:00,587225252.0,5047.060074031467,-13.34,2
05:04,550169791.0,20743.858680812293,-1.36,7
05:05,766941757.0,9391.905006751866,-35.29,9
05:08,858989281.0,26187.83156006256,-1.92,5
05:08,500043411.0,13112.910704001564,-69.83,5
05:09,675806859.0,6557.307577815892,-33.22,2
05:10,675231808.0,16179.46600127281,-36.85,2
05:13,668329719.0,8033.860840354365,-9.67,5
05:16,229205098.0,7173.760541316257,-16.96,8
05:17,704517789.0,16909.15794321939,-20.68,9
05:20,183888402.0,17644.58680305986,-36.08,9
05:24,187111705.0,6534.294459821383,-5.33,7
05:26,106601471.0,10000.499284226167,-6.54,5
05:27,984783496.0,13829.424986008533,-16.86,5
05:28,270374623.0,9885.04144873541,-5.89,8
05:29,749378808.0,3916.118424177912,-7.9,2
05:29,145387690.0,4731.684862034967,-33.8,9
05:31,510101371.0,12746.051154403924,-34.63,9
05:44,554792076.0,26717.62997773854,-17.72,2
05:47,613729471.0,8623.029231430164,-0.91,2
05:55,711045550.0,4183.224350000003,-33.57,9
05:56,670102069.0,3640.487201059302,-28.68,9
05:57,414805878.0,12646.283074919258,-28.49,9
05:58,718058208.0,2495.7556999022995,-35.39,2
06:01,399144202.0,1744.6698547911958,-38.65,9
06:03,383625050.0,5765.416339186936,-1.78,5
06:13,558119802.0,31499.07659885461,-8.29,7
06:15,899742927.0,12142.077155209545,-0.1,5
06:15,215311171.0,6194.413088980693,-31.75,2
06:16,639549973.0,7232.086458076416,-6.84,7
06:16,679662108.0,15543.004187527931,-21.94,2
06:17,949032480.0,4483.529721176272,-6.3,8
06:18,874431242.0,8018.7975668126255,-4.36,2
06:18,195895574.0,7063.2471444901685,-30.93,9
06:21,124102251.0,3309.396517770587,-10.24,7
06:25,851649498.0,10066.163963932648,-13.75,9
06:33,305778936.0,10071.193355853242,-1.0,7
06:33,930277104.0,10110.703371641996,-32.57,2
06:36,414805878.0,12616.516074722002,-29.77,7
06:42,252760664.0,6584.5613915292415,-42.46,2
06:45,609939116.0,7045.317920100591,-20.06,5
06:48,315546581.0,26911.196243813512,-11.7,7
06:49,828532554.0,302.2668765071483,-19.04,7
06:49,195895574.0,7048.100409875634,-15.15,5
06:49,709608057.0,2788.7469012872543,-44.78,9
06:54,985188462.0,-501.7332112887751,-27.73,9
06:54,678851253.0,3301.88703855999,-5.08,5
06:58,549414742.0,6987.032748060083,-32.92,9
06:58,534325901.0,6520.887675557471,-11.65,2
07:00,842682241.0,5044.8323484206885,-61.45,7
07:01,779236304.0,851.8375954795323,-32.45,9
07:02,822250278.0,7034.348809550924,-44.28,7
07:03,785749304.0,8101.776459705387,-37.35,8
07:04,851649498.0,10051.574788392792,-14.59,2
07:07,588565416.0,7169.7054396180665,-4.74,7
07:11,461990622.0,8511.604031920897,-36.26,7
07:11,322221939.0,3744.609116204126,-1.71,8
07:16,245690309.0,9120.364156111496,-4.33,5
07:22,386729293.0,30185.356023218756,-1.55,7
07:24,213112754.0,6458.678728174128,-2.43,8
07:27,897714622.0,8431.58362354693,-14.57,2
07:29,489964679.0,20065.206108610244,-43.1,9
07:35,237684254.0,5681.803785382185,-25.23,7
07:47,673025413.0,3798.217151140848,-1.11,2
07:48,700138124.0,5186.655351794728,-63.24,7
07:49,532478725.0,4474.447692234071,-3.99,8
07:55,494789005.0,2814.5629892830143,-3.0,5
07:56,259015404.0,1335.6821299704968,-2.39,7
07:58,383833857.0,23607.45852365664,-1.1,5
08:06,170637730.0,2716.286942748871,-2.11,5
08:11,678330503.0,2338.988322023324,-8.66,5
08:14,683319988.0,7146.16719737246,-6.83,5
08:21,120634201.0,4492.051500000007,-24.23,9
08:22,522188082.0,7669.035456355128,-22.55,7
08:24,624500124.0,3450.2782480068386,-15.41,5
08:25,108481285.0,8377.455798765171,-46.47,7
08:25,315078351.0,7099.230067094549,-11.83,8
08:26,407574996.0,521.403880073912,-3.4,5
08:30,108563213.0,22966.452325485225,-13.29,8
08:30,310375875.0,2881.639301819453,-25.89,9
08:34,752362502.0,8437.111137011658,-37.18,7
08:36,736340277.0,8475.0517749558,-1.88,2
08:40,809499628.0,16398.556654529035,-18.34,9
08:44,285220959.0,11353.127898942965,-16.93,5
08:48,166019891.0,7587.553105406887,-68.62,2
08:52,973086490.0,9933.73264118608,-12.11,5
08:52,639409800.0,34286.73756977651,-31.35,2
08:59,113747882.0,11945.722695792729,-71.41,7
09:03,581655972.0,39208.795178850974,-68.82,2
09:15,865748375.0,3600.259229718812,-20.99,1
09:16,121858569.0,315.5511500000025,-11.98,6
09:17,986774156.0,3805.306931625769,-5.99,7
09:20,672913754.0,10518.16526159575,-5.53,7
09:22,450896297.0,12818.672713637678,-3.82,2
09:23,361201224.0,3205.5842320678917,-10.03,7
09:23,280098744.0,334.9163778716656,-1.5,4
09:23,541639148.0,4611.9911576681725,-10.52,4
09:24,187541224.0,1358.5340081130407,-26.61,7
09:25,187541224.0,1319.982650716096,-38.55,2
09:25,832564361.0,15475.21096211931,-13.9,4
09:25,886837068.0,596.5480999999994,-28.0,6
09:26,461029994.0,7101.978299682366,-89.97,4
09:26,143061865.0,6517.213336922143,-38.95,1
09:26,264550521.0,9210.843150795192,-17.05,7
09:32,255814263.0,3469.1978815504904,-27.96,1
09:32,769311479.0,6861.40370436939,-30.39,7
09:39,905860285.0,10148.512358531822,-27.3,2
09:41,518474507.0,14519.10727602811,-126.0,2
09:43,364357875.0,7079.592979756512,-23.35,2
09:43,736340277.0,8454.5317749558,-20.52,7
09:48,951817450.0,9471.504469557214,-131.6,2
09:48,859603181.0,3478.0364940229083,-238.69,2
09:49,873701090.0,690.9234903039921,-46.7,7
09:49,859603181.0,3446.351620338608,-31.68,5
09:49,851649498.0,10014.474788392792,-37.1,1
09:52,975345315.0,34514.94924301253,-193.9,2
09:53,822718326.0,10367.301096823465,-9.99,7
09:54,506618547.0,16586.479430747564,-41.3,2
09:56,147474476.0,4103.073665119361,-236.59,2
09:58,866941383.0,1434.8860500000062,-20.97,1
10:01,500843551.0,639.6938999999995,-64.5,2
10:02,704517789.0,16877.86794321939,-31.29,7
10:02,514362267.0,-499.87018089293974,-79.97,4
10:05,419550103.0,18536.085718732604,-175.69,2
10:05,113747882.0,11921.052695792729,-24.67,1
10:07,134461671.0,5454.165760498112,-38.01,5
10:07,903663593.0,909.507055859541,-31.96,7
10:08,480557476.0,10770.308188872144,-3.24,8
10:08,975345315.0,34510.443836040904,-4.51,4
10:09,624563756.0,-566.7085712164436,-149.98,2
10:13,905860285.0,9916.112358531822,-232.4,2
10:13,518474507.0,14309.80727602811,-209.3,2
10:14,506618547.0,16470.979430747564,-115.5,2
10:14,762896656.0,-84.73500184814131,-45.03,2
10:17,618138606.0,1055.5843472714346,-121.99,6
10:18,970298834.0,3046.387879171679,-10.96,8
10:19,639549973.0,7200.586458076416,-31.5,2
10:19,176922958.0,847.8015471976495,-101.49,2
10:19,668175891.0,369.84322315849903,-24.94,5
10:20,215311171.0,6031.423088980693,-162.99,6
10:21,623156843.0,5296.191074474428,-179.17,2
10:22,254853117.0,1996.6709144468448,-5.37,8
10:23,433917275.0,7076.977688884316,-51.73,2
10:23,158414827.0,-1749.7600000000016,-7.15,5
10:24,314980178.0,2832.3638500000056,-129.98,2
10:24,656812046.0,569.4307537325188,-68.17,2
10:25,815993333.0,6181.931639061408,-38.03,2
10:25,767447966.0,4430.500065512111,-28.06,2
10:27,795847804.0,22282.37469762769,-37.5,1
10:27,822135975.0,10745.129083871268,-25.37,2
10:28,713057426.0,-129.02675000000022,-26.38,5
10:28,188263947.0,-113.2305999999995,-90.98,2
10:29,986267641.0,7261.757784102976,-45.86,2
10:29,419550103.0,18330.3277187326,-205.76,2
10:29,364357875.0,7039.842979756512,-39.75,2
10:29,355733816.0,4854.754913842311,-17.97,7
10:29,250895529.0,386.00428246928834,-90.33,5
10:30,466649401.0,461.0219113978914,-54.95,4
10:30,876890798.0,2825.7829706999314,-59.99,2
10:31,667367404.0,9130.372968968188,-51.0,2
10:32,743630833.0,101.9161132847012,-71.48,4
10:33,384497904.0,547.7806499999991,-47.88,5
10:33,489964679.0,20028.904912638587,-36.3,2
10:35,350921975.0,-386.9915289261256,-132.71,5
10:36,779376323.0,2717.6937666549406,-24.0,4
10:36,834581602.0,389.84304999999904,-29.99,4
10:37,828532554.0,260.2768765071483,-41.99,2
10:38,585625048.0,1431.2611832415312,-79.99,2
10:39,736310094.0,-783.9218240274259,-24.99,5
10:39,329840194.0,190.50189014314796,-67.81,5
10:40,246753533.0,546.7195999999985,-40.99,2
10:40,957821152.0,-1642.5081535715497,-102.04,5
10:40,518474507.0,14122.20727602811,-187.6,2
10:41,449871732.0,10092.76280165523,-33.96,7
10:43,183186021.0,-295.2975499999989,-34.39,5
10:43,912705941.0,17707.02921623891,-64.04,2
10:44,605711527.0,-295.28748616741643,-130.22,5
10:44,506618547.0,16449.979430747564,-21.0,2
10:45,726913482.0,-1070.9242485264765,-72.9,5
10:45,819515373.0,2485.391286063792,-51.97,4
10:46,905860285.0,9849.612358531822,-66.5,2
10:47,970298834.0,2896.097879171679,-150.29,2
10:49,893134725.0,648.4569819367791,-58.35,5
10:49,672994751.0,-161.13370921398996,-9.99,7
10:49,345582855.0,-154.99524717945073,-61.41,5
10:50,736340277.0,8390.8597749558,-63.67,5
10:51,166019891.0,7568.947105406887,-18.61,5
10:51,897592348.0,14529.291968797628,-10.98,1
10:52,147474476.0,3963.115665119361,-139.96,2
10:54,140893085.0,5753.059056365462,-30.99,2
10:54,490868147.0,-349.2242208786985,-120.04,5
10:55,197050303.0,283.20943256349506,-25.98,2
10:55,779376323.0,2665.7137666549406,-51.98,2
10:56,618138606.0,922.9966472714344,-132.59,5
10:56,688712152.0,6112.8626448634395,-62.98,2
10:56,856147482.0,-896.2751985986248,-151.62,5
10:56,639549973.0,7179.586458076416,-21.0,2
10:56,858989281.0,26127.11156006256,-60.72,2
10:56,308068836.0,176.6215225681922,-28.03,2
10:57,147341222.0,-1768.1909253207957,-150.66,5
10:57,506618547.0,16352.679430747565,-97.3,2
11:00,766941757.0,9365.786616200952,-26.12,5
11:00,987163717.0,5925.0784800000065,-92.24,2
11:01,352899149.0,509.7650499999989,-11.98,2
11:01,500843551.0,394.19389999999953,-141.5,2
11:02,366550080.0,25276.21786440597,-52.36,7
11:03,951817450.0,9402.918469557217,-68.59,2
11:03,859603181.0,3428.879620338608,-17.47,2
11:04,518474507.0,14059.90727602811,-62.3,2
11:07,833899961.0,1556.5858942498696,-46.38,5
11:07,146686559.0,-658.9381111734779,-79.02,5
11:11,395284483.0,469.8933402113085,-65.88,5
11:11,586041848.0,308.8986999999988,-51.98,2
11:12,905860285.0,9696.312358531824,-153.3,2
11:12,792845450.0,606.286150000001,-97.8,5
11:13,310620484.0,9.687195092198332,-26.16,2
11:16,769319491.0,1364.1019999999994,-35.98,2
11:16,471897866.0,8074.434768403602,-325.47,2
11:16,615144184.0,550.7465491255189,-95.58,5
11:17,639549973.0,7116.586458076416,-63.0,2
11:17,448004226.0,1840.328710862856,-20.98,4
11:20,781554833.0,1953.5406319437236,-50.0,2
11:22,491392945.0,4494.245500000007,-52.57,5
11:23,500843551.0,307.69389999999953,-86.5,2
11:25,987229118.0,3632.422019293243,-34.96,7
11:25,951817450.0,9315.432469557214,-87.49,2
11:26,471897866.0,7928.162768403602,-146.27,2
11:27,771125520.0,1570.3770499999996,-62.99,2
11:28,108931112.0,13468.734696139534,-8.07,4
11:29,758160963.0,7930.68849183713,-12.11,5
11:30,224112146.0,282.2622999999986,-161.08,5
11:31,449871732.0,10008.79280165523,-83.97,2
11:35,639549973.0,7032.586458076416,-84.0,2
11:35,910730524.0,7900.769408769631,-20.02,5
11:37,975345315.0,34336.843836040905,-173.6,2
11:37,633345190.0,6926.538945999846,-22.84,2
11:39,909669130.0,247.9628847367666,-24.02,4
11:40,166019891.0,7553.957105406887,-14.99,9
11:41,419550103.0,18048.241718732603,-282.09,2
11:43,494156462.0,-1100.0458364817605,-143.86,5
11:43,402438092.0,624.8294999999988,-28.0,2
11:45,874431242.0,7955.517566812626,-63.28,2
11:45,849096144.0,1852.0420207513416,-132.3,2
11:46,951817450.0,9197.160469557211,-118.27,2
11:47,822135975.0,10740.059083871269,-5.07,4
11:48,184430449.0,1935.948363885164,-31.96,1
11:48,340321732.0,1570.680150000003,-84.98,2
11:49,905860285.0,9633.312358531824,-63.0,2
11:50,822250278.0,7032.261889550924,-2.09,4
11:51,987163717.0,5918.938480000006,-6.14,2
11:54,331450202.0,7121.251014409599,-17.66,2
11:56,604334058.0,506.80389999999943,-36.98,4
11:58,303843160.0,128.60290000000165,-49.99,4
11:58,623156843.0,5272.060826976348,-24.13,2
11:59,113747882.0,11908.762695792728,-12.29,4
12:01,308068836.0,33.94752256819223,-142.67,5
12:02,131388684.0,20887.844759509135,-64.49,2
12:02,975345315.0,34100.943836040904,-235.9,2
12:03,639549973.0,6858.286458076416,-174.3,2
12:03,471897866.0,7814.062768403602,-114.1,2
12:03,867987292.0,3947.127844838212,-59.3,8
12:04,170637730.0,2665.695202748871,-50.59,4
12:05,442070890.0,918.9724124443712,-19.9,9
12:05,644751433.0,-1479.3481584655383,-29.2,9
12:06,849096144.0,1796.7420207513417,-55.3,2
12:06,482513594.0,5573.016655266465,-22.11,5
12:07,994214354.0,9483.78586349604,-38.57,9
12:08,259015404.0,1300.4921299704968,-35.19,9
12:09,169006407.0,11429.596814236049,-28.07,1
12:09,126929801.0,2009.892106340476,-59.46,2
12:10,951817450.0,9006.088469557213,-191.07,2
12:12,992204045.0,5788.146123147319,-34.44,9
12:17,213112754.0,6437.648728174128,-21.03,9
12:18,419550103.0,17857.883718732603,-190.36,2
12:18,905860285.0,9606.012358531823,-27.3,2
12:19,639549973.0,6655.986458076416,-202.3,2
12:19,849096144.0,1707.1840207513417,-89.56,2
12:21,859603181.0,3366.5796203386076,-62.3,2
12:22,887853850.0,10469.550246156345,-38.59,9
12:22,623156843.0,5126.516826976348,-145.54,2
12:26,229205098.0,7160.8105413162575,-12.95,9
12:27,639409800.0,34281.70756977651,-5.03,7
12:27,822718326.0,10291.311096823463,-75.99,2
12:28,166019891.0,7521.517105406888,-32.44,2
12:29,519644021.0,2737.637841664451,-50.38,5
12:29,720742759.0,1399.2878308830077,-43.97,2
12:36,423208402.0,948.1007500000026,-112.99,2
12:37,951817450.0,8875.902469557213,-130.19,2
12:41,639549973.0,6508.986458076416,-147.0,2
12:41,975345315.0,34030.943836040904,-70.0,2
12:42,322221939.0,3649.941116204126,-94.67,5
12:43,905860285.0,9512.212358531824,-93.8,2
12:46,845648250.0,105.31214999999943,-92.63,5
12:47,570323670.0,3974.184948020328,-24.32,7
12:48,683319988.0,7114.71719737246,-31.45,9
12:48,623156843.0,5036.216826976348,-90.3,2
12:49,799861885.0,-35.77115000000117,-98.65,5
12:49,558119802.0,31477.48659885461,-21.59,9
12:49,215426302.0,-693.5675959743081,-9.79,5
12:49,540159353.0,10586.11059487148,-49.52,5
12:51,555804115.0,-1342.128547558703,-10.89,5
12:52,609939116.0,7015.147920100591,-30.17,2
12:53,994214354.0,9467.465605235771,-16.32,5
12:54,639549973.0,6426.386458076416,-82.6,2
12:54,975345315.0,33918.943836040904,-112.0,2
12:54,785749304.0,8089.526459705387,-12.25,9
12:55,887156614.0,-1092.9778710407736,-149.31,5
12:56,849096144.0,1665.8840207513415,-41.3,2
12:57,859603181.0,3296.6216203386075,-69.96,2
12:58,455831435.0,-1784.3146048014944,-20.89,5
12:58,965038148.0,-656.4200143676723,-43.47,5
12:59,299871610.0,329.05315305876655,-59.98,2
12:59,992204045.0,5759.477393258441,-28.67,8
13:01,698955014.0,919.7415169516668,-85.67,5
13:05,905860285.0,9240.612358531824,-271.6,2
13:08,623156843.0,4884.316826976348,-151.9,2
13:09,639549973.0,6210.786458076415,-215.6,2
13:09,500843551.0,277.7038999999995,-29.99,2
13:10,849096144.0,1575.6120207513418,-90.27,2
13:10,812692024.0,3487.9308579489525,-5.4,9
13:11,500043411.0,13071.792704001564,-41.12,5
13:11,322221939.0,3642.341116204126,-7.6,9
13:11,518474507.0,13917.107276028111,-142.8,2
13:13,936917570.0,-2754.2524999999973,-8.83,5
13:15,321372947.0,-456.5111507890994,-54.46,5
13:18,629078930.0,605.5256906575534,-172.89,2
13:18,187111705.0,6527.844459821383,-6.45,9
13:19,975345315.0,33649.443836040904,-269.5,2
13:21,633345190.0,6766.378945999846,-160.16,4
13:22,277562576.0,693.618298224955,-6.3,9
13:23,890567652.0,-67.00430032039938,-104.04,5
13:23,340321732.0,1564.9801500000033,-5.7,9
13:23,856957948.0,9274.344187619512,-42.98,2
13:23,117308635.0,827.3750370053701,-31.08,7
13:25,240643705.0,346.3257673739808,-15.98,7
13:26,709632525.0,-1596.3973500000006,-38.9,5
13:31,849096144.0,1472.7260207513418,-102.89,2
13:35,152488934.0,1498.5109573137306,-35.47,5
13:38,887853850.0,10431.950246156342,-37.6,7
13:38,859603181.0,3228.7356203386075,-67.89,2
13:39,518474507.0,13746.307276028112,-170.8,2
13:41,623156843.0,4720.558826976348,-163.76,2
13:43,651756497.0,11508.240794017142,-54.7,4
13:43,124125096.0,220.02994438780232,-104.02,5
13:45,456246119.0,19531.122066565145,-99.99,2
13:45,680773155.0,231.12718333109171,-62.32,5
13:47,905860285.0,9136.312358531824,-104.3,2
13:48,639409800.0,34271.65756977651,-10.05,2
13:49,280098744.0,234.4523778716656,-100.46,5
13:59,793781222.0,437.7388789474045,-30.65,9
14:01,971010829.0,95.60505644424524,-25.78,9
14:01,849096144.0,1360.7260207513418,-112.0,2
14:01,629078930.0,543.2396906575534,-62.29,2
14:03,519933553.0,-398.98899584927153,-44.2,5
14:03,518474507.0,13492.907276028112,-253.4,2
14:04,335698481.0,-2255.702996694939,-38.08,5
14:05,604288474.0,2298.167526891131,-38.73,5
14:05,905860285.0,9095.012358531823,-41.3,2
14:06,540159353.0,10561.11059487148,-25.0,2
14:07,310375875.0,2863.698451707266,-17.94,4
14:09,699997811.0,216.7091000000036,-61.03,5
14:10,642924505.0,212.26332018352613,-32.5,5
14:11,441142605.0,2089.112000000006,-16.5,4
14:15,586315521.0,11683.932159386775,-35.38,1
14:16,113747882.0,11881.372695792728,-27.39,9
14:16,949032480.0,4467.589721176272,-15.94,9
14:16,510101371.0,12726.871154403923,-19.18,4
14:18,364396689.0,-658.25925,-76.38,5
14:18,836110591.0,6422.5155869321225,-7.95,7
14:19,141521177.0,6909.615900000014,-129.97,2
14:19,122884111.0,-2429.8185830729694,-16.86,5
14:19,637433131.0,-176.54740000000086,-152.52,5
14:20,849096144.0,1216.540020751342,-144.19,2
14:20,905860285.0,9007.512358531823,-87.5,2
14:20,471897866.0,7790.990768403602,-23.07,4
14:21,851181128.0,4299.843968263858,-168.84,2
14:21,730002588.0,12282.11910071262,-183.26,5
14:23,441142605.0,2055.632000000006,-33.48,4
14:24,147474476.0,3815.471665119361,-147.64,2
14:26,859603181.0,3158.7356203386075,-70.0,2
14:27,287480331.0,7518.910285687398,-29.69,9
14:27,500043411.0,13061.472704001564,-10.32,2
14:27,518474507.0,13234.607276028111,-258.3,2
14:27,221868392.0,4933.216033489492,-53.1,7
14:27,905860285.0,8826.912358531825,-180.6,2
14:30,506618547.0,16289.679430747565,-63.0,2
14:31,722971557.0,-379.90027915692434,-74.1,5
14:33,951817450.0,8792.602469557214,-83.3,2
14:33,629078930.0,410.28169065755344,-132.96,2
14:34,849096144.0,1194.1680207513418,-22.37,2
14:35,744968736.0,-1625.5718265694238,-42.39,5
14:39,832564361.0,15442.10096211931,-33.11,2
14:39,905860285.0,8764.612358531826,-62.3,2
14:40,771125520.0,1528.3970499999996,-41.98,2
14:42,130154096.0,1349.5167820134182,-54.42,5
14:44,147474476.0,3711.185665119361,-104.29,2
14:45,471897866.0,7682.532768403602,-108.46,7
14:49,661295096.0,3064.0638399041513,-182.67,2
14:50,585596026.0,2984.63433387667,-20.0,4
14:51,849096144.0,1082.1680207513418,-112.0,2
14:55,575652395.0,3211.7225750440944,-25.05,2
14:56,117273481.0,8961.240287205384,-81.48,4
14:59,987656636.0,5723.626272300669,-38.22,1
15:00,859603181.0,2962.0636203386075,-196.67,2
15:01,506618547.0,16062.179430747565,-227.5,2
15:02,943329213.0,1621.0789552015924,-3.82,2
15:03,147474476.0,3645.399665119361,-65.79,2
15:04,192202372.0,-195.32206611120213,-112.98,2
15:05,629078930.0,228.98169065755343,-181.3,2
15:05,196289502.0,14911.03129250258,-13.69,7
15:10,886837068.0,536.5680999999994,-59.98,2
15:13,195895574.0,6990.930409875634,-57.17,2
15:16,147474476.0,3513.099665119361,-132.3,2
15:18,506618547.0,15981.679430747565,-80.5,2
15:18,419550103.0,17723.525718732602,-134.36,2
15:21,849096144.0,1004.4680207513418,-77.7,2
15:25,518474507.0,12932.207276028112,-302.4,2
15:27,138609932.0,3283.5450032945855,-9.0,4
15:29,951817450.0,8715.644469557214,-76.96,2
15:32,705848712.0,25492.623215778654,-14.94,9
15:32,237493332.0,13919.774738546255,-54.8,2
15:37,975345315.0,33517.843836040905,-131.6,2
15:42,147474476.0,3378.699665119361,-134.4,2
15:45,492215823.0,2427.022563815444,-10.19,1
15:47,134847904.0,3785.5820443862954,-125.86,4
15:47,506618547.0,15926.379430747564,-55.3,2
15:47,951817450.0,8627.472469557213,-88.17,2
15:48,414454079.0,370.9678500000019,-3.05,4
15:49,903953091.0,3299.516038995664,-62.97,4
15:51,518474507.0,12762.107276028111,-170.1,2
15:53,419550103.0,17584.2677187326,-139.26,2
15:56,166019891.0,7508.347105406888,-13.17,2
15:57,388862238.0,1166.2641312624228,-22.64,7
15:58,456221621.0,617.6856673026282,-48.45,5
16:00,849096144.0,870.8100207513418,-133.66,2
16:05,506618547.0,15808.079430747566,-118.3,2
16:06,905860285.0,8757.612358531826,-7.0,2
16:10,629078930.0,148.50969065755345,-80.47,2
16:21,995615876.0,1690.2566896983883,-182.99,2
16:24,905860285.0,8640.012358531825,-117.6,2
16:28,886921642.0,3097.3726621635847,-84.4,2
16:33,901432314.0,3479.364182299796,-87.59,2
16:34,399144202.0,1727.4224547911958,-17.25,4
16:36,143003091.0,21774.177359285215,-24.97,1
16:47,629078930.0,130.33769065755345,-18.17,2
16:48,506618547.0,15710.079430747566,-98.0,2
16:54,995615876.0,1625.7566896983883,-64.5,2
16:59,905860285.0,8563.712358531826,-76.3,2
17:04,623156843.0,4476.958826976348,-243.6,2
17:15,506618547.0,15615.579430747566,-94.5,2
17:17,623156843.0,4230.572826976348,-246.39,2
17:18,905860285.0,8487.412358531827,-76.3,2
17:20,629078930.0,-56.506309342446514,-186.84,2
17:20,280268430.0,4800.5582292456,-16.69,8
17:21,272538745.0,14928.909900000028,-139.3,2
17:24,120634201.0,4485.041500000007,-7.01,7
17:26,995615876.0,1548.7766896983885,-76.98,2
17:26,409971170.0,2615.3230038062657,-7.29,2
17:29,506618547.0,15580.579430747566,-35.0,2
17:31,905860285.0,8312.412358531827,-175.0,2
17:31,492058070.0,445.0759687404707,-40.94,1
17:34,272538745.0,14726.609900000029,-202.3,2
17:43,137913631.0,1483.8996499999998,-36.59,9
17:44,506618547.0,15549.079430747566,-31.5,2
17:45,256002321.0,5820.622473370626,-29.02,4
17:47,838830098.0,436.8571420877843,-38.95,1
17:52,995615876.0,1455.3266896983885,-93.45,2
17:55,272538745.0,14671.30990000003,-55.3,2
17:58,866941383.0,1402.9160500000062,-31.97,4
17:58,629078930.0,-188.7783093424465,-132.27,2
18:01,506618547.0,15465.079430747566,-84.0,2
18:12,272538745.0,14561.40990000003,-109.9,2
18:14,176922958.0,813.9315471976495,-33.87,9
18:21,653667523.0,5034.018310761824,-24.37,9
18:27,629078930.0,-395.2643093424465,-206.49,2
18:30,901432314.0,3476.4853901473975,-2.88,2
18:59,198946608.0,3793.2478246226246,-51.59,7
19:03,472995101.0,1976.9038342428032,-79.71,5
19:30,547010927.0,21922.56841731638,-28.49,2
19:32,809499628.0,16338.933590454417,-59.62,5
20:23,270374623.0,9872.09144873541,-12.95,9
20:23,948558249.0,8596.032140383675,-5.85,2
20:31,128033695.0,1771.2208204362062,-41.14,2
20:37,399144202.0,1726.552031029482,-0.87,7
21:34,348325817.0,9923.88158199271,-23.49,8
00:10,221868392.0,4906.276033489492,-26.94,9
00:11,419550103.0,17578.813816381684,-5.45,5
00:13,213930646.0,-1509.5592134725632,-34.5,9
00:16,146909202.0,2420.8014513734342,-53.38,5
00:19,918160369.0,-889.3036500000004,-31.38,9
00:29,897714622.0,8360.534088010065,-71.05,7
00:30,282837512.0,13366.35774603716,-37.89,9
00:36,519644021.0,2675.3954169185117,-62.24,2
00:38,858989281.0,26115.08156006256,-12.03,9
00:42,887853850.0,10401.560246156345,-30.39,9
00:44,113747882.0,11869.054836081255,-12.32,2
00:49,633345190.0,6739.428945999846,-26.95,9
00:55,822135975.0,10734.74171789496,-5.32,2
00:56,718058208.0,2492.7752627099267,-2.98,2
00:56,785749304.0,8082.843323167078,-6.68,2
00:56,987163717.0,5893.298480000006,-25.64,9
00:58,572384506.0,7010.733181449041,-38.39,9
01:00,131388684.0,20835.238587584685,-52.61,8
01:07,383625050.0,5757.952673973356,-7.46,7
01:08,704517789.0,16811.9308121011,-65.94,2
01:09,586315521.0,11676.060415955157,-7.87,8
01:14,824916823.0,8433.604014511498,-19.93,8
01:15,108481285.0,8353.327791000398,-24.13,2
01:17,858989281.0,26111.15479150286,-3.93,4
01:30,471897866.0,7668.803919299094,-13.73,2
01:34,344219145.0,7326.629590289772,-10.69,7
01:36,471897866.0,7658.603919299094,-10.2,9
01:40,912705941.0,17674.9298433473,-32.1,5
01:41,213112754.0,6390.899077674214,-46.75,5
01:42,264550521.0,9177.75303218398,-33.09,7
01:44,124102251.0,3306.079938769342,-3.32,5
01:45,859603181.0,2961.797836406435,-0.27,7
01:51,824916823.0,8414.614014511499,-18.99,9
01:52,985188462.0,-544.9132112887751,-43.18,9
01:56,117308635.0,800.5350370053701,-26.84,9
02:07,851649498.0,10014.048791714087,-0.43,7
02:13,949032480.0,4435.409721176272,-32.18,9
02:20,540159353.0,10552.4525487764,-8.66,2
02:27,940569402.0,5949.22537213229,-12.94,9
02:28,769311479.0,6837.793950365737,-23.61,5
02:39,779236304.0,810.4375954795323,-41.4,9
02:42,893134725.0,634.9669819367791,-13.49,9
02:46,549414742.0,6964.142748060082,-22.89,9
02:51,987656636.0,5708.583974692272,-15.04,7
02:51,116598243.0,2007.3314597347676,-2.87,7
02:55,815385232.0,9783.14573152816,-8.21,8
02:56,719586818.0,16807.845782803528,-79.86,7
02:59,949032480.0,4433.079391020802,-2.33,5
03:02,285220959.0,11352.05144737752,-1.08,2
03:10,874431242.0,7954.620664403292,-0.9,2
03:11,887853850.0,10389.120246427876,-12.44,2
03:11,930277104.0,10082.073371641996,-28.63,9
03:12,705848712.0,25451.96047850169,-40.66,2
03:12,558119802.0,31395.701462755547,-81.79,2
03:16,554792076.0,26716.723238592545,-0.91,2
03:17,549414742.0,6949.650140694659,-14.49,8
03:20,699139822.0,1485.6562273395407,-21.05,2
03:23,237684254.0,5612.482885478135,-69.32,7
03:26,518474507.0,12725.027276028111,-37.08,9
03:35,743630833.0,65.57611328470122,-36.34,9
03:36,749378808.0,3887.138424177912,-28.98,9
03:41,940569402.0,5915.234239658035,-33.99,8
03:41,547010927.0,21903.11841731638,-19.45,9
03:47,454356905.0,1055.91412781206,-14.68,7
03:55,414805878.0,12570.126074722002,-46.39,9
04:02,541639148.0,4595.507957420308,-16.48,4
04:05,836110591.0,6369.2698957465445,-53.25,5
04:07,534325901.0,6512.357651116357,-8.53,5
04:10,522188082.0,7628.431439925845,-40.6,2
04:14,683319988.0,7084.709065023874,-30.01,2
04:17,270374623.0,9858.054363549078,-14.04,8
04:20,802697323.0,15107.415801764908,-40.3,5
04:26,315546581.0,26877.49700102861,-33.7,8
04:28,506618547.0,15452.14092623218,-12.94,2
04:39,287480331.0,7490.110285687398,-28.8,9
04:40,764450279.0,19459.028345772935,-7.72,7
04:48,308505160.0,13787.057867726417,-10.42,5
04:48,305778936.0,10043.853355853242,-27.34,9
04:52,690958123.0,19405.744683105364,-44.92,2
04:53,179173981.0,4590.913840549262,-64.09,5
04:53,667367404.0,9114.43734891972,-15.94,7
04:55,187541224.0,1286.812650716096,-33.17,9
04:58,183888402.0,17607.36680305986,-37.22,9
05:12,752362502.0,8433.026908893578,-4.08,4
05:12,930277104.0,10028.400417077772,-53.67,8
05:12,639409800.0,34268.40832517898,-3.25,2
05:14,489964679.0,19989.854912638588,-39.05,9
05:14,216285378.0,23014.43938463492,-35.18,9
05:15,604288474.0,2292.6913161251646,-5.48,5
05:16,421881811.0,3038.631837563457,-28.22,2
05:17,873701090.0,669.2068996260871,-21.72,7
05:18,366550080.0,25251.53776028117,-24.68,5
05:19,305778936.0,10010.426462471454,-33.43,7
05:22,675806859.0,6548.682348512797,-8.63,5
05:26,532478725.0,4438.987692234071,-35.46,9
05:27,187111705.0,6455.414745092195,-72.43,7
05:28,587225252.0,5027.140715711852,-19.92,5
05:30,383833857.0,23591.558523656637,-15.9,9
05:30,851181128.0,4264.643968263858,-35.2,9
05:30,534204159.0,5857.554387985089,-5.76,5
05:33,285873880.0,11371.634228353983,-10.54,8
05:36,853907490.0,6861.145469652111,-32.55,7
05:39,802697323.0,15079.675801764908,-27.74,9
05:40,480557476.0,10745.469921754428,-24.84,2
05:46,461990622.0,8472.619074916069,-38.98,7
05:56,108563213.0,22934.981129417403,-31.47,7
05:58,670102069.0,3607.757201059302,-32.73,9
05:58,169006407.0,11420.401846686069,-9.19,7
06:00,749378808.0,3880.37117336999,-6.77,7
06:01,383833857.0,23573.34138329819,-18.22,5
06:10,679662108.0,15535.561791779755,-7.44,5
06:20,196289502.0,14894.581292502578,-16.45,9
06:20,496395938.0,11533.665463573185,-3.66,5
06:22,973086490.0,9922.98628744385,-10.75,7
06:24,187541224.0,1277.5507569643712,-9.26,7
06:24,229205098.0,7109.355727321817,-51.45,7
06:25,290818242.0,6813.578272036888,-7.09,7
06:26,256002321.0,5793.782473370626,-12.95,9
06:33,364357875.0,6980.22341666373,-59.62,5
06:34,706250160.0,11470.800885232802,-5.15,5
06:34,668329719.0,8010.686530941198,-23.17,7
06:37,406772240.0,-1187.4353500000004,-31.64,9
06:38,905860285.0,8309.890816263012,-2.52,7
06:40,575652395.0,3159.049113461456,-52.67,5
06:40,407574996.0,509.9822593533365,-11.42,5
06:43,482513594.0,5553.669609208303,-19.35,8
06:47,510101371.0,12707.441154403925,-19.43,9
06:49,322221939.0,3617.751116204126,-24.59,9
06:54,687135796.0,26040.701625641228,-10.89,8
06:55,788740658.0,3815.5895391277145,-29.43,8
06:55,994214354.0,9426.575605235772,-40.89,9
06:56,165691047.0,-359.810200000001,-18.19,9
07:06,766941757.0,9346.286616200952,-19.5,9
07:06,233981231.0,2307.1188819606236,-45.2,2
07:06,166019891.0,7489.318116349619,-19.03,5
07:07,259015404.0,1282.4210964065285,-18.07,8
07:08,324224854.0,2911.428286673772,-17.3,7
07:10,280268430.0,4777.574272555075,-22.98,8
07:10,601627384.0,4329.497921976346,-37.86,9
07:11,657139925.0,13413.637965119286,-0.14,2
07:12,550169791.0,20721.87147688548,-21.99,8
07:14,179173981.0,4557.673840549262,-33.24,9
07:17,588565416.0,7149.526870274404,-20.18,2
07:21,779946617.0,16286.77019740483,-21.23,7
07:22,450896297.0,12776.622713637678,-42.05,9
07:22,613729471.0,8617.15991911089,-5.87,8
07:29,108931112.0,13434.244696139534,-34.49,9
07:36,441274121.0,11190.741235038666,-9.44,7
07:36,408057540.0,3935.037157524765,-62.44,2
07:37,417850087.0,16277.10965892692,-59.16,7
07:39,873693307.0,9464.387212466096,-52.89,2
07:47,651756497.0,11506.2799378794,-1.96,5
07:48,473820682.0,10860.526474329108,-30.85,2
07:53,450896297.0,12771.541703418729,-5.08,7
07:58,245690309.0,9113.636912837976,-6.73,7
08:02,673025413.0,3792.7013114886904,-5.52,5
08:04,170637730.0,2637.831768420265,-27.86,5
08:07,885259672.0,3732.757860115035,-6.5,9
08:09,500043411.0,13009.175757510244,-52.3,2
08:12,370521542.0,25031.52197507724,-51.53,7
08:14,399538448.0,6995.3338435994365,-27.47,5
08:19,121858569.0,284.8311500000025,-30.72,5
08:22,724997545.0,-120.80370800221831,-57.99,5
08:22,331450202.0,7093.265014409599,-27.99,5
08:23,668329719.0,7981.888530941198,-28.8,5
08:23,358846516.0,697.2479225272178,-4.95,9
08:24,158766229.0,-797.13553589347,-14.54,5
08:26,493571342.0,-2447.615880907048,-15.97,5
08:26,518474507.0,12721.972518377564,-3.05,5
08:27,409370545.0,1188.7422755455204,-63.08,5
08:27,494789005.0,2757.7929892830143,-56.77,5
08:28,224215364.0,-1729.6925920882788,-37.23,5
08:28,832564361.0,15394.94896211931,-47.15,5
08:28,647472692.0,23884.63727579779,-56.24,5
08:29,534908754.0,-854.0357000000002,-61.37,5
08:29,647472692.0,23825.32643745408,-59.31,2
08:29,990461108.0,140.68781862061104,-67.77,5
08:30,380911501.0,-150.71705000000082,-92.89,5
08:31,899692478.0,-1850.2764935240073,-88.84,5
08:32,779620857.0,-347.5760963851759,-111.82,5
08:34,954263768.0,-255.78700000000023,-27.92,5
08:34,766692943.0,-1975.75675,-31.93,5
08:34,666952234.0,-396.64160187551306,-101.8,5
08:35,124377686.0,-2687.859899999998,-30.78,5
08:36,441274121.0,11121.231235038666,-69.51,5
08:38,836655156.0,-2976.376455219156,-40.53,5
08:38,867679563.0,-86.99604629828416,-35.74,5
08:39,818552503.0,43.01494999999892,-151.88,5
08:40,474301748.0,-2161.631505683968,-17.15,5
08:40,842682241.0,5019.335870237408,-25.5,8
08:43,482513594.0,5492.237609208303,-61.43,5
08:43,519935524.0,-136.51015026248098,-30.41,5
08:43,673025413.0,3757.4423114886904,-35.26,5
08:45,979122276.0,-1011.1160377056711,-88.77,5
08:45,812012103.0,-1327.5493000000004,-39.09,5
08:45,678851253.0,3285.0916179585784,-16.8,2
08:46,352291960.0,2695.7690533035734,-136.58,5
08:46,198946608.0,3786.0563636918514,-7.19,2
08:47,128033695.0,1753.3918204362062,-17.83,5
08:49,399144202.0,1648.946637037704,-77.61,2
08:49,430910686.0,-60.87099999999961,-94.04,5
08:52,795847804.0,22209.01033450515,-73.36,7
08:53,145387690.0,4730.955607269043,-0.73,8
08:55,948558249.0,8558.673140383675,-37.36,5
08:58,876890798.0,2739.4792706999315,-86.3,5
08:58,850290152.0,-2901.893499999997,-37.55,5
08:59,558875206.0,2810.7593108989513,-5.8,9
09:00,684988568.0,-663.9679734272014,-107.93,5
09:01,237493332.0,13873.924738546257,-45.85,5
09:01,355602925.0,1438.5407195597525,-64.94,5
09:03,170637730.0,2578.667768420265,-59.16,5
09:04,117273481.0,8954.740287205384,-6.5,9
09:04,155867488.0,-29.865300000001568,-137.63,5
09:06,727417797.0,5314.281500000011,-45.74,5
09:07,187111705.0,6386.044745092195,-69.37,5
09:09,581655972.0,39203.445178850976,-5.35,9
09:09,586315521.0,11669.710415955156,-6.35,9
09:09,348325817.0,9896.79905691555,-27.08,5
09:10,760704118.0,484.0543127174888,-71.06,5
09:13,656389634.0,-2987.151840421986,-34.0,5
09:15,819515373.0,2445.351636063792,-40.04,5
09:15,540159353.0,10546.7525487764,-5.7,9
09:16,417850087.0,16270.60965892692,-6.5,9
09:16,683319988.0,7078.659065023874,-6.05,9
09:16,659415300.0,1037.085690250704,-116.97,5
09:16,722358036.0,776.4662406270829,-137.75,5
09:17,951817450.0,8538.950469557212,-88.52,5
09:18,690958123.0,19399.944683105365,-5.8,9
09:18,700138124.0,5087.171351794727,-99.48,5
09:19,812692024.0,3401.3548579489525,-86.58,5
09:20,828750680.0,1313.7323452136798,-118.82,5
09:20,446720287.0,-483.6152091815944,-231.97,2
09:21,727417797.0,5284.291500000011,-29.99,4
09:21,162162212.0,1191.4480433273088,-63.0,2
09:22,198946608.0,3735.9663636918513,-50.09,2
09:22,821971408.0,846.7211534046047,-51.04,5
09:23,667367404.0,9109.38734891972,-5.05,9
09:24,473820682.0,10772.424474329107,-88.1,5
09:24,853907490.0,6828.295469652111,-32.85,2
09:25,461029994.0,7021.988299682366,-79.99,2
09:25,511179916.0,6463.376873683574,-147.52,5
09:25,683078800.0,1788.371018035628,-5.65,9
09:26,383833857.0,23566.17138329819,-7.17,1
09:26,603375739.0,949.133063023267,-151.9,2
09:27,960208650.0,17032.812160008354,-24.6,7
09:27,187111705.0,6346.8247450921945,-39.22,7
09:28,587225252.0,5001.6207157118515,-25.52,2
09:29,618138606.0,914.6966472714346,-8.3,9
09:30,287480331.0,7483.794235687397,-6.32,4
09:31,910730524.0,7868.719408769631,-32.05,2
09:32,570410059.0,1581.69974677631,-84.99,2
09:33,913127700.0,945.7803380111164,-89.97,2
09:34,414454079.0,359.78785000000187,-11.18,4
09:34,520447032.0,8092.303159821997,-22.37,2
09:35,520447032.0,8089.021103099567,-3.28,4
09:35,865748375.0,3594.8456111540527,-5.41,2
09:36,421881811.0,2984.781837563457,-53.85,2
09:36,583558311.0,-781.7272152486677,-28.29,5
09:40,603375739.0,903.647063023267,-45.49,2
09:40,930277104.0,10007.910417077772,-20.49,2
09:40,162162212.0,1168.4880433273088,-22.96,1
09:42,552980092.0,-477.0222808806625,-35.22,5
09:44,659415300.0,953.115690250704,-83.97,2
09:45,519644021.0,2635.255416918512,-40.14,2
09:47,534204159.0,5848.316847985089,-9.24,4
09:47,909669130.0,217.9778847367666,-29.98,5
09:51,910730524.0,7828.609408769631,-40.11,5
09:51,279149837.0,1501.4810499999985,-30.95,7
09:57,585625048.0,1378.1521832415312,-53.11,5
09:58,722358036.0,736.4862406270829,-39.98,2
10:00,454356905.0,1049.82580781206,-6.09,4
10:01,385685918.0,209.63994084155232,-132.97,2
10:05,246753533.0,540.9695999999985,-5.75,9
10:09,639549973.0,6202.776458076415,-8.01,4
10:09,197050303.0,181.95943256349503,-101.25,2
10:12,128033695.0,1747.821090023108,-5.57,7
10:13,424927189.0,-241.3891672558947,-70.02,5
10:19,653667523.0,5019.048310761824,-14.97,7
10:22,475277431.0,1172.8531369436191,-17.98,4
10:22,986774156.0,3783.336931625769,-21.97,7
10:24,904154012.0,1096.567458120432,-24.48,2
10:29,570269025.0,2862.565657045128,-33.54,5
10:31,252760664.0,6508.441391529242,-76.12,2
10:32,252760664.0,6465.790862019314,-42.65,7
10:38,955035930.0,1457.823479171477,-77.99,2
10:41,151916463.0,100.27155559916878,-204.4,2
10:42,925037906.0,914.9708000000016,-45.91,5
10:44,197050303.0,107.33443256349506,-74.62,2
10:44,266777719.0,356.86643378023956,-37.63,5
10:47,856957948.0,9234.364187619512,-39.98,2
10:51,812692024.0,3384.3748579489525,-16.98,4
10:52,456246119.0,19529.622066565145,-1.5,4
10:54,143003091.0,21769.597916142942,-4.58,4
10:54,305778936.0,9947.926462471454,-62.5,2
11:05,856957948.0,9206.864187619512,-27.5,4
11:07,272538745.0,14451.43990000003,-109.97,4
11:09,901432314.0,3423.1453901473974,-53.34,5
11:16,924045955.0,1415.9100126586643,-98.93,5
11:23,179173981.0,4495.953840549262,-61.72,2
11:24,425730826.0,1441.6919093887198,-74.98,2
11:24,472995101.0,1860.4038342428032,-116.5,2
11:24,305778936.0,9937.516462471454,-10.41,1
11:35,776431321.0,3308.8649671072526,-89.99,2
11:37,472995101.0,1850.9238342428032,-9.48,4
11:38,899742927.0,12129.813675961814,-12.26,4
11:43,603375739.0,634.1750630232671,-269.47,2
11:47,711045550.0,4037.6243500000032,-145.6,7
11:54,970298834.0,2876.0678791716787,-20.03,2
11:54,556992209.0,11261.611025558765,-59.6,5
12:00,448004226.0,1808.338710862856,-31.99,2
12:05,151916463.0,-10.328444400831216,-110.6,2
12:06,587225252.0,4964.180715711852,-37.44,9
12:12,711045550.0,3895.5243500000033,-142.1,4
12:13,603375739.0,534.7750630232671,-99.4,2
12:15,673818591.0,1100.032175375841,-14.12,5
12:18,933491926.0,2987.106300000002,-18.99,9
12:22,233981231.0,2296.148881960624,-10.97,4
12:28,106601471.0,9960.750619006683,-39.75,2
12:28,822250278.0,6995.672128972925,-36.59,5
12:29,322221939.0,3594.301458820055,-23.45,8
12:32,419084831.0,-239.57437552610307,-43.85,5
12:38,564214408.0,-170.50531527427393,-13.27,5
12:40,461029994.0,6986.988299682366,-35.0,2
12:40,151916463.0,-272.82844440083124,-262.5,2
12:42,984783496.0,13815.974986008532,-13.45,9
12:45,916225911.0,-2179.924250000001,-47.28,5
12:45,308897841.0,933.9704999999988,-17.26,5
12:47,180616589.0,706.8907092146952,-34.99,5
12:50,564744955.0,330.1156585888419,-35.75,5
12:53,711045550.0,3561.6243500000032,-333.9,4
12:55,245198540.0,-198.8136011982205,-24.54,5
12:55,195895574.0,6965.240409875634,-25.69,9
12:56,598793068.0,543.2678999999982,-89.97,4
12:59,696758548.0,-3369.477896320137,-26.68,5
12:59,737547541.0,-101.90040043222577,-44.69,5
13:00,910730524.0,7821.459408769631,-7.15,9
13:00,625658193.0,-675.1056202437832,-186.94,5
13:01,570323670.0,3958.618474035425,-15.57,7
13:02,670102069.0,3594.487201059302,-13.27,7
13:04,688712152.0,6105.062644863439,-7.8,9
13:06,151916463.0,-425.42844440083127,-152.6,2
13:06,355733816.0,4837.774913842311,-16.98,7
13:07,575652395.0,2932.949113461456,-226.1,2
13:09,973086490.0,9898.83628744385,-24.15,9
13:11,197050303.0,53.33443256349506,-54.0,2
13:11,706301742.0,-2923.318149999998,-17.06,5
13:22,767447966.0,4425.500065512111,-5.0,9
13:24,744211756.0,-4092.130749999994,-20.45,5
13:26,197050303.0,-2.5405674365049435,-55.88,2
13:26,703537476.0,400.54924999999906,-31.2,9
13:27,711045550.0,3289.3243500000035,-272.3,7
13:31,993039226.0,-4177.744499999994,-58.68,5
13:34,856957948.0,9196.874187619513,-9.99,4
13:36,603375739.0,392.68906302326707,-142.09,2
13:39,151916463.0,-523.4284444008313,-98.0,2
13:43,355940285.0,7408.362978189683,-19.99,2
13:49,225210798.0,828.0307737592086,-19.99,4
13:58,603375739.0,-5.610936976732887,-398.3,2
14:02,151916463.0,-603.9284444008313,-80.5,2
14:18,151916463.0,-882.5284444008312,-278.6,2
14:26,575652395.0,2687.249113461456,-245.7,2
14:27,366550080.0,25149.00176028117,-102.54,5
14:28,603375739.0,-183.38293697673285,-177.77,2
14:30,788740658.0,3714.054539127714,-101.53,5
14:31,383833857.0,23535.43138329819,-30.74,1
14:36,596171893.0,84.6717448255111,-22.97,7
14:41,984783496.0,13796.240113504831,-19.73,7
14:41,403383649.0,1752.1954815642523,-7.31,8
14:43,399538448.0,6990.086794127587,-5.25,7
14:47,779236304.0,712.1875954795323,-98.25,6
14:47,522188082.0,7571.120019925845,-57.31,4
14:49,407574996.0,484.92225935333647,-25.06,1
15:00,421881811.0,2933.179197563457,-51.6,4
15:02,195895574.0,6896.8564060505,-68.38,7
15:03,259015404.0,1020.5810964065284,-31.84,9
15:03,215311171.0,6028.187945656328,-3.24,7
15:07,535744551.0,175.98726599562602,-122.31,5
15:10,461029994.0,6951.008299682367,-35.98,4
15:22,127809299.0,1004.550253485056,-31.99,2
15:27,151916463.0,-1134.5284444008312,-252.0,2
15:34,829914501.0,685.4448065709742,-212.79,7
15:34,274818272.0,406.6895285671315,-37.38,9
15:42,901432314.0,3392.9553901473973,-30.19,2
16:06,679911053.0,2396.3926011755107,-3.08,7
16:11,904154012.0,1062.087458120432,-34.48,2
16:11,829914501.0,632.9868065709742,-52.46,4
16:19,624500124.0,3437.0582480068388,-13.22,2
16:21,679943657.0,842.9204478166846,-80.45,2
16:24,120634201.0,4457.461500000007,-27.58,4
16:24,158414827.0,-1758.4500000000016,-8.69,5
16:27,409971170.0,2547.7430038062657,-67.58,4
16:28,713641917.0,900.5805352159157,-69.99,2
16:28,829914501.0,507.7008065709742,-125.29,4
16:34,479456865.0,1175.9773314894048,-8.99,4
16:36,901432314.0,3351.9457685819316,-41.01,2
16:39,603721739.0,959.242899483184,-48.43,5
16:41,700138124.0,5045.489319563656,-41.68,5
16:42,603375739.0,-316.35493697673286,-132.97,2
16:43,605116158.0,2127.215200000002,-45.86,5
16:46,904154012.0,935.607458120432,-126.48,2
16:46,286484726.0,780.6602700631588,-68.57,5
16:47,129018172.0,8361.796896282198,-4.99,1
16:52,183888402.0,17577.442512934937,-29.92,7
16:53,392270893.0,12416.65451108325,-14.62,5
16:58,807714284.0,932.252260736,-33.99,2
16:58,532478725.0,4407.502201842932,-31.49,2
17:01,151916463.0,-1339.628444400831,-205.1,2
17:01,605116158.0,2102.215200000002,-25.0,2
17:07,701070224.0,-656.2836,-29.58,9
17:07,497772347.0,871.3755999999979,-94.97,6
17:08,227104649.0,2513.1070343161773,-18.05,4
17:09,141521177.0,6893.115900000014,-16.5,9
17:09,492215823.0,1034.681563815444,-292.34,5
17:12,237493332.0,13856.372879331908,-17.55,5
17:12,558119802.0,31368.51146275555,-27.19,9
17:14,631111289.0,-656.4865000000008,-7.99,5
17:15,336557504.0,1219.060437201019,-35.0,2
17:15,603375739.0,-472.3989369767328,-156.04,2
17:19,613427466.0,5953.031956011864,-31.95,7
17:19,308505160.0,13760.727867726417,-26.33,9
17:20,709608057.0,2749.966901287254,-38.78,9
17:22,489964679.0,19979.354912638588,-10.5,7
17:23,994214354.0,9393.98706988281,-32.59,4
17:23,971010829.0,77.62505644424525,-17.98,4
17:25,815385232.0,9730.64573152816,-52.5,2
17:25,471897866.0,7587.773919299094,-70.83,2
17:28,876890798.0,2719.4892706999317,-19.99,2
17:31,196289502.0,14815.12129250258,-79.46,2
17:32,628470485.0,838.0930299001232,-74.97,2
17:33,575652395.0,2527.649113461456,-159.6,2
17:33,838830098.0,430.8671420877843,-5.99,2
17:33,534325901.0,6353.817651116357,-158.54,2
17:34,290818242.0,6709.264272036888,-104.31,5
17:35,245690309.0,9091.034852837976,-22.6,4
17:37,851181128.0,4264.589893831513,-0.05,4
17:38,198630866.0,7.269876438731462,-15.98,7
17:39,660874296.0,2294.0674499608476,-11.98,1
17:40,516051449.0,1233.2090389400978,-44.71,5
17:47,151968462.0,6440.475584740582,-236.6,2
17:48,736340277.0,8375.498545945717,-15.36,2
17:48,854895960.0,3001.3805824849146,-123.9,2
17:52,873693307.0,9283.815212466096,-180.57,2
17:53,134847904.0,3779.592044386296,-5.99,4
17:54,780463728.0,2801.8489709422397,-28.0,2
17:54,996042490.0,5508.089696170786,-51.97,4
17:55,603375739.0,-605.3849369767328,-132.99,2
17:58,940569402.0,5706.634239658035,-208.6,2
18:01,624500124.0,3381.880607037373,-55.18,8
18:03,829914501.0,151.45680657097424,-173.59,2
18:03,245690309.0,9075.648852837976,-15.39,5
18:03,832564361.0,15378.64622674643,-16.3,4
18:06,609939116.0,6975.69902435825,-39.45,4
18:07,873693307.0,9087.129212466098,-196.69,2
18:10,699997811.0,183.9691000000036,-32.74,9
18:10,500051919.0,1375.3468966505905,-33.25,9
18:11,466649401.0,354.56871139789143,-106.45,5
18:13,705848712.0,25438.62047850169,-13.34,9
18:17,625281433.0,-800.0319073707568,-60.99,5
18:17,494404688.0,-2567.085765336208,-28.86,5
18:18,256002321.0,5792.031551219393,-1.75,7
18:21,822718326.0,10250.813522634277,-40.5,8
18:23,829914501.0,-50.82919342902576,-202.29,2
18:26,709608057.0,2740.40429753133,-9.56,5
18:27,940569402.0,5651.334239658035,-55.3,2
18:28,809499628.0,16323.393590454414,-15.54,9
18:29,624500124.0,3342.2746070373723,-39.61,5
18:32,200080192.0,8964.332481938736,-3.73,2
18:32,500043411.0,12937.712817510244,-71.46,7
18:34,616924659.0,-154.5304201769147,-11.29,5
18:35,873693307.0,9006.405212466098,-80.72,5
18:35,782058249.0,-1318.5313733101616,-24.1,9
18:37,435984758.0,4171.860654339488,-6.08,5
18:41,873693307.0,8995.515212466098,-10.89,9
18:41,358846516.0,656.4102725272178,-40.84,5
18:42,885259672.0,3710.9613840562415,-21.8,2
18:42,992204045.0,5746.581373629233,-12.9,7
18:44,940569402.0,5511.334239658035,-140.0,2
18:45,296972867.0,-931.524200000001,-75.57,5
18:48,188263947.0,-223.07529999999952,-109.84,5
18:48,979135922.0,-155.66919940954924,-49.44,5
18:48,683319988.0,7047.069065023874,-31.59,9
18:48,423208402.0,912.5707500000026,-35.53,9
18:51,214339619.0,37.281850868356294,-43.98,5
18:51,898104045.0,-1646.3730500000022,-35.63,9
18:51,492215823.0,1011.301563815444,-23.38,9
18:54,785749304.0,8020.053323167078,-62.79,5
18:54,280268430.0,4762.584272555076,-14.99,7
18:54,581655972.0,39157.32916768979,-46.12,7
18:56,198946608.0,3645.918363691851,-90.05,5
18:56,496674181.0,-1399.7660223307223,-107.75,5
18:57,836110591.0,6341.839895746544,-27.43,9
18:57,331450202.0,7087.871802627437,-5.39,5
18:58,565175333.0,-3629.438522729826,-38.53,5
18:59,795847804.0,22182.110334505152,-26.9,9
19:02,287480331.0,7467.776702485926,-16.02,2
19:04,291580432.0,-390.3928999999997,-64.96,5
19:07,409971170.0,2542.8524242360854,-4.89,2
19:09,280200287.0,-1289.245453386949,-78.53,5
19:10,151916463.0,-1493.9994444008312,-154.37,5
19:16,166019891.0,7457.272116349619,-32.05,5
19:17,720221651.0,-2395.8413665984344,-39.11,5
19:21,871866387.0,-326.8180000000007,-82.3,5
19:21,409971170.0,2518.9624242360856,-23.89,9
19:23,653640811.0,16151.89072694858,-122.11,5
19:24,785749304.0,8005.573323167078,-14.48,9
19:24,310375875.0,2844.2084517072662,-19.49,9
19:26,578131296.0,477.2091694440438,-125.53,5
19:30,433917275.0,7076.0407740860655,-0.94,4
19:33,809499628.0,16279.18476743008,-44.21,7
19:34,336557504.0,1180.9958372010194,-38.06,5
19:34,124102251.0,3220.763938769342,-85.32,5
19:35,511179916.0,6461.185018157796,-2.19,5
19:36,610645022.0,-788.6076626449183,-52.22,5
19:36,203466392.0,2537.316049751391,-89.49,5
19:38,868014990.0,-3309.033599999997,-47.81,5
19:38,854895960.0,2859.5605824849144,-141.82,5
19:38,730002588.0,12274.918971503164,-7.2,2
19:39,361955473.0,-486.8462547559156,-68.95,5
19:40,202320275.0,-759.1271500000005,-61.79,5
19:43,294474095.0,-2310.896286499239,-38.59,5
19:53,558875206.0,2697.1703108989514,-113.59,5
19:55,489964679.0,19962.33838009409,-17.02,4
19:59,131388684.0,20804.354587584687,-30.88,5
20:00,641764023.0,-1238.776303772005,-29.83,5
20:02,494977194.0,-176.7072294024219,-119.96,5
20:02,868377987.0,2438.0019958778507,-144.24,5
20:05,806358207.0,11824.821240008809,-15.03,4
20:08,203466392.0,2520.183356915248,-17.13,8
20:16,978951113.0,-905.0688425904192,-174.0,5
20:21,698076160.0,5890.060982137873,-142.44,5
20:25,892354433.0,-1225.4599606343386,-76.04,5
20:25,198630866.0,-70.85432356126854,-78.12,5
20:27,510101371.0,12661.316177404577,-46.12,2
20:28,331048953.0,-272.33963202150636,-124.15,5
20:28,874431242.0,7934.130664403292,-20.49,9
20:39,844835978.0,9481.291736205148,-17.91,5
20:52,235881534.0,12520.046351086969,-19.84,7
20:58,441274121.0,11111.191235038665,-10.04,9
21:00,310375875.0,2807.1621948368033,-37.05,8
21:08,556992209.0,11229.327890107725,-32.28,7
00:10,252760664.0,6387.302786403471,-78.49,8
00:21,613729471.0,8614.851581411078,-2.31,7
00:22,399144202.0,1632.7575759822548,-16.19,7
00:29,984783496.0,13784.790113504832,-11.45,9
00:31,899742927.0,12121.553175473537,-8.26,2
00:33,766941757.0,2114.1066162009524,-22.18,9
00:44,973086490.0,9870.321282490557,-28.52,7
00:47,250895529.0,348.4142824692883,-37.59,9
00:52,245690309.0,9017.516440723375,-58.13,8
01:03,348325817.0,9859.811511043728,-36.99,7
01:29,480557476.0,10686.562056680756,-58.91,8
01:48,834383043.0,5330.824875778231,-57.53,2
01:51,779376323.0,2655.9805757479376,-9.73,5
02:17,518474507.0,12683.382518377564,-38.59,9
02:29,858989281.0,26089.91479150286,-21.24,9
02:31,973086490.0,9855.121282490554,-15.2,9
02:42,199016328.0,4229.279979675477,-13.38,9
02:47,895331556.0,-680.6611000000008,-22.75,9
02:54,705848712.0,25416.67047850169,-21.95,9
02:55,655730067.0,-457.4959500000005,-33.44,9
02:58,809499628.0,16259.994767430078,-19.19,9
03:11,998390769.0,-409.9669490594758,-20.94,9
03:17,623156843.0,4217.653508555292,-12.92,5
03:25,519644021.0,2607.2071953549166,-28.05,7
03:26,910730524.0,7808.732258487082,-12.73,2
03:29,586315521.0,11661.390539552558,-8.32,7
03:30,940569402.0,5501.834239658035,-9.5,9
03:31,510101371.0,12629.416177404575,-31.9,9
03:37,858989281.0,26079.79922180477,-10.12,5
03:46,489964679.0,19925.48838009409,-36.85,9
03:49,450896297.0,12747.061703418727,-24.48,9
03:51,572384506.0,6981.3431814490405,-29.39,9
03:53,822718326.0,10238.863522634274,-11.95,9
03:55,305778936.0,9936.110995213014,-1.41,5
04:03,383625050.0,5748.88108637846,-9.07,8
04:04,766941757.0,2107.4158880920268,-6.69,7
04:07,364357875.0,6976.669124139755,-3.55,7
04:08,169006407.0,11409.08883190878,-11.31,7
04:08,461990622.0,8471.891517572605,-0.73,7
04:11,587225252.0,4935.540715711852,-28.64,9
04:15,187111705.0,6334.836741659846,-11.99,5
04:19,108481285.0,8351.813546217072,-1.51,5
04:19,187541224.0,1241.1307569643711,-36.42,9
04:22,287480331.0,7429.826702485926,-37.95,9
04:31,460463595.0,-746.8379454185788,-42.6,9
04:31,213112754.0,6380.459077674214,-10.44,9
04:32,290818242.0,6683.1098313618095,-26.15,5
04:34,322221939.0,3587.721468200783,-6.58,2
04:34,667367404.0,9106.220791641104,-3.17,2
04:36,994214354.0,9358.45706988281,-35.53,9
04:38,785749304.0,7990.333323167079,-15.24,9
04:41,315078351.0,7045.142281097179,-54.09,5
04:41,473820682.0,10752.85510621732,-19.57,2
04:44,216285378.0,22976.64938463492,-37.79,9
04:47,647936800.0,3292.8598161516343,-39.47,9
04:48,639409800.0,34265.138628332206,-3.27,8
04:51,719586818.0,16802.55236225744,-5.29,5
04:52,407574996.0,408.9692565211295,-75.95,2
04:52,183888402.0,17537.322512934938,-40.12,9
04:57,145387690.0,4701.815607269043,-29.14,9
04:59,310620484.0,-29.242804907801663,-38.93,9
05:01,522188082.0,7562.963214250024,-8.16,8
05:03,128033695.0,1736.737917176903,-11.08,2
05:04,985188462.0,-577.3632112887751,-32.45,9
05:14,324224854.0,2904.280974343615,-7.15,5
05:15,113747882.0,11849.276321585405,-19.78,4
05:15,668329719.0,7926.606436587672,-55.28,5
05:15,679662108.0,15511.66747073303,-23.89,2
05:16,785749304.0,7976.877617380879,-13.46,5
05:19,541639148.0,4534.935094536447,-60.57,7
05:20,853907490.0,6797.048538624891,-31.25,7
05:20,604288474.0,2282.283155857799,-10.41,2
05:20,749378808.0,3844.4711733699905,-35.9,9
05:23,912705941.0,17652.22687968596,-22.7,5
05:24,992204045.0,5743.155789699634,-3.43,7
05:25,179173981.0,4425.0870316757855,-70.87,2
05:27,673025413.0,3700.500210303006,-56.94,2
05:27,547010927.0,21857.176904064265,-45.94,7
05:28,117308635.0,798.8875374114854,-1.65,5
05:30,308505160.0,13704.175723052527,-56.55,7
05:32,874431242.0,7927.498186983718,-6.63,5
05:34,822135975.0,10670.140869884932,-64.6,7
05:35,903663593.0,882.2907198350957,-27.22,7
05:35,198946608.0,3642.774011615143,-3.14,7
05:36,832564361.0,15377.98594381898,-0.66,7
05:36,842682241.0,4939.787121389851,-79.55,2
05:37,809499628.0,16236.57239916858,-23.42,8
05:38,758160963.0,7920.057355415933,-10.63,5
05:38,802697323.0,15040.085801764908,-39.59,9
05:40,520447032.0,8066.081103099567,-22.94,9
05:43,421881811.0,2907.5090423697043,-25.67,7
05:44,108563213.0,22932.913001021698,-2.07,2
05:46,633345190.0,6694.088945999846,-45.34,9
05:46,441142605.0,2049.042688878031,-6.59,2
05:47,433917275.0,7048.921330514094,-27.12,5
05:48,718058208.0,2474.949632192236,-17.83,7
05:52,264550521.0,9161.510344918295,-16.24,5
05:52,687135796.0,26028.451625641228,-12.25,9
05:55,749378808.0,3840.367687532791,-4.1,7
06:01,994214354.0,9326.032910107757,-32.42,7
06:06,116598243.0,1990.8244424999357,-16.51,7
06:06,873693307.0,8980.875212466099,-14.64,9
06:09,822250278.0,6974.717711504237,-20.95,2
06:09,284905540.0,7522.534355527526,-12.45,2
06:13,235881534.0,12453.028421677083,-67.02,2
06:13,550169791.0,20695.626615986028,-26.24,5
06:15,887853850.0,10362.090246427875,-27.03,9
06:21,256002321.0,5772.101551219393,-19.93,9
06:24,151968462.0,6423.306440012689,-17.17,7
06:27,633345190.0,6693.998122571731,-0.09,2
06:30,678851253.0,3260.7243583848385,-24.37,2
06:30,229205098.0,7033.475911579896,-75.88,2
06:30,409971170.0,2513.284600201931,-5.68,2
06:31,873701090.0,666.4136835252805,-2.79,5
06:37,496395938.0,11531.70912648016,-1.96,5
06:38,651756497.0,11491.623083335491,-14.66,7
06:38,779946617.0,16252.020221095656,-34.75,5
06:39,670102069.0,3553.5972010593023,-40.89,9
06:41,558119802.0,31355.149828733647,-13.36,2
06:50,520447032.0,8052.5909894419565,-13.49,5
06:54,506618547.0,15421.751212394824,-30.39,5
06:55,836110591.0,6306.489895746544,-35.35,9
06:57,824916823.0,8391.624014511499,-22.99,9
07:00,704517789.0,16746.800552035198,-65.13,8
07:03,873693307.0,8968.028632408555,-12.85,7
07:03,370521542.0,25029.951285971067,-1.57,7
07:03,601627384.0,4286.357921976346,-43.14,9
07:03,450896297.0,12702.111600977842,-44.95,8
07:04,482513594.0,5438.15065817196,-54.09,7
07:11,124102251.0,3216.855228284959,-3.91,2
07:13,549414742.0,6919.536209039115,-30.11,2
07:14,705848712.0,25369.21657380489,-47.45,7
07:15,709608057.0,2737.477025135733,-2.93,7
07:18,897714622.0,8338.487964537338,-22.05,5
07:18,815385232.0,9687.97189231432,-42.67,7
07:19,905860285.0,8256.645443919402,-53.25,5
07:20,414805878.0,12533.996074722005,-36.13,9
07:27,435984758.0,4146.13006198813,-25.73,2
07:34,806358207.0,11769.35394538858,-55.47,8
07:35,270374623.0,9829.869082030014,-28.19,7
07:37,699139822.0,1411.561406192829,-74.09,2
07:40,609939116.0,6974.836415165765,-0.86,8
07:43,532478725.0,4398.375277034782,-9.13,2
07:48,259015404.0,975.0510964065284,-45.53,9
07:50,859603181.0,2902.5893015662655,-59.21,5
07:54,380228542.0,-395.81305818443445,-5.65,9
07:58,449871732.0,9995.375604856989,-13.42,2
07:59,854895960.0,2852.7069008766553,-6.85,5
07:59,700138124.0,5036.1275739167,-9.36,5
08:00,655368335.0,4358.763534449747,-56.44,2
08:00,706250160.0,11439.073453252702,-31.73,2
08:00,930277104.0,9983.630417077771,-24.28,9
08:02,297823329.0,228.04369999999912,-5.65,9
08:02,518474507.0,12670.764205397656,-12.62,2
08:02,675806859.0,6547.0639675121165,-1.62,2
08:05,752362502.0,8430.782648239765,-2.24,5
08:06,454129843.0,1379.44889516656,-6.1,9
08:08,336557504.0,1173.8958372010195,-7.1,9
08:09,237493332.0,13850.372879331908,-6.0,9
08:09,146909202.0,2415.4514513734343,-5.35,9
08:10,287230540.0,997.6473432932662,-81.62,8
08:10,657139925.0,13389.407965119286,-24.23,9
08:11,256002321.0,5736.306978056205,-35.79,7
08:12,237684254.0,5590.405144078212,-22.08,7
08:12,575652395.0,2523.1523063145273,-4.5,2
08:14,534325901.0,6347.044525615674,-6.77,2
08:15,366550080.0,25148.5467745525,-0.45,8
08:22,659008214.0,-3268.5626022904235,-17.46,5
08:22,744398361.0,499.3009999999998,-31.04,5
08:22,982286721.0,-3350.20302401773,-19.33,5
08:24,197865285.0,-44.66053826877981,-43.83,5
08:27,885259672.0,3705.5613840562414,-5.4,9
08:27,624563756.0,-602.9643712164436,-36.26,5
08:30,128030172.0,-623.9432774498499,-98.27,5
08:30,398429109.0,404.7362000000011,-102.92,5
08:30,820686957.0,-952.158416311196,-105.3,5
08:32,261894284.0,-1847.988799999997,-21.43,5
08:32,391559884.0,-62.93575000000061,-106.03,5
08:35,837876918.0,-2179.6552914654208,-28.93,5
08:36,452974357.0,-3139.2189499999945,-12.37,5
08:38,975345315.0,33481.0798360409,-36.76,5
08:38,550644516.0,-267.1899500000014,-127.78,5
08:40,524425303.0,-757.2078000000012,-77.18,5
08:40,143383029.0,-390.15666934766136,-169.38,5
08:42,951817450.0,8537.776804326195,-1.17,5
08:47,667367404.0,8982.719791641104,-123.5,5
08:51,932820758.0,-2550.3115667755537,-50.8,5
08:52,282837512.0,13313.92074603716,-52.44,5
08:53,108931112.0,13384.814696139534,-49.43,9
08:54,999752672.0,849.0122935333346,-83.29,5
08:55,890830949.0,1143.9920499999978,-35.11,5
08:55,518746136.0,95.59027176308348,-49.52,5
08:58,338022396.0,355.2877393757391,-133.33,5
08:59,143003091.0,21741.926908169884,-27.67,4
09:02,145387690.0,4685.518273317337,-16.3,7
09:03,540159353.0,10539.6025487764,-7.15,9
09:04,506618547.0,15414.251212394824,-7.5,9
09:04,954263768.0,-290.06110000000024,-34.27,5
09:04,661295096.0,3022.891762857226,-41.17,7
09:05,254853117.0,1804.1849144468447,-192.49,5
09:06,441274121.0,11104.991235038664,-6.2,9
09:07,999752672.0,843.6122935333347,-5.4,9
09:08,197865285.0,-49.66053826877981,-5.0,9
09:08,117273481.0,8949.740287205384,-5.0,9
09:08,149684419.0,225.12159999999807,-17.56,5
09:09,581655972.0,39152.37916768979,-4.95,9
09:10,683078800.0,1782.9710180356278,-5.4,9
09:10,558875206.0,2691.0203108989513,-6.15,9
09:10,667367404.0,8974.919791641105,-7.8,9
09:10,587225252.0,4914.274473279901,-21.27,2
09:12,290818242.0,6675.6098313618095,-7.5,9
09:13,913127700.0,848.7701380111164,-97.01,5
09:15,170637730.0,2526.420952635649,-52.25,5
09:15,586315521.0,11656.190539552555,-5.2,9
09:15,631744379.0,-2113.8037594910675,-40.96,5
09:15,960208650.0,16981.792160008354,-51.02,2
09:16,494156986.0,-774.6858543276651,-90.79,5
09:16,703478110.0,4647.944209495413,-72.62,5
09:18,961077907.0,-24.842550000000003,-72.5,5
09:18,215426302.0,-746.0395959743081,-52.47,5
09:18,851649498.0,10009.348791714086,-4.7,9
09:20,551755686.0,6382.597655850649,-16.5,4
09:20,744398361.0,479.3109999999998,-19.99,2
09:20,169006407.0,11404.138831908778,-4.95,9
09:21,895750759.0,-820.8550380756658,-50.03,5
09:23,282837512.0,13308.78074603716,-5.14,7
09:24,987656636.0,5706.463767918188,-2.12,7
09:24,304455868.0,2706.6245568972317,-10.45,5
09:24,743630833.0,10.65611328470122,-54.92,7
09:25,601627384.0,4265.907921976346,-20.45,1
09:26,414454079.0,353.68785000000184,-6.1,4
09:27,776431321.0,3261.0479671072526,-47.82,5
09:27,134461671.0,5433.165760498112,-21.0,7
09:28,556992209.0,11202.50072856816,-26.83,2
09:29,240643705.0,288.3457673739808,-57.98,2
09:32,762896656.0,-98.2125018481413,-13.48,5
09:34,984783496.0,13767.318113504833,-17.47,2
09:35,866941383.0,1298.537650000006,-104.38,5
09:37,762700245.0,-427.5742999999975,-42.57,5
09:38,964702094.0,1612.7230376402888,-147.0,2
09:39,593191200.0,-256.4302500000009,-120.34,5
09:40,703537476.0,340.49924999999905,-60.05,2
09:40,145387690.0,4646.348273317337,-39.17,1
09:40,663479159.0,4554.326541827711,-16.98,7
09:42,781554833.0,1926.9799861949157,-26.56,5
09:42,779376323.0,2617.990575747938,-37.99,6
09:44,550832673.0,2730.675134474408,-226.07,2
09:48,348325817.0,9774.151511043729,-85.66,2
09:48,170637730.0,2468.757032635649,-57.66,4
09:50,198630866.0,-163.84432356126854,-92.99,2
09:51,195895574.0,6880.228802479105,-16.63,7
09:51,116169597.0,885.9119499999996,-64.98,4
09:52,556992209.0,11178.51072856816,-23.99,4
09:54,409370545.0,1176.7022755455205,-12.04,7
09:56,984783496.0,13509.718113504832,-257.6,2
09:58,248658670.0,166.9566500000002,-141.75,2
09:59,170637730.0,2446.667032635649,-22.09,7
10:09,788740658.0,3623.054539127714,-91.0,2
10:10,248658670.0,60.456650000000195,-106.5,2
10:12,497772347.0,794.445599999998,-76.93,4
10:13,866941383.0,1279.567650000006,-18.97,7
10:16,741903302.0,2048.1704587407876,-16.98,4
10:25,886921642.0,3039.8886621635847,-57.48,5
10:25,137822385.0,3726.996147768435,-5.0,9
10:30,855129444.0,-183.933545437372,-41.06,5
10:36,152616936.0,875.4020078630647,-105.98,2
10:37,383833857.0,23477.877099738944,-57.55,2
10:37,183888402.0,17490.442512934937,-46.88,2
10:41,788740658.0,3448.054539127714,-175.0,2
10:41,722358036.0,578.5062406270829,-157.98,2
10:41,522188082.0,7439.777214250024,-123.19,5
10:43,305778936.0,9776.524995213014,-159.59,4
10:44,240643705.0,159.10966737398076,-129.24,5
10:45,285220959.0,11307.573547905013,-44.48,2
10:51,479456865.0,1090.9973314894048,-84.98,2
10:56,930277104.0,9973.258051152445,-10.37,5
10:56,305778936.0,9570.066995213014,-206.46,7
11:02,670102069.0,3503.1517360946623,-50.45,8
11:03,788740658.0,3420.7545391277145,-27.3,2
11:07,548907062.0,-207.0062112317114,-104.98,2
11:13,738958551.0,8686.077704639574,-19.12,8
11:13,653667523.0,5005.500290159131,-13.55,8
11:15,305778936.0,9540.694995213014,-29.37,7
11:27,519644021.0,2587.1571953549164,-20.05,7
11:34,788740658.0,3365.4545391277143,-55.3,2
11:42,305778936.0,9493.108995213017,-47.59,4
11:42,479366718.0,1953.6914476324007,-31.99,2
11:56,551755686.0,6362.6176558506495,-19.98,4
12:06,588565416.0,7121.526870274404,-28.0,2
12:09,666952234.0,-413.6216018755131,-16.98,9
12:30,709608057.0,2690.697025135733,-46.78,9
12:35,106601471.0,9950.854278910938,-9.9,5
12:40,663479159.0,4540.836541827711,-13.49,9
12:41,995615876.0,1430.3466896983884,-24.98,9
12:41,128033695.0,1710.132437176903,-26.61,4
12:42,108812033.0,548.6217499999984,-33.08,5
12:48,975200042.0,-2994.872699999997,-40.83,5
12:48,816685391.0,-729.2096037084262,-45.15,5
12:49,909676212.0,543.9394045320274,-38.48,4
12:57,162370388.0,-2312.3828999999996,-43.42,5
12:59,788740658.0,3240.154539127714,-125.3,2
13:02,766941757.0,2082.1658880920268,-25.25,7
13:02,924045955.0,1408.9030126586645,-7.01,4
13:08,688712152.0,6098.562644863439,-6.5,9
13:10,550832673.0,2531.203134474408,-199.47,2
13:10,272538745.0,14423.43990000003,-28.0,2
13:12,285220959.0,11294.193547905012,-13.38,9
13:15,165691047.0,-461.315800000001,-101.51,5
13:19,890196840.0,-2857.0913166751307,-28.61,5
13:23,788740658.0,3027.354539127714,-212.8,2
13:27,448004226.0,1793.1294609010629,-15.21,7
13:28,550832673.0,2289.017134474408,-242.19,2
13:28,248658670.0,-43.793349999999805,-104.25,2
13:29,909676212.0,505.98940453202744,-37.95,7
13:29,259015404.0,934.6744025845315,-40.38,7
13:29,655450953.0,-2781.92487845553,-52.82,5
13:29,475117511.0,7331.177905789157,-65.97,7
13:33,170233640.0,46.306939949897256,-8.98,4
13:34,984783496.0,13504.5487394563,-5.17,8
13:41,277562576.0,667.5958181051029,-26.02,2
13:52,964702094.0,1397.1230376402889,-215.6,2
13:56,128033695.0,1685.902437176903,-24.23,4
13:58,886921642.0,3037.8767665141504,-2.01,5
14:00,788740658.0,2764.154539127714,-263.2,2
14:02,553734946.0,565.6478999999985,-1.5,4
14:05,339791565.0,-3516.981199999997,-18.83,5
14:10,964702094.0,1132.523037640289,-264.6,2
14:19,964702094.0,1048.523037640289,-84.0,2
14:22,298000165.0,24753.03124133149,-23.63,2
14:28,248658670.0,-88.0433499999998,-44.25,2
14:28,572136270.0,-410.6867884119768,-63.21,5
14:32,788740658.0,2577.254539127714,-186.9,2
14:50,964702094.0,744.023037640289,-304.5,2
15:04,964702094.0,653.723037640289,-90.3,2
15:20,248658670.0,-168.6683499999998,-80.62,2
15:26,165045150.0,-542.3089385971441,-21.42,5
15:32,180616589.0,700.9007092146952,-5.99,4
15:32,867987292.0,3839.313844838213,-107.81,5
15:36,106601471.0,9935.864278910938,-14.99,1
15:43,964702094.0,479.42303764028907,-174.3,2
15:45,352899149.0,428.2850499999988,-81.48,2
15:53,248658670.0,-239.1683499999998,-70.5,2
15:58,720742759.0,1220.3178308830074,-178.97,4
16:03,352899149.0,334.2850499999988,-94.0,2
16:05,964702094.0,256.1230376402891,-223.3,2
16:10,720742759.0,162.32783088300744,-57.99,4
16:11,788740658.0,2475.754539127714,-101.5,2
16:12,984783496.0,13380.6487394563,-123.9,2
16:13,718058208.0,2468.949632192236,-6.0,2
16:16,352899149.0,318.3050499999988,-15.98,2
16:29,228136274.0,1594.2822999999994,-59.85,4
16:29,310375875.0,2768.0845208458945,-39.08,2
16:32,964702094.0,110.52303764028912,-145.6,2
16:33,449387287.0,257.25769383510146,-101.99,2
16:35,310375875.0,2727.2945208458946,-40.79,9
16:36,480198977.0,12744.543720897707,-39.98,4
16:36,250957494.0,490.3214499999988,-144.7,5
16:38,286484726.0,708.6902700631588,-71.97,2
16:44,736310094.0,-846.524924027426,-62.6,5
16:45,788740658.0,2297.954539127714,-177.8,2
16:46,984783496.0,13157.376739456298,-223.27,2
16:48,146909202.0,2392.394933784888,-23.06,4
16:49,964702094.0,-0.0769623597108761,-110.6,2
16:52,248658670.0,-355.4183499999998,-116.25,2
16:53,399538448.0,6914.1767941275875,-75.91,7
16:58,624500124.0,3299.6616938559337,-42.61,2
16:59,286484726.0,620.9702700631588,-87.72,2
17:06,788740658.0,2120.854539127714,-177.1,2
17:09,683319988.0,7024.919065023874,-22.15,9
17:11,540159353.0,10521.72059384113,-17.88,2
17:12,248658670.0,-518.9183499999998,-163.5,2
17:17,887853850.0,10281.63447267148,-80.46,5
17:17,500043411.0,12924.512817510244,-13.2,9
17:18,690958123.0,19375.964683105365,-23.98,7
17:19,266777719.0,203.41643378023957,-153.45,2
17:19,277562576.0,630.1158181051029,-37.48,4
17:20,534325901.0,6337.094525615674,-9.95,9
17:20,730002588.0,12192.833875972989,-82.09,5
17:21,851181128.0,4216.089491052693,-48.5,7
17:23,221868392.0,4868.076033489492,-38.2,9
17:24,141521177.0,6815.135900000015,-77.98,2
17:24,822135975.0,10667.110869884931,-3.03,4
17:24,333054026.0,-61.01010597681001,-10.03,7
17:24,138609932.0,3250.5450032945855,-33.0,4
17:25,956717493.0,1120.0767610230714,-33.95,1
17:26,286484726.0,543.3677700631588,-77.6,2
17:27,511179916.0,6429.342885245215,-31.84,2
17:27,108563213.0,22910.013001021696,-22.9,9
17:27,134847904.0,3773.602044386296,-5.99,1
17:28,704517789.0,16673.0205520352,-73.78,2
17:29,834581602.0,348.863049999999,-40.98,2
17:29,919185264.0,2844.5072239131237,-37.95,1
17:31,996042490.0,5384.203696170785,-123.89,2
17:32,373163757.0,9981.163721725978,-16.0,4
17:32,792845450.0,591.296150000001,-14.99,4
17:32,386277162.0,356.0699999999994,-19.99,4
17:34,213112754.0,6362.836782019314,-17.62,2
17:34,482513594.0,5335.470658171959,-102.68,2
17:34,531186970.0,6432.574881634225,-82.0,2
17:35,441274121.0,11098.721235038664,-6.27,2
17:36,741269136.0,3180.8784500000006,-27.96,7
17:37,429556122.0,5643.260741187455,-10.01,1
17:37,137913631.0,1329.9196499999998,-153.98,2
17:38,822718326.0,10208.913522634271,-29.95,7
17:38,806358207.0,11758.01394538858,-11.34,4
17:39,184430449.0,1879.968363885164,-55.98,2
17:40,454129843.0,1352.48889516656,-26.96,7
17:40,479456865.0,1064.0273314894048,-26.97,4
17:41,633345190.0,6687.668122571731,-6.33,7
17:41,851649498.0,9987.256791714086,-22.09,5
17:41,795847804.0,22170.92381429767,-11.19,2
17:43,520418719.0,624.9718000000036,-122.15,5
17:43,846550094.0,1423.667464472557,-66.97,4
17:43,248658670.0,-703.4183499999998,-184.5,2
17:44,305778936.0,9363.636995213015,-129.47,2
17:46,996042490.0,5298.859696170785,-85.34,2
17:46,788740658.0,1968.9545391277136,-151.9,2
17:46,833499132.0,2068.717700000001,-26.96,7
17:48,930271460.0,58.56279753577624,-115.95,5
17:49,143061865.0,6514.213336922143,-3.0,4
17:52,975345315.0,33475.089836040905,-5.99,2
17:52,532478725.0,4376.3552770347815,-22.02,9
17:53,851181128.0,4191.1894910526935,-24.9,9
17:53,152488934.0,1419.5109573137306,-79.0,2
17:54,221868392.0,4835.049972001699,-33.03,5
17:56,656812046.0,455.0437537325189,-114.39,5
17:57,349614277.0,615.3966499999997,-130.15,5
17:57,559995067.0,3637.035153300056,-20.27,5
17:58,208381936.0,345.21442177825486,-35.34,9
17:58,558875206.0,2671.0403108989512,-19.98,7
18:01,248658670.0,-766.7933499999998,-63.38,2
18:06,195895574.0,6857.988802479105,-22.24,9
18:06,352899149.0,269.8150499999988,-48.49,2
18:07,642015139.0,-730.8061625343618,-32.5,9
18:07,128033695.0,1648.932437176903,-36.97,9
18:17,788740658.0,1937.4545391277136,-31.5,2
18:19,975345315.0,33453.6098360409,-21.48,4
18:25,779236304.0,665.5475954795323,-46.64,9
18:28,352899149.0,163.8150499999988,-106.0,2
18:32,520239952.0,-1626.6792266547632,-188.15,5
18:34,548907062.0,-271.9862112317114,-64.98,7
18:36,471897866.0,7563.901311189976,-23.87,5
18:37,987163717.0,5855.998480000006,-37.3,9
18:41,433917275.0,7041.438280514094,-7.48,7
18:42,336171116.0,-891.7075500000005,-260.91,5
18:42,119993184.0,-2029.9319029108624,-1.12,5
18:43,147474476.0,3367.712157098796,-10.99,2
18:46,817294757.0,-2613.1533,-15.35,5
18:48,994214354.0,9323.884250107756,-2.15,7
18:48,788740658.0,1695.2545391277138,-242.2,2
18:49,414805878.0,12504.597034722005,-29.4,7
18:50,885259672.0,3695.7845203669262,-9.78,2
18:51,998405607.0,-730.381499999998,-35.07,5
18:53,610645022.0,-808.9576626449183,-20.35,9
18:53,956717493.0,1046.7272610230714,-73.35,5
18:55,871200314.0,-41.82247575736165,-134.94,5
18:55,151278285.0,-920.2957000000004,-104.4,5
18:55,667367404.0,8915.637391641105,-59.28,7
18:56,815385232.0,9615.22789231432,-72.74,5
18:56,282102606.0,-155.37833757717362,-67.01,5
18:56,245690309.0,9007.604440723377,-9.91,5
18:58,769311479.0,6820.069306020127,-17.72,7
19:02,352899149.0,78.3350499999988,-85.48,2
19:04,419550103.0,17577.554309306848,-1.26,5
19:06,678726554.0,-940.1562476516102,-104.29,5
19:07,499410772.0,-2830.7268629051623,-23.98,5
19:13,478986718.0,-1194.0086000000008,-54.64,5
19:14,683319988.0,7014.604626408294,-10.31,2
19:15,630468201.0,-670.6630838897017,-59.83,5
19:17,435984758.0,4053.98206198813,-92.15,5
19:17,812839908.0,-1694.1998500000002,-11.85,5
19:20,940569402.0,5475.437751699124,-26.4,2
19:21,388862238.0,1089.6960312624228,-76.57,5
19:21,346874167.0,56.34809999999903,-50.45,5
19:21,414805878.0,12495.56425564347,-9.03,4
19:22,352899149.0,-1.6549500000011932,-79.99,2
19:22,687135796.0,26014.695696413677,-13.76,2
19:24,417850087.0,16247.806147915318,-22.8,5
19:26,384497904.0,476.3995499999991,-71.38,5
19:39,200080192.0,8895.613896880763,-68.72,8
19:39,623156843.0,4015.549508555293,-202.1,5
19:42,435313070.0,2195.7949310493455,-14.08,8
19:44,844206657.0,-207.5600948534302,-146.89,5
19:47,441274121.0,11081.87979141419,-16.84,5
19:55,662610817.0,-1370.320231324928,-152.44,5
19:57,491392945.0,4481.305500000008,-12.94,9
19:58,551196328.0,3696.00841862956,-127.93,5
20:01,380228542.0,-553.4978581844344,-157.68,5
20:02,287480331.0,7366.286411386145,-63.54,5
20:04,762859681.0,384.4425999999988,-13.87,5
20:05,487051121.0,724.369162146668,-147.09,5
20:07,234952520.0,-2109.423600000001,-21.79,5
20:12,366477356.0,93.83884999999988,-271.48,5
20:17,203466392.0,2490.370482915352,-29.81,7
20:19,668329719.0,7831.518436587672,-95.09,5
20:21,315546581.0,26875.020132256985,-2.48,7
20:22,331450202.0,7084.032182375265,-3.84,7
20:29,417850087.0,16128.92514791532,-118.88,5
20:31,355602925.0,1431.9573951313746,-6.58,2
20:32,949032480.0,4415.797571097749,-17.28,8
20:33,925659248.0,-818.0595892295712,-127.12,5
20:34,399144202.0,1601.0675759822548,-31.69,9
20:36,822135975.0,10605.818869884932,-61.29,5
20:43,131388684.0,20778.80946030305,-25.55,7
20:44,547010927.0,21831.386904064264,-25.79,9
20:51,113747882.0,11808.096321585404,-41.18,9
20:52,626989363.0,355.9123633173752,-42.07,5
20:56,600585971.0,188.23239999999953,-98.09,5
21:14,853907490.0,6783.408538624891,-13.64,9
21:38,454356905.0,1029.35580781206,-20.47,9
22:10,960208650.0,16971.970680877617,-9.82,2
02:19,518474507.0,12655.794205397657,-14.97,9
02:26,259015404.0,909.1844025845317,-25.49,9
02:38,887853850.0,10262.24447267148,-19.39,9
02:49,433917275.0,7019.108280514094,-22.33,9
03:05,520447032.0,8020.900989441957,-31.69,9
03:05,705848712.0,25356.26657380489,-12.95,9
03:06,709608057.0,2650.477025135733,-40.22,9
03:07,930277104.0,9940.25050873383,-33.01,5
03:12,256002321.0,5711.856978056205,-24.45,9
03:14,534325901.0,6325.252345086763,-11.84,7
03:14,213112754.0,6357.154950433372,-5.68,2
03:16,324224854.0,2883.183924149562,-21.1,7
03:17,802697323.0,15002.705801764909,-37.38,9
03:21,554792076.0,26663.704156078664,-53.02,7
03:21,719586818.0,16719.661028014158,-82.89,2
03:24,842682241.0,4903.614234343489,-36.17,5
03:26,785749304.0,7961.877617380879,-15.0,9
03:26,679662108.0,15459.877437292633,-51.79,8
03:30,287480331.0,7346.296411386145,-19.99,9
03:32,940569402.0,5452.521019281793,-4.73,8
03:33,678851253.0,3256.8439267458753,-3.88,2
03:38,520447032.0,8002.943032401564,-17.96,8
03:38,749378808.0,3803.396050365529,-36.97,2
03:42,874431242.0,7892.258186983719,-35.24,9
03:45,779236304.0,632.2175954795323,-33.33,9
03:46,766941757.0,2049.525888092027,-32.64,9
03:51,549414742.0,6904.210251689783,-15.33,5
03:54,108563213.0,22865.11214162991,-44.9,5
03:55,383625050.0,5717.006673107914,-31.87,5
03:58,519644021.0,2553.944114892644,-33.21,5
04:00,550169791.0,20678.370510454693,-17.26,2
04:00,873693307.0,8910.427240070547,-57.6,7
04:03,511179916.0,6414.154954374509,-15.19,2
04:11,310375875.0,2721.436088975235,-5.86,5
04:14,322720763.0,5474.684230811608,-25.08,8
04:15,706250160.0,11425.684698273264,-13.39,2
04:18,752362502.0,8427.274468980493,-3.51,7
04:20,874431242.0,7883.558308677465,-8.7,5
04:22,322221939.0,3532.4267264298164,-55.29,2
04:27,822250278.0,6946.717711504237,-28.0,9
04:28,113747882.0,11788.080858008538,-20.02,7
04:29,865748375.0,3577.810425738394,-17.04,7
04:31,256002321.0,5679.6278673657025,-32.23,5
04:35,506618547.0,15397.783384472175,-16.47,2
04:36,383833857.0,23473.123195044293,-4.75,2
04:38,419550103.0,17541.014309306847,-36.54,9
04:39,417850087.0,16118.984552910666,-9.94,5
04:42,532478725.0,4349.965277034781,-26.39,9
04:47,510101371.0,12594.376177404576,-35.04,9
04:49,639549973.0,6200.629943278187,-2.15,2
04:50,670102069.0,3471.7617360946624,-31.39,9
04:53,547010927.0,21817.58485270624,-13.8,8
04:54,679911053.0,2364.612366754157,-31.78,5
04:55,887853850.0,10245.36737445374,-16.88,2
04:55,705848712.0,25355.16229937316,-1.1,5
04:55,572384506.0,6946.21318144904,-35.13,9
04:59,633345190.0,6660.188122571732,-27.48,9
05:05,331450202.0,7073.315125128859,-10.72,5
05:06,308505160.0,13696.128446336974,-8.05,7
05:08,604288474.0,2273.348490237777,-8.93,5
05:10,651756497.0,11446.464149171174,-45.16,4
05:13,683319988.0,6974.374626408295,-40.23,9
05:14,985188462.0,-617.5532112887752,-40.19,9
05:14,994214354.0,9301.544250107756,-22.34,9
05:14,897714622.0,8330.142063206384,-8.35,5
05:17,853907490.0,6686.9319456832345,-81.24,2
05:17,145387690.0,4621.9582733173365,-24.39,9
05:23,510101371.0,12571.2083302572,-23.17,8
05:27,822250278.0,6924.051357289891,-22.67,2
05:32,836110591.0,6275.099895746544,-31.39,9
05:35,885259672.0,3659.2686773266105,-36.52,2
05:35,304455868.0,2692.260788840245,-14.36,7
05:36,285220959.0,11277.084029467804,-17.11,8
05:37,687135796.0,26005.71569641368,-8.98,9
05:39,905860285.0,8189.153192804764,-67.49,2
05:40,657139925.0,13372.167965119286,-17.24,9
05:45,120634201.0,4439.531500000006,-17.93,9
05:45,601627384.0,4230.487921976346,-35.42,9
05:47,482513594.0,5310.232161593704,-25.24,7
05:48,145387690.0,4616.299206755323,-5.66,5
05:50,221868392.0,4802.959972001699,-32.09,9
05:52,183888402.0,17441.142512934937,-49.3,9
05:52,673025413.0,3670.834801527474,-29.67,5
05:53,670102069.0,3459.452801544446,-12.31,5
05:54,407574996.0,392.9176027083207,-16.05,5
05:56,270374623.0,9758.092854958766,-71.78,5
06:05,683319988.0,6958.203439708285,-16.17,5
06:06,758160963.0,7872.61979136265,-47.44,7
06:08,639409800.0,34194.89748599883,-70.24,5
06:10,836110591.0,6269.449512033104,-5.65,2
06:15,237493332.0,13769.616551480964,-80.76,2
06:17,675806859.0,6528.94999152572,-18.11,7
06:19,196289502.0,14801.37129250258,-13.75,9
06:25,264550521.0,9123.936385962492,-37.57,7
06:26,414454079.0,313.00785000000184,-40.68,9
06:30,187541224.0,1205.760756964371,-35.37,9
06:30,187111705.0,6334.181583165262,-0.66,7
06:33,943329213.0,1614.906857554019,-6.17,7
06:35,949032480.0,4381.547571097749,-34.25,9
06:39,203466392.0,2477.27884422618,-13.09,7
06:43,414805878.0,12459.81425564347,-35.75,9
06:44,399144202.0,1568.0875759822547,-32.98,9
06:49,200080192.0,8837.690166440241,-57.92,8
06:50,421881811.0,2899.1978742967754,-8.31,4
06:51,899742927.0,12100.558973120264,-20.99,8
06:51,699139822.0,1370.311406192829,-41.25,9
06:51,581655972.0,39125.58648808456,-26.79,4
06:52,973086490.0,9831.661502419009,-23.46,2
06:54,809499628.0,16217.67239916858,-18.9,9
06:54,496395938.0,11529.65045441734,-2.06,5
06:55,473820682.0,10668.095269836638,-84.76,5
06:57,235881534.0,12435.890188061228,-17.14,7
07:04,613729471.0,8606.010903534234,-1.77,7
07:05,815385232.0,9599.093799782491,-16.13,8
07:09,832564361.0,15329.722380254563,-48.26,8
07:09,346874167.0,23.108099999999027,-33.24,9
07:11,429556122.0,5628.377293564646,-14.88,2
07:11,633345190.0,6636.145870734288,-24.04,2
07:12,305778936.0,9341.646995213016,-21.99,9
07:13,601627384.0,4230.074344934625,-0.41,8
07:15,912705941.0,17638.90318272593,-13.32,7
07:15,667367404.0,8897.632124029218,-18.01,8
07:16,169006407.0,11387.529804017267,-16.61,7
07:18,738958551.0,8667.74827897255,-18.33,7
07:20,623156843.0,4012.74129733316,-2.81,2
07:22,986267641.0,7252.622043564545,-9.14,2
07:27,575652395.0,2492.862964366797,-30.29,2
07:29,858989281.0,26064.072629356688,-15.73,5
07:29,435984758.0,4053.630899401866,-0.35,7
07:29,366550080.0,25142.433247375913,-6.11,2
07:30,315546581.0,26870.28665190169,-4.73,8
07:30,588565416.0,7060.876713196424,-60.65,2
07:31,518474507.0,12651.518611502615,-4.28,2
07:37,151968462.0,6402.528778412117,-20.78,7
07:37,795847804.0,22167.3331049844,-3.59,2
07:37,450896297.0,12677.141600977842,-24.97,9
07:41,128033695.0,1598.1618081314036,-50.77,7
07:41,687135796.0,26000.83597795342,-4.88,2
07:42,657139925.0,13361.215667245917,-10.95,7
07:47,216285378.0,22942.16938463492,-34.48,9
07:49,134461671.0,5386.387709105707,-46.78,8
07:58,364357875.0,6955.75927695651,-20.91,7
07:58,785749304.0,7948.0727558898925,-13.8,7
07:58,290818242.0,6665.506872921571,-10.1,2
08:01,540159353.0,10515.319721611431,-6.4,5
08:03,987656636.0,5672.271093481563,-34.19,2
08:04,970298834.0,2842.459436105614,-7.53,8
08:07,399538448.0,6909.376794127587,-4.8,9
08:07,124102251.0,3199.5238062231297,-17.33,8
08:08,336557504.0,1166.0958372010195,-7.8,9
08:12,779946617.0,16219.238222273125,-32.78,2
08:13,454129843.0,1346.33889516656,-6.15,9
08:19,851649498.0,9979.11283654294,-8.14,2
08:22,618514666.0,19820.56008321062,-65.62,5
08:22,885259672.0,3652.6686773266106,-6.6,9
08:23,948558249.0,8552.573140383674,-6.1,9
08:25,229205098.0,7006.774669873388,-26.7,5
08:26,252701364.0,-3669.901172677916,-13.11,5
08:26,391688371.0,202.93529956852308,-45.74,5
08:29,651756497.0,11365.572149171174,-80.89,5
08:31,213112754.0,6322.056950433372,-35.1,5
08:32,564214408.0,-213.4244152742739,-42.92,5
08:32,833899961.0,1506.6111442498695,-49.97,5
08:34,189335192.0,-1163.3920017578605,-75.33,5
08:35,558119802.0,31326.842041562093,-28.31,2
08:35,540159353.0,10462.175721611433,-53.14,5
08:37,287480331.0,7325.989907088004,-20.31,7
08:37,344522228.0,-2805.3469882083928,-7.34,5
08:38,344219145.0,7226.305590289772,-100.32,5
08:39,535804582.0,-1403.773900000001,-42.03,5
08:45,280130290.0,-9.199750000000408,-119.84,5
08:46,180719578.0,-4227.580249999995,-16.19,5
08:46,461990622.0,8461.913385583235,-9.98,5
08:47,173317688.0,-2295.538734884285,-47.82,5
08:49,541639148.0,4515.922693255756,-19.01,5
08:55,737645298.0,-2701.5491999999986,-52.05,5
08:56,534204159.0,5844.052049706105,-4.26,7
09:02,585625048.0,1328.6131832415313,-49.54,5
09:03,534325901.0,6256.148345086763,-69.1,5
09:03,461029994.0,6917.982299682367,-33.03,5
09:05,558875206.0,2664.590310898951,-6.45,9
09:06,425964226.0,3529.6526500000023,-5.8,9
09:09,370521542.0,25026.177265487957,-3.77,5
09:09,993663752.0,56.74979241039652,-109.21,5
09:11,639409800.0,34062.807485998834,-132.09,5
09:12,540159353.0,10455.825721611433,-6.35,9
09:15,355733816.0,4824.794913842312,-12.98,7
09:15,290818242.0,6659.606872921571,-5.9,9
09:16,596328017.0,-2479.5728499999987,-66.43,5
09:16,718058208.0,2453.635073764162,-15.31,2
09:16,737537711.0,-1119.1319663984643,-19.34,5
09:17,553734946.0,476.44479999999845,-89.2,5
09:17,690958123.0,19370.464683105365,-5.5,9
09:19,851649498.0,9972.01283654294,-7.1,9
09:19,609939116.0,6963.986324417849,-10.85,2
09:19,117273481.0,8944.040287205384,-5.7,9
09:20,506618547.0,15392.583384472176,-5.2,9
09:20,767447966.0,4299.416065512111,-126.08,5
09:20,246753533.0,517.9895999999985,-22.98,2
09:21,298007503.0,993.4801036256332,-57.84,2
09:21,679662108.0,15380.407437292632,-79.47,2
09:22,414454079.0,306.92785000000185,-6.08,4
09:22,169006407.0,11382.829804017269,-4.7,9
09:23,687135796.0,25961.295977953418,-39.54,1
09:26,519644021.0,2543.924114892644,-10.02,7
09:26,596171893.0,45.721744825511095,-38.95,7
09:27,741903302.0,2042.4704587407875,-5.7,9
09:28,541639148.0,4484.092693255756,-31.83,2
09:29,441274121.0,11076.62979141419,-5.25,9
09:31,214765415.0,-1046.2660488501351,-113.06,5
09:32,822250278.0,6904.677277289891,-19.37,4
09:32,246753533.0,453.0095999999985,-64.98,2
09:33,673025413.0,3544.834801527474,-126.0,7
09:34,821971408.0,821.7611534046047,-24.96,7
09:34,598793068.0,537.2678999999982,-6.0,4
09:36,779376323.0,2605.490575747938,-12.5,4
09:40,179173981.0,4360.738651758548,-64.35,2
09:41,282837512.0,13295.209298290229,-13.57,2
09:44,681955876.0,-1627.5856000000006,-41.83,5
09:44,191992682.0,-2731.301460292063,-95.66,5
09:46,391688371.0,170.91529956852307,-32.02,2
09:49,175452235.0,949.0232500000002,-71.55,2
09:49,575652395.0,2342.5829643667967,-150.28,2
09:50,280098744.0,174.4723778716656,-59.98,4
09:51,828750680.0,1288.7323452136798,-25.0,2
09:52,195895574.0,6827.418802479106,-30.57,4
09:57,700138124.0,5031.5940062393265,-4.53,2
09:59,647472692.0,23741.13287745408,-84.19,4
09:59,977899503.0,-510.5631064191474,-93.25,5
10:01,308897841.0,896.3846999999989,-37.59,5
10:06,454356905.0,973.8190459217604,-55.54,2
10:06,673025413.0,3419.534801527474,-125.3,7
10:15,310620484.0,-44.31280490780166,-15.07,7
10:18,225210798.0,685.2447737592086,-142.79,2
10:19,924045955.0,1311.7855126586644,-97.12,2
10:19,879091637.0,-459.972476262023,-206.66,5
10:20,456246119.0,19457.632066565144,-71.99,2
10:21,137822385.0,3579.2065477684355,-147.79,5
10:23,246753533.0,448.0595999999985,-4.95,9
10:25,857997794.0,660.3466651508871,-16.49,4
10:26,943829984.0,-1056.175490886543,-27.64,5
10:27,237684254.0,5531.222851140548,-59.18,2
10:27,993238248.0,-921.267487392884,-209.2,5
10:33,570269025.0,2825.615657045128,-36.95,1
10:33,828750680.0,1205.7623452136795,-82.97,2
10:37,673025413.0,3136.034801527474,-283.5,4
10:38,570323670.0,3908.578474035425,-50.04,2
10:39,469330905.0,96.54006802921552,-31.99,2
11:07,604288474.0,2170.954330237777,-102.39,4
11:08,391688371.0,3.643299568523105,-167.27,2
11:09,973086490.0,9726.675502419008,-104.99,2
11:38,973086490.0,9623.831502419009,-102.84,2
11:44,673025413.0,3034.534801527474,-101.5,4
11:48,456246119.0,19441.132066565144,-16.5,4
11:52,769319491.0,1349.4094999999993,-14.69,5
11:56,370521542.0,25012.847265487955,-13.33,2
11:58,673025413.0,2888.234801527474,-146.3,4
11:59,809499628.0,16197.872000478825,-19.8,5
12:08,322221939.0,3519.3667264298165,-13.06,1
12:09,480557476.0,10664.23465625861,-22.33,5
12:09,973086490.0,9511.831502419009,-112.0,2
12:13,744398361.0,441.2609999999998,-38.05,9
12:14,547010927.0,21790.99485270624,-26.59,9
12:22,409370545.0,1159.6522755455203,-17.05,7
12:28,973086490.0,9423.659502419008,-88.17,2
12:40,225210798.0,613.8587737592086,-71.39,2
12:45,133755851.0,-20.56145838198858,-22.62,9
12:48,776431321.0,3250.067967107253,-10.98,1
12:51,726913482.0,-1164.9884985264762,-94.06,5
12:51,815993333.0,6134.912639061407,-47.02,5
12:52,936813994.0,925.1831608327882,-67.39,5
12:54,213096759.0,-1469.8491082144396,-54.72,5
12:55,661295096.0,3017.901762857226,-4.99,1
13:00,262767079.0,-1219.6478000000002,-68.33,5
13:02,340321732.0,1557.680150000003,-7.3,9
13:04,225210798.0,533.3867737592086,-80.47,2
13:06,799286313.0,-1269.9318128758614,-127.54,5
13:07,585625048.0,1321.1131832415313,-7.5,9
13:09,142791593.0,-243.64870000000036,-143.68,5
13:10,280098744.0,153.9723778716656,-20.5,9
13:10,127809299.0,976.550253485056,-28.0,2
13:10,672994751.0,-185.10370921398996,-23.97,7
13:13,679662108.0,15347.847437292632,-32.56,7
13:15,421475159.0,-472.88173732558744,-85.41,5
13:18,688712152.0,6093.762644863439,-4.8,9
13:19,472995101.0,1746.9444342428033,-103.98,5
13:22,407574996.0,386.9176027083207,-6.0,9
13:23,910730524.0,7802.632258487081,-6.1,9
13:39,673025413.0,2770.634801527474,-117.6,4
13:40,444371478.0,550.6379999999988,-121.14,5
13:54,673025413.0,2452.134801527474,-318.5,7
13:56,970298834.0,2787.229436105614,-55.23,5
14:06,401293808.0,-273.6802000000008,-198.6,5
14:13,108931112.0,13346.434696139537,-38.38,9
14:35,718058208.0,2373.247073764162,-80.39,5
14:39,441142605.0,2046.5426888780312,-2.5,4
15:46,867987292.0,3838.652493325805,-0.66,2
15:53,409971170.0,2472.2839784307043,-41.0,8
15:59,996042490.0,5292.354006936873,-6.51,4
16:04,116598243.0,1937.544026768629,-53.28,7
16:14,392270893.0,12396.90451108325,-19.75,9
16:15,587225252.0,4866.834473279901,-47.44,9
16:15,534097839.0,-3533.668549999998,-9.97,5
16:18,603721739.0,939.272899483184,-19.97,7
16:21,786879739.0,-2287.850794120557,-49.38,5
16:21,475117511.0,7322.16544837991,-9.01,2
16:27,713641917.0,837.5905352159157,-62.99,2
16:33,180616589.0,665.9765281236176,-34.92,5
16:36,673025413.0,2249.8348015274737,-202.3,7
16:41,208381936.0,251.2144217782549,-94.0,2
16:42,679662108.0,15287.661437292632,-60.19,5
16:44,948558249.0,8527.603140383675,-24.97,7
16:46,252760664.0,6366.12968209446,-21.17,5
16:50,126929801.0,1947.165106340476,-62.73,5
16:51,192202372.0,270.7079338887978,-13.97,4
16:53,444428189.0,1024.404200000003,-233.36,5
16:54,158414827.0,-1767.4400000000016,-8.99,5
16:55,170233640.0,-31.693060050102744,-78.0,2
16:58,673025413.0,2061.5348015274735,-188.3,4
17:00,709608057.0,2618.410081360085,-32.07,8
17:03,679911053.0,2350.132366754157,-14.48,4
17:03,233981231.0,2270.168881960624,-25.98,4
17:04,586315521.0,11618.896548077091,-37.29,7
17:09,208381936.0,61.23442177825484,-189.98,2
17:10,651372390.0,-3495.930749999999,-28.4,5
17:11,587225252.0,4707.584473279901,-159.25,2
17:12,678330503.0,2335.925893880826,-3.06,7
17:13,497772347.0,787.455599999998,-6.99,7
17:15,704517789.0,16658.03221624029,-14.99,2
17:15,522188082.0,7438.1397489459105,-1.64,2
17:15,679911053.0,2326.172366754157,-23.96,7
17:22,581655972.0,39112.60648808456,-12.98,7
17:24,358846516.0,606.4102725272178,-50.0,2
17:24,984783496.0,13140.426739456298,-16.95,9
17:25,651756497.0,11350.372149171171,-15.2,7
17:27,885259672.0,3536.4966773266106,-116.17,2
17:27,647936800.0,3262.209816151634,-30.65,9
17:27,854513972.0,1201.44305,-32.95,7
17:27,489964679.0,19888.762134756624,-36.73,4
17:29,308068836.0,5.14752256819223,-28.8,9
17:29,987163717.0,5804.318480000005,-51.68,9
17:29,859603181.0,2879.6093015662655,-22.98,7
17:30,901432314.0,3342.596654826323,-9.35,2
17:30,859603181.0,2862.6266206736764,-16.98,4
17:32,990461108.0,8.70781862061105,-131.98,2
17:33,899742927.0,11863.321973120264,-237.24,5
17:33,771125520.0,1483.4070499999996,-44.99,6
17:36,113747882.0,11751.040858008537,-37.04,9
17:38,446720287.0,-546.5952091815944,-62.98,2
17:38,610450243.0,-936.1196,-33.78,5
17:38,216285378.0,22786.76938463492,-155.4,2
17:40,532478725.0,4330.177438385288,-19.79,7
17:41,462962606.0,2911.244049999999,-70.98,2
17:42,117273481.0,8934.050287205384,-9.99,7
17:43,256002321.0,5621.637867365703,-57.99,1
17:43,940569402.0,5416.971019281793,-35.55,7
17:44,986267641.0,7142.212043564545,-110.41,2
17:46,534325901.0,6240.465755086762,-15.68,4
17:47,891716230.0,249.67665139261624,-174.0,2
17:47,631111289.0,-692.3665000000008,-35.88,5
17:49,815385232.0,9505.283799782492,-93.81,2
17:49,596463612.0,-982.3401047251388,-24.13,5
17:51,340295966.0,-1575.1469500000003,-36.48,5
17:51,361201224.0,3178.5142320678915,-27.07,7
17:52,358846516.0,521.4102725272178,-85.0,2
17:53,982949451.0,-3625.9991670525087,-51.26,5
17:53,399144202.0,1550.069390589871,-18.02,7
17:54,858989281.0,26008.58262935669,-55.49,2
17:54,106601471.0,9922.156998553104,-13.71,2
17:56,885259672.0,3371.3246773266105,-165.17,2
17:57,742223719.0,667.5316073048026,-56.97,4
17:57,771125520.0,1463.4370499999995,-19.97,7
17:59,121858569.0,191.3211500000025,-93.51,5
18:05,857455726.0,-979.1196641243156,-33.18,9
18:07,441274121.0,11063.62979141419,-13.0,9
18:07,668329719.0,7831.046289083685,-0.47,2
18:10,762859681.0,363.3025999999988,-21.14,9
18:10,131388684.0,20755.003284443443,-23.81,2
18:12,195895574.0,6804.278802479105,-23.14,9
18:13,548907062.0,-423.48651123171146,-151.5,5
18:17,824916823.0,8369.284014511499,-22.34,9
18:18,448279144.0,976.5449999999992,-100.81,5
18:18,365608668.0,214.84695202418877,-11.97,7
18:21,486495235.0,1595.4868393887164,-157.35,5
18:22,471897866.0,7518.569311189975,-45.33,5
18:22,656812046.0,422.4937537325188,-32.55,9
18:23,471897866.0,7505.368251111056,-13.2,2
18:26,730002588.0,12190.79661230634,-2.04,2
18:26,500043411.0,12908.326225334584,-16.19,2
18:28,270374623.0,9716.806854958766,-41.29,5
18:28,331450202.0,7062.115125128859,-11.2,5
18:28,280268430.0,4488.555272555075,-274.03,5
18:30,383833857.0,23466.13319504429,-6.99,9
18:30,639420537.0,-1583.0239499999998,-31.91,5
18:37,822135975.0,10592.589843674094,-13.23,8
18:37,298007503.0,963.5501036256333,-29.93,9
18:42,471897866.0,7484.855001111056,-20.51,7
18:44,433837402.0,-362.71586846418813,-50.12,9
18:45,348525881.0,-1025.2583754050638,-82.28,5
18:47,583558311.0,-844.2652152486677,-62.54,5
18:50,851181128.0,4144.391414777757,-46.8,2
18:50,949032480.0,4370.781734253108,-10.77,7
18:50,433917275.0,7002.028280514094,-17.08,7
18:51,184430449.0,1744.487913885164,-135.48,5
18:51,901432314.0,3322.285454826323,-20.31,7
18:54,795847804.0,22100.595104984397,-66.74,5
18:55,752362502.0,8348.398468980493,-78.88,5
18:56,558119802.0,31300.662041562093,-26.18,9
18:58,138969884.0,737.8837999999994,-41.46,5
19:00,489964679.0,19858.572134756625,-30.19,9
19:01,682194230.0,-2277.8433499999996,-36.2,5
19:03,873701090.0,588.3776835252805,-78.04,5
19:06,305778936.0,9328.329997297693,-13.32,4
19:07,902798190.0,-1023.8036344310266,-161.2,5
19:09,108481285.0,8351.018246515458,-0.8,5
19:14,299871610.0,311.72815305876657,-17.33,5
19:16,564744955.0,287.23645858884186,-42.88,5
19:18,570575024.0,-1129.7605500000006,-162.53,5
19:18,406862520.0,141.3910265374104,-197.94,5
19:20,758160963.0,7856.16979136265,-16.45,9
19:21,461990622.0,8368.589385583235,-93.32,5
19:21,426474982.0,-3660.21475,-18.49,5
19:24,769311479.0,6793.744834733415,-26.32,2
19:25,675231808.0,16060.711001272812,-118.75,5
19:30,698955014.0,377.0615169516667,-22.68,9
19:32,986267641.0,7118.032043564544,-24.18,9
19:33,170637730.0,2380.5335579433868,-66.13,2
19:37,297823329.0,159.11644999999913,-68.93,5
19:42,331450202.0,7018.043125128859,-44.07,5
19:43,627723633.0,-2063.7763280037625,-37.09,5
19:45,550832673.0,2242.481134474408,-46.54,5
19:45,170233640.0,-52.62061005010274,-20.93,5
19:45,623156843.0,3996.30129733316,-16.44,9
19:46,678851253.0,3144.8089267458754,-112.03,5
19:48,719742742.0,-1118.6600077779633,-31.48,9
19:53,441274121.0,10989.856924708827,-73.77,5
19:56,245690309.0,8984.350126186437,-23.25,7
19:57,587225252.0,4688.629076743216,-18.96,7
19:58,175452235.0,911.2652500000002,-37.76,5
20:00,184430449.0,1703.7039276932644,-40.78,7
20:06,282837512.0,13260.409298290228,-34.8,9
20:15,146909202.0,2376.3714452635454,-16.02,5
20:17,416060965.0,-215.21774529941968,-47.72,5
20:22,742223719.0,527.3828573048027,-140.15,5
20:23,500051919.0,1322.3596966505904,-52.99,5
20:23,245690309.0,8957.106126186436,-27.24,5
20:26,503575533.0,6174.41888693877,-128.18,5
20:29,196289502.0,14744.37298488658,-57.0,7
20:37,933491926.0,2946.534300000002,-40.57,5
20:45,414805878.0,12455.61664831722,-4.2,7
20:49,624500124.0,3288.015954908591,-11.65,7
20:54,741903302.0,2010.314065014125,-32.16,7
21:14,450896297.0,12673.567828424457,-3.57,7
21:15,973086490.0,9405.319502419008,-18.34,9
21:43,259015404.0,905.2962661598168,-3.89,2
00:03,987656636.0,5657.034871610741,-15.24,7
00:29,575652395.0,2335.1839692291874,-7.4,7
01:30,879091637.0,-500.172476262023,-40.2,9
01:34,687135796.0,25945.065977953414,-16.23,9
01:52,809499628.0,16179.508153236333,-18.36,5
02:27,779946617.0,16183.548222273124,-35.69,9
02:40,749378808.0,3737.676050365529,-31.54,9
02:41,348325817.0,9737.611511043726,-36.54,9
02:45,461990622.0,8343.40826287333,-25.18,7
02:51,987163717.0,5769.578480000006,-34.74,9
03:00,709608057.0,2588.7600813600848,-29.65,9
03:08,613729471.0,8592.784623826807,-13.23,2
03:08,930277104.0,9906.92050873383,-33.33,9
03:12,348325817.0,9733.038811256549,-4.57,8
03:13,912705941.0,17613.72862458717,-25.17,7
03:13,705848712.0,25353.7005021796,-1.46,7
03:15,984783496.0,13121.754359975515,-18.67,8
03:17,520418719.0,585.8418000000036,-39.13,9
03:23,853907490.0,6669.351630160027,-17.58,5
03:26,698076160.0,5880.916133491008,-9.14,8
03:34,901432314.0,3319.807821965381,-2.48,2
03:36,670102069.0,3430.862801544446,-28.59,9
03:36,116598243.0,1903.6483495061843,-33.9,2
03:36,899742927.0,11821.526843763437,-41.8,2
03:44,601627384.0,4187.644344934624,-42.43,9
03:45,738958551.0,8665.05799813645,-2.69,8
03:47,785749304.0,7940.5727558898925,-7.5,9
03:53,657139925.0,13348.015667245914,-13.2,9
03:54,930277104.0,9887.230652911365,-19.69,7
03:57,216285378.0,22743.28938463492,-43.48,9
03:59,706250160.0,11385.694338723835,-39.99,8
04:01,198051483.0,-1284.8319104088569,-22.44,9
04:02,581655972.0,39107.2564719474,-5.35,7
04:02,994214354.0,9256.304250107756,-45.24,9
04:04,506618547.0,15386.874970734136,-5.71,7
04:05,417850087.0,16107.330798221565,-11.65,2
04:08,887853850.0,10244.549599942276,-0.82,4
04:16,586315521.0,11584.683201486812,-34.21,4
04:18,779946617.0,16181.586502571665,-1.96,2
04:28,550169791.0,20622.89302204506,-55.48,7
04:29,960208650.0,16926.41656625298,-45.55,5
04:32,187541224.0,1167.480756964371,-38.28,9
04:32,678330503.0,2320.6154319991983,-15.31,7
04:33,407574996.0,348.9382817224177,-37.98,8
04:36,108563213.0,22844.78053668322,-20.33,7
04:37,802697323.0,14968.965801764907,-33.74,9
04:40,414805878.0,12421.82664831722,-33.79,9
04:41,305778936.0,9324.831922615642,-3.5,7
04:42,822250278.0,6888.1521533736595,-16.53,7
04:43,237684254.0,5495.987591771629,-35.24,5
04:44,117308635.0,776.9341457238347,-21.95,7
04:48,886921642.0,3013.7267665141503,-24.15,9
04:51,824916823.0,8344.3240145115,-24.96,9
04:55,985188462.0,-651.2832112887752,-33.73,9
04:57,572384506.0,6912.63318144904,-33.58,9
05:02,687135796.0,25921.30726689676,-23.76,7
05:03,858989281.0,25991.642629356687,-16.94,9
05:06,766941757.0,2019.455888092027,-30.07,9
05:06,264550521.0,9092.407137170589,-31.53,7
05:08,670102069.0,3429.8487081728063,-1.01,5
05:12,399144202.0,1527.689390589871,-22.38,9
05:13,851181128.0,4119.5014147777565,-24.89,9
05:14,285220959.0,11204.260617707016,-72.82,7
05:17,494789005.0,2757.04287621259,-0.75,7
05:19,324224854.0,2878.556096042618,-4.63,2
05:19,113747882.0,11715.150858008536,-35.89,9
05:21,183888402.0,17412.422512934936,-28.72,9
05:21,994214354.0,9223.615951885013,-32.69,4
05:23,532478725.0,4325.410200962868,-4.77,7
05:27,957821152.0,-1678.0981535715496,-35.59,9
05:28,719586818.0,16701.034439245595,-18.63,2
05:29,259015404.0,861.4662661598167,-43.83,9
05:30,433917275.0,6973.588280514095,-28.44,9
05:36,752362502.0,8325.480215355523,-22.92,4
05:40,124102251.0,3139.7861019389547,-59.74,7
05:43,196289502.0,14728.38298488658,-15.99,9
05:46,779236304.0,593.7175954795323,-38.5,9
05:47,679662108.0,15276.669429652522,-10.99,5
05:49,473820682.0,10656.816022935876,-11.28,8
05:52,370521542.0,24974.21043301759,-38.64,5
05:53,108931112.0,13306.744696139534,-39.69,9
05:53,856957948.0,9173.834187619512,-23.04,9
05:54,588565416.0,7056.509766954423,-4.37,2
05:58,683319988.0,6918.373439708285,-39.83,9
05:59,785749304.0,7911.609576427285,-28.96,5
06:00,256002321.0,5611.087867365703,-10.55,9
06:01,609939116.0,6963.528561182568,-0.46,7
06:02,145387690.0,4587.669206755323,-28.63,9
06:03,570269025.0,2820.850800644421,-4.76,7
06:06,951817450.0,8529.769153283709,-8.01,7
06:06,287480331.0,7298.799907088004,-27.19,9
06:06,678851253.0,3137.4547988879417,-7.35,7
06:21,558119802.0,31277.86867894478,-22.79,5
06:21,657139925.0,13328.811793504436,-19.2,2
06:26,858989281.0,25942.54759652954,-49.1,2
06:26,547010927.0,21758.56358582431,-32.43,2
06:27,146909202.0,2369.1954148354,-7.18,7
06:28,414805878.0,12399.637285648118,-22.19,5
06:29,683319988.0,6895.828424325123,-22.55,7
06:32,187111705.0,6331.613265286995,-2.57,5
06:33,749378808.0,3727.12817050911,-10.55,5
06:35,851649498.0,9956.285304642228,-15.73,7
06:39,824916823.0,8321.367672698154,-22.96,5
06:40,769311479.0,6773.228690657349,-20.52,2
06:40,549414742.0,6871.2302516897835,-32.98,9
06:42,940569402.0,5395.781019281793,-21.19,9
06:42,145387690.0,4577.35462293832,-10.31,8
06:45,170233640.0,-70.56061005010274,-17.94,9
06:50,433917275.0,6943.41397071294,-30.17,7
06:51,541639148.0,4444.0870930489455,-40.01,2
06:51,975345315.0,33422.4098931732,-31.2,5
06:51,169006407.0,11374.135994552218,-8.69,2
06:51,482513594.0,5300.470496298431,-9.76,5
06:53,170637730.0,2360.459442296441,-20.07,4
06:55,668329719.0,7825.828494222776,-5.22,7
06:55,554792076.0,26588.72937575841,-74.97,7
07:00,450896297.0,12649.647828424457,-23.92,9
07:05,873693307.0,8888.947240070547,-21.48,9
07:06,510101371.0,12534.0783302572,-37.13,9
07:08,245690309.0,8950.16608145665,-6.94,5
07:09,673025413.0,2058.8278025748023,-2.71,5
07:09,284905540.0,7522.055891119422,-0.48,7
07:10,304455868.0,2657.6678581668994,-34.59,5
07:10,518474507.0,12616.028611502616,-35.49,9
07:10,383833857.0,23431.908253308105,-34.22,2
07:13,940569402.0,5342.663675686443,-53.12,5
07:13,718058208.0,2342.459366622482,-30.79,8
07:15,675806859.0,6513.890670420737,-15.06,7
07:16,829914501.0,-56.52919342902577,-5.7,9
07:24,252760664.0,6334.581819674451,-31.55,7
07:29,815385232.0,9422.746163762818,-82.54,5
07:34,480557476.0,10656.926811744026,-7.31,5
07:34,322221939.0,3504.672223150747,-14.69,5
07:38,399144202.0,1522.6246603986522,-5.06,5
07:38,730002588.0,12188.01615442368,-2.78,7
07:40,873693307.0,8862.572607253374,-26.37,5
07:42,949032480.0,4352.831734253108,-17.95,9
07:43,270374623.0,9692.40786866079,-24.4,5
07:44,639409800.0,33991.570672869726,-71.24,5
07:45,587225252.0,4651.859076743215,-36.77,9
07:47,454356905.0,946.8790459217604,-26.94,9
07:48,198946608.0,3574.9381573261844,-67.84,5
07:49,383625050.0,5709.869171654807,-7.14,2
07:52,836110591.0,6231.769512033104,-37.68,9
07:54,392270893.0,12375.254845481602,-21.65,7
07:54,623156843.0,3951.1102896332977,-45.19,5
08:01,842682241.0,4888.201193759997,-15.41,8
08:01,203466392.0,2465.6567964030883,-11.62,5
08:04,308505160.0,13687.36341695207,-8.77,4
08:04,179173981.0,4344.240466284988,-16.5,8
08:06,948558249.0,8522.303140383676,-5.3,9
08:10,564744955.0,280.73645858884186,-6.5,9
08:10,256002321.0,5592.772252788479,-18.32,8
08:10,399538448.0,6903.276794127587,-6.1,9
08:14,559995067.0,3576.3364199000835,-60.7,4
08:19,364357875.0,6951.832424275356,-3.93,4
08:19,806358207.0,11732.057896872631,-25.96,7
08:20,822135975.0,10559.44007448455,-33.15,8
08:22,340680761.0,-3061.083099999997,-18.05,5
08:23,885259672.0,3365.9246773266104,-5.4,9
08:26,697140785.0,-217.8873832638968,-69.28,5
08:27,116169597.0,783.9989499999996,-101.91,5
08:27,654329190.0,-151.2927490514807,-33.46,5
08:30,903468956.0,387.2551999999994,-26.28,5
08:31,287480331.0,7274.294025153994,-24.51,5
08:32,980500334.0,-732.809433892904,-34.19,5
08:33,992204045.0,5722.678079910139,-20.48,2
08:34,970298834.0,2778.350612298042,-8.88,8
08:35,795847804.0,22046.218832067927,-54.38,2
08:36,920031185.0,-729.7790705162921,-132.33,5
08:37,954263768.0,-300.03610000000026,-9.98,5
08:38,905860285.0,8183.549595599397,-5.6,5
08:39,704517789.0,16643.90399712006,-14.13,7
08:40,522188082.0,7436.517639675818,-1.62,5
08:41,667367404.0,8878.667545199838,-18.96,5
08:42,497772347.0,677.1121499999979,-110.34,5
08:43,737547541.0,-170.73840043222577,-68.84,5
08:47,973086490.0,9396.151226438453,-9.17,4
08:51,282837512.0,13229.849361522978,-30.56,8
08:52,555804115.0,-1359.1535475587032,-17.02,5
08:53,776431321.0,3222.9761566683096,-27.09,7
08:54,549414742.0,6866.09574805406,-5.13,7
08:54,331450202.0,6948.101067760539,-69.94,5
08:58,197865285.0,-56.01053826877981,-6.35,9
08:58,455831435.0,-1806.8821048014945,-22.57,5
08:59,403383649.0,1634.6584815642525,-117.54,5
08:59,421881811.0,2874.5466599380698,-24.65,7
09:00,624563756.0,-645.3780712164437,-42.41,5
09:01,613729471.0,8587.484623826807,-5.3,9
09:03,117273481.0,8926.550287205384,-7.5,9
09:04,667367404.0,8873.417545199838,-5.25,9
09:04,809499628.0,16095.87215323633,-83.64,5
09:04,874431242.0,7724.735308677465,-158.82,5
09:05,851649498.0,9950.935304642227,-5.35,9
09:10,425964226.0,3523.852650000002,-5.8,9
09:10,200080192.0,8798.084166440241,-39.61,5
09:13,601627384.0,4117.9111617377375,-69.73,2
09:13,554792076.0,26524.09137575841,-64.64,5
09:14,586315521.0,11578.983201486812,-5.7,9
09:16,683319988.0,6891.128424325123,-4.7,9
09:17,540159353.0,10448.325721611433,-7.5,9
09:17,534583529.0,1244.0193880547652,-131.96,5
09:17,849096144.0,778.5150207513418,-92.3,5
09:19,407574996.0,326.8782817224177,-22.06,1
09:19,417850087.0,16101.830798221565,-5.5,9
09:19,124102251.0,3133.6361019389547,-6.15,9
09:20,316793091.0,583.020010054951,-24.97,7
09:20,348325817.0,9657.828811256548,-75.21,2
09:20,663479159.0,4534.846541827711,-5.99,7
09:22,169006407.0,11369.135994552218,-5.0,9
09:22,971129830.0,-2130.040649999999,-13.34,5
09:23,163470640.0,876.1662999999998,-59.12,5
09:24,618138606.0,908.7466472714344,-5.95,9
09:25,550169791.0,20548.51102204506,-74.38,5
09:26,280268430.0,4362.585272555075,-125.97,2
09:27,799453072.0,-405.7440500000011,-41.04,5
09:29,854895960.0,2780.7169008766555,-71.99,2
09:31,279149837.0,1469.9810499999985,-31.5,2
09:32,857997794.0,594.4696651508872,-65.88,5
09:32,910730524.0,7642.129258487082,-160.5,5
09:32,703588001.0,-83.78885000000045,-35.0,2
09:34,280268430.0,4345.451466877026,-17.13,2
09:35,462962606.0,2869.264049999999,-41.98,2
09:37,639549973.0,6175.559943278187,-25.07,2
09:37,575652395.0,2329.171969229187,-6.01,4
09:45,299871610.0,281.73815305876656,-29.99,2
09:46,195895574.0,6788.6574415432715,-15.62,7
09:47,316793091.0,542.0300100549509,-40.99,2
09:47,930277104.0,9851.320652911363,-35.91,2
09:51,366550080.0,25111.192168900063,-31.24,5
09:51,137913631.0,1196.9496499999998,-132.97,2
09:52,163470640.0,846.1862999999997,-29.98,4
09:52,618514666.0,19804.59008321062,-15.97,4
09:53,987656636.0,5579.524871610741,-77.51,2
09:54,570323670.0,3876.558474035425,-32.02,2
09:55,913801979.0,169.26197991449388,-60.39,5
09:56,348325817.0,9639.290511256548,-18.54,4
09:57,284905540.0,7354.275891119422,-167.78,2
10:00,699139822.0,1259.268203374609,-91.25,2
10:02,183888402.0,17408.604973285397,-3.82,7
10:03,706361191.0,34.305998494078,-70.76,5
10:06,943329213.0,1594.8468575540194,-20.06,1
10:08,279149837.0,1428.6810499999983,-41.3,2
10:12,133755851.0,-27.55145838198858,-6.99,4
10:13,246753533.0,416.9508999999985,-31.11,5
10:20,137822385.0,3574.1565477684353,-5.05,9
10:22,828750680.0,1184.8023452136797,-20.96,7
10:24,373875019.0,15644.304012548138,-34.95,1
10:24,699139822.0,1254.4052308145729,-4.86,2
10:27,534204159.0,5815.22819709452,-28.82,5
10:32,909669130.0,208.99788473676665,-8.98,4
10:33,137913631.0,1151.4596499999998,-45.49,2
10:37,143003091.0,21739.463161516447,-2.46,2
10:38,152616936.0,736.1440078630646,-139.26,2
10:38,809499628.0,16022.88215323633,-72.99,2
10:39,604288474.0,2154.850324419925,-16.1,2
10:42,279149837.0,1302.6810499999983,-126.0,2
10:45,246753533.0,326.4608999999985,-90.49,2
10:52,414454079.0,300.82785000000183,-6.1,4
10:56,373875019.0,15527.32401254814,-116.98,2
10:59,518466565.0,511.0734999999995,-31.99,2
11:00,179173981.0,4331.910466284988,-12.33,7
11:00,152616936.0,530.3720078630647,-205.77,2
11:02,137913631.0,1039.4696499999998,-111.99,2
11:16,519644021.0,2533.894114892644,-10.03,2
11:17,279149837.0,1180.1810499999983,-122.5,2
11:19,441142605.0,2036.5526888780312,-9.99,7
11:25,462962606.0,2849.284049999999,-19.98,1
11:29,137913631.0,879.9696499999998,-159.5,2
11:36,137913631.0,739.9796499999998,-139.99,2
11:40,904154012.0,897.627458120432,-37.98,2
11:42,279149837.0,1096.8810499999986,-83.3,2
11:46,448004226.0,1761.1394609010626,-31.99,2
11:49,284905540.0,7227.165891119423,-127.11,6
11:55,152616936.0,498.8860078630647,-31.49,2
12:00,639549973.0,6131.501008028571,-44.06,8
12:09,414454079.0,270.4078500000018,-30.42,9
12:09,809499628.0,16011.142153236333,-11.74,9
12:11,340321732.0,1259.6870000000033,-297.99,5
12:12,246753533.0,160.48089999999848,-165.98,2
12:15,627936697.0,366.7103,-28.7,9
12:15,421881811.0,2864.38665993807,-10.16,2
12:16,152616936.0,381.2860078630647,-117.6,2
12:18,308505160.0,13618.77741695207,-68.59,2
12:32,475277431.0,1150.873136943619,-21.98,4
12:35,402438092.0,565.0326999999988,-59.8,5
12:35,600585971.0,152.64239999999953,-35.59,9
12:35,218795010.0,-1015.9821000000004,-32.06,5
12:37,441142605.0,2028.5726888780312,-7.98,4
12:39,137913631.0,690.4896499999998,-49.49,2
12:41,547010927.0,21724.423585824312,-34.14,9
12:41,246753533.0,35.00089999999848,-125.48,2
12:41,867679563.0,-109.97844629828415,-22.98,5
12:41,308505160.0,13563.49141695207,-55.29,2
12:41,128030172.0,-649.1332774498499,-25.19,9
12:47,119943495.0,-1491.230062112858,-25.61,5
12:49,344522228.0,-2836.516988208393,-31.17,5
12:49,916270283.0,1948.3882499999995,-23.73,5
12:52,298007503.0,806.1551036256333,-157.39,5
12:53,549414742.0,6792.96664805406,-73.13,4
12:57,657528784.0,-59.687099999999305,-34.42,5
13:01,277562576.0,625.065818105103,-5.05,9
13:03,308505160.0,13450.833416952071,-112.66,2
13:08,910730524.0,7634.3292584870815,-7.8,9
13:08,688712152.0,6086.262644863439,-7.5,9
13:10,407574996.0,319.07828172241767,-7.8,9
13:11,598586358.0,-3377.094949999996,-42.94,5
13:11,137913631.0,606.5096499999997,-83.98,2
13:13,855129444.0,-271.853195437372,-87.92,5
13:13,948069469.0,-867.1799000000011,-87.95,5
13:17,308505160.0,13422.861416952072,-27.97,2
13:18,749378808.0,3721.22817050911,-5.9,9
13:25,348325817.0,9633.640511256548,-5.65,9
13:27,585625048.0,1315.7131832415312,-5.4,9
13:30,761272540.0,-54.15125000000117,-75.51,5
13:33,429235692.0,-1419.5145000000002,-110.91,5
13:43,137913631.0,422.5296499999997,-183.98,2
13:50,308505160.0,13310.175416952072,-112.69,2
13:51,137913631.0,359.5496499999997,-62.98,2
14:01,541639148.0,4392.817093048945,-51.27,1
14:04,941285623.0,1346.2463990667702,-115.96,5
14:06,943329213.0,1579.974486612988,-14.87,7
14:19,137913631.0,226.5796499999997,-132.97,2
14:21,333054026.0,-67.02010597681002,-6.01,1
14:39,433837402.0,-397.45586846418814,-34.74,9
14:42,308505160.0,13217.089416952072,-93.09,2
14:49,137913631.0,162.0796499999997,-64.5,2
14:52,282046994.0,-475.7206499999997,-101.77,5
15:00,137913631.0,120.5996499999997,-41.48,2
15:11,108481285.0,8331.257384161048,-19.76,7
15:14,308505160.0,13204.503416952071,-12.59,2
15:22,246753533.0,-61.47910000000151,-96.48,2
15:33,108481285.0,8300.277384161049,-30.98,7
15:40,796709231.0,-489.4886721037026,-48.06,5
15:42,308505160.0,13163.203416952074,-41.3,2
15:46,137913631.0,72.1096499999997,-48.49,2
15:55,321372947.0,-512.8632507890994,-56.35,5
16:00,409971170.0,2467.173978430704,-5.11,7
16:05,137913631.0,-56.870350000000315,-128.98,2
16:07,538003940.0,1301.5400000000086,-49.99,4
16:07,514362267.0,-501.86018089293975,-1.99,4
16:07,687135796.0,25915.567266896756,-5.74,4
16:08,310375875.0,2696.1960889752354,-25.24,9
16:08,532478725.0,4292.180200962868,-33.23,9
16:09,632065391.0,-158.6786499999995,-87.5,5
16:11,308505160.0,13079.917416952074,-83.29,2
16:22,516051449.0,1207.2390389400978,-25.97,7
16:24,308505160.0,12930.831416952076,-149.09,2
16:24,604334058.0,504.8138999999994,-1.99,4
16:25,180616589.0,643.0065281236176,-22.97,7
16:26,583579399.0,1209.3949499999992,-38.95,1
16:27,345582855.0,-194.81544717945073,-39.82,5
16:31,198946608.0,3514.8381573261845,-60.1,2
16:32,137913631.0,-86.36035000000032,-29.49,2
16:32,233981231.0,2225.188881960624,-44.98,2
16:39,308505160.0,12878.331416952076,-52.5,2
16:42,625281433.0,-857.8270573707568,-57.8,5
16:46,456221621.0,577.6925673026282,-39.99,5
16:55,399538448.0,6901.776794127587,-1.5,4
16:56,308505160.0,12743.959416952075,-134.37,2
16:58,183186021.0,-315.6900499999989,-20.39,5
16:59,613427466.0,5946.041956011864,-6.99,4
17:02,152616936.0,281.2000078630647,-100.09,2
17:03,128033695.0,1581.5836782584051,-16.58,4
17:05,785210466.0,1829.2995569695472,-80.0,5
17:05,180616589.0,621.3065281236176,-21.7,5
17:09,838830098.0,315.8753420877843,-114.99,5
17:13,137913631.0,-171.36035000000032,-85.0,2
17:14,358846516.0,499.44027252721776,-21.97,7
17:14,912584712.0,318.5246195447332,-29.96,1
17:17,802697323.0,14928.81976398391,-40.15,5
17:17,511179916.0,6402.253062096598,-11.9,2
17:17,200080192.0,8777.431183807012,-20.65,2
17:18,836110591.0,6222.369512033104,-9.4,4
17:19,420109571.0,515.1638107166796,-32.99,4
17:19,836110591.0,6163.338528198608,-59.03,4
17:19,776108637.0,598.0979536574957,-80.28,5
17:21,886921642.0,3003.149312191694,-10.58,5
17:21,441274121.0,10984.146401613129,-5.71,4
17:21,987163717.0,5763.438480000005,-6.14,2
17:22,287230540.0,985.6673432932662,-11.98,1
17:23,874431242.0,7620.102868677465,-104.63,4
17:23,256045540.0,-3449.708899999999,-46.61,5
17:25,627622066.0,2996.4145547156613,-27.96,7
17:26,435984758.0,4025.0897402233018,-28.54,5
17:26,887853850.0,10219.519599942274,-25.03,9
17:27,844835978.0,9436.421736205148,-44.87,5
17:27,361201224.0,3019.6142320678914,-158.9,2
17:28,424397946.0,3612.463783605399,-55.15,5
17:30,496395938.0,11504.620454417338,-25.03,7
17:30,835736339.0,1711.4313520918795,-10.01,4
17:31,660874296.0,2280.0874499608476,-13.98,4
17:31,450896297.0,12621.092160635228,-28.56,2
17:32,376271050.0,789.6428069057438,-59.98,4
17:33,120634201.0,4420.925675814986,-18.61,7
17:34,690958123.0,19364.454683105367,-6.01,4
17:36,941285623.0,1318.7463990667702,-27.5,7
17:37,518474507.0,12587.878611502618,-28.15,1
17:37,815385232.0,9398.556163762818,-24.19,4
17:38,585596026.0,2932.6443338766703,-51.99,2
17:38,510101371.0,12521.2383302572,-12.84,4
17:39,758160963.0,7850.11969136265,-6.05,4
17:39,832564361.0,15302.688093033756,-27.03,8
17:40,736340277.0,8319.694545945717,-55.8,5
17:41,442070890.0,854.9924124443711,-63.98,2
17:42,152616936.0,209.8140078630647,-71.39,2
17:45,355602925.0,1419.9773951313746,-11.98,7
17:46,361201224.0,2921.6142320678914,-98.0,2
17:47,955035930.0,1435.323479171477,-22.5,2
17:48,859603181.0,2782.7006206736764,-79.93,5
17:48,137913631.0,-216.35035000000033,-44.99,2
17:49,788740658.0,1679.784336447721,-15.47,2
17:49,581655972.0,39094.266471947405,-12.99,2
17:50,971010829.0,49.625056444245246,-28.0,2
17:51,668692488.0,1769.0063285738092,-14.99,4
17:52,147474476.0,3360.7221570987963,-6.99,7
17:53,822718326.0,10161.915522634274,-47.0,5
17:54,824916823.0,8318.297672698154,-3.07,7
17:54,699997811.0,98.8624000000036,-85.11,5
17:56,639409800.0,33956.29067286973,-35.28,2
17:56,287230540.0,947.1673432932662,-38.5,4
17:56,624500124.0,3245.690271096436,-42.33,8
17:56,534325901.0,6232.25784429655,-8.21,7
17:56,633345190.0,6602.665870734289,-33.48,9
17:57,290818242.0,6573.856872921571,-85.75,6
17:57,169006407.0,11288.831994552218,-80.3,5
18:00,140893085.0,5584.387056365463,-168.67,2
18:01,361201224.0,2790.7142320678913,-130.9,2
18:03,496395938.0,11498.940088112877,-5.68,8
18:03,138609932.0,3158.4390032945857,-92.11,5
18:08,308505160.0,12613.073416952077,-130.89,2
18:09,720742759.0,-66.07971911699258,-228.41,5
18:09,901432314.0,3269.1698219653813,-50.64,5
18:18,137913631.0,-332.34035000000034,-115.99,2
18:19,758160963.0,7773.81969136265,-76.3,7
18:21,489964679.0,19652.800134756624,-26.59,2
18:22,308505160.0,12462.573416952077,-150.5,2
18:24,556992209.0,11168.010238568158,-10.5,7
18:26,195895574.0,6764.767441543271,-23.89,9
18:27,578131296.0,451.2891694440438,-25.92,9
18:29,140893085.0,5527.001056365462,-57.39,2
18:30,833499132.0,2035.8600500000011,-32.86,5
18:33,489964679.0,19611.500134756625,-41.3,2
18:38,556992209.0,11137.279472312895,-30.73,8
18:40,779946617.0,16115.116502571664,-66.47,4
18:41,176922958.0,749.3355471976495,-64.6,5
18:42,308505160.0,12447.187416952074,-15.39,2
18:42,914806976.0,171.1832501854867,-49.99,7
18:43,758160963.0,7627.51969136265,-146.3,4
18:44,489964679.0,19580.050134756624,-31.45,9
18:44,471897866.0,7482.448897407592,-2.41,2
18:46,865748375.0,3533.518904461338,-44.29,7
18:49,534908754.0,-938.9030000000002,-84.87,5
18:50,108812033.0,446.7370999999984,-101.88,5
18:51,868033067.0,-2322.013286451082,-33.26,5
18:53,628470485.0,-3.406970099876844,-1.5,7
18:55,949032480.0,4283.956336587773,-68.88,7
18:58,221868392.0,4799.133953425014,-3.83,4
18:58,104832000.0,-2951.2998589058443,-43.4,5
18:59,245690309.0,8936.92608145665,-13.24,9
19:00,633345190.0,6569.158970734289,-33.51,4
19:03,500043411.0,12840.230225334584,-68.1,5
19:03,817294757.0,-2638.1058,-24.95,5
19:05,851649498.0,9864.219304642227,-86.72,5
19:05,282837512.0,13192.729361522976,-37.12,9
19:06,472213568.0,-565.1570942060532,-69.17,5
19:08,771125520.0,1442.5094999999994,-20.93,5
19:10,587202562.0,122.46149941706864,-46.06,5
19:13,680773155.0,212.4007833310917,-18.73,5
19:21,308505160.0,12318.415416952072,-128.77,2
19:23,237493332.0,13674.431900518412,-64.17,7
19:25,452974357.0,-3151.2039499999946,-11.98,5
19:27,651756497.0,11348.771060607913,-1.6,2
19:34,605116158.0,2073.686700000002,-28.53,5
19:35,744211756.0,-4124.500749999994,-32.37,5
19:39,489964679.0,19550.40379141747,-29.65,5
19:42,331450202.0,6932.731067760539,-15.37,9
19:46,624500124.0,3225.306271096436,-20.38,5
19:47,290818242.0,6562.366064081768,-11.49,5
19:49,237493332.0,13620.307900518414,-54.12,5
19:50,859603181.0,2776.0592313353973,-6.64,7
19:51,873701090.0,583.357328913574,-5.02,8
19:52,897592348.0,14379.897968797628,-149.39,5
19:54,897714622.0,8300.678173495327,-29.46,4
19:59,768271776.0,-738.9198967665794,-140.09,5
20:01,703478110.0,4647.338517931947,-0.61,7
20:08,872286364.0,-1200.7431958130996,-51.83,5
20:12,151968462.0,6340.651941367341,-61.88,8
20:14,229205098.0,6987.888669873388,-18.89,5
20:14,851181128.0,4090.302295172814,-29.2,2
20:27,874431242.0,7604.770661349023,-15.33,7
20:33,885259672.0,3339.4678833514204,-26.46,2
20:33,874431242.0,7584.090661349022,-20.68,9
20:45,898104045.0,-1811.2080500000025,-164.84,5
20:52,629078930.0,-415.1005202743981,-19.84,5
21:00,131388684.0,20719.611284443443,-35.39,5
21:42,315546581.0,26855.142609526843,-15.14,5
01:22,547010927.0,21684.263585824312,-40.16,9
01:29,679662108.0,15267.244670294494,-9.42,2
01:36,786927378.0,-1491.3802796373163,-23.74,9
01:39,639549973.0,6096.925153389864,-34.58,5
01:50,718058208.0,2326.6415418169313,-15.82,8
01:53,547010927.0,21662.94539715282,-21.32,7
02:26,421881811.0,2852.4161692593593,-11.97,7
02:37,556992209.0,11123.829472312897,-13.45,9
02:47,195895574.0,6742.067441543271,-22.7,9
02:53,779946617.0,16077.904472215225,-37.21,7
02:55,899742927.0,11769.260163984049,-52.27,5
03:05,435984758.0,4013.242026885858,-11.85,7
03:06,699139822.0,1237.9124110044866,-16.49,2
03:08,237493332.0,13618.986435859268,-1.32,5
03:09,647936800.0,3228.1195063953987,-34.09,8
03:21,749378808.0,3699.888107897721,-21.34,7
03:27,525524239.0,-262.3876497888064,-33.6,9
03:30,421881811.0,2823.2361692593595,-29.18,9
03:32,905860285.0,8148.391404353856,-35.16,7
03:35,678851253.0,3109.4160156763933,-28.04,7
03:35,668329719.0,7757.968987182453,-67.86,7
03:38,480557476.0,10599.66676030944,-57.26,7
03:44,304455868.0,2656.3478575345093,-1.32,8
03:46,570323670.0,3851.1667001256833,-25.39,2
03:46,324224854.0,2867.041149752464,-11.51,7
03:52,705848712.0,25339.5005021796,-14.2,9
03:54,719586818.0,16695.85828197448,-5.18,5
03:56,128033695.0,1573.8765256371084,-7.71,8
03:59,851181128.0,4055.412295172814,-34.89,9
04:06,399144202.0,1493.174660398652,-29.45,9
04:07,581655972.0,39039.563494645954,-54.7,7
04:11,986267641.0,7089.127139510802,-28.9,5
04:11,706250160.0,11314.328301609736,-71.37,7
04:12,673025413.0,2054.149246501762,-4.68,8
04:17,331450202.0,6932.290227592109,-0.44,5
04:19,532478725.0,4254.240200962869,-37.94,9
04:21,853907490.0,6661.9593916782505,-7.39,7
04:25,613729471.0,8532.459515927638,-55.03,8
04:30,221356538.0,383.5718999999996,-16.23,9
04:31,108481285.0,8295.70353099895,-4.57,7
04:34,216285378.0,22711.139384634916,-32.15,9
04:34,769311479.0,6743.88393711261,-29.34,8
04:34,169006407.0,11271.763846976495,-17.07,2
04:44,116598243.0,1878.3188632278336,-25.33,4
04:46,657139925.0,13303.661793504438,-25.15,9
04:49,134461671.0,5365.638983220354,-20.75,7
04:50,633345190.0,6539.9689707342895,-29.19,9
04:57,575652395.0,2322.2532512563175,-6.92,2
04:58,558119802.0,31215.32659417958,-62.54,2
04:59,973086490.0,9383.901226438453,-12.25,9
05:00,199016328.0,4215.506606911702,-13.77,5
05:04,235881534.0,12401.91886437154,-33.97,2
05:10,419550103.0,17519.090777870308,-21.92,7
05:15,994214354.0,9194.045951885011,-29.57,9
05:16,450896297.0,12595.212160635228,-25.88,9
05:19,229205098.0,6938.197768178536,-16.44,7
05:21,308505160.0,12314.2300822841,-4.19,7
05:22,984783496.0,13108.754359975515,-13.0,9
05:23,657139925.0,13288.345158944212,-15.32,2
05:25,824916823.0,8290.657672698155,-27.64,9
05:25,473820682.0,10607.395405277406,-49.42,5
05:26,822250278.0,6867.162627532158,-20.99,5
05:28,252760664.0,6331.770790750435,-2.81,7
05:30,494789005.0,2750.2721161258837,-6.77,7
05:37,836110591.0,6121.288528198608,-42.05,9
05:39,195895574.0,6738.207619560617,-3.86,7
05:39,709608057.0,2546.040081360085,-42.72,9
05:40,973086490.0,9367.417790322452,-16.48,2
05:40,779236304.0,572.8675954795323,-20.85,9
05:41,858989281.0,25928.05759652954,-14.49,9
05:41,987163717.0,5724.038480000006,-39.4,9
05:43,370521542.0,24956.88947696963,-17.32,7
05:45,124125096.0,198.9399443878023,-21.09,9
05:46,994214354.0,9145.743610425714,-48.3,8
05:49,675806859.0,6501.901221566369,-11.99,2
05:49,687135796.0,25893.36426264027,-22.2,2
05:57,730002588.0,12184.807782092035,-3.21,8
06:01,758160963.0,7603.311886937667,-24.21,5
06:01,572384506.0,6871.8431814490405,-40.79,9
06:04,851181128.0,3980.3844424016415,-75.03,7
06:06,766941757.0,1971.375888092027,-48.08,9
06:06,264550521.0,9061.991682753429,-30.42,2
06:07,940569402.0,5324.463675686443,-18.2,9
06:07,414805878.0,12359.517285648117,-40.12,9
06:08,187111705.0,6316.513362259381,-15.1,5
06:10,653640811.0,16119.55947255822,-32.33,7
06:12,858989281.0,25902.135068801817,-25.92,2
06:15,541639148.0,4368.6969428156435,-24.12,2
06:20,183888402.0,17367.274973285395,-41.33,9
06:20,912705941.0,17593.456022737417,-20.27,2
06:20,305778936.0,9284.82531681695,-40.01,2
06:23,203466392.0,2420.6842986337374,-44.97,8
06:24,510101371.0,12488.8183302572,-32.42,9
06:24,532478725.0,4225.9859495258315,-28.25,2
06:25,417850087.0,16077.958209201735,-23.87,7
06:27,187541224.0,1136.050756964371,-31.43,9
06:31,657528784.0,-91.7170999999993,-32.03,9
06:32,405945930.0,4473.741189413555,-3.51,7
06:33,256002321.0,5577.802252788479,-14.97,9
06:33,851649498.0,9827.140925367436,-37.08,5
06:34,752362502.0,8316.907382171892,-8.57,7
06:34,383833857.0,23431.61266416239,-0.3,5
06:35,198946608.0,3496.9782258966466,-17.86,2
06:38,940569402.0,5321.880764239656,-2.58,5
06:38,679911053.0,2307.0088596008777,-19.16,5
06:39,809499628.0,15997.94215323633,-13.2,9
06:40,670102069.0,3402.968708172806,-26.88,9
06:41,887853850.0,10191.139599942277,-28.38,9
06:43,556992209.0,11088.20992883665,-35.62,4
06:44,373163757.0,9971.005129575917,-10.16,8
06:47,534325901.0,6219.25784429655,-13.0,9
06:47,366550080.0,25102.76916126408,-8.42,5
06:48,383625050.0,5684.558751735155,-25.31,2
06:50,361201224.0,2723.6453223161443,-67.07,5
06:52,802697323.0,14884.62976398391,-44.19,9
06:54,506618547.0,15375.701680321776,-11.17,2
06:55,259015404.0,827.1262661598166,-34.34,9
06:56,213112754.0,6276.593828750469,-45.46,8
06:57,873693307.0,8851.890055754458,-10.68,2
07:02,836110591.0,6105.822815159681,-15.47,2
07:02,518474507.0,12558.178611502615,-29.7,9
07:04,683319988.0,6860.548424325123,-30.58,9
07:05,221868392.0,4772.643953425014,-26.49,9
07:05,433917275.0,6915.813970712939,-27.6,9
07:06,897714622.0,8275.00974574786,-25.67,2
07:13,873701090.0,578.1028596287682,-5.25,7
07:16,678330503.0,2315.2654319991984,-5.35,9
07:17,587225252.0,4610.259076743215,-41.6,9
07:17,683078800.0,1753.331252944871,-29.64,7
07:21,322221939.0,3465.5753658918165,-39.1,2
07:26,482513594.0,5294.279007764258,-6.19,2
07:26,290818242.0,6503.714894009586,-58.65,2
07:29,588565416.0,7051.987906144032,-4.52,2
07:37,987656636.0,5574.014709708223,-5.51,7
07:37,108563213.0,22768.223373325545,-76.56,5
07:40,151968462.0,6340.126590821662,-0.53,5
07:41,586315521.0,11572.455399849468,-6.53,5
07:42,534204159.0,5785.892245979391,-29.34,8
07:47,270374623.0,9647.3335326856,-45.07,7
07:49,461990622.0,8326.879135774469,-16.53,5
07:54,651756497.0,11312.980923301862,-35.79,4
08:01,885259672.0,3332.3678833514205,-7.1,9
08:01,287480331.0,7241.1319138099025,-33.16,5
08:04,949032480.0,4232.07327482945,-51.88,5
08:10,131388684.0,20710.53343359895,-9.08,4
08:11,454129843.0,1342.03889516656,-4.3,9
08:19,399538448.0,6896.076794127587,-5.7,9
08:20,237684254.0,5490.211346957086,-5.78,2
08:22,960208650.0,16891.80856625298,-34.61,5
08:22,527842638.0,-19.460607367016383,-5.3,9
08:24,146909202.0,2362.6954148354,-6.5,9
08:24,493855007.0,-2606.0716315743925,-20.6,5
08:24,895331556.0,-723.2876000000008,-42.63,5
08:25,407574996.0,292.09118444604246,-26.99,2
08:25,853907490.0,6624.4813916782505,-37.48,5
08:25,113747882.0,11704.83454550515,-10.32,2
08:26,549414742.0,6771.02664805406,-21.94,9
08:28,771125520.0,1364.5847999999994,-77.92,5
08:28,449387287.0,178.82269383510146,-78.44,5
08:29,390747457.0,292.948399999998,-32.43,5
08:30,842682241.0,4857.996425986756,-30.2,7
08:30,145387690.0,4513.788316174552,-63.57,2
08:31,612304466.0,-2108.9132500000005,-41.07,5
08:36,795847804.0,22018.192532736488,-28.03,5
08:37,603375739.0,-722.7539369767328,-117.37,5
08:38,644751433.0,-1555.9231584655383,-76.57,5
08:38,364357875.0,6946.404448754881,-5.43,2
08:38,180719578.0,-4276.675249999996,-49.09,5
08:43,510101371.0,12458.494561723555,-30.32,7
08:43,555393405.0,-1023.3785,-78.32,5
08:43,611143859.0,1255.4851000000112,-124.33,5
08:43,202320275.0,-885.4306000000005,-126.3,5
08:44,812839908.0,-1743.0548500000002,-48.86,5
08:46,585596026.0,2870.85918387667,-61.79,5
08:47,215426302.0,-799.3375959743081,-53.3,5
08:47,969804197.0,-378.9237500000007,-48.54,5
08:48,806358207.0,11670.880687344206,-61.18,7
08:48,954263768.0,-335.3875000000003,-35.35,5
08:49,785749304.0,7839.768970266926,-71.84,2
08:51,960208650.0,16890.22736726904,-1.58,4
08:51,361955473.0,-619.8329547559156,-132.99,5
08:52,670427480.0,-36.10234999999858,-136.14,5
08:55,758160963.0,7537.469886937667,-65.84,5
08:56,815385232.0,9377.375051613804,-21.18,2
08:57,414805878.0,12359.33584152478,-0.18,7
08:58,667367404.0,8867.367545199839,-6.05,9
08:58,138609932.0,3152.3890032945856,-6.05,9
08:59,358846516.0,493.64027252721775,-5.8,9
09:00,832564361.0,15255.564093033758,-47.12,5
09:04,975345315.0,33414.1098931732,-8.3,9
09:04,743630833.0,-98.35068671529878,-109.01,5
09:04,441274121.0,10977.646401613129,-6.5,9
09:07,290818242.0,6495.814894009586,-7.9,9
09:09,489964679.0,19517.36379141747,-33.04,9
09:10,170637730.0,2347.4143803115253,-13.05,4
09:11,417850087.0,16072.158209201736,-5.8,9
09:12,540159353.0,10442.575721611433,-5.75,9
09:16,124102251.0,3128.3861019389547,-5.25,9
09:17,285220959.0,11203.350490704264,-0.91,7
09:18,604288474.0,2118.470324419925,-36.38,1
09:18,690958123.0,19359.204683105367,-5.25,9
09:18,586315521.0,11566.705399849468,-5.75,9
09:18,741903302.0,2005.114065014125,-5.2,9
09:20,117273481.0,8921.550287205384,-5.0,9
09:21,857997794.0,494.4896651508872,-99.98,4
09:23,819515373.0,1606.3816360637918,-18.97,7
09:23,298007503.0,801.0951036256333,-5.06,7
09:25,609939116.0,6880.978561182568,-82.55,2
09:25,499244466.0,-485.32838128342223,-103.84,5
09:25,916270283.0,1770.4082499999995,-177.98,2
09:25,131388684.0,20703.73343359895,-6.8,9
09:27,621181115.0,-394.4192495707712,-84.21,5
09:28,285873880.0,11333.997338273984,-37.64,7
09:30,700138124.0,4989.444006239327,-42.15,2
09:31,414454079.0,228.7578500000018,-41.65,2
09:32,804317849.0,-3742.01913302052,-59.44,5
09:33,766941757.0,1955.0879769329963,-16.29,4
09:38,282837512.0,13077.229361522976,-115.5,2
09:38,709151315.0,-443.78078162584006,-136.39,5
09:40,355733816.0,4798.834913842312,-25.96,7
09:41,933491926.0,2939.5443000000023,-6.99,7
09:41,678851253.0,3062.226015676393,-47.19,2
09:42,970298834.0,2765.330612298042,-13.02,2
09:43,316793091.0,486.03036005495096,-56.0,5
09:46,779946617.0,15856.004472215223,-221.9,2
09:47,285220959.0,11140.791490704263,-62.56,5
09:47,812692024.0,3299.3848579489527,-84.99,2
09:49,240643705.0,127.13966737398076,-31.97,4
09:50,979892433.0,-1554.1305000000011,-79.19,5
09:50,270374623.0,9598.3835326856,-48.95,2
09:51,421881811.0,2809.2930992593597,-13.94,4
09:52,409370545.0,1051.2292755455203,-108.42,5
09:56,652048867.0,-161.604700000001,-118.22,5
09:56,596171893.0,12.771744825511092,-32.95,7
09:59,779946617.0,15744.704472215226,-111.3,2
10:02,270374623.0,9460.693532685598,-137.69,2
10:03,828532554.0,210.3468765071483,-49.93,7
10:06,137822385.0,3568.756547768435,-5.4,9
10:07,699139822.0,1203.8224110044866,-34.09,2
10:08,609939116.0,6880.594668435583,-0.38,7
10:12,282837512.0,12906.429361522978,-170.8,2
10:13,497772347.0,648.1421499999979,-28.97,4
10:13,601627384.0,4103.207901517498,-14.7,5
10:15,316793091.0,479.04036005495095,-6.99,4
10:21,657139925.0,13268.073158944211,-20.27,2
10:22,282837512.0,12900.37936152298,-6.05,9
10:25,679943657.0,808.1615258664518,-34.76,8
10:35,930277104.0,9849.848028276703,-1.47,4
10:38,657139925.0,13109.887158944211,-158.19,2
10:41,919185264.0,2707.05225976317,-133.08,5
10:43,782013626.0,1261.9721993116284,-131.6,2
10:44,259015404.0,781.0723274601992,-46.05,5
10:45,355940285.0,7388.392978189683,-19.97,7
10:50,414454079.0,223.6778500000018,-5.08,4
10:52,421881811.0,2650.42109925936,-158.87,2
10:52,284905540.0,7217.568716283518,-9.6,4
10:54,570323670.0,3811.1066801256834,-40.06,4
10:54,520447032.0,7993.1718977268465,-9.77,2
11:00,910730524.0,7631.088558691161,-3.24,7
11:13,652048867.0,-277.594700000001,-115.99,2
11:22,987229118.0,3621.7495301396607,-10.67,5
11:29,572384506.0,6802.499871056863,-69.34,5
11:31,298000165.0,24726.739241331485,-26.29,5
11:35,652048867.0,-309.584700000001,-31.99,2
11:36,454356905.0,937.2425659217604,-9.64,4
11:37,657139925.0,12885.18715894421,-224.7,2
11:39,604288474.0,2118.3721494476395,-0.1,2
11:44,782013626.0,1063.8721993116285,-198.1,2
11:54,541639148.0,4339.191232815643,-29.51,4
12:06,284161641.0,114.98231104057568,-17.99,9
12:07,548638376.0,-353.00481324453347,-30.44,9
12:07,194745206.0,506.35037209124306,-67.19,2
12:09,601627384.0,4061.567901517498,-41.64,9
12:13,519644021.0,2454.5593786339587,-79.33,7
12:14,223207876.0,-329.5288999999997,-30.35,9
12:17,270374623.0,9454.583532685598,-6.11,7
12:19,913801979.0,149.91197991449388,-19.35,9
12:19,727417797.0,5274.301500000011,-9.99,1
12:21,679943657.0,802.4615258664518,-5.7,9
12:27,598793068.0,532.2778999999982,-4.99,4
12:30,270374623.0,9443.3735326856,-11.21,4
12:31,270374623.0,9426.6335326856,-16.74,9
12:37,835829467.0,-1706.764749999999,-13.71,5
12:43,956717493.0,1042.7472610230714,-3.98,4
12:48,604288474.0,2105.3661494476396,-13.01,5
12:49,985188462.0,-695.2232112887752,-43.94,9
12:51,989506909.0,-2470.6048707594373,-36.33,5
13:02,722358036.0,570.6062406270829,-7.9,9
13:03,280098744.0,148.4923778716656,-5.48,4
13:07,187111705.0,6310.813362259381,-5.7,9
13:10,585625048.0,1310.0131832415311,-5.7,9
13:12,111137699.0,-315.87069999999954,-93.05,5
13:13,322221939.0,3459.6753658918165,-5.9,9
13:13,494789005.0,2748.2460361258836,-2.03,4
13:13,688712152.0,6081.512644863439,-4.75,9
13:15,659008214.0,-3293.582602290423,-25.02,5
13:17,874506295.0,-1612.059256245572,-53.29,5
13:19,684284526.0,-3113.3363667457575,-18.22,5
13:21,348325817.0,9627.840511256549,-5.8,9
13:23,480557476.0,10593.96676030944,-5.7,9
13:25,280268430.0,4333.471466877027,-11.98,4
13:27,250895529.0,306.5392324692883,-41.88,5
13:37,909669130.0,141.40788473676662,-67.59,5
13:38,929044080.0,-684.4661084943717,-50.14,5
13:40,982286721.0,-3379.55802401773,-29.36,5
13:53,904154012.0,875.657458120432,-21.97,7
14:12,165098840.0,-651.7781263623731,-53.27,5
14:33,349107386.0,-3479.7459731945614,-110.02,5
14:38,845648250.0,8.195549999999443,-97.12,5
14:45,783650950.0,-1035.7846434110115,-64.22,5
14:54,807098817.0,414.8012499999992,-77.59,5
15:03,304455868.0,2604.05785753451,-52.29,2
15:08,266777719.0,180.3764337802396,-23.04,1
15:08,867987292.0,3778.819398967036,-59.83,5
15:13,901037631.0,344.09932309640715,-32.44,9
15:48,990894155.0,-84.82959132115849,-117.5,2
15:51,939972497.0,-108.30974139998924,-42.65,5
16:08,421881811.0,2537.0630992593597,-113.36,2
16:13,310375875.0,2661.7337652238625,-34.46,7
16:14,990894155.0,-244.3295913211585,-159.5,2
16:21,129018172.0,8351.806896282198,-9.99,7
16:28,158414827.0,-1776.1750000000015,-8.73,5
16:31,252760664.0,6090.270790750435,-241.5,2
16:33,477216513.0,-633.1621999999994,-39.02,5
16:36,885259672.0,3222.1778033514206,-110.19,4
16:36,886921642.0,2969.4523752225396,-33.7,2
16:40,899742927.0,11763.260163984049,-6.0,2
16:40,698076160.0,5854.956133491008,-25.96,1
16:41,478651121.0,-397.1879204015303,-176.14,5
16:44,198630866.0,-206.83657356126855,-42.99,5
16:45,399144202.0,1478.681615307377,-14.49,7
16:50,286484726.0,473.3831700631588,-69.98,5
16:51,679911053.0,2287.018859600878,-19.99,4
16:51,512989907.0,-2376.2844039753663,-36.2,5
16:57,421881811.0,2358.59109925936,-178.47,2
17:03,990894155.0,-489.3295913211585,-245.0,2
17:04,146909202.0,2321.8754148353996,-40.82,2
17:07,252760664.0,5815.170790750434,-275.1,2
17:11,450896297.0,12542.663049973196,-52.55,7
17:11,366477356.0,54.36884999999987,-39.47,9
17:11,456221621.0,554.7125673026281,-22.98,2
17:13,667367404.0,8860.050485050473,-7.32,7
17:13,613729471.0,8502.109515927637,-30.35,9
17:17,627917561.0,3397.1650500000046,-50.0,2
17:19,108563213.0,22755.153373325546,-13.07,2
17:19,914806976.0,161.1932501854867,-9.99,7
17:21,365608668.0,208.85695202418876,-5.99,4
17:22,802697323.0,14851.63871398391,-32.99,4
17:23,383625050.0,5583.388751735155,-101.17,2
17:23,522188082.0,7430.1847563647725,-6.33,2
17:23,647936800.0,3214.0995063953987,-14.02,7
17:23,713910252.0,-258.5278742714588,-40.64,5
17:23,832564361.0,15254.656489298131,-0.91,2
17:24,874431242.0,7582.763162074929,-1.33,2
17:25,736340277.0,8290.984545945717,-28.71,1
17:26,736340277.0,8272.604545945718,-18.38,9
17:27,496395938.0,11444.074088112877,-54.87,5
17:28,213112754.0,6266.103828750469,-10.49,9
17:28,833899961.0,1484.6111442498695,-22.0,2
17:28,370757362.0,1232.7515898126758,-196.0,2
17:29,421881811.0,2258.5050992593597,-100.09,2
17:29,256002321.0,5561.472997831248,-16.33,2
17:30,713910252.0,-279.9678742714588,-21.44,9
17:30,511179916.0,6401.667163747269,-0.59,2
17:30,235881534.0,12391.86880437154,-10.05,4
17:31,506618547.0,15369.661680321777,-6.04,7
17:31,651756497.0,11239.910923301864,-73.07,2
17:32,558119802.0,31182.77659417958,-32.55,5
17:33,169006407.0,11141.143846976494,-130.62,2
17:34,992204045.0,5691.816717772078,-30.86,2
17:35,423208402.0,888.6007500000026,-23.97,4
17:36,331450202.0,6904.700227592109,-27.59,7
17:37,912705941.0,17527.349982737418,-66.11,4
17:37,851649498.0,9726.750925367438,-100.39,2
17:39,130154096.0,1348.0167820134182,-1.5,4
17:40,788740658.0,1654.804336447721,-24.98,7
17:41,873693307.0,8833.92005575446,-17.97,9
17:42,822135975.0,10513.076115092654,-46.36,5
17:42,846550094.0,1416.677464472557,-6.99,4
17:42,417850087.0,16050.088209201736,-22.07,2
17:43,450896297.0,12484.663049973196,-58.0,7
17:44,196289502.0,14713.10298488658,-15.28,4
17:47,245690309.0,8846.62608145665,-90.3,2
17:48,824916823.0,8260.957672698154,-29.7,7
17:48,166019891.0,7422.846116349619,-34.43,5
17:49,891716230.0,234.68665139261623,-14.99,4
17:49,500043411.0,12817.634063081265,-22.6,7
17:52,738958551.0,8646.144085478125,-18.91,7
17:53,196289502.0,14693.65298488658,-19.45,9
17:55,500043411.0,12806.844063081262,-10.79,9
17:56,466649401.0,247.57871139789145,-106.99,6
17:56,486495235.0,1519.5168393887163,-75.97,2
17:56,990894155.0,-683.8295913211584,-194.5,2
17:58,370757362.0,960.4515898126758,-272.3,2
18:00,613729471.0,8483.919515927637,-18.19,7
18:00,897592348.0,14366.907968797628,-12.99,2
18:01,785749304.0,7826.828970266926,-12.94,9
18:02,949032480.0,4210.123274829451,-21.95,9
18:03,245690309.0,8780.421453422885,-66.2,8
18:04,241459011.0,687.1606132723472,-9.96,5
18:05,691843653.0,-3041.1658999999936,-33.49,9
18:05,975345315.0,33361.9318931732,-52.18,5
18:07,413557825.0,411.83149999999944,-22.23,9
18:08,678330503.0,2308.8045882709052,-6.46,5
18:16,475117511.0,7235.670820753877,-19.59,5
18:20,252701364.0,-3694.703672677915,-24.8,5
18:23,990894155.0,-738.3295913211584,-54.5,2
18:25,806358207.0,11585.699407344207,-85.18,7
18:25,198946608.0,3469.6082258966467,-27.37,9
18:26,340295966.0,-1610.1169500000003,-34.97,9
18:26,824916823.0,8245.597672698153,-15.36,7
18:26,370757362.0,709.1515898126759,-251.3,2
18:27,383833857.0,23422.212664162387,-9.4,9
18:28,196289502.0,14688.231704573054,-5.42,7
18:31,486495235.0,1509.5268393887163,-9.99,2
18:43,630468201.0,-734.6626838897017,-64.0,5
18:46,885259672.0,3212.082030717937,-10.1,2
18:47,344843570.0,-183.69181750933384,-42.65,5
18:51,449871732.0,9975.395604856987,-19.98,7
18:52,696758548.0,-3405.9053963201363,-36.43,5
18:54,690523499.0,-777.4588999999997,-111.82,5
18:56,373875019.0,15384.65001254814,-142.67,5
18:57,241459011.0,624.7304132723472,-62.43,5
18:58,583558311.0,-1000.0012152486676,-155.74,5
18:59,486495235.0,1484.5268393887163,-25.0,2
18:59,490868147.0,-519.1982208786985,-169.97,5
19:00,807714284.0,846.9726607359999,-85.28,5
19:07,893134725.0,593.8965819367792,-41.07,5
19:10,494404688.0,-2620.950765336208,-53.86,5
19:10,146909202.0,2299.070487420869,-22.8,7
19:16,145553416.0,-2619.223149999999,-44.41,5
19:20,779816907.0,-2851.9560829229117,-36.07,5
19:22,285873880.0,11289.330338273983,-44.67,5
19:23,762859681.0,314.2750999999988,-49.03,5
19:26,460463595.0,-837.7829454185788,-90.95,5
19:26,639409800.0,33925.30456308369,-30.99,2
19:27,214339619.0,-36.732649131643704,-74.01,5
19:35,486495235.0,1385.5468393887163,-98.98,2
19:35,550169791.0,20527.083779402437,-21.43,7
19:38,170233640.0,-91.08916005010272,-20.53,5
19:39,648644594.0,-300.00360000000086,-61.98,5
19:39,687135796.0,25875.42426264027,-17.94,9
19:42,925037906.0,738.7178000000015,-176.25,5
19:45,221868392.0,4726.665368303541,-45.98,5
19:45,358846516.0,418.3290225272177,-75.31,5
19:46,212560376.0,-368.5938742208979,-102.4,5
19:46,255814263.0,3442.7178815504903,-26.48,9
19:50,709632525.0,-1672.9498500000009,-76.55,5
19:53,486495235.0,1292.0668393887163,-93.48,2
19:55,801500539.0,-3349.873699999999,-51.28,5
19:58,969697937.0,-4688.945265670551,-32.38,5
20:00,822135975.0,10470.684115092654,-42.39,5
20:05,305778936.0,9248.47531681695,-36.35,9
20:07,461029994.0,6857.292299682367,-60.69,5
20:09,151968462.0,6269.230590821662,-70.9,5
20:09,175452235.0,828.5672500000002,-82.7,5
20:10,117273481.0,8896.586364139072,-24.96,7
20:17,887853850.0,10171.23600047173,-19.9,7
20:21,603721739.0,777.740899483184,-161.53,5
20:22,809499628.0,15988.856489210137,-9.09,2
20:22,948558249.0,8521.635081706883,-0.67,5
20:23,469561218.0,-369.3320000000009,-130.43,5
20:23,441274121.0,10977.020564442691,-0.63,2
20:25,705848712.0,25233.9125021796,-105.59,5
20:26,141521177.0,6779.771900000015,-35.36,5
20:27,815993333.0,6098.183639061407,-36.73,5
20:29,859264768.0,218.31383378193837,-53.63,5
20:31,452974357.0,-3167.3139499999947,-16.11,5
20:50,540159353.0,10438.645719102042,-3.93,2
20:54,705848712.0,25229.06596223987,-4.85,4
20:56,491392945.0,4450.701500000007,-30.6,5
20:56,180616589.0,597.8005281236176,-23.51,5
20:58,113747882.0,11671.09454550515,-33.74,9
21:00,859603181.0,2759.040101809839,-17.02,5
21:11,422955974.0,-324.8580150009501,-32.35,9
21:22,736340277.0,8269.681039542103,-2.92,5
01:34,678851253.0,3057.417053754877,-4.81,5
02:17,547010927.0,21630.54539715282,-32.4,9
02:32,987163717.0,5683.438480000005,-40.6,9
02:45,450896297.0,12446.573049973194,-38.09,9
02:48,547010927.0,21592.200264385712,-38.35,4
02:51,348325817.0,9597.520511256547,-30.32,9
02:53,145387690.0,4499.408316174552,-14.38,9
02:55,407574996.0,289.2573572812745,-2.83,5
02:57,822135975.0,10439.665539031472,-31.02,4
02:59,113747882.0,11632.15454550515,-38.94,9
03:01,809499628.0,15976.606489210137,-12.25,9
03:01,324224854.0,2846.995027784086,-20.05,5
03:24,489964679.0,19483.713791417467,-33.65,9
03:26,506618547.0,15361.138500176648,-8.52,2
03:30,572384506.0,6768.819871056863,-33.68,9
03:32,897714622.0,8273.445389491242,-1.56,7
03:32,639409800.0,33924.65105750591,-0.65,4
03:34,809499628.0,15931.14650672085,-45.46,7
03:36,259015404.0,748.9523274601992,-32.12,9
03:48,858989281.0,25870.081228861156,-32.05,2
03:48,940569402.0,5302.180764239656,-19.7,9
03:49,399144202.0,1459.9416153073769,-18.74,9
03:54,601627384.0,4015.1879015174977,-46.38,9
04:04,874431242.0,7556.843162074929,-25.92,9
04:09,534325901.0,6204.25250718273,-15.01,7
04:09,655368335.0,4355.110027413142,-3.65,7
04:09,985188462.0,-724.8432112887753,-29.62,9
04:09,657139925.0,12867.197158944213,-17.99,9
04:10,873693307.0,8793.675061380116,-40.24,7
04:15,705848712.0,25214.16596223987,-14.9,9
04:17,679662108.0,15233.609513365742,-33.64,5
04:18,285220959.0,11128.273727102416,-12.52,5
04:23,822250278.0,6826.553622621852,-40.61,2
04:25,519644021.0,2444.791773692521,-9.77,5
04:25,758160963.0,7532.266323894944,-5.2,5
04:27,120634201.0,4400.425675814986,-20.5,9
04:32,851181128.0,3979.446904606752,-0.94,7
04:35,886921642.0,2960.3215914586876,-9.13,2
04:35,647936800.0,3199.4048074225834,-14.69,5
04:42,146909202.0,2291.8594461519024,-7.21,7
04:42,609939116.0,6865.224756771029,-15.37,7
04:45,511179916.0,6398.335888549893,-3.33,8
04:48,116169597.0,737.1489499999996,-46.85,9
04:55,510101371.0,12419.554561723557,-38.94,9
04:58,183888402.0,17328.344973285395,-38.93,9
04:58,651756497.0,11237.894796467404,-2.02,2
05:00,853907490.0,6621.954705702975,-2.53,2
05:02,216285378.0,22672.76938463492,-38.37,9
05:05,473820682.0,10577.14868940088,-30.25,7
05:05,769311479.0,6734.855369709299,-9.03,5
05:06,169006407.0,11083.80954411686,-57.33,2
05:07,859603181.0,2751.351899091466,-7.69,7
05:09,532478725.0,4188.115949525832,-37.87,9
05:09,370521542.0,24940.68947696963,-16.2,9
05:10,541639148.0,4335.795837185661,-3.4,8
05:10,785749304.0,7814.578970266926,-12.25,9
05:12,450896297.0,12415.879982418122,-30.69,5
05:12,166019891.0,7397.088780370751,-25.76,4
05:15,766941757.0,1920.2579769329964,-34.83,9
05:18,237684254.0,5418.829174083724,-71.38,8
05:20,143003091.0,21730.97580279697,-8.49,7
05:23,940569402.0,5293.665774031321,-8.51,2
05:32,399144202.0,1448.4988455105788,-11.44,2
05:33,949032480.0,4184.53327482945,-25.59,9
05:35,187541224.0,1098.870756964371,-37.18,9
05:38,287480331.0,7217.188623788065,-23.94,8
05:40,633345190.0,6513.17897073429,-26.79,9
05:44,259015404.0,743.1017630627056,-5.85,7
05:48,187111705.0,6303.81592968797,-7.0,2
05:51,785749304.0,7774.764262104109,-39.81,7
05:53,310375875.0,2621.5537652238627,-40.18,9
05:54,116598243.0,1815.4922217774492,-62.83,7
05:55,532478725.0,4183.318025924446,-4.8,7
05:55,824916823.0,8215.147672698153,-30.45,9
05:58,885259672.0,3137.4973359592236,-74.58,8
05:59,700138124.0,4972.943172909543,-16.5,7
05:59,433917275.0,6882.643970712939,-33.17,9
06:01,270374623.0,9416.390505631272,-10.24,2
06:04,949032480.0,4184.4215257315855,-0.11,7
06:05,639549973.0,6083.675889879809,-13.25,7
06:05,304455868.0,2566.904513953213,-37.15,2
06:07,221868392.0,4686.7253683035415,-39.94,9
06:08,215311171.0,6004.724724008947,-23.46,5
06:09,480557476.0,10589.031579359173,-4.94,5
06:12,108563213.0,22701.20051808205,-53.95,2
06:12,237493332.0,13610.006435859268,-8.98,9
06:13,435984758.0,3966.2385692626176,-47.0,8
06:13,930277104.0,9821.098028276703,-28.75,9
06:19,909676212.0,406.2814045320274,-12.25,9
06:22,322221939.0,3444.7361555017064,-14.94,7
06:24,779946617.0,15737.334343839251,-7.37,2
06:24,414805878.0,12316.475841524778,-42.86,9
06:29,687135796.0,25868.824429441214,-6.6,7
06:31,370521542.0,24928.247519041783,-12.44,2
06:32,108481285.0,8291.36156828661,-4.34,7
06:33,660874296.0,2252.4974499608475,-27.59,9
06:35,534204159.0,5779.094804939582,-6.8,8
06:36,305778936.0,9211.998366674632,-36.48,8
06:39,383833857.0,23409.37285302479,-12.84,5
06:40,986267641.0,7072.586089395325,-16.54,5
06:43,851649498.0,9723.140532442743,-3.61,5
06:43,383625050.0,5537.181994521743,-46.21,7
06:45,482513594.0,5275.529007764258,-18.75,9
06:45,522188082.0,7422.160994403173,-8.02,7
06:45,987656636.0,5529.7823867397465,-44.23,5
06:49,409971170.0,2456.0227512476663,-11.15,5
06:52,678330503.0,2236.084805216415,-72.72,2
06:54,421881811.0,2234.9555843337857,-23.55,2
06:54,667367404.0,8853.922990251287,-6.13,2
06:57,282837512.0,12874.07936152298,-26.3,9
06:57,310375875.0,2619.3445698244977,-2.21,5
06:59,518474507.0,12510.327138477229,-47.85,7
06:59,930277104.0,9784.100997149742,-37.0,5
06:59,704517789.0,16623.249049023354,-20.65,5
07:01,128033695.0,1541.3865256371084,-32.49,9
07:05,844835978.0,9435.416258356558,-1.01,5
07:06,471897866.0,7469.64452877513,-12.8,7
07:06,816685391.0,-748.0996037084262,-18.89,9
07:11,709608057.0,2521.4281547394985,-24.61,7
07:11,554792076.0,26474.693574187106,-49.4,5
07:14,706250160.0,11304.904656270764,-9.42,2
07:14,124102251.0,3087.2300140844104,-41.16,2
07:15,298000165.0,24713.789241331484,-12.95,9
07:16,482513594.0,5269.245093646098,-6.28,2
07:16,252760664.0,5799.59759329798,-15.57,5
07:17,699139822.0,1177.9937483071772,-25.83,7
07:17,108931112.0,13272.154696139534,-34.59,9
07:19,195895574.0,6713.027619560617,-25.18,9
07:21,613729471.0,8460.049999701749,-23.87,7
07:21,280268430.0,4329.86379831937,-3.61,5
07:22,478412511.0,113.85297019746072,-28.83,9
07:24,587225252.0,4590.00062306096,-20.26,5
07:25,832564361.0,15253.666752463709,-0.99,4
07:27,749378808.0,3676.238107897721,-23.65,9
07:28,802697323.0,14848.36938393617,-3.27,5
07:28,730002588.0,12184.15717248463,-0.65,8
07:31,874431242.0,7545.774784956165,-11.07,5
07:32,905860285.0,8141.7641717003025,-6.63,8
07:32,290818242.0,6477.559002939585,-18.26,5
07:36,131388684.0,20687.537725594186,-16.2,2
07:36,520447032.0,7990.161317369416,-3.01,7
07:37,815385232.0,9375.507632653584,-1.87,4
07:40,984783496.0,13103.62969758344,-5.12,7
07:43,973086490.0,9344.927790322452,-22.49,9
07:50,672913754.0,10509.512399880485,-8.65,7
07:54,575652395.0,2298.7190306567463,-23.53,8
07:58,256002321.0,5511.730599889506,-49.74,7
07:59,901432314.0,3263.8198219653814,-5.35,9
08:01,675806859.0,6501.742026872673,-0.16,8
08:05,245690309.0,8780.12150977267,-0.3,5
08:05,718058208.0,2285.922272105441,-40.72,7
08:06,752362502.0,8272.127508144595,-44.78,7
08:06,948558249.0,8516.385081706883,-5.25,9
08:07,196289502.0,14621.532853363313,-66.7,7
08:07,842682241.0,4853.5823274041595,-4.41,2
08:17,683319988.0,6825.395298622385,-35.15,2
08:17,399538448.0,6890.026794127587,-6.05,9
08:20,179173981.0,4304.525422391086,-27.39,7
08:21,668329719.0,7721.043834846608,-36.93,2
08:21,461990622.0,8309.968438486607,-16.91,2
08:22,775790822.0,-3073.075919216068,-19.54,5
08:24,753525749.0,-2331.8008999999993,-14.09,5
08:27,496395938.0,11434.02259919868,-10.05,2
08:31,647472692.0,23706.79287745408,-34.34,9
08:31,282102606.0,-197.0339375771736,-41.66,5
08:32,945054126.0,-406.6819,-26.8,5
08:34,497809732.0,286.1098695525952,-112.2,5
08:34,999752672.0,800.5801435333346,-43.03,5
08:37,736310094.0,-887.967724027426,-41.44,5
08:37,143061865.0,6489.210500072905,-25.0,5
08:40,235881534.0,12386.559682654375,-5.31,2
08:40,348325817.0,9582.800714173556,-14.72,4
08:41,419084831.0,-402.00727552610306,-162.43,5
08:42,979122276.0,-1137.3680377056712,-126.25,5
08:43,719586818.0,16670.341578188476,-25.52,7
08:43,198051483.0,-1379.856910408857,-95.03,5
08:43,480198977.0,12594.183720897709,-150.36,5
08:44,113747882.0,11629.017722554052,-3.14,5
08:44,197865285.0,-139.0025382687798,-82.99,5
08:44,673025413.0,1957.4022465017615,-96.75,5
08:46,425730826.0,1400.2994093887198,-41.39,5
08:47,143606916.0,62.1164540291897,-172.77,5
08:48,520447032.0,7836.714317369416,-153.45,5
08:48,124125096.0,85.1451443878023,-113.79,5
08:49,119943495.0,-1521.635062112858,-30.41,5
08:50,957821152.0,-1797.8779535715496,-119.78,5
08:50,668175891.0,334.43197315849903,-35.41,5
08:53,101531259.0,-375.2153000000004,-76.51,5
08:57,417850087.0,16001.601034854864,-48.49,5
08:59,120634201.0,4313.877675814986,-86.55,5
08:59,127809299.0,920.111703485056,-56.44,5
09:01,633345190.0,6456.852627645703,-56.33,5
09:02,145387690.0,4470.954902768713,-28.45,5
09:04,891513205.0,539.2868796590691,-52.63,5
09:05,705848712.0,25207.423745074982,-6.74,8
09:05,734161378.0,-2679.1701694342128,-23.76,5
09:07,264550521.0,9039.355546900391,-22.64,7
09:08,570269025.0,2780.4258006444206,-40.42,5
09:09,383833857.0,23403.27285302479,-6.1,9
09:09,806358207.0,11579.232020328474,-6.47,2
09:11,905860285.0,8066.542171700303,-75.22,5
09:12,795847804.0,22011.50783228181,-6.68,7
09:13,162162212.0,1091.7603433273089,-76.73,5
09:14,195895574.0,6687.411116917022,-25.62,8
09:14,170637730.0,2345.527471587438,-1.89,5
09:14,920830317.0,-366.6787793625187,-159.48,5
09:15,303843160.0,-38.69709999999833,-167.3,2
09:15,943329213.0,1512.7641187748354,-67.21,5
09:16,730002588.0,12166.97717248463,-17.18,7
09:16,762896656.0,-123.2325018481413,-25.02,2
09:17,663479159.0,4528.856541827711,-5.99,7
09:17,479366718.0,1938.7014476324007,-14.99,4
09:17,613729471.0,8454.649999701749,-5.4,9
09:18,749378808.0,3634.2412254722767,-42.0,7
09:18,865748375.0,3524.892052686042,-8.63,8
09:18,605116158.0,2051.706700000002,-21.98,4
09:18,792845450.0,586.796150000001,-4.5,4
09:19,586041848.0,298.9086999999988,-9.99,4
09:19,138609932.0,3128.4490032945855,-23.94,4
09:19,604288474.0,2078.8608870732783,-26.51,4
09:20,224524792.0,-2220.0356824308483,-40.39,5
09:21,835736339.0,1681.8423520918798,-29.59,5
09:22,534583529.0,1139.7693880547652,-104.25,7
09:23,893134725.0,561.9065819367792,-31.99,2
09:23,480557476.0,10546.531579359173,-27.51,7
09:24,315546581.0,26831.372424289948,-23.77,2
09:24,907987693.0,-2521.0119999999984,-46.18,5
09:24,769311479.0,6712.6653697093,-22.19,1
09:24,581655972.0,39024.58349464595,-14.98,7
09:24,130154096.0,1321.046782013418,-26.97,7
09:24,711045550.0,3239.3243500000035,-50.0,2
09:25,510101371.0,12398.154561723555,-21.4,4
09:27,992204045.0,5684.809717772078,-7.01,4
09:28,897592348.0,14350.927968797629,-15.98,1
09:30,556992209.0,10980.74592883665,-107.46,5
09:30,730002588.0,12058.70717248463,-108.27,2
09:33,986774156.0,3614.664931625769,-168.67,2
09:33,858989281.0,25841.82122886116,-28.26,7
09:33,402438092.0,545.0426999999988,-19.99,2
09:34,550169791.0,20482.616796088452,-44.47,2
09:34,705848712.0,25201.143745074987,-6.28,1
09:34,469330905.0,55.26806802921554,-41.27,2
09:34,873701090.0,527.7168596287682,-50.39,2
09:36,673025413.0,1907.4391587223752,-49.96,2
09:36,792845450.0,498.816150000001,-87.98,2
09:38,237493332.0,13570.349673537312,-39.66,5
09:41,538003940.0,1169.5600000000086,-131.98,2
09:43,435984758.0,3964.2325692626177,-2.01,4
09:43,960208650.0,16873.97190926935,-16.26,5
09:45,491392945.0,4415.701500000007,-35.0,2
09:46,992204045.0,5633.821717772078,-50.99,5
09:47,639549973.0,6029.306889879809,-54.37,5
09:47,873701090.0,515.6968596287683,-12.02,7
09:48,303843160.0,-195.4970999999983,-156.8,2
09:49,943829984.0,-1091.127890886543,-34.95,5
09:52,822135975.0,10429.515539031472,-10.15,4
09:52,973086490.0,9307.448857650188,-37.48,2
09:53,417850087.0,15999.595034854863,-2.01,4
09:53,280098744.0,100.5023778716656,-47.99,2
09:53,903953091.0,3251.657038995664,-47.86,5
09:54,479366718.0,1864.2014476324007,-74.5,2
09:54,506618547.0,15345.018500176646,-16.12,7
09:55,876890798.0,2709.499270699932,-9.99,1
09:55,494789005.0,2703.180036125884,-45.07,5
10:00,659415300.0,938.135690250704,-14.98,1
10:00,448004226.0,1706.5674609010628,-54.57,2
10:00,496395938.0,11386.88259919868,-47.14,2
10:01,558875206.0,2609.6003108989516,-54.99,2
10:01,933745726.0,145.78105642932326,-64.68,5
10:01,504055745.0,-392.9038386582331,-35.09,5
10:02,469330905.0,-82.63193197078444,-137.9,2
10:03,896821055.0,-506.7127407329175,-64.82,5
10:03,992204045.0,5592.847264439104,-40.97,5
10:06,887853850.0,10162.784915923696,-8.45,7
10:07,891716230.0,132.7066513926162,-101.98,2
10:09,854513972.0,1181.4530499999998,-19.99,2
10:10,627622066.0,2908.4245547156615,-87.99,2
10:10,176922958.0,664.0955471976495,-85.24,2
10:10,586041848.0,139.2876999999988,-159.62,5
10:11,279149837.0,1036.9010499999986,-59.98,2
10:11,986774156.0,3461.378931625769,-153.29,2
10:12,510101371.0,12357.363843192095,-40.79,7
10:12,229205098.0,6899.626286659045,-38.57,7
10:13,506618547.0,15296.608500176646,-48.41,2
10:14,117273481.0,8867.63636413907,-28.95,7
10:15,187541224.0,1062.020756964371,-36.85,7
10:16,479366718.0,1804.7014476324007,-59.5,2
10:17,303843160.0,-237.4970999999983,-42.0,2
10:19,134847904.0,3671.632044386296,-101.97,4
10:20,897592348.0,14328.927968797629,-22.0,2
10:23,466649401.0,202.62871139789144,-44.95,4
10:24,727417797.0,5246.331500000011,-27.97,4
10:26,137822385.0,3561.456547768435,-7.3,9
10:27,531186970.0,6271.420881634225,-161.15,5
10:27,887853850.0,10092.574915923697,-70.21,2
10:28,990461108.0,-44.13973137938895,-52.85,5
10:32,986774156.0,3444.398931625769,-16.98,7
10:32,116598243.0,1564.1922217774493,-251.3,2
10:32,469330905.0,-233.8179319707844,-151.19,2
10:32,242218612.0,344.4388000000006,-28.0,2
10:33,366550080.0,25085.848935596063,-16.92,2
10:34,200080192.0,8739.071183807011,-38.36,2
10:34,203466392.0,2398.3071705278076,-22.38,7
10:37,166019891.0,7386.698780370751,-10.39,9
10:38,456246119.0,19433.40736037719,-7.72,7
10:38,846550094.0,1281.619464472557,-135.06,2
10:39,833899961.0,1424.2224942498694,-60.39,5
10:40,558119802.0,31175.429020615946,-7.35,7
10:42,994214354.0,9101.37396833609,-44.37,2
10:44,419550103.0,17513.100777870306,-5.99,1
10:44,970298834.0,2747.9771466127336,-17.35,5
10:46,131388684.0,20660.937725594184,-26.6,2
10:48,718058208.0,2107.464272105441,-178.46,2
10:50,683078800.0,1746.341252944871,-6.99,7
11:01,333054026.0,-80.06010597681001,-13.04,2
11:01,486495235.0,1268.1068393887165,-23.96,7
11:03,598793068.0,264.56884999999824,-267.71,5
11:04,846550094.0,1196.933464472557,-84.69,2
11:09,949032480.0,4010.8415257315855,-173.58,2
11:10,975345315.0,33344.38196837637,-17.55,7
11:11,857754342.0,2384.675482099383,-109.47,2
11:11,718058208.0,1975.8642721054412,-131.6,2
11:16,836110591.0,6100.53657332514,-5.29,4
11:17,116598243.0,1424.892221777449,-139.3,2
11:18,639549973.0,5996.256889879809,-33.05,7
11:24,653640811.0,16072.520297281955,-47.04,7
11:24,414454079.0,217.5778500000018,-6.1,4
11:26,639409800.0,33911.56105750591,-13.09,2
11:27,624500124.0,3188.912671096436,-36.39,4
11:28,824916823.0,8176.177672698152,-38.97,2
11:29,951817450.0,8512.77915328371,-16.99,7
11:30,315078351.0,7024.831081097179,-20.31,4
11:30,752362502.0,8237.077508144595,-35.05,7
11:30,469330905.0,-557.1899319707844,-323.37,2
11:33,776431321.0,3190.0161566683096,-32.96,7
11:36,282837512.0,12870.808763145082,-3.27,7
11:38,703478110.0,4637.278450637635,-10.06,2
11:39,909669130.0,126.3978847367666,-15.01,4
11:40,448004226.0,1663.1954609010627,-43.37,2
11:42,116598243.0,1254.0922217774494,-170.8,2
11:43,480557476.0,10470.035579359172,-76.5,5
11:45,822135975.0,10401.075539031472,-28.44,7
11:45,469330905.0,-606.8759319707844,-49.69,2
11:50,489964679.0,19448.259281417468,-35.45,4
11:53,500051919.0,1300.3596966505904,-22.0,2
11:54,583579399.0,1179.4049499999992,-29.99,2
11:59,703478110.0,4617.308450637634,-19.97,7
12:04,419550103.0,17476.689781162328,-36.41,2
12:06,344219145.0,7220.315590289772,-5.99,9
12:07,500051919.0,1295.3696966505904,-4.99,1
12:07,420109571.0,482.0838107166796,-33.08,9
12:08,857754342.0,2270.205482099383,-114.47,2
12:08,489964679.0,19434.021208494545,-14.24,2
12:11,116598243.0,1128.7922217774494,-125.3,2
12:11,518474507.0,12464.777138477228,-45.55,9
12:11,559995067.0,3524.9461168709176,-51.39,2
12:12,469330905.0,-723.0339319707845,-116.16,2
12:14,575652395.0,2100.2900306567462,-198.43,5
12:17,858989281.0,25834.43122886116,-7.39,9
12:18,414805878.0,12303.717592255269,-12.76,7
12:19,623156843.0,3898.1102896332977,-53.0,2
12:20,623156843.0,3885.624086456768,-12.49,8
12:22,667367404.0,8852.362390251286,-1.56,4
12:24,116598243.0,1030.7922217774494,-98.0,2
12:25,846550094.0,986.233464472557,-210.7,2
12:25,986774156.0,3317.7129316257688,-126.69,2
12:26,581655972.0,39011.58349464595,-13.0,9
12:27,836110591.0,6057.41657332514,-43.12,9
12:28,151968462.0,6249.142036673519,-20.09,5
12:28,364357875.0,6938.806017236548,-7.6,4
12:30,520447032.0,7805.324317369415,-31.39,9
12:31,857754342.0,2147.7354820993833,-122.47,2
12:31,471897866.0,7290.48652877513,-179.16,2
12:32,970298834.0,2712.9571466127336,-35.02,7
12:36,225210798.0,531.8867737592086,-1.5,4
12:38,492058070.0,373.0759687404707,-72.0,2
12:40,705848712.0,25144.563745074985,-56.58,2
12:41,857754342.0,2130.7554820993832,-16.98,2
12:41,867987292.0,3755.179440972699,-23.64,7
12:50,213096759.0,-1517.9391082144396,-48.09,5
12:50,851181128.0,3951.516904606752,-27.93,1
12:51,897714622.0,8253.805389491243,-19.64,9
12:51,116598243.0,800.4922217774495,-230.3,2
12:53,213930646.0,-1556.2023134725632,-46.64,5
12:56,391688371.0,-73.7627004314769,-77.41,5
12:57,471897866.0,7220.48652877513,-70.0,2
13:00,718058208.0,1908.6922721054411,-67.17,2
13:00,572384506.0,6758.035051056863,-10.78,4
13:01,441274121.0,10966.980564442692,-10.04,9
13:01,585625048.0,1303.813183241531,-6.2,9
13:01,558119802.0,31161.04902061594,-14.38,9
13:02,851181128.0,3945.083344606752,-6.43,4
13:02,749378808.0,3627.141225472277,-7.1,9
13:04,365608668.0,32.64525202418875,-176.21,5
13:05,986774156.0,3271.5269316257686,-46.19,2
13:05,541639148.0,4008.237837185661,-129.49,2
13:05,660874296.0,2190.517449960847,-61.98,2
13:05,812692024.0,3293.3848579489527,-6.0,9
13:06,147474476.0,3348.7421570987963,-11.98,7
13:07,994214354.0,9099.225308336088,-2.15,4
13:08,340321732.0,1253.4870000000033,-6.2,9
13:10,683319988.0,6800.245298622385,-25.15,9
13:10,370757362.0,673.1715898126758,-35.98,2
13:10,187111705.0,6298.31592968797,-5.5,9
13:15,857754342.0,2086.295482099383,-44.46,2
13:20,116598243.0,604.4922217774495,-196.0,2
13:21,277562576.0,619.665818105103,-5.4,9
13:21,698076160.0,5808.1538913220475,-46.8,5
13:22,480557476.0,10464.335579359173,-5.7,9
13:23,986774156.0,3074.8689316257687,-196.66,2
13:26,475277431.0,977.7281369436192,-173.14,5
13:28,282837512.0,12855.96236314508,-14.85,4
13:29,776431321.0,3188.1010947294008,-1.92,8
13:29,657139925.0,12854.358926353769,-12.84,4
13:31,143003091.0,21650.99580279697,-79.98,4
13:32,441274121.0,10958.616397539932,-8.36,5
13:32,688712152.0,6012.25201717615,-69.26,8
13:33,629078930.0,-509.07052027439806,-93.97,2
13:34,986267641.0,7071.0700493953245,-1.52,4
13:35,541639148.0,3746.4658371856617,-261.77,2
13:40,986774156.0,2943.996931625769,-130.87,2
13:41,116598243.0,301.3922217774495,-303.1,2
13:43,897592348.0,14302.828603925536,-26.1,2
13:48,386729293.0,30173.87880262263,-11.48,7
13:48,403765849.0,-2384.190499999998,-15.21,5
13:49,914806976.0,111.21325018548671,-49.98,2
13:50,429556122.0,5606.698478442135,-21.68,8
13:53,433837402.0,-439.3458684641882,-41.89,9
13:55,923322792.0,-772.3868317536376,-19.57,5
13:59,541639148.0,3619.779837185661,-126.69,2
13:59,781554833.0,1896.4932255639665,-30.49,7
14:01,534583529.0,1063.2693880547652,-76.5,7
14:01,270374623.0,9408.240505631273,-8.15,4
14:04,456221621.0,489.2366673026281,-65.48,5
14:05,472995101.0,1680.9744342428032,-65.97,4
14:06,471897866.0,7013.34252877513,-207.14,2
14:09,541639148.0,3596.007837185661,-23.77,2
14:12,857754342.0,2034.2954820993832,-52.0,2
14:14,116598243.0,23.492221777449515,-277.9,2
14:14,986774156.0,2750.796931625769,-193.2,2
14:15,534583529.0,941.3943880547652,-121.88,4
14:17,242218612.0,333.95380000000057,-10.48,5
14:23,762896656.0,-132.82500184814128,-9.59,5
14:24,541639148.0,3490.335837185661,-105.67,2
14:26,857754342.0,1975.8054820993832,-58.49,2
14:30,851181128.0,3764.588344606752,-180.5,5
14:35,611143859.0,1239.4751000000113,-16.01,2
14:35,534583529.0,827.7693880547652,-113.62,4
14:45,986774156.0,2561.124931625769,-189.67,2
14:57,698955014.0,360.08151695166674,-16.98,4
14:57,534583529.0,781.6443880547652,-46.12,7
14:59,857754342.0,1889.8154820993832,-85.99,2
15:13,853907490.0,6570.514705702975,-51.44,2
15:15,409370545.0,1013.0892755455204,-38.14,7
15:20,986774156.0,2407.852931625769,-153.27,2
15:20,454356905.0,919.082011377028,-18.16,5
15:22,200080192.0,8689.30118380701,-49.77,5
15:27,322720763.0,5458.164230811608,-16.52,4
15:27,857754342.0,1760.8554820993832,-128.96,2
15:30,469330905.0,-807.0339319707845,-84.0,2
15:42,857754342.0,1566.3754820993831,-194.48,2
15:55,448004226.0,1596.023460901063,-67.17,2
15:55,986774156.0,2353.966931625769,-53.89,2
16:00,534583529.0,671.7693880547652,-109.88,7
16:04,718058208.0,1755.4202721054412,-153.27,2
16:04,469330905.0,-952.6059319707844,-145.57,2
16:04,116598243.0,-59.10777822255048,-82.6,2
16:12,128033695.0,1528.976279543051,-12.41,2
16:16,986774156.0,2090.0949316257693,-263.87,2
16:18,857754342.0,1458.905482099383,-107.47,2
16:22,516051449.0,1201.2490389400978,-5.99,4
16:24,116598243.0,-257.90777822255046,-198.8,2
16:29,469330905.0,-1014.8919319707844,-62.29,2
16:31,986774156.0,1798.8949316257692,-291.2,2
16:33,272538745.0,14399.95990000003,-23.48,4
16:45,986774156.0,1507.0089316257693,-291.89,2
16:46,857754342.0,1267.425482099383,-191.48,2
16:49,116598243.0,-486.8077782225504,-228.9,2
16:49,489964679.0,19397.171208494547,-36.85,2
16:52,899692478.0,-1937.5577435240073,-87.28,5
16:55,234952520.0,-2142.453600000001,-33.03,5
16:57,596171893.0,-12.228255174488908,-25.0,2
16:57,899742927.0,11744.938310280424,-18.32,4
17:02,948558249.0,8496.435081706883,-19.95,5
17:06,454356905.0,888.9920113770279,-30.09,9
17:08,925037906.0,688.7278000000015,-49.99,2
17:10,116598243.0,-692.6077782225505,-205.8,2
17:11,986774156.0,1280.9369316257694,-226.07,2
17:14,857754342.0,1083.445482099383,-183.98,2
17:24,670102069.0,3371.2287081728064,-31.74,9
17:25,287480331.0,7177.938623788065,-39.25,9
17:34,857754342.0,1016.4554820993832,-66.99,2
17:35,163470640.0,777.1862999999997,-69.0,2
17:38,527842638.0,-199.4894073670164,-180.03,5
17:41,534583529.0,600.5193880547652,-71.25,7
17:41,120634201.0,4303.847675814986,-10.03,7
17:44,444428189.0,999.4042000000028,-25.0,2
17:47,261894284.0,-1868.8837999999969,-20.89,5
17:49,454356905.0,838.208971377028,-50.78,4
17:50,280098744.0,49.0123778716656,-51.49,4
17:52,534583529.0,493.6443880547651,-106.88,7
17:52,308505160.0,12168.6440822841,-145.59,2
17:57,709608057.0,2489.4481547394985,-31.98,9
17:58,857754342.0,931.965482099383,-84.49,2
17:59,581655972.0,38982.546793607595,-29.04,7
18:00,256002321.0,5444.292599889506,-67.44,5
18:03,448004226.0,1492.4374609010629,-103.59,2
18:05,444428189.0,972.1742000000028,-27.23,9
18:07,469330905.0,-1128.2779319707845,-113.39,2
18:11,534583529.0,366.8943880547651,-126.75,4
18:20,308505160.0,12113.3440822841,-55.3,2
18:22,116598243.0,-972.6077782225505,-280.0,2
18:35,308505160.0,12078.3440822841,-35.0,2
18:42,687135796.0,25853.844429441215,-14.98,9
18:50,308505160.0,12020.9720822841,-57.37,2
18:52,116598243.0,-1132.9077782225504,-160.3,2
19:01,493571342.0,-2497.910880907048,-50.3,5
19:07,679662108.0,15190.433513365742,-43.18,5
19:19,819515373.0,1529.9132860637917,-76.47,5
19:23,308505160.0,11953.0860822841,-67.89,2
19:28,675806859.0,6398.065026872673,-103.68,5
19:32,462962606.0,2792.248049999999,-57.04,5
19:38,391559884.0,-258.8248000000006,-195.89,5
19:40,564744955.0,228.04185858884185,-52.69,5
19:41,213112754.0,6175.341828750469,-90.76,5
19:46,871866387.0,-405.4476000000007,-78.63,5
19:57,886921642.0,2913.449591458688,-46.87,5
19:58,137822385.0,3512.1116431810474,-49.34,5
20:15,106601471.0,9918.786024080166,-3.37,2
20:16,308505160.0,11944.453384641529,-8.63,2
20:22,305778936.0,9190.548366674631,-21.45,9
20:25,943329213.0,1407.4911187748355,-105.27,5
20:29,252760664.0,5770.07159329798,-29.53,5
20:31,358836279.0,114.74569280758588,-103.28,5
20:33,308897841.0,838.3168999999989,-58.07,5
20:39,229205098.0,6795.858286659045,-103.77,5
20:42,984783496.0,13088.43969758344,-15.19,9
20:44,551755686.0,6340.3762128977105,-22.24,5
20:56,736340277.0,8228.422429584502,-41.26,2
21:36,213112754.0,6153.091551265502,-22.25,5
00:12,624500124.0,3136.1050836787576,-52.81,4
00:16,235881534.0,12384.101075277553,-2.46,7
00:16,719586818.0,16654.89274483817,-15.45,7
00:19,730002588.0,12037.091554116305,-21.62,2
00:25,858989281.0,25814.691228861157,-19.74,9
00:25,421881811.0,2233.9429510008495,-1.01,2
00:25,910730524.0,7590.714687435755,-40.37,7
00:26,169006407.0,11076.214575752532,-7.59,2
00:29,873693307.0,8719.029185482985,-74.65,2
00:30,867987292.0,3729.838067044329,-25.34,4
00:33,802697323.0,14815.46938393617,-32.9,9
00:36,113747882.0,11594.335107314211,-34.68,4
00:38,815385232.0,9336.88236550543,-38.63,2
00:38,586315521.0,11537.255399849466,-29.45,9
00:42,679911053.0,2271.2191134201416,-15.8,2
00:44,482513594.0,5215.175100006462,-0.13,5
00:46,433917275.0,6855.353970712939,-27.29,9
00:50,853907490.0,6567.501451027738,-3.01,2
00:52,601627384.0,3974.697901517498,-40.49,9
00:57,905860285.0,8052.07651691974,-14.47,7
01:07,858989281.0,25747.197923062555,-67.49,5
01:08,324224854.0,2822.423411435284,-24.57,2
01:16,473820682.0,10566.606519723033,-10.54,7
01:27,534204159.0,5740.978441044128,-38.12,2
01:36,874431242.0,7528.4911635548515,-17.28,4
01:36,986267641.0,7054.331038062814,-16.74,2
01:37,541639148.0,3449.8195011293337,-40.52,7
01:42,940569402.0,5276.475774031322,-17.19,9
01:42,264550521.0,8975.223898859565,-64.13,7
01:43,987163717.0,5642.838480000005,-40.6,9
01:45,887853850.0,10001.42192582227,-57.97,5
01:47,647936800.0,3168.7611705138147,-30.64,2
01:50,506618547.0,15287.32124767028,-9.29,5
01:57,145387690.0,4440.474902768713,-30.48,9
02:02,450896297.0,12385.949982418122,-29.93,9
02:05,237493332.0,13554.501690403886,-15.85,8
02:13,705848712.0,25129.563745074985,-15.0,9
02:15,270374623.0,9359.305138551948,-48.94,7
02:19,435984758.0,3957.9453899684063,-6.29,7
02:27,824916823.0,8152.947672698153,-23.23,9
02:27,874431242.0,7505.761163554852,-22.73,9
02:29,290818242.0,6440.157903860534,-37.4,8
02:30,651756497.0,11233.563481845296,-4.33,2
02:30,586315521.0,11491.178839872966,-46.08,4
02:31,758160963.0,7501.411019717961,-30.86,4
02:38,496395938.0,11349.4758348156,-37.41,8
02:46,851649498.0,9719.019856587256,-4.12,8
02:47,519644021.0,2420.8156293504667,-23.98,5
02:48,994214354.0,9066.495308336089,-32.73,9
02:51,196289502.0,14620.792478092037,-0.74,4
02:53,550169791.0,20428.24724104294,-54.37,2
03:04,414454079.0,181.40785000000184,-36.17,9
03:10,704517789.0,16593.970587730822,-29.28,7
03:11,670102069.0,3340.0987081728063,-31.13,9
03:11,310620484.0,-77.66280490780167,-33.35,9
03:12,179173981.0,4277.385422391086,-27.14,9
03:16,795847804.0,21998.00783228181,-13.5,9
03:17,187541224.0,1036.430756964371,-25.59,9
03:23,675806859.0,6373.698193493143,-24.37,5
03:26,534325901.0,6198.473135797368,-5.78,2
03:28,166019891.0,7385.708355990761,-0.99,2
03:29,633345190.0,6420.162627645704,-36.69,9
03:30,940569402.0,5221.644331209081,-54.83,7
03:31,836110591.0,6021.42657332514,-35.99,9
03:31,709608057.0,2459.2181547394985,-30.23,9
03:33,183888402.0,17293.254973285395,-35.09,9
03:34,678851253.0,3057.223015443368,-0.19,7
03:35,572384506.0,6723.595051056864,-34.44,9
03:43,683319988.0,6774.065298622385,-26.18,9
03:48,399144202.0,1411.5588455105787,-36.94,9
03:53,779236304.0,526.6375954795323,-46.23,9
03:53,575652395.0,2097.3757596720943,-2.91,7
03:56,510101371.0,12322.683843192097,-34.68,9
03:57,912705941.0,17522.33439439059,-5.01,7
03:59,196289502.0,14605.502478092034,-15.29,9
03:59,851181128.0,3724.5554296829814,-40.03,7
04:00,687135796.0,25836.904429441216,-16.94,9
04:08,795847804.0,21928.810706214797,-69.2,5
04:10,806358207.0,11572.022509428089,-7.21,5
04:14,518474507.0,12443.787138477228,-20.99,9
04:15,821971408.0,815.1391102355434,-6.62,4
04:18,673025413.0,1868.6079727375873,-38.83,2
04:22,256002321.0,5421.842599889506,-22.45,9
04:24,836110591.0,6019.729853885926,-1.7,5
04:24,657139925.0,12837.968926353768,-16.39,9
04:25,259015404.0,705.1717630627056,-37.93,9
04:35,399144202.0,1395.5094545723566,-16.05,2
04:38,670102069.0,3309.0367194265737,-31.06,2
04:38,897714622.0,8228.599608080025,-25.21,5
04:41,216285378.0,22644.389384634916,-28.38,9
04:46,679662108.0,15147.934462524005,-42.5,5
04:48,461990622.0,8308.500035307192,-1.47,7
04:51,890567652.0,-85.45430032039938,-18.45,9
04:52,298000165.0,24704.18338868054,-9.61,5
04:52,985188462.0,-757.3332112887753,-32.49,9
04:53,613729471.0,8449.970918307063,-4.68,2
04:54,718058208.0,1723.1168519536527,-32.3,5
04:54,417850087.0,15996.077641484502,-3.52,7
04:57,532478725.0,4127.527793840304,-55.79,7
05:04,699139822.0,1149.603748307177,-28.39,9
05:04,213112754.0,6148.568117613747,-4.52,2
05:05,383625050.0,5536.564488057286,-0.62,2
05:05,949032480.0,3974.791525731586,-36.05,9
05:05,308505160.0,11921.141663266682,-23.31,7
05:07,873701090.0,494.07883322710734,-21.62,2
05:07,284905540.0,7199.078716283519,-18.49,9
05:10,252760664.0,5768.767709053483,-1.3,5
05:10,315546581.0,26809.695668560904,-21.68,2
05:14,683319988.0,6747.486584059476,-26.58,7
05:15,832564361.0,15234.726839955145,-18.94,5
05:18,522188082.0,7402.636414910484,-19.52,7
05:19,500043411.0,12792.227348801143,-14.62,2
05:24,623156843.0,3852.6778325174296,-32.95,2
05:32,134461671.0,5338.868617238033,-26.77,8
05:34,885259672.0,3134.612606035509,-2.88,7
05:34,304455868.0,2535.3769394772507,-31.53,7
05:36,366550080.0,25079.29651821968,-6.55,2
05:40,549414742.0,6725.286648054061,-45.74,9
05:43,678330503.0,2235.849016009394,-0.24,2
05:46,287480331.0,7153.324133466914,-24.61,7
05:48,809499628.0,15922.554150956588,-8.59,7
05:55,221868392.0,4654.9753683035415,-31.75,9
05:57,407574996.0,233.06011806007768,-56.2,5
05:59,518474507.0,12378.99913077945,-64.79,2
06:02,228136274.0,1562.6322999999993,-31.65,9
06:02,285220959.0,11102.164199933608,-26.11,7
06:03,200080192.0,8670.739105099687,-18.56,4
06:04,992204045.0,5589.971675886652,-2.88,2
06:05,766941757.0,1882.2079769329964,-38.05,9
06:11,282837512.0,12841.483661709675,-14.48,2
06:17,930277104.0,9763.620997149745,-20.48,9
06:22,667367404.0,8768.368629102612,-83.99,7
06:25,653640811.0,16058.632154296343,-13.89,2
06:27,699139822.0,1119.8073280530853,-29.8,2
06:33,383833857.0,23402.11892425373,-1.15,7
06:36,540159353.0,10405.13171124572,-33.51,5
06:38,310375875.0,2586.5131903485203,-32.83,2
06:46,960208650.0,16789.385103505403,-84.59,2
06:50,145387690.0,4434.2100841561205,-6.26,2
06:50,951817450.0,8509.955912420308,-2.82,2
06:51,766941757.0,1871.269911511485,-10.94,7
06:52,558119802.0,31135.70902061594,-25.34,9
06:54,973086490.0,9286.948857650188,-20.5,9
06:55,785749304.0,7763.774262104109,-10.99,9
07:00,984783496.0,13071.69969758344,-16.74,9
07:00,108563213.0,22694.633308602548,-6.57,2
07:03,930277104.0,9728.967569113009,-34.65,7
07:03,187111705.0,6247.802579135109,-50.51,5
07:09,581655972.0,38905.992098815965,-76.55,8
07:12,752362502.0,8225.669035893185,-11.41,5
07:20,588565416.0,7046.374420578901,-5.61,8
07:21,305778936.0,9178.98583425158,-11.56,5
07:23,124102251.0,3038.31509640627,-48.91,5
07:24,558119802.0,31125.38245474003,-10.33,2
07:24,994214354.0,9043.65496898596,-22.84,4
07:26,785749304.0,7762.547239636973,-1.23,7
07:27,687135796.0,25828.69110911621,-8.21,5
07:29,949032480.0,3940.993785043307,-33.8,5
07:32,355733816.0,4795.800731027458,-3.03,7
07:32,886921642.0,2866.2961499415565,-47.15,7
07:33,706250160.0,11280.00370860242,-24.9,2
07:36,364357875.0,6878.0481849179805,-60.76,2
07:38,859603181.0,2745.4756380767485,-5.88,2
07:39,633345190.0,6399.121964823182,-21.04,7
07:39,108481285.0,8240.163965902311,-51.2,5
07:41,788740658.0,1654.1883940894704,-0.62,5
07:43,822250278.0,6800.993995336087,-25.56,2
07:44,769311479.0,6676.053200167599,-36.61,5
07:54,489964679.0,19376.231208494548,-20.94,9
07:54,237684254.0,5398.5115450557205,-20.32,8
07:56,639409800.0,33896.21379906425,-15.35,5
08:04,547010927.0,21551.455954238827,-40.74,2
08:06,409971170.0,2449.957039037908,-6.07,2
08:14,984783496.0,13069.610270207144,-2.09,8
08:18,587225252.0,4555.26062306096,-34.74,9
08:27,549414742.0,6722.1038144115255,-3.18,5
08:35,403383649.0,1603.1848048612508,-31.47,5
08:36,842682241.0,4850.846976929288,-2.74,2
08:39,203466392.0,2397.5059660776747,-0.8,7
08:57,170637730.0,2339.452111825804,-6.08,4
09:13,846550094.0,947.283464472557,-38.95,7
09:14,245690309.0,8765.70118046657,-14.42,2
09:14,975345315.0,33342.391968376374,-1.99,4
09:19,596171893.0,-41.18825517448891,-28.96,7
09:20,403383649.0,1581.1948048612508,-21.99,1
09:20,833899961.0,1400.2624942498694,-23.96,1
09:21,639409800.0,33873.87651906425,-22.34,4
09:21,259015404.0,634.9477964948803,-70.22,7
09:22,876890798.0,2652.509270699932,-56.99,6
09:22,705848712.0,25103.795799530977,-25.77,5
09:25,924045955.0,1288.7955126586644,-22.99,7
09:25,609939116.0,6842.445987897043,-22.78,7
09:27,255814263.0,3414.7678815504905,-27.95,1
09:29,336557504.0,1130.1458372010195,-35.95,7
09:30,383625050.0,5333.564488057286,-203.0,2
09:31,237684254.0,5359.49154505572,-39.02,1
09:32,829914501.0,-93.47919342902576,-36.95,7
09:34,865748375.0,3472.9320899914705,-51.96,2
09:37,370521542.0,24927.461897942452,-0.79,7
09:38,867987292.0,3671.038067044328,-58.8,2
09:38,549414742.0,6678.717814411525,-43.39,4
09:39,215311171.0,5992.744724008948,-11.98,7
09:40,828750680.0,1132.8323452136797,-51.97,4
09:42,821971408.0,522.5391102355434,-292.6,2
09:44,769311479.0,6508.781200167599,-167.27,2
09:47,407574996.0,175.91011806007768,-57.15,1
09:48,844835978.0,9405.436258356558,-29.98,4
09:49,254853117.0,1780.204914446845,-23.98,7
09:51,373163757.0,9951.015129575915,-19.99,1
09:51,749378808.0,3566.484759123314,-60.66,5
09:53,858560423.0,11708.315784057646,-6.99,4
09:53,549414742.0,6610.117814411525,-68.6,7
09:57,108931112.0,13261.307476139536,-10.85,4
10:03,187111705.0,6217.602579135109,-30.2,7
10:03,179173981.0,4276.453825956585,-0.93,7
10:04,601627384.0,3939.867901517498,-34.83,1
10:06,383625050.0,5099.064488057286,-234.5,2
10:10,867987292.0,3559.738067044328,-111.3,2
10:13,423208402.0,882.6107500000026,-5.99,2
10:13,450896297.0,12362.051382418122,-23.9,4
10:17,383625050.0,5015.064488057286,-84.0,2
10:18,769311479.0,6462.5952001676,-46.19,2
10:19,259015404.0,597.4477964948803,-37.5,7
10:19,987229118.0,3593.7495301396607,-28.0,2
10:20,500051919.0,1273.3996966505904,-21.97,7
10:21,821971408.0,501.4131102355434,-21.13,5
10:22,581655972.0,38870.04209881597,-35.95,7
10:22,873693307.0,8678.089185482984,-40.94,2
10:23,675231808.0,15995.731001272812,-64.98,2
10:23,183186021.0,-328.8825499999989,-13.19,5
10:24,279149837.0,986.9110499999986,-49.99,2
10:25,365608668.0,-37.344747975811245,-69.99,2
10:26,456221621.0,356.2366673026281,-133.0,2
10:26,549414742.0,6513.559814411525,-96.56,2
10:26,844835978.0,9344.746258356558,-60.69,5
10:27,668329719.0,7677.0234284816015,-44.02,7
10:27,822135975.0,10332.95553903147,-68.12,2
10:27,489964679.0,19344.17679003018,-32.05,7
10:28,867987292.0,3325.238067044328,-234.5,2
10:30,421881811.0,2211.5929510008496,-22.35,4
10:30,822718326.0,10148.909522634274,-13.01,5
10:32,724537117.0,-1128.5685500000004,-74.55,5
10:32,779376323.0,2555.990575747938,-49.5,4
10:32,846550094.0,926.7647715014136,-20.52,7
10:33,610645022.0,-837.6590626449183,-28.7,5
10:34,719586818.0,16579.75274483817,-75.14,2
10:35,909669130.0,52.347884736766616,-74.05,2
10:35,345582855.0,-208.1154471794507,-13.3,5
10:35,940569402.0,5167.114331209082,-54.53,2
10:36,583579399.0,1062.1986999999992,-117.21,5
10:38,916270283.0,1614.2942499999997,-156.11,5
10:39,134461671.0,5283.768617238033,-55.1,2
10:39,628470485.0,-158.38697009987683,-154.98,6
10:40,350921975.0,-516.7064289261257,-129.71,5
10:40,433917275.0,6842.41397071294,-12.94,4
10:41,435984758.0,3912.835389968406,-45.11,2
10:41,264550521.0,8958.123898859565,-17.1,7
10:41,344219145.0,7217.86941756805,-2.45,4
10:43,426474982.0,-3675.80725,-15.59,5
10:43,786141370.0,-458.9007000000008,-24.99,5
10:43,858989281.0,25729.697923062555,-17.5,2
10:44,548907062.0,-483.4665112317115,-59.98,4
10:44,769319491.0,1319.4494999999993,-29.96,1
10:46,703537476.0,195.38924999999904,-145.11,2
10:47,886837068.0,347.59809999999936,-18.97,4
10:48,824916823.0,8142.707672698153,-10.24,7
10:49,304455868.0,2401.676939477251,-133.7,2
10:49,348325817.0,9559.95426211546,-22.85,8
10:50,769311479.0,6245.6372001676,-216.96,2
10:51,279149837.0,979.9210499999986,-6.99,1
10:51,117273481.0,8837.656364139071,-29.98,4
10:54,388862238.0,1086.7815284731942,-2.91,7
10:55,779946617.0,15601.081317794538,-127.39,5
10:55,346874167.0,-120.55185000000098,-143.66,5
10:56,885259672.0,3106.703606035509,-27.91,5
10:56,304455868.0,2166.490939477251,-235.19,2
10:57,195895574.0,6679.742640557946,-7.67,2
10:57,218795010.0,-1054.8447000000006,-38.86,5
10:59,324224854.0,2779.933411435284,-42.49,2
10:59,370757362.0,651.1715898126758,-22.0,2
10:59,585625048.0,1177.5401832415312,-126.27,5
11:00,858989281.0,25694.697923062555,-35.0,2
11:01,286484726.0,433.4031700631588,-39.98,2
11:01,299871610.0,264.5856530587666,-17.15,5
11:01,576188756.0,-3527.0789999999993,-51.47,5
11:04,475277431.0,950.7581369436192,-26.97,4
11:04,858560423.0,11660.345784057648,-47.97,2
11:04,291580432.0,-441.5646499999997,-51.17,5
11:06,703537476.0,163.34324999999905,-32.05,5
11:07,322720763.0,5423.184230811608,-34.98,7
11:08,117273481.0,8775.686364139072,-61.97,2
11:09,217540156.0,-3408.6473199999946,-40.92,5
11:11,815993333.0,6088.153639061407,-10.03,2
11:11,151968462.0,6221.146755168342,-28.0,2
11:13,277562576.0,552.035318105103,-67.63,5
11:14,604288474.0,2017.4428870732784,-61.42,5
11:14,137822385.0,3457.1216431810476,-54.99,2
11:14,858989281.0,25640.825923062555,-53.87,2
11:15,719586818.0,16426.38974483817,-153.36,5
11:17,574548998.0,-322.4918000000008,-151.48,2
11:17,425964226.0,3483.847650000002,-40.0,5
11:18,255814263.0,3319.7678815504905,-95.0,2
11:19,836110591.0,5996.769853885926,-22.96,7
11:19,364357875.0,6838.04318491798,-40.0,5
11:20,322221939.0,3351.1811555017066,-93.55,5
11:20,492215823.0,950.868573815444,-60.43,4
11:22,298007503.0,790.9551036256333,-10.14,7
11:23,700138124.0,4949.863172909543,-23.08,7
11:23,833499132.0,1920.9081500000011,-114.95,5
11:24,170637730.0,2267.562111825804,-71.89,5
11:25,609939116.0,6821.325987897043,-21.12,7
11:26,478986718.0,-1227.0990000000008,-33.09,5
11:27,769311479.0,6059.4652001676,-186.17,2
11:27,520447032.0,7794.537115497954,-10.79,8
11:27,409971170.0,2447.868079037908,-2.09,4
11:28,229205098.0,6783.582598389648,-12.28,2
11:29,642015139.0,-760.8661625343617,-30.06,5
11:33,310375875.0,2472.37819034852,-114.14,5
11:34,179173981.0,4224.963825956585,-51.49,2
11:34,615144184.0,501.13089912551885,-49.62,5
11:37,388862238.0,1066.791528473194,-19.99,4
11:41,987229118.0,3537.553530139661,-56.2,5
11:42,822135975.0,10327.77267962122,-5.18,7
11:42,113747882.0,11548.995107314213,-45.34,2
11:44,661295096.0,2992.931762857226,-24.97,1
11:44,414454079.0,79.81785000000181,-101.59,2
11:44,604288474.0,2000.7524369636828,-16.69,5
11:45,169006407.0,10984.784575752532,-91.43,2
11:46,298000165.0,24656.19338868054,-47.99,2
11:46,574548998.0,-396.9818000000008,-74.49,2
11:46,679911053.0,2145.249113420142,-125.97,2
11:47,769311479.0,5811.6792001676,-247.79,2
11:50,688712152.0,5990.25201717615,-22.0,2
11:52,549414742.0,6475.101814411525,-38.46,4
11:55,237493332.0,13428.361690403886,-126.14,2
11:56,975345315.0,33039.99196837637,-302.4,2
12:01,858989281.0,25518.325923062555,-122.5,2
12:03,857754342.0,809.9911820993831,-121.97,5
12:03,769311479.0,5618.5212001676,-193.16,2
12:04,574548998.0,-535.9618000000008,-138.98,2
12:07,433917275.0,6838.407259894569,-4.01,4
12:07,517934629.0,1047.9276787084264,-38.97,2
12:09,146909202.0,2250.8606498386107,-41.0,7
12:09,633345190.0,6183.521964823181,-215.6,7
12:10,605711527.0,-427.0204861674164,-131.73,5
12:10,583579399.0,1029.0086999999992,-33.19,9
12:12,706361191.0,15.405998494077998,-18.9,9
12:14,450896297.0,12330.208445107395,-31.84,7
12:15,856461967.0,-337.26364647050747,-30.2,9
12:16,574548998.0,-645.9318000000009,-109.97,2
12:17,124102251.0,3007.5570964062704,-30.76,5
12:18,807098817.0,389.8512499999992,-24.95,9
12:19,409971170.0,2430.478079037908,-17.39,1
12:20,480557476.0,10441.26452180013,-23.07,2
12:22,549414742.0,6438.715814411525,-36.39,7
12:22,532478725.0,4089.187793840304,-38.34,9
12:27,355602925.0,1272.6865451313745,-147.29,5
12:29,534325901.0,6182.1231357973675,-16.35,9
12:29,408057540.0,3934.30707280612,-0.73,8
12:30,131388684.0,20640.261099911117,-20.68,7
12:34,315546581.0,26677.332668560903,-132.36,5
12:36,657528784.0,-160.93309999999929,-69.22,5
12:36,975345315.0,32744.59196837637,-295.4,2
12:36,858989281.0,25502.939923062557,-15.39,2
12:36,854513972.0,1036.8155499999998,-144.64,5
12:38,245690309.0,8737.729180466571,-27.97,5
12:39,873693307.0,8665.139185482984,-12.95,9
12:40,496395938.0,11334.4858348156,-14.99,9
12:42,383625050.0,4734.3644880572865,-280.7,2
12:45,203466392.0,2378.305966077675,-19.2,9
12:45,390747457.0,263.422399999998,-29.53,5
12:45,471897866.0,6992.6592652427635,-20.68,2
12:49,555804115.0,-1382.2385475587032,-23.09,5
12:50,967989787.0,-298.4319673592728,-120.02,5
12:50,581655972.0,38842.63009881597,-27.41,5
12:51,540159353.0,10323.16171124572,-81.97,2
12:52,812692024.0,3291.394857948953,-1.99,4
12:55,975345315.0,32647.291968376372,-97.3,2
12:55,303843160.0,-387.16199999999833,-149.66,5
12:56,736340277.0,8205.672429584502,-22.75,9
13:00,192202372.0,260.7179338887978,-9.99,4
13:01,287480331.0,7126.634133466914,-26.69,7
13:01,858989281.0,25446.953923062556,-55.99,2
13:03,235310449.0,-1579.54881516969,-149.56,5
13:04,187111705.0,6211.90257913511,-5.7,9
13:07,633345190.0,5953.221964823181,-230.3,7
13:07,277562576.0,544.135318105103,-7.9,9
13:07,407574996.0,169.81011806007768,-6.1,9
13:07,340680761.0,-3096.2355999999972,-35.15,5
13:08,113747882.0,11520.005107314211,-28.99,9
13:08,867987292.0,3043.838067044328,-281.4,2
13:09,221356538.0,278.57189999999963,-105.0,2
13:09,364396689.0,-761.87325,-103.61,5
13:09,135937041.0,-1643.7010482684118,-30.14,9
13:10,279149837.0,897.2860499999986,-82.63,5
13:10,585625048.0,1172.2901832415312,-5.25,9
13:10,287480331.0,7104.674133466914,-21.96,9
13:10,749378808.0,3560.784759123314,-5.7,9
13:11,624500124.0,3097.3550836787576,-38.75,2
13:11,829914501.0,-148.03719342902576,-54.56,5
13:11,383625050.0,4623.064488057286,-111.3,2
13:12,535804582.0,-1500.2321500000012,-96.46,5
13:14,656812046.0,313.62975373251885,-108.86,5
13:16,975200042.0,-3042.145199999997,-47.27,5
13:16,833499132.0,1907.928150000001,-12.98,7
13:17,456221621.0,306.2366673026281,-50.0,2
13:18,858989281.0,25380.453923062556,-66.5,2
13:18,383625050.0,4542.564488057286,-80.5,2
13:18,322221939.0,3345.481155501707,-5.7,9
13:19,859603181.0,2601.3946380767484,-144.08,5
13:20,480557476.0,10434.66452180013,-6.6,9
13:20,414805878.0,12261.037592255268,-42.68,9
13:20,843174694.0,-4822.970999999998,-33.26,5
13:21,315078351.0,6969.559375374218,-55.27,7
13:22,720221651.0,-2436.2288665984343,-40.39,5
13:27,587202562.0,30.17279941706863,-92.29,5
13:30,853907490.0,6551.561451027738,-15.94,9
13:31,792845450.0,472.336150000001,-26.48,4
13:33,858989281.0,25366.467923062555,-13.99,2
13:34,867987292.0,2785.538067044328,-258.3,2
13:35,887853850.0,9968.87192582227,-32.55,9
13:36,117308635.0,740.8141457238347,-36.12,2
13:37,421881811.0,2178.5302810008498,-33.06,4
13:38,641764023.0,-1247.2438037720046,-8.47,5
13:41,254853117.0,1758.1849144468447,-22.02,2
13:42,867987292.0,2681.2380670443276,-104.3,2
13:45,383625050.0,4447.560488057286,-95.0,5
13:46,478412511.0,-111.62192980253928,-225.47,5
13:50,304455868.0,2153.4209394772506,-13.07,2
13:52,456221621.0,212.23666730262812,-94.0,2
13:58,858989281.0,25235.595923062556,-130.87,2
13:58,540159353.0,10296.56171124572,-26.6,5
14:01,454129843.0,1326.05889516656,-15.98,2
14:01,126929801.0,1875.175106340476,-71.99,2
14:02,119993184.0,-2059.4669029108627,-29.54,5
14:03,168414279.0,-398.61771572507865,-34.92,5
14:06,867987292.0,2327.038067044328,-354.2,2
14:07,618138606.0,806.7666472714345,-101.98,2
14:08,117273481.0,8538.274364139072,-237.41,5
14:08,456221621.0,13.73666730262812,-198.5,2
14:14,691843653.0,-3056.008399999994,-14.84,5
14:15,867987292.0,2112.1380670443277,-214.9,2
14:16,285428103.0,9132.811491187382,-40.31,5
14:16,821971408.0,317.3131102355434,-184.1,2
14:17,867679563.0,-139.17194629828415,-29.19,5
14:20,221868392.0,4637.412765864989,-17.56,7
14:20,575652395.0,2062.255659672094,-35.12,4
14:26,653640811.0,16051.632154296343,-7.0,1
14:26,143061865.0,6472.230500072906,-16.98,4
14:30,769311479.0,5600.3492001676,-18.17,2
14:34,858989281.0,25199.19592306255,-36.4,2
14:35,683078800.0,1619.080202944871,-127.26,5
14:38,541639148.0,3410.7995011293337,-39.02,2
14:39,867987292.0,2049.8380670443275,-62.3,2
14:42,971010829.0,-49.32494355575476,-63.0,2
14:44,456221621.0,-193.76333269737188,-207.5,2
14:49,858989281.0,25185.209923062554,-13.99,2
14:51,987656636.0,5526.716235940814,-3.07,5
14:55,570269025.0,2738.435800644421,-41.99,2
15:00,143003091.0,21624.986874707098,-26.01,7
15:03,624563756.0,-670.1027712164437,-24.72,5
15:06,441274121.0,10956.890538508478,-1.73,7
15:12,835736339.0,1669.8403620918798,-12.0,4
15:17,331450202.0,6889.730227592108,-14.97,9
15:21,639409800.0,33867.82651906425,-6.05,4
15:22,383625050.0,4225.660488057287,-221.9,2
15:23,858989281.0,25150.209923062554,-35.0,2
15:24,572384506.0,6674.715051056864,-48.88,2
15:25,633345190.0,5737.621964823181,-215.6,2
15:28,456221621.0,-328.2633326973719,-134.5,2
15:29,200080192.0,8658.639105099686,-12.1,1
15:30,196289502.0,14554.462478092031,-51.04,2
15:31,358846516.0,353.3590225272177,-64.97,2
15:31,574548998.0,-809.9118000000009,-163.98,2
15:35,254853117.0,1749.4106520607834,-8.77,2
15:37,166019891.0,7339.068355990761,-46.64,1
15:42,383625050.0,3846.2604880572862,-379.4,2
15:46,844835978.0,9325.77497372076,-18.97,5
15:46,456221621.0,-498.7633326973719,-170.5,2
15:47,897714622.0,8218.469608080026,-10.13,1
15:48,816685391.0,-794.3304037084263,-46.23,5
15:49,143061865.0,6430.552500072906,-41.68,5
15:49,690958123.0,19279.32068310537,-79.88,5
15:52,224112146.0,160.2081999999986,-122.05,5
15:53,466649401.0,30.021311397891424,-172.61,5
15:54,166019891.0,7308.6283559907615,-30.44,2
15:59,858989281.0,25137.62392306255,-12.59,2
16:01,785210466.0,1777.3195569695472,-51.98,2
16:03,475277431.0,912.8081369436192,-37.95,7
16:07,574548998.0,-904.8718000000008,-94.96,2
16:08,916270283.0,1609.3042499999997,-4.99,7
16:10,492215823.0,934.548573815444,-16.32,1
16:11,331450202.0,6879.440396614687,-10.29,2
16:16,633345190.0,5520.621964823181,-217.0,2
16:20,304455868.0,2054.7349394772505,-98.69,2
16:20,873701090.0,431.9088332271073,-62.17,2
16:33,414805878.0,12220.767795901646,-40.27,7
16:36,858989281.0,25060.651923062553,-76.97,2
16:46,511179916.0,6324.974150707447,-73.36,2
16:55,333054026.0,-95.10010597681,-15.04,1
16:58,670102069.0,3274.3267194265736,-34.71,7
17:08,867987292.0,1986.8380670443275,-63.0,2
17:11,233981231.0,2097.102881960624,-128.09,2
17:17,304455868.0,1985.4489394772504,-69.29,2
17:20,867987292.0,1920.3380670443275,-66.5,2
17:23,550832673.0,2192.491134474408,-49.99,4
17:39,280268430.0,4170.26379831937,-159.6,2
17:45,867987292.0,1752.3380670443275,-168.0,2
17:46,233981231.0,2006.130881960624,-90.97,2
17:51,806358207.0,11546.272509428089,-25.75,7
17:53,984783496.0,13017.870270207144,-51.74,6
17:58,866941383.0,1249.607650000006,-29.96,7
18:00,233981231.0,1915.830881960624,-90.3,2
18:01,120634201.0,4282.617675814987,-21.23,9
18:03,280268430.0,4060.36379831937,-109.9,2
18:08,454356905.0,805.3830833540064,-32.83,2
18:13,809499628.0,15903.704150956588,-18.85,9
18:53,738958551.0,8628.775604211749,-17.37,7
18:56,128033695.0,1525.164407212607,-3.81,5
19:05,899742927.0,11732.002279736493,-12.94,7
19:07,559995067.0,3519.0000372578515,-5.95,7
19:12,285873880.0,11274.375084392845,-14.96,8
19:20,601627384.0,3890.245659798639,-49.62,7
19:20,550169791.0,20421.25724104294,-6.99,9
19:24,128033695.0,1479.6944072126073,-45.47,9
19:24,736340277.0,8178.571562927236,-27.1,7
19:28,176922958.0,634.1655471976495,-29.93,9
19:39,706250160.0,11254.81370860242,-25.19,9
19:42,479456865.0,1045.795699583305,-18.23,2
19:52,373875019.0,15355.47001254814,-29.18,9
20:18,134847904.0,3640.892044386296,-30.74,9
20:23,956717493.0,1031.797261023071,-10.95,9
21:06,138351025.0,-1010.8651500000004,-12.98,9
21:20,187541224.0,1010.275762027924,-26.15,7
21:38,587225252.0,4525.149720066005,-30.11,5
00:13,657139925.0,12816.728926353768,-21.24,9
00:17,785749304.0,7747.547239636973,-15.0,9
00:19,886837068.0,304.7080999999994,-42.89,9
00:21,851181128.0,3704.071820697934,-20.48,7
00:25,887156614.0,-1121.4178710407737,-28.44,9
00:27,851181128.0,3677.8318206979343,-26.24,9
00:27,987163717.0,5597.748480000005,-45.09,9
00:28,421881811.0,2170.741535943479,-7.79,2
00:34,851649498.0,9703.385208315916,-15.63,2
00:37,985188462.0,-794.6232112887752,-37.29,9
00:38,699139822.0,1076.3460048312124,-43.46,2
00:39,237493332.0,13361.753735071472,-66.61,7
00:40,970298834.0,2697.4374844446183,-15.52,2
00:40,815385232.0,9329.11746734774,-7.76,7
00:40,213112754.0,6141.776711628294,-6.79,2
00:46,647936800.0,3165.1384662807504,-3.62,2
00:47,987229118.0,3456.2322546918185,-81.32,7
00:48,858989281.0,25056.33401527532,-4.32,7
00:58,802697323.0,14811.968059920391,-3.5,8
01:11,264550521.0,8920.224120366072,-37.9,7
01:15,705848712.0,25066.69745024443,-37.1,2
01:16,822135975.0,10288.855263245909,-38.92,2
01:16,586315521.0,11455.161192800906,-36.02,7
01:21,441274121.0,10949.16583029172,-7.72,2
01:31,912705941.0,17486.813715619297,-35.52,2
01:32,949032480.0,3921.11262685177,-19.88,8
01:33,705848712.0,25055.46745024443,-11.23,9
01:33,113747882.0,11472.659087818802,-47.35,5
01:34,108481285.0,8213.433258150872,-26.73,5
01:37,836110591.0,5961.849853885926,-34.92,9
01:47,887853850.0,9932.29192582227,-36.58,9
01:55,237684254.0,5336.653831158862,-22.84,2
02:01,419550103.0,17462.44899371621,-14.24,5
02:10,221868392.0,4615.422765864989,-21.99,9
02:16,667367404.0,8707.418972044326,-60.95,4
02:23,383625050.0,3812.776922135152,-33.48,2
02:23,704517789.0,16593.646948175214,-0.32,2
02:23,519644021.0,2413.8894273775636,-6.93,8
02:25,315546581.0,26644.345452309015,-32.99,7
02:44,785749304.0,7741.18338408985,-6.36,7
02:50,859603181.0,2594.367771076386,-7.03,8
02:50,842682241.0,4836.089401022272,-14.76,7
02:51,398429109.0,364.056200000001,-40.68,9
02:58,773633520.0,528.1598109385116,-26.28,9
02:58,534204159.0,5740.239888347944,-0.74,7
03:10,534325901.0,6167.860148710339,-14.26,2
03:18,221868392.0,4558.064882615239,-57.36,7
03:19,124102251.0,2968.6611521287487,-38.9,5
03:21,633345190.0,5509.712715804664,-10.91,7
03:24,506618547.0,15275.271640861143,-12.05,5
03:28,187111705.0,6156.586146142602,-55.32,5
03:29,885259672.0,3078.051021318038,-28.65,5
03:33,657139925.0,12769.170922515024,-47.56,8
03:36,930277104.0,9683.127569113009,-45.84,9
03:36,145387690.0,4407.07008415612,-27.14,9
03:38,196289502.0,14553.59894336088,-0.86,2
03:40,541639148.0,3390.652808208806,-20.15,5
03:40,828750680.0,1103.2323452136798,-29.6,9
03:42,256002321.0,5395.219910117658,-26.62,5
03:46,719586818.0,16383.88062110038,-42.51,2
03:47,779236304.0,490.50759547953226,-36.13,9
03:57,853907490.0,6517.146548553689,-34.41,4
03:58,673025413.0,1801.418189990893,-67.19,2
04:01,108563213.0,22650.122169423543,-44.51,2
04:01,668329719.0,7673.2206571120305,-3.8,8
04:02,824916823.0,8135.401947175466,-7.31,2
04:03,324224854.0,2755.307317424031,-24.63,7
04:04,897714622.0,8198.07030729615,-20.4,2
04:07,581655972.0,38756.34407171943,-86.29,5
04:11,752362502.0,8214.494722553425,-11.17,8
04:12,930277104.0,9655.788166007014,-27.34,2
04:15,145387690.0,4355.27023295627,-51.8,5
04:15,984783496.0,13004.670270207143,-13.2,9
04:22,195895574.0,6625.419675773134,-54.32,7
04:22,433917275.0,6836.891595312959,-1.52,4
04:26,992204045.0,5579.381983249249,-10.59,5
04:31,758160963.0,7493.597026705332,-7.81,5
04:33,216285378.0,22605.399384634915,-38.99,9
04:34,718058208.0,1708.8076563128295,-14.31,5
04:36,285220959.0,11092.50691000551,-9.66,2
04:38,874431242.0,7496.160039045995,-9.6,7
04:44,940569402.0,5156.164331209082,-10.95,9
04:45,510101371.0,12292.053843192096,-30.63,9
04:46,873701090.0,423.76801320574987,-8.14,7
04:52,245690309.0,8721.755040100348,-15.97,2
04:55,473820682.0,10548.721051932538,-17.89,2
04:55,973086490.0,9270.679568613965,-16.27,5
04:56,795847804.0,21840.68634362537,-88.12,7
04:57,383833857.0,23398.243798167572,-3.88,7
05:00,613729471.0,8411.224771721127,-38.75,7
05:00,496395938.0,11327.332608094164,-7.15,5
05:04,601627384.0,3850.605659798639,-39.64,9
05:08,370521542.0,24899.62594803942,-27.84,4
05:17,187541224.0,975.185762027924,-35.09,9
05:18,146909202.0,2248.128547660931,-2.73,2
05:26,779946617.0,15557.232830355184,-43.85,5
05:26,887853850.0,9908.626448081444,-23.67,5
05:27,730002588.0,12025.577068719036,-11.51,7
05:28,984783496.0,12970.931365468325,-33.74,2
05:28,482513594.0,5168.846097537978,-46.33,7
05:30,120634201.0,4258.467675814987,-24.15,9
05:33,549414742.0,6407.035814411524,-31.68,9
05:39,475117511.0,7209.545605211004,-26.13,8
05:40,960208650.0,16786.2073134363,-3.18,2
05:41,809499628.0,15890.464150956588,-13.24,9
05:43,417850087.0,15979.594926432985,-16.48,2
05:44,305778936.0,9158.14583425158,-20.84,9
05:45,489964679.0,19309.33679003018,-34.84,9
05:56,873693307.0,8656.982268685406,-8.16,7
05:57,836110591.0,5955.966647955839,-5.88,7
05:58,235881534.0,12367.001728709993,-17.1,2
05:58,687135796.0,25808.208705790115,-20.48,7
05:59,128033695.0,1442.8767134162003,-36.82,2
06:00,678330503.0,2232.2611938803175,-3.59,5
06:05,435984758.0,3890.4183772011825,-22.42,7
06:06,766941757.0,1831.789911511485,-39.48,9
06:06,987656636.0,5487.611260548981,-39.1,7
06:08,558119802.0,31117.2118702566,-8.17,2
06:11,639409800.0,33850.17493805419,-17.65,5
06:12,531186970.0,6248.839464432307,-22.58,5
06:14,749378808.0,3528.574759123314,-32.21,9
06:15,305778936.0,9105.897540144786,-52.25,2
06:15,108931112.0,13228.877476139534,-32.43,9
06:16,651756497.0,11213.25477938437,-20.31,2
06:16,522188082.0,7355.239116648339,-47.4,7
06:18,679662108.0,15116.034462524003,-31.9,9
06:18,183888402.0,17266.864973285396,-26.39,9
06:20,252760664.0,5748.031068867253,-20.74,5
06:20,769311479.0,5594.236487548198,-6.11,4
06:24,609939116.0,6803.503199649386,-17.82,5
06:24,706250160.0,11251.646674190251,-3.17,7
06:27,886921642.0,2866.2615007993872,-0.03,7
06:28,570410059.0,1549.8597467763102,-31.84,9
06:36,905860285.0,7995.6750094387,-56.4,5
06:37,308505160.0,11905.542103067435,-15.6,7
06:38,832564361.0,15190.776516624615,-43.95,8
06:39,197050303.0,-29.780567436504946,-27.24,9
06:41,709608057.0,2420.6281547394983,-38.59,9
06:45,749378808.0,3514.4763195637815,-14.1,2
06:49,679662108.0,15087.864666079986,-28.17,5
06:56,280268430.0,3991.944074732613,-68.42,7
06:58,270374623.0,9312.775357856155,-46.53,7
06:58,547010927.0,21517.633919225143,-33.82,2
07:06,549414742.0,6389.961578877198,-17.07,2
07:12,517934629.0,1039.6276787084264,-8.3,9
07:17,700138124.0,4946.675357613922,-3.19,7
07:19,310375875.0,2449.23819034852,-23.14,9
07:19,822250278.0,6795.320025399327,-5.67,5
07:22,834383043.0,5287.522095132721,-43.3,2
07:22,448004226.0,1460.5567735099764,-31.88,5
07:23,203466392.0,2339.5941521093932,-38.71,5
07:23,550169791.0,20392.793522249365,-28.46,2
07:24,414805878.0,12189.127795901646,-31.64,9
07:27,994214354.0,9011.87496898596,-31.78,9
07:28,170637730.0,2229.295563992294,-38.27,8
07:29,259015404.0,568.1577964948804,-29.29,9
07:29,670102069.0,3236.1767194265735,-38.15,9
07:33,366550080.0,25062.401190399065,-16.9,4
07:34,290818242.0,6436.289082912856,-3.87,4
07:35,559995067.0,3513.276138025154,-5.72,4
07:39,675806859.0,6337.994451888997,-35.7,2
07:40,331450202.0,6868.051798425381,-11.39,7
07:42,532478725.0,4074.911448604098,-14.28,2
07:45,588565416.0,7032.930816938192,-13.44,5
07:52,304455868.0,1968.0023835446384,-17.45,7
07:56,461990622.0,8298.660036849173,-9.84,4
07:57,454129843.0,1320.10889516656,-5.95,9
07:57,940569402.0,5140.959348718858,-15.2,2
07:58,806358207.0,11530.946472159943,-15.33,8
08:00,259015404.0,557.1124421549043,-11.05,7
08:04,500043411.0,12781.237042970995,-10.99,4
08:05,570323670.0,3791.084756941951,-20.02,5
08:11,297823329.0,153.16644999999914,-5.95,9
08:12,678851253.0,3003.2651957850103,-53.96,2
08:13,358846516.0,348.3090225272177,-5.05,9
08:13,683319988.0,6744.562522079931,-2.92,2
08:14,724997545.0,-146.8983080022183,-26.09,5
08:17,322221939.0,3327.841265187066,-17.64,8
08:20,287480331.0,7091.276804240647,-13.4,8
08:23,146909202.0,2243.428547660931,-4.7,9
08:23,339791565.0,-3532.048699999997,-15.07,5
08:23,252701364.0,-3707.138672677915,-12.43,5
08:23,155317149.0,12.04239999999914,-32.86,5
08:24,995615876.0,1400.2820396983884,-30.06,5
08:25,511179916.0,6317.853066802005,-7.12,7
08:25,399144202.0,1322.79262637465,-42.43,5
08:26,262767079.0,-1274.25095,-54.6,5
08:26,280098744.0,-17.284622128334398,-66.3,5
08:26,885259672.0,3070.551021318038,-7.5,9
08:27,454356905.0,795.3343272204759,-10.05,7
08:27,660789920.0,-2429.3333473823727,-21.96,5
08:27,331450202.0,6819.345798425381,-48.71,5
08:29,554792076.0,26432.595574187104,-42.1,5
08:31,474951915.0,-2559.2260952340116,-21.58,5
08:32,191161970.0,-3712.805999999996,-66.49,5
08:33,621652856.0,-52.14303038945992,-146.56,5
08:34,331048953.0,-404.5346320215063,-132.19,5
08:34,722971557.0,-455.1782791569243,-75.28,5
08:34,519935524.0,-173.16265026248098,-36.65,5
08:34,663479159.0,4396.493541827711,-132.36,5
08:35,838415080.0,-3434.766499999999,-45.1,5
08:37,675398089.0,-826.800140774651,-145.81,5
08:37,595800644.0,-1092.2008500000002,-44.87,5
08:39,749371623.0,-2611.4766535173426,-45.11,5
08:39,711045550.0,3144.2993500000034,-95.02,5
08:40,474301748.0,-2167.099005683968,-5.47,5
08:41,308505160.0,11877.234103067436,-28.31,5
08:42,141521177.0,6686.587900000015,-93.18,5
08:42,659415300.0,814.7050402507041,-123.43,5
08:42,764450279.0,19402.580345772934,-56.45,5
08:43,660561861.0,-457.72521256235,-84.31,5
08:43,500843551.0,154.1535499999995,-123.55,5
08:44,473820682.0,10500.799051932538,-47.92,5
08:44,782013626.0,892.9951993116285,-170.88,5
08:45,684284526.0,-3136.8563667457574,-23.52,5
08:45,766692943.0,-2035.27675,-59.52,5
08:46,383833857.0,23303.127798167578,-95.12,5
08:47,683319988.0,6629.419522079931,-115.14,5
08:50,246753533.0,-76.4815000000015,-15.0,5
08:51,229205098.0,6772.882598389649,-10.7,9
08:52,403902116.0,129.3382499999992,-238.94,5
08:53,954263768.0,-362.50620000000026,-27.12,5
08:54,713057426.0,-189.28175000000024,-60.26,5
08:54,491392945.0,4387.995500000007,-27.71,5
08:54,680773155.0,163.7892833310917,-48.61,5
08:55,769311479.0,5455.342487548198,-138.89,5
08:56,936813994.0,799.3784608327882,-125.8,5
08:56,198946608.0,3317.0012258966467,-152.61,5
08:57,452974357.0,-3175.7889499999947,-8.48,5
08:57,695607232.0,-671.05350538944,-134.65,5
08:58,143003091.0,21622.84465800277,-2.14,8
09:00,913127700.0,732.2488380111164,-116.52,5
09:00,696333897.0,138.42244999999895,-37.47,5
09:01,726913482.0,-1259.2522485264765,-94.26,5
09:02,455831435.0,-1856.0371048014945,-49.16,5
09:02,280200287.0,-1380.130453386949,-90.89,5
09:02,131388684.0,20595.881099911116,-44.38,5
09:03,618138606.0,800.8666472714345,-5.9,9
09:05,683078800.0,1613.380202944871,-5.7,9
09:05,690958123.0,19273.02068310537,-6.3,9
09:06,441274121.0,10943.565830291718,-5.6,9
09:06,290818242.0,6353.787082912856,-82.5,5
09:07,506618547.0,15269.771640861143,-5.5,9
09:11,169006407.0,10979.284575752532,-5.5,9
09:12,899742927.0,11729.307432785912,-2.69,8
09:12,473820682.0,10435.670371932538,-65.13,4
09:13,760704118.0,423.3223127174888,-60.73,5
09:14,215311171.0,5972.794724008948,-19.95,5
09:14,399538448.0,6846.787794127587,-43.24,5
09:15,653667523.0,4918.62329015913,-86.88,5
09:16,117273481.0,8532.57436413907,-5.7,9
09:16,552980092.0,-513.9612808806625,-36.94,5
09:17,618514666.0,19711.51808321062,-93.07,5
09:20,398429109.0,327.1062000000011,-36.95,7
09:20,903468956.0,284.55259999999936,-102.7,5
09:21,903953091.0,3131.6870389956644,-119.97,2
09:21,986774156.0,1258.9369316257694,-22.0,2
09:22,417850087.0,15974.544926432984,-5.05,9
09:22,540159353.0,10289.96171124572,-6.6,9
09:25,910730524.0,7547.694687435755,-43.02,1
09:25,467207141.0,251.9791170482637,-103.26,5
09:25,383833857.0,23266.167798167575,-36.96,1
09:25,479456865.0,1029.295699583305,-16.5,4
09:26,865748375.0,3390.8720899914706,-82.06,2
09:26,663479159.0,4384.513541827711,-11.98,7
09:28,653667523.0,4901.643290159131,-16.98,7
09:30,137822385.0,3451.131643181048,-5.99,2
09:31,454356905.0,771.474967220476,-23.86,4
09:31,575652395.0,2008.954024379022,-53.3,8
09:31,370521542.0,24867.82594803942,-31.8,2
09:34,406772240.0,-1256.9810500000003,-69.55,5
09:36,762700245.0,-466.0042999999975,-38.43,5
09:37,639549973.0,5936.344003122313,-59.91,2
09:37,558875206.0,2270.954310898952,-338.65,5
09:38,180616589.0,549.4025281236176,-48.4,5
09:39,355733816.0,4777.830731027458,-17.97,7
09:40,352291960.0,2643.7290533035734,-52.04,2
09:41,399144202.0,1316.57262637465,-6.22,2
09:43,386277162.0,320.0899999999994,-35.98,4
09:43,995615876.0,1237.3120396983884,-162.97,2
09:44,613729471.0,8399.104771721126,-12.12,2
09:45,933491926.0,2897.4603000000025,-42.08,5
09:45,558875206.0,2263.1543108989517,-7.8,9
09:48,955035930.0,1433.823479171477,-1.5,4
09:49,180616589.0,482.43252812361754,-66.97,4
09:49,522188082.0,7311.07911664834,-44.16,1
09:52,430910686.0,-215.8957999999996,-155.02,5
09:52,572384506.0,6642.709917561706,-32.01,7
09:56,792845450.0,462.346150000001,-9.99,2
09:56,901432314.0,3219.4698219653815,-44.35,7
09:58,279149837.0,890.2960499999986,-6.99,1
09:58,399144202.0,1282.0570463746503,-34.52,4
09:58,815993333.0,6054.063639061407,-34.09,1
10:00,108931112.0,13173.038476139534,-55.84,5
10:01,945054126.0,-448.2419,-41.56,5
10:06,570323670.0,3512.484756941951,-278.6,2
10:09,149684419.0,181.27149999999807,-43.85,5
10:11,781554833.0,1746.5232255639664,-149.97,2
10:17,287480331.0,7085.076804240647,-6.2,9
10:17,613427466.0,5801.561956011865,-144.48,5
10:17,901432314.0,3164.6458219653814,-54.82,5
10:19,305778936.0,9091.287540144784,-14.61,7
10:19,456246119.0,19419.437360377193,-13.97,4
10:21,348325817.0,9487.16826211546,-72.79,5
10:21,910730524.0,7533.834231335098,-13.86,8
10:22,117308635.0,610.3141457238347,-130.5,2
10:25,727417797.0,5146.341500000011,-99.99,2
10:30,129018172.0,8334.826896282199,-16.98,1
10:31,187111705.0,6125.2401461426025,-31.35,5
10:32,779236304.0,404.40759547953223,-86.1,2
10:34,305778936.0,9025.487540144786,-65.8,6
10:39,570323670.0,3253.484756941951,-259.0,2
10:39,995615876.0,1183.3220396983884,-53.99,2
10:42,352291960.0,2484.1290533035735,-159.6,2
10:43,550832673.0,2098.3551344744083,-94.14,5
10:43,587225252.0,4461.716053166946,-63.43,2
10:45,117308635.0,541.0981457238347,-69.22,5
10:46,738958551.0,8546.445853549963,-82.33,5
10:46,766812921.0,-453.9205500000006,-154.33,5
10:47,779236304.0,348.40759547953223,-56.0,2
10:47,718058208.0,1625.7316563128295,-83.08,5
10:48,385685918.0,179.6499408415523,-29.99,2
10:52,538003940.0,1143.6000000000083,-25.96,7
10:59,352291960.0,2319.6290533035735,-164.5,2
11:09,653667523.0,4847.75729015913,-53.89,2
11:10,570269025.0,2620.835800644421,-117.6,2
11:13,475117511.0,7186.065605211004,-23.48,4
11:14,553734946.0,441.49479999999846,-34.95,7
11:17,170233640.0,-101.05916005010272,-9.97,4
11:18,779236304.0,36.207595479532245,-312.2,2
11:19,399144202.0,1259.2270463746504,-22.83,7
11:20,364357875.0,6828.128102987966,-9.92,7
11:25,653667523.0,4708.47129015913,-139.29,2
11:25,352291960.0,2174.0290533035736,-145.6,2
11:26,441142605.0,2023.0726888780312,-5.5,4
11:28,819515373.0,1494.9132860637917,-35.0,2
11:34,386277162.0,286.1399999999994,-33.95,7
11:35,886921642.0,2780.861500799387,-85.4,2
11:38,653667523.0,4520.87129015913,-187.6,2
11:38,984783496.0,12946.091365468325,-24.84,4
11:56,480198977.0,12370.911720897706,-223.27,2
11:57,647472692.0,23560.56987745408,-146.22,5
11:57,534204159.0,5638.939888347943,-101.3,4
11:58,556992209.0,10964.22592883665,-16.52,4
12:09,564744955.0,102.74185858884184,-125.3,2
12:12,364357875.0,6790.728102987966,-37.4,9
12:14,555804115.0,-1401.1385475587033,-18.9,9
12:22,385685918.0,-110.85005915844768,-290.5,2
12:22,352291960.0,1968.9290533035737,-205.1,2
12:23,402438092.0,473.0726999999988,-71.97,2
12:26,661295096.0,2939.9765133217475,-52.96,5
12:27,604288474.0,1969.908790384384,-30.84,5
12:31,973086490.0,9254.479568613962,-16.2,9
12:35,653667523.0,4356.39929015913,-164.47,2
12:41,537487133.0,-656.4816500000005,-26.14,9
12:42,256002321.0,5372.919910117658,-22.3,9
12:43,588565416.0,6911.424816938192,-121.51,5
12:43,987390838.0,-2952.5762412103786,-46.55,5
12:44,643610517.0,-2974.046190729657,-37.55,5
12:44,198946608.0,3284.2000099059915,-10.76,4
12:45,385685918.0,-407.6500591584477,-296.8,2
12:48,551755686.0,6213.26321289771,-127.11,5
12:52,228136274.0,1439.6604999999993,-122.97,5
12:54,909669130.0,31.207884736766616,-21.14,9
12:55,799861885.0,-150.16445000000118,-114.39,5
12:55,136770968.0,-488.1422500000005,-116.97,5
12:56,245198540.0,-238.36860119822052,-39.55,5
12:56,856461967.0,-421.41064647050746,-84.15,5
12:58,352291960.0,1863.9290533035737,-105.0,2
13:02,538003940.0,1127.1000000000083,-16.5,4
13:03,910730524.0,7528.684231335098,-5.15,9
13:03,564744955.0,40.44185858884185,-62.3,2
13:05,189757473.0,-2160.2336499999997,-11.83,5
13:07,344522228.0,-2860.786988208393,-24.27,5
13:09,688712152.0,5984.1520171761495,-6.1,9
13:14,656389634.0,-3017.729340421986,-30.58,5
13:16,916225911.0,-2233.136750000001,-53.21,5
13:20,119943495.0,-1588.5800621128578,-66.95,5
13:22,570323670.0,3025.984756941951,-227.5,2
13:25,352291960.0,1730.9290533035737,-133.0,2
13:25,909676212.0,308.3014045320274,-97.98,2
13:30,760753808.0,-430.5546500000005,-83.91,5
13:30,570323670.0,2857.984756941951,-168.0,2
13:31,766941757.0,1788.5899115114848,-43.2,2
13:31,146686559.0,-709.5446111734778,-50.61,5
13:31,868014990.0,-3352.6310999999964,-43.6,5
13:41,252760664.0,5692.969068867254,-55.06,5
13:46,941285623.0,1293.7763990667702,-24.97,7
13:48,933491926.0,2893.9703000000027,-3.49,4
13:51,653667523.0,4259.12729015913,-97.27,2
13:56,901432314.0,3144.140789922898,-20.51,7
13:57,520447032.0,7756.940180105305,-37.6,2
14:03,549414742.0,6243.570578877198,-146.39,5
14:03,564744955.0,-161.15814141115814,-201.6,2
14:08,285115279.0,-3144.2131607892875,-121.77,5
14:17,873701090.0,330.8010132057499,-92.97,5
14:20,779236304.0,-162.59240452046774,-198.8,2
14:32,310620484.0,-89.72280490780167,-12.06,7
14:39,480557476.0,10418.687368559666,-15.98,2
14:41,834383043.0,5271.552095132721,-15.97,7
14:41,494789005.0,2662.8800361258836,-40.3,2
14:44,822250278.0,6774.328025399327,-20.99,4
14:44,818552503.0,-183.5330000000011,-188.35,5
14:48,684988568.0,-702.4116234272014,-38.44,5
14:49,941285623.0,1273.7863990667702,-19.99,4
14:52,938992364.0,209.8796437313995,-55.17,5
14:56,564744955.0,-259.1581414111581,-98.0,2
14:57,480198977.0,12181.239720897704,-189.67,2
14:57,352291960.0,1606.3290533035738,-124.6,2
14:58,527842638.0,-202.9794073670164,-3.49,4
15:09,298000165.0,24585.00338868054,-71.19,5
15:15,385685918.0,-521.7500591584477,-114.1,2
15:21,653667523.0,4152.05529015913,-107.07,2
15:25,480198977.0,11915.267720897706,-265.97,2
15:27,564744955.0,-478.95814141115807,-219.8,2
15:28,352291960.0,1425.729053303574,-180.6,2
15:34,653667523.0,4007.88329015913,-144.17,2
15:34,924045955.0,1238.7555126586644,-50.04,2
15:39,744968736.0,-1654.396826569424,-28.82,5
15:42,939972497.0,-216.7180413999893,-108.41,5
15:45,385685918.0,-745.0500591584477,-223.3,2
15:46,564744955.0,-597.258141411158,-118.3,2
15:49,779236304.0,-298.3924045204677,-135.8,2
15:53,653667523.0,3862.28329015913,-145.6,2
15:55,779376323.0,2523.8118718223127,-32.18,5
15:57,461029994.0,6845.075411866107,-12.22,2
15:58,596171893.0,-62.67440517448891,-21.49,5
15:59,409971170.0,2379.5294614476043,-50.95,7
16:01,385685918.0,-801.0500591584477,-56.0,2
16:02,352291960.0,1380.229053303574,-45.5,2
16:05,779236304.0,-374.69240452046773,-76.3,2
16:08,625281433.0,-938.5447573707568,-80.72,5
16:10,819515373.0,1479.9232860637917,-14.99,4
16:17,930277104.0,9603.428166007014,-52.36,2
16:20,395284483.0,369.3453402113085,-100.55,5
16:20,779236304.0,-724.6924045204678,-350.0,2
16:21,352291960.0,1334.729053303574,-45.5,2
16:23,388862238.0,964.801528473194,-101.99,2
16:25,370757362.0,614.2215898126758,-36.95,7
16:25,329840194.0,118.80789014314796,-71.69,5
16:33,170233640.0,-171.04376005010272,-69.98,5
16:36,480198977.0,11776.681720897706,-138.59,2
16:39,345582855.0,-251.71284717945073,-43.6,5
16:40,605116158.0,2020.105900000002,-31.6,5
16:42,296972867.0,-962.4999000000008,-30.98,5
16:45,352291960.0,1160.429053303574,-174.3,2
17:00,310375875.0,2446.8402085332123,-2.4,7
17:06,407574996.0,168.77095959777992,-1.04,2
17:07,738958551.0,8482.645853549964,-63.8,2
17:08,480198977.0,11644.395720897706,-132.29,2
17:11,518474507.0,12353.30913077945,-25.69,9
17:13,581618317.0,-4874.054201873206,-29.14,5
17:18,352291960.0,1003.629053303574,-156.8,2
17:21,287230540.0,942.1773432932662,-4.99,1
17:22,113747882.0,11451.2190878188,-21.44,9
17:24,558119802.0,31081.1918702566,-36.02,9
17:24,604334058.0,362.7964999999994,-142.02,5
17:25,834581602.0,342.873049999999,-5.99,4
17:27,491392945.0,4365.995500000007,-22.0,2
17:28,385685918.0,-916.5500591584477,-115.5,2
17:29,633345190.0,5470.882715804664,-38.83,9
17:30,480198977.0,11462.437720897706,-181.96,2
17:31,348325817.0,9464.736428475377,-22.43,7
17:34,373875019.0,15353.889515006582,-1.58,2
17:37,858989281.0,25041.39401527532,-14.94,9
17:37,358846516.0,285.3090225272177,-63.0,2
17:40,858560423.0,11573.365784057649,-86.98,2
17:43,471897866.0,6973.429265242764,-19.23,2
17:44,802697323.0,14665.91305992039,-146.05,5
17:44,653667523.0,3692.19729015913,-170.09,2
17:45,151968462.0,6169.074735168342,-52.07,4
17:45,361201224.0,2698.565322316144,-5.01,7
17:45,713910252.0,-429.1938742714588,-149.23,5
17:45,315078351.0,6933.229375374218,-36.33,2
17:46,683078800.0,1563.130202944871,-50.25,2
17:46,482513594.0,5152.416097537977,-16.43,2
17:46,296770890.0,1858.472010379083,-47.59,2
17:50,741903302.0,1926.7240650141248,-72.99,2
17:50,314980178.0,2727.748850000006,-42.98,2
17:53,517190750.0,1401.2135899154127,-140.11,2
17:54,255814263.0,3226.8607315504905,-92.91,5
17:54,596463612.0,-1007.5101047251388,-25.17,5
17:55,534325901.0,6104.966068710339,-62.89,4
17:55,124102251.0,2955.6611521287487,-13.0,2
17:56,409971170.0,2290.5944614476043,-88.94,5
17:57,316793091.0,382.04036005495095,-97.0,2
17:57,653640811.0,16045.632154296343,-6.0,2
17:58,245690309.0,8701.120080100349,-20.63,4
17:58,385685918.0,-1157.3500591584475,-240.8,2
18:00,779236304.0,-922.7924045204678,-198.1,2
18:00,480198977.0,11286.751720897706,-175.69,2
18:02,383625050.0,3792.836922135152,-19.94,9
18:03,653667523.0,3506.71129015913,-185.49,2
18:04,163470640.0,704.5150999999997,-72.67,5
18:06,425964226.0,3282.247650000002,-201.6,2
18:09,471897866.0,6918.073265242764,-55.36,5
18:09,683078800.0,1458.880202944871,-104.25,2
18:09,429556122.0,5574.748478442135,-31.95,9
18:10,570323670.0,2793.7667569419514,-64.22,5
18:11,385685918.0,-1518.5500591584478,-361.2,2
18:15,752362502.0,8005.894722553425,-208.6,2
18:16,480198977.0,10971.779720897706,-314.97,2
18:16,106601471.0,9915.62197211811,-3.16,7
18:18,316793091.0,255.54036005495095,-126.5,2
18:18,138609932.0,3112.5290032945854,-15.92,7
18:18,296770890.0,1567.272010379083,-291.2,2
18:20,624500124.0,3033.4730836787576,-63.88,5
18:21,679943657.0,767.0315258664518,-35.43,9
18:24,517190750.0,1322.4785899154128,-78.73,2
18:28,108563213.0,22550.498169423543,-99.62,5
18:32,605116158.0,2009.105900000002,-11.0,7
18:37,832564361.0,15175.836516624617,-14.94,9
18:39,450896297.0,12328.410934729143,-1.8,7
18:40,806358207.0,11524.756472159945,-6.19,7
18:43,213112754.0,6120.546711628294,-21.23,9
18:45,450896297.0,12296.120934729142,-32.29,9
18:46,321372947.0,-533.8240507890994,-20.96,5
18:46,160166876.0,864.9400405862436,-31.45,9
18:47,604870380.0,-1866.654052900553,-23.14,5
18:48,471897866.0,6898.963047871552,-19.11,7
18:49,752362502.0,7970.894722553425,-35.0,2
18:49,585133606.0,4401.9144181394695,-201.54,5
18:51,264208990.0,166.40944999999877,-121.2,5
18:51,117273481.0,8500.539809844897,-32.03,2
18:54,392270893.0,12312.128845481602,-63.13,5
18:55,867987292.0,1693.7298393965075,-58.61,5
19:01,752362502.0,7904.394722553425,-66.5,2
19:01,986267641.0,6971.864038062814,-82.47,5
19:06,282102606.0,-225.14348757717363,-28.11,5
19:06,822718326.0,10091.145522634277,-57.76,5
19:06,593191200.0,-288.31035000000094,-31.88,5
19:09,455052690.0,-425.51626005137234,-129.67,5
19:14,517190750.0,1297.5185899154128,-24.96,5
19:14,965038148.0,-699.0725143676723,-42.65,5
19:14,993039226.0,-4230.3344999999945,-52.59,5
19:14,504055745.0,-429.5852386582331,-36.68,5
19:15,868033067.0,-2382.410786451082,-60.4,5
19:15,630468201.0,-783.8793338897017,-49.22,5
19:19,518466565.0,357.8175999999995,-153.26,5
19:21,122884111.0,-2444.1285830729694,-14.31,5
19:24,203466392.0,2244.814152109393,-94.78,5
19:27,138351025.0,-1060.2813000000003,-49.42,5
19:29,752362502.0,7780.494722553425,-123.9,2
19:32,924045955.0,1218.3855126586643,-20.37,5
19:33,659008214.0,-3340.5551022904233,-46.97,5
19:35,229205098.0,6739.568083083444,-33.31,2
19:35,675231808.0,15990.692167590714,-5.04,2
19:38,824916823.0,8109.011947175466,-26.39,9
19:41,423208402.0,800.3369500000025,-82.27,5
19:42,993663752.0,-18.242257589603483,-74.99,5
19:44,842682241.0,4692.932401022272,-143.16,5
19:46,310620484.0,-175.73880490780166,-86.02,5
19:49,892354433.0,-1288.5899606343387,-63.13,5
19:51,880546403.0,-1561.4245000000017,-111.62,5
19:55,403765849.0,-2424.960499999998,-40.77,5
20:00,151968462.0,6100.946355185164,-68.13,2
20:06,496395938.0,11258.942608094165,-68.39,5
20:07,213930646.0,-1675.0045634725632,-118.8,5
20:08,783650950.0,-1185.5776434110116,-149.79,5
20:08,414805878.0,12187.843574253382,-1.28,5
20:11,951817450.0,8412.137912420309,-97.82,5
20:13,788740658.0,1507.3353940894704,-146.85,5
20:15,235663459.0,-39.43857018798481,-23.54,5
20:21,169006407.0,10908.846731226764,-70.44,8
20:22,242218612.0,284.14630000000056,-49.81,5
20:23,796709231.0,-641.3680221037025,-151.88,5
20:29,454129843.0,1223.47109516656,-96.64,5
20:34,815385232.0,9270.20546734774,-58.91,5
20:39,435984758.0,3815.8403772011825,-74.58,5
20:43,912584712.0,148.92861954473318,-169.6,5
20:46,547010927.0,21480.453919225143,-37.18,9
20:50,626989363.0,200.8210633173752,-155.09,5
20:50,433917275.0,6809.441595312959,-27.45,9
20:54,624500124.0,3015.5730836787575,-17.9,9
20:54,698955014.0,267.01476695166673,-93.07,5
20:55,137913631.0,-480.98780000000033,-148.65,5
00:23,305778936.0,9002.687540144787,-22.8,9
00:55,613729471.0,8372.595465710088,-26.51,5
01:09,984783496.0,12929.861365468323,-16.23,9
01:52,480557476.0,10402.113305822664,-16.57,2
02:01,399144202.0,1226.8681037292183,-32.36,5
02:20,899742927.0,11714.845270162195,-14.46,7
02:28,259015404.0,524.5224421549043,-32.59,9
02:31,169006407.0,10875.456373828934,-33.39,7
02:31,216285378.0,22568.409384634913,-36.99,9
02:31,749378808.0,3487.2563195637817,-27.22,9
02:32,287480331.0,7052.6768042406475,-32.4,9
02:37,305778936.0,8994.104360772404,-8.58,7
02:42,221868392.0,4534.174882615239,-23.89,9
02:47,822135975.0,10282.585143344537,-6.27,2
02:49,510101371.0,12259.223843192096,-32.83,9
02:56,270374623.0,9264.392659811036,-48.38,7
02:59,259015404.0,521.8273476636423,-2.7,5
03:01,815385232.0,9242.747738681532,-27.46,2
03:01,237493332.0,13351.803735071471,-9.95,9
03:01,865748375.0,3390.3989851494457,-0.47,2
03:10,984783496.0,12900.303043203834,-29.56,7
03:13,285220959.0,11082.68173468356,-9.83,4
03:14,585625048.0,1147.3226823533744,-24.97,5
03:14,322221939.0,3282.598620033052,-45.24,2
03:16,213112754.0,6110.12481123696,-10.42,5
03:16,383833857.0,23253.917798167575,-12.25,9
03:25,187541224.0,937.315762027924,-37.87,9
03:27,348325817.0,9421.096428475375,-43.64,9
03:33,237493332.0,13324.77632277274,-27.03,2
03:37,749378808.0,3405.509219725473,-81.75,2
03:42,407574996.0,167.77433119583284,-1.0,2
03:45,221868392.0,4521.119455228289,-13.06,7
03:46,183888402.0,17233.644973285394,-33.22,9
03:47,836110591.0,5922.0666479558395,-33.9,9
03:49,985188462.0,-838.4632112887753,-43.84,9
03:50,758885184.0,635.9371822743447,-18.94,9
03:51,282837512.0,12806.543661709677,-34.94,9
03:51,986267641.0,6955.432345578322,-16.43,7
03:55,858989281.0,25024.94401527532,-16.45,9
03:59,601627384.0,3818.675659798639,-31.93,9
04:02,639409800.0,33828.14307361528,-22.03,7
04:02,842682241.0,4687.325045345994,-5.61,7
04:02,252760664.0,5683.476451189044,-9.49,2
04:04,769311479.0,5403.419554666433,-51.92,7
04:05,264550521.0,8915.303344164677,-4.92,2
04:07,832564361.0,15170.733892048716,-5.1,7
04:08,534325901.0,6039.053621686867,-65.91,8
04:09,719586818.0,16380.485248754663,-3.4,7
04:12,853907490.0,6466.549045225687,-50.6,7
04:16,532478725.0,4048.1714486040983,-26.74,9
04:22,940569402.0,5122.059348718858,-18.9,9
04:23,500043411.0,12776.623144583247,-4.61,7
04:24,709608057.0,2381.0281547394984,-39.6,9
04:31,120634201.0,4236.677675814987,-21.79,9
04:35,795847804.0,21807.238506218146,-33.45,4
04:36,700138124.0,4933.335357613922,-13.34,9
04:38,973086490.0,9207.752823139004,-46.73,2
04:38,675806859.0,6326.301081168359,-11.69,5
04:39,414454079.0,54.237850000001814,-25.58,9
04:41,683319988.0,6627.725483831423,-1.69,7
04:42,651756497.0,11213.068334471243,-0.19,7
04:43,679662108.0,15080.94495272978,-6.92,7
04:46,802697323.0,14631.37305992039,-34.54,9
04:47,824916823.0,8081.131947175466,-27.88,9
04:47,237684254.0,5291.084393692646,-45.57,2
04:48,358836279.0,89.00569280758586,-25.74,9
04:48,930277104.0,9574.378166007014,-29.05,9
04:49,113747882.0,11421.2790878188,-29.94,9
04:50,235881534.0,12355.73929282958,-11.26,7
04:57,806358207.0,11478.35313694394,-46.4,2
05:02,687135796.0,25798.258705790115,-9.95,9
05:07,657139925.0,12752.630922515023,-16.54,9
05:09,287480331.0,7046.084066886004,-6.59,2
05:10,124102251.0,2948.5707918599646,-7.09,5
05:10,519644021.0,2394.153425212282,-19.74,7
05:10,858989281.0,24969.94615236642,-55.0,8
05:15,992204045.0,5568.001953812149,-11.38,2
05:18,510101371.0,12249.93898107361,-9.28,5
05:18,824916823.0,8072.637864463942,-8.49,8
05:19,930277104.0,9570.128864901206,-4.25,8
05:25,809499628.0,15873.014150956587,-17.45,9
05:28,836110591.0,5882.086327623504,-39.98,2
05:28,200080192.0,8603.392708857646,-55.25,7
05:28,738958551.0,8444.344266846883,-38.3,7
05:29,417850087.0,15953.758663364184,-20.79,7
05:32,308505160.0,11858.74860746939,-18.49,2
05:35,414805878.0,12145.253574253382,-42.59,9
05:37,822250278.0,6754.66854609585,-19.66,2
05:38,709608057.0,2370.569460014566,-10.46,7
05:39,321372947.0,-541.3240507890994,-7.5,9
05:42,527842638.0,-235.9194073670164,-32.94,9
05:42,547010927.0,21460.703919225143,-19.75,9
05:43,492215823.0,908.818573815444,-25.73,9
05:46,766941757.0,1761.5599115114849,-27.03,9
05:47,609939116.0,6802.210320177492,-1.29,7
05:48,496395938.0,11218.133032449512,-40.81,5
05:48,623156843.0,3799.4162116919847,-53.26,2
05:50,550169791.0,20380.227293893626,-12.57,5
05:50,994214354.0,8978.514058052631,-33.36,5
05:51,779236304.0,-953.0224045204678,-30.23,9
05:56,874431242.0,7476.340040529075,-19.82,8
05:57,912705941.0,17476.722395402627,-10.09,7
06:03,187111705.0,6123.751621391567,-1.49,2
06:07,704517789.0,16573.17851675582,-20.47,5
06:10,873701090.0,318.7938100569393,-12.01,7
06:12,383625050.0,3742.209280869338,-50.63,5
06:15,518474507.0,12314.25913077945,-39.05,9
06:16,405416860.0,1834.5033568809035,-22.8,2
06:19,482513594.0,5118.007608104966,-34.41,5
06:19,940569402.0,5116.767299233838,-5.29,5
06:21,506618547.0,15229.4137352734,-40.36,4
06:22,145387690.0,4333.07023295627,-22.2,9
06:23,776431321.0,3140.867258708011,-47.23,7
06:26,752362502.0,7777.902858393545,-2.59,8
06:27,370521542.0,24865.614536358826,-2.21,4
06:28,698955014.0,240.87476695166671,-26.14,9
06:29,885259672.0,3026.698169798632,-43.85,5
06:31,785749304.0,7705.475180177959,-35.71,2
06:31,670102069.0,3197.0067194265735,-39.17,9
06:32,549414742.0,6218.890578877198,-24.68,9
06:33,887853850.0,9882.486448081445,-26.14,9
06:34,128033695.0,1378.4038940535263,-64.47,7
06:35,229205098.0,6718.808067286718,-20.76,2
06:36,146909202.0,2221.0194479283564,-22.41,2
06:38,873693307.0,8645.032268685405,-11.95,9
06:44,419550103.0,17443.83305917318,-18.62,7
06:45,586315521.0,11422.902218812987,-32.26,5
06:46,151968462.0,6094.130576474903,-6.82,7
06:50,687135796.0,25764.689898610683,-33.57,5
06:52,905860285.0,7994.59544831668,-1.08,5
06:52,575652395.0,2002.7102964764215,-6.24,7
06:53,718058208.0,1588.2399937547502,-37.49,2
06:54,383833857.0,23231.330117498997,-22.59,7
06:55,203466392.0,2223.591157058176,-21.22,2
06:57,433917275.0,6773.101595312959,-36.34,9
06:57,572384506.0,6593.579917561706,-49.13,9
07:03,108563213.0,22517.9613952899,-32.54,2
07:09,678851253.0,2972.59178679251,-30.67,5
07:09,987163717.0,5558.618480000005,-39.13,9
07:16,143003091.0,21597.384256784782,-25.46,7
07:18,897714622.0,8143.98699951827,-54.08,5
07:22,256002321.0,5363.251924444224,-9.67,8
07:24,779946617.0,15520.417346802857,-36.82,5
07:27,639549973.0,5932.230818763937,-4.11,7
07:33,705848712.0,25038.27745024443,-17.19,9
07:37,668329719.0,7624.397437559442,-48.82,5
07:39,534204159.0,5580.445163635521,-58.49,7
07:40,106601471.0,9890.807367093264,-24.81,8
07:41,310375875.0,2390.424631927897,-56.42,5
07:43,730002588.0,12015.608953955629,-9.97,7
07:44,581655972.0,38739.87855968993,-16.47,5
07:48,113747882.0,11381.569995770287,-39.71,7
07:49,355733816.0,4766.4592723143,-11.37,2
07:51,633345190.0,5450.002715804664,-20.88,9
07:51,670102069.0,3140.493314617758,-56.51,7
07:54,647936800.0,3154.252936910399,-10.89,7
07:57,885259672.0,3021.698169798632,-5.0,9
07:58,304455868.0,1961.6040156607128,-6.4,2
07:58,511179916.0,6300.298347534496,-17.55,2
08:03,196289502.0,14536.45894336088,-17.14,9
08:04,960208650.0,16779.880447648124,-6.33,7
08:07,587225252.0,4431.786053166946,-29.93,9
08:08,873693307.0,8644.169063986454,-0.86,5
08:11,170637730.0,2210.2644019895456,-19.03,8
08:12,290818242.0,6323.702730096464,-30.08,7
08:15,145387690.0,4329.753681668899,-3.32,7
08:16,147341222.0,-1800.6495753207955,-32.46,5
08:21,788740658.0,1490.610278753294,-16.73,2
08:21,454129843.0,1216.32109516656,-7.15,9
08:23,158766229.0,-806.1130358934699,-8.98,5
08:25,461990622.0,8282.32070558316,-16.34,8
08:27,246753533.0,-93.74490000000152,-17.26,5
08:27,856147482.0,-998.1598485986248,-101.88,5
08:28,435984758.0,3811.086738641473,-4.75,7
08:28,534908754.0,-967.8305000000004,-28.93,5
08:29,215832575.0,-1564.4469637442196,-39.11,5
08:29,987656636.0,5476.136774146818,-11.47,7
08:31,250895529.0,230.5696324692883,-75.97,5
08:31,699997811.0,51.8402500000036,-47.02,5
08:32,899983008.0,-3075.006149999997,-25.86,5
08:32,913801979.0,94.92977991449388,-54.98,5
08:33,317161035.0,-3550.3200999999967,-40.98,5
08:35,324224854.0,2752.917352220587,-2.39,5
08:35,817294757.0,-2660.9583,-22.85,5
08:35,478986718.0,-1252.475400000001,-25.38,5
08:36,666952234.0,-491.9852018755131,-78.36,5
08:38,699139822.0,1054.225403293838,-22.12,8
08:38,287230540.0,876.3622932932661,-65.82,5
08:40,673025413.0,1784.7917280383597,-16.63,7
08:40,682194230.0,-2317.000849999999,-39.16,5
08:41,518378868.0,-1573.8549000000005,-119.16,5
08:41,117308635.0,529.9996953227452,-11.1,2
08:42,737547541.0,-291.13140043222575,-120.39,5
08:47,134461671.0,5274.612920746758,-9.16,5
08:47,518474507.0,12307.07803052298,-7.18,2
08:47,194023154.0,-2477.877171784734,-23.89,5
08:48,775790822.0,-3122.155919216068,-49.08,5
08:54,473820682.0,10402.025922041674,-33.64,2
08:57,426466211.0,-3239.6057499999997,-17.97,5
08:58,520447032.0,7718.845623968504,-38.09,7
09:01,425964226.0,3276.247650000002,-6.0,9
09:02,564214408.0,-228.7061152742739,-15.28,5
09:05,586315521.0,11417.752218812988,-5.15,9
09:08,558875206.0,2256.2543108989516,-6.9,9
09:08,169006407.0,10870.456373828934,-5.0,9
09:09,761272540.0,-194.2601000000012,-140.11,5
09:09,667367404.0,8702.418972044326,-5.0,9
09:12,290818242.0,6315.802730096464,-7.9,9
09:15,655368335.0,4348.182569247764,-6.93,5
09:15,637649383.0,326.6384499999982,-41.48,5
09:17,554792076.0,26398.825355296736,-33.77,5
09:17,853907490.0,6363.669045225687,-102.88,2
09:17,403383649.0,1552.2048048612508,-28.99,1
09:18,189335192.0,-1272.3190017578604,-108.93,5
09:19,298000165.0,24563.02338868054,-21.98,4
09:21,117273481.0,8493.439809844896,-7.1,9
09:22,572136270.0,-500.6479884119768,-89.96,5
09:22,540159353.0,10284.66171124572,-5.3,9
09:23,131388684.0,20590.581099911116,-5.3,9
09:23,943329213.0,1374.4011187748356,-33.09,7
09:24,550169791.0,20221.32729389362,-158.9,7
09:24,417850087.0,15948.058663364183,-5.7,9
09:25,781554833.0,1490.5232255639664,-256.0,2
09:26,425730826.0,1372.2994093887198,-28.0,2
09:26,544961962.0,-32.90567699439089,-35.0,2
09:28,497772347.0,633.1521499999978,-14.99,4
09:31,279149837.0,884.3060499999985,-5.99,1
09:32,128033695.0,1310.6238940535263,-67.78,2
09:33,823208989.0,1509.0547138695313,-347.2,2
09:37,553734946.0,331.99479999999846,-109.5,2
09:37,143003091.0,21547.404256784783,-49.98,4
09:38,215426302.0,-869.9675959743081,-70.63,5
09:39,766941757.0,1738.3699115114848,-23.19,2
09:43,930277104.0,9508.468864901206,-61.66,2
09:44,781554833.0,1306.5232255639664,-184.0,2
09:44,461029994.0,6763.085411866107,-81.99,2
09:45,762896656.0,-224.8850018481413,-92.06,2
09:47,448004226.0,1458.5667735099764,-1.99,4
09:51,175452235.0,723.5672500000002,-105.0,2
09:54,519644021.0,2374.083425212282,-20.07,2
09:55,553734946.0,242.4947999999985,-89.5,2
09:57,857455726.0,-1227.0383141243158,-247.92,5
09:57,550169791.0,19879.727293893626,-341.6,4
10:02,454356905.0,735.0879146877163,-36.39,7
10:02,461029994.0,6746.5954118661075,-16.49,4
10:05,823208989.0,1250.0547138695313,-259.0,2
10:12,986774156.0,1224.986931625769,-33.95,7
10:12,781554833.0,1079.0232255639664,-227.5,2
10:13,663479159.0,4363.543541827711,-20.97,7
10:14,659415300.0,809.0550402507041,-5.65,9
10:15,984783496.0,12898.698793203834,-1.6,4
10:18,175452235.0,570.2672500000002,-153.3,2
10:22,548907062.0,-508.4665112317115,-25.0,2
10:22,179173981.0,4189.449425956585,-35.51,4
10:25,556992209.0,10926.037135579014,-38.19,2
10:26,256002321.0,5357.0319244442235,-6.22,2
10:26,553734946.0,145.49479999999846,-97.0,2
10:36,421881811.0,2163.347607259805,-7.39,8
10:37,596171893.0,-75.65440517448891,-12.98,7
10:39,522188082.0,7285.787497841662,-25.29,7
10:42,718058208.0,1543.2199937547502,-45.02,2
10:43,340321732.0,1218.4970000000033,-34.99,2
10:46,549414742.0,6187.4660776109695,-31.42,5
10:48,910730524.0,7506.665442850794,-22.02,5
10:51,970298834.0,2664.86802299727,-32.57,8
10:52,175452235.0,528.2672500000002,-42.0,2
10:57,901432314.0,3138.046429922898,-6.09,4
10:58,522188082.0,7273.687297841662,-12.1,4
11:11,198946608.0,3257.681869295679,-26.52,2
11:19,233981231.0,1899.850881960624,-15.98,4
11:21,386277162.0,193.1799999999994,-92.96,2
11:27,120634201.0,4219.1076758149875,-17.57,4
11:32,366550080.0,25056.335289369126,-6.07,2
11:40,441142605.0,2011.1026888780311,-11.97,4
11:42,175452235.0,395.96725000000026,-132.3,2
11:52,386277162.0,33.17999999999941,-160.0,2
12:10,256002321.0,5345.7419244442235,-11.29,9
12:11,179173981.0,4185.361757054092,-4.09,2
12:16,741903302.0,1884.7540650141248,-41.97,4
12:18,116169597.0,672.1689499999995,-64.98,4
12:22,175452235.0,193.66725000000028,-202.3,2
12:42,904154012.0,842.707458120432,-32.95,7
12:44,175452235.0,-58.33274999999969,-252.0,2
12:47,386277162.0,-14.310000000000592,-47.49,2
12:49,781554833.0,953.5232255639664,-125.5,2
12:50,426474982.0,-3727.33975,-51.53,5
12:51,855129444.0,-353.009795437372,-81.16,5
12:55,661295096.0,2909.9865133217477,-29.99,4
12:57,405416860.0,1762.5133568809035,-71.99,2
12:58,910730524.0,7501.465442850794,-5.2,9
13:01,943829984.0,-1176.859690886543,-85.73,5
13:02,407323346.0,-2517.1504325553124,-58.72,5
13:05,338022396.0,252.6649393757391,-102.62,5
13:08,248625662.0,-1171.3619157151477,-39.57,5
13:10,422955974.0,-417.08686500095007,-92.23,5
13:14,263882093.0,-1481.1838000000005,-103.43,5
13:14,781554833.0,896.5232255639664,-57.0,2
13:16,386277162.0,-126.7900000000006,-112.48,2
13:17,522188082.0,7185.267297841662,-88.42,2
13:23,973086490.0,9186.202823139003,-21.55,9
13:25,688712152.0,5979.20201717615,-4.95,9
13:38,364357875.0,6774.6906956486355,-16.04,2
13:46,553734946.0,-74.50520000000154,-220.0,2
13:46,823208989.0,1132.4547138695314,-117.6,2
13:46,766941757.0,1676.6299397168566,-61.74,5
13:52,518746136.0,52.29277176308349,-43.3,5
13:58,494789005.0,2656.4668322118187,-6.41,5
14:00,435313070.0,2191.0413330332203,-4.75,2
14:01,535744551.0,26.481965995626012,-149.51,5
14:02,744211756.0,-4136.3432499999935,-11.84,5
14:05,588565416.0,6904.62056437322,-6.8,4
14:10,322221939.0,3258.343960033052,-24.25,4
14:11,170233640.0,-251.0237600501027,-79.98,4
14:12,823208989.0,1014.1547138695314,-118.3,2
14:22,610450243.0,-945.2646,-9.14,5
14:27,572333122.0,-3684.6950499999966,-102.57,5
14:28,259015404.0,508.2773476636423,-13.55,2
14:44,994947671.0,1123.0357000000004,-10.0,4
14:45,441142605.0,2004.1126888780311,-6.99,7
15:00,383833857.0,23220.040117498997,-11.29,1
15:01,901432314.0,3113.347297655635,-24.7,2
15:06,899742927.0,11685.825270162197,-29.02,7
15:12,886921642.0,2775.162068683061,-5.7,2
15:14,679911053.0,2140.611015428798,-4.64,2
15:36,691012931.0,-1734.482250000001,-35.89,5
15:42,158414827.0,-1781.8150000000016,-5.64,5
15:43,211493028.0,923.5214499999992,-44.47,5
15:43,348325817.0,9370.586135821097,-50.51,7
15:52,198946608.0,3077.1718692956792,-180.51,2
15:52,828750680.0,1073.2423452136798,-29.99,2
15:55,613729471.0,8353.38546571009,-19.21,6
16:01,776108637.0,503.6546536574957,-94.44,5
16:20,570323670.0,2663.536656941951,-130.23,4
16:24,834383043.0,5270.052095132721,-1.5,4
16:29,108481285.0,8158.644258150872,-54.79,5
16:31,175452235.0,-274.63274999999965,-216.3,2
16:33,713641917.0,774.817167877851,-62.77,7
16:34,867987292.0,1551.6198393965074,-142.11,2
16:36,785210466.0,1751.3595569695472,-25.96,1
16:44,964913066.0,-2282.4796999999994,-51.53,5
16:45,297823329.0,138.18644999999916,-14.98,7
16:45,386277162.0,-225.77000000000055,-98.98,2
16:45,108481285.0,8149.45865887228,-9.19,7
16:46,175452235.0,-343.23274999999967,-68.6,2
16:48,183186021.0,-345.2850499999989,-16.4,5
16:52,553734946.0,-192.5052000000015,-118.0,2
16:54,909676212.0,291.8114045320274,-16.49,4
17:00,624500124.0,2931.9330836787576,-83.64,2
17:05,310375875.0,2356.7746319278967,-33.65,9
17:08,175452235.0,-624.6327499999996,-281.4,2
17:09,413557825.0,192.04234999999943,-219.79,5
17:13,628470485.0,-188.34697009987684,-29.96,1
17:14,225210798.0,471.9167737592086,-59.97,4
17:14,736310094.0,-975.268924027426,-87.3,5
17:15,553734946.0,-324.50520000000154,-132.0,2
17:19,660874296.0,2175.5474499608476,-14.97,1
17:20,386277162.0,-294.75000000000057,-68.98,2
17:24,891716230.0,126.7166513926162,-5.99,4
17:27,887853850.0,9846.906448081443,-35.58,7
17:27,986267641.0,6933.342345578322,-22.09,2
17:27,130154096.0,1314.056782013418,-6.99,4
17:27,138609932.0,3080.7490032945852,-31.78,9
17:28,744398361.0,416.2609999999998,-25.0,2
17:30,668175891.0,689.441973158499,-4.99,1
17:32,433917275.0,6718.654284878886,-54.45,7
17:32,893134725.0,516.8594819367792,-45.05,5
17:33,859603181.0,2565.376917927768,-28.99,8
17:34,331450202.0,6801.975798425381,-17.37,7
17:35,639420537.0,-1609.4014499999998,-26.38,5
17:36,633345190.0,5417.617526581931,-32.39,7
17:37,857754342.0,800.0011820993831,-9.99,4
17:37,618514666.0,19666.54808321062,-44.97,4
17:38,802697323.0,14563.04955992039,-68.32,4
17:41,604334058.0,297.8164999999994,-64.98,4
17:41,698076160.0,5758.005891322047,-50.15,5
17:42,668175891.0,687.451973158499,-1.99,4
17:42,531186970.0,6247.339464432307,-1.5,4
17:44,471897866.0,6895.9096972314055,-3.05,7
17:45,169006407.0,10839.346373828934,-31.11,1
17:45,435984758.0,3788.0567386414727,-23.03,7
17:46,392270893.0,12289.50609642486,-22.62,7
17:46,683319988.0,6591.075483831423,-36.65,9
17:48,857754342.0,646.021182099383,-153.98,2
17:48,355602925.0,1240.6965451313745,-31.99,2
17:49,419550103.0,17442.33155917318,-1.5,4
17:51,245690309.0,8690.382785491254,-10.74,7
17:51,229205098.0,6688.168067286718,-30.64,7
17:52,420109571.0,378.6038107166795,-103.48,2
17:52,736340277.0,8159.675999286669,-18.9,2
17:53,667367404.0,8701.523031687253,-0.9,7
17:53,315546581.0,26463.045452309016,-181.3,2
17:53,296770890.0,1515.864010379083,-51.41,5
17:56,399144202.0,1195.0881037292183,-31.78,9
17:57,429556122.0,5524.608478442135,-50.14,2
17:57,999752672.0,642.2768935333347,-158.3,5
17:58,832564361.0,15169.116172048714,-1.62,4
17:59,450896297.0,12259.511025141232,-36.61,8
18:00,419550103.0,17422.321559173182,-20.01,2
18:01,287230540.0,806.3622932932661,-70.0,2
18:02,175452235.0,-873.1327499999996,-248.5,2
18:02,858560423.0,11288.465784057647,-284.9,2
18:05,227104649.0,2481.1170343161775,-31.99,9
18:08,194023154.0,-2515.817171784734,-37.94,9
18:09,541639148.0,3337.0566735940315,-53.6,7
18:11,450896297.0,12220.421025141231,-39.09,9
18:14,315546581.0,26373.445452309017,-89.6,2
18:15,315546581.0,26339.226142957592,-34.22,2
18:16,414805878.0,11991.253574253382,-154.0,2
18:16,245690309.0,8662.690785491255,-27.69,5
18:23,553734946.0,-489.50520000000154,-165.0,2
18:23,851181128.0,3645.431820697934,-32.4,9
18:24,842682241.0,4653.195045345994,-34.13,9
18:26,994214354.0,8955.584058052631,-22.93,9
18:26,314980178.0,2684.3488500000058,-43.4,9
18:26,510101371.0,12241.90898107361,-8.03,7
18:31,858560423.0,11149.165784057648,-139.3,2
18:33,228136274.0,1417.6804999999993,-21.98,7
18:34,409971170.0,2284.7023781587995,-5.89,4
18:39,331450202.0,6743.869220762072,-58.11,7
18:44,124102251.0,2901.8807918599646,-46.69,5
18:45,534325901.0,6021.813621686867,-17.24,9
18:47,856957948.0,9129.018187619513,-27.85,5
18:47,128033695.0,1278.3838940535263,-32.24,9
18:47,546760202.0,-1894.340527675968,-51.83,5
18:52,270374623.0,9164.796659811036,-99.6,5
18:53,291128777.0,-2716.4764405263686,-34.61,5
18:53,270374623.0,9157.806659811036,-6.99,9
18:55,786141370.0,-529.8828000000008,-70.98,5
18:56,390747457.0,187.984799999998,-75.44,5
18:59,615144184.0,408.6825991255188,-92.45,5
19:02,668329719.0,7573.801437559442,-50.6,5
19:08,195895574.0,6546.411992862981,-79.01,4
19:08,310171581.0,-2172.19370434092,-15.82,5
19:08,822135975.0,10228.601143344536,-53.98,5
19:15,472213568.0,-692.9168942060533,-127.76,5
19:15,641764023.0,-1298.6263037720046,-51.38,5
19:16,836655156.0,-2993.303955219156,-16.93,5
19:16,654329190.0,-168.84874905148072,-17.56,5
19:17,962295212.0,-2162.005149999997,-88.35,5
19:18,489964679.0,19283.55679003018,-25.78,9
19:24,446720287.0,-642.2754091815945,-95.68,5
19:25,700138124.0,4853.717357613921,-79.62,5
19:43,274818272.0,288.72517856713154,-117.96,5
19:47,540159353.0,10229.13771124572,-55.52,5
19:48,700138124.0,4849.729600549765,-3.99,7
19:48,553734946.0,-591.2502000000015,-101.75,5
19:48,520447032.0,7693.905623968504,-24.94,9
19:49,930271460.0,-89.04725246422376,-147.61,5
19:51,736340277.0,8135.749999286669,-23.93,5
19:55,631744379.0,-2160.1087594910673,-46.3,5
20:02,876890798.0,2639.960720699932,-12.55,5
20:04,558119802.0,31055.3618702566,-25.83,9
20:19,610645022.0,-902.1906626449183,-64.53,5
20:22,701070224.0,-778.8165,-122.53,5
20:26,851649498.0,9629.180580686649,-74.2,2
20:28,196289502.0,14434.53894336088,-101.92,5
20:34,441274121.0,10926.06643610265,-17.5,2
20:34,340295966.0,-1642.2244500000004,-32.11,5
20:36,581655972.0,38645.29455968993,-94.58,5
20:43,366550080.0,25000.265289369127,-56.07,5
20:51,809499628.0,15841.561299694697,-31.45,5
20:55,653640811.0,16034.920856678167,-10.71,2
20:57,441274121.0,10892.088436102653,-33.98,5
20:59,698076160.0,5717.132401975247,-40.87,7
21:00,624500124.0,2912.3209705117333,-19.61,7
21:17,678330503.0,2221.8874987988856,-10.37,2
02:23,518474507.0,12274.65803052298,-32.42,9
02:29,216285378.0,22533.799384634913,-34.61,9
02:30,549414742.0,6157.326077610969,-30.14,9
02:37,973086490.0,9170.262823139004,-15.94,9
02:49,709608057.0,2332.6794600145668,-37.89,9
02:52,683319988.0,6553.795483831424,-37.28,9
02:54,985188462.0,-867.2532112887752,-28.79,9
02:55,657139925.0,12740.430922515025,-12.2,9
02:57,832564361.0,15123.919067558068,-45.2,7
03:02,930277104.0,9486.238864901206,-22.23,9
03:02,145387690.0,4303.573681668899,-26.18,9
03:05,987163717.0,5523.938480000004,-34.68,9
03:08,973086490.0,9138.02530337681,-32.24,7
03:09,874431242.0,7410.747734479947,-65.59,2
03:09,910730524.0,7466.975442850794,-34.49,9
03:15,183888402.0,17195.504973285395,-38.14,9
03:15,322221939.0,3255.4635106738256,-2.88,7
03:17,461990622.0,8277.815123734386,-4.51,7
03:25,187541224.0,906.075762027924,-31.24,9
03:30,885259672.0,2995.9565712704593,-25.74,8
03:33,145387690.0,4234.422605616854,-69.15,5
03:35,108481285.0,8122.178212829153,-27.28,5
03:39,785749304.0,7693.52518017796,-11.95,9
03:46,912705941.0,17455.14165024583,-21.58,7
03:46,587225252.0,4407.506053166946,-24.28,9
03:50,802697323.0,14527.40955992039,-35.64,9
03:54,108931112.0,13139.598476139534,-33.44,9
03:56,506618547.0,15207.292234647985,-22.12,5
03:58,925037906.0,662.7478000000015,-25.98,9
04:01,633345190.0,5379.067526581931,-38.55,9
04:14,558119802.0,31044.376054817418,-10.99,5
04:14,532478725.0,4003.4214486040983,-44.75,9
04:15,500043411.0,12756.151357111336,-20.47,5
04:22,822250278.0,6740.628466152259,-14.04,5
04:22,480557476.0,10400.953139263716,-1.16,2
04:26,237684254.0,5288.811623633671,-2.27,2
04:26,719586818.0,16377.282098067966,-3.2,7
04:27,809499628.0,15825.631299694694,-15.93,9
04:27,749378808.0,3375.5392197254732,-29.97,9
04:28,108563213.0,22480.47930690309,-37.48,7
04:30,549414742.0,6151.042488243714,-6.28,2
04:34,678851253.0,2947.564243932386,-25.03,7
04:38,534325901.0,6011.99022553284,-9.82,4
04:40,859603181.0,2542.997715247643,-22.38,7
04:40,779236304.0,-984.862404520468,-31.84,9
04:48,282837512.0,12769.613661709676,-36.93,9
04:49,310375875.0,2336.284631927897,-20.49,9
04:49,409971170.0,2277.698682035155,-7.0,2
04:57,550169791.0,19850.369344578194,-29.36,2
04:59,520447032.0,7692.675770514684,-1.23,5
04:59,331450202.0,6725.169220762072,-18.7,9
05:02,683319988.0,6504.109816517252,-49.69,7
05:04,435984758.0,3786.9590380507225,-1.1,7
05:06,170637730.0,2206.99156631414,-3.27,2
05:06,749378808.0,3364.0972615824116,-11.44,2
05:07,809499628.0,15779.09361846294,-46.54,8
05:10,806358207.0,11436.09752648846,-42.26,2
05:10,196289502.0,14419.10894336088,-15.43,9
05:18,575652395.0,2000.2976058668871,-2.41,2
05:19,113747882.0,11355.829995770287,-25.74,9
05:19,675806859.0,6323.754838755123,-2.55,7
05:19,282837512.0,12697.389631613974,-72.22,7
05:20,785749304.0,7691.706875622031,-1.82,2
05:21,482513594.0,5050.989999419678,-67.02,7
05:24,992204045.0,5518.84900404432,-49.15,2
05:27,994214354.0,8913.80405805263,-41.78,9
05:33,169006407.0,10832.362717615484,-6.98,8
05:34,779946617.0,15501.601369036083,-18.82,7
05:34,954263768.0,-371.25620000000026,-8.75,9
05:37,264550521.0,8903.95417022342,-11.35,5
05:38,399144202.0,1160.5981037292183,-34.49,9
05:39,532478725.0,4000.2748918516127,-3.15,5
05:48,601627384.0,3394.485659798639,-34.19,9
05:49,417850087.0,15946.60345053449,-1.46,2
05:53,887853850.0,9817.676448081444,-29.23,9
05:55,270374623.0,9103.272834991923,-54.53,2
05:56,120634201.0,4196.8576758149875,-22.25,9
05:57,836110591.0,5851.406327623504,-30.68,9
05:57,305778936.0,8975.854360772404,-18.25,9
05:58,994214354.0,8899.609758529868,-14.19,7
06:01,873701090.0,274.80402198936207,-43.99,7
06:03,366550080.0,24941.8238368868,-58.44,4
06:08,128033695.0,1258.5461721329743,-19.84,8
06:11,308505160.0,11830.869981392743,-27.88,5
06:13,414805878.0,11957.373574253385,-33.88,9
06:21,552980092.0,-548.7612808806624,-34.8,9
06:21,287480331.0,7012.384066886004,-33.7,9
06:21,556992209.0,10902.847135579012,-23.19,9
06:21,687135796.0,25756.047804985355,-8.64,2
06:24,899742927.0,11679.405545810743,-6.42,5
06:29,930277104.0,9457.883213581945,-28.36,7
06:30,668329719.0,7544.986999523376,-28.81,7
06:31,324224854.0,2751.7608903582286,-1.16,7
06:34,842682241.0,4648.0863976393275,-5.11,7
06:35,700138124.0,4836.683193544245,-13.05,5
06:35,705848712.0,25027.88745024443,-10.39,9
06:38,176922958.0,607.2255471976496,-26.94,9
06:39,653640811.0,16028.897540913871,-6.02,2
06:39,853907490.0,6350.669045225687,-13.0,9
06:40,547010927.0,21442.279404186807,-18.42,2
06:41,471897866.0,6879.442182472386,-16.47,5
06:42,383833857.0,23190.04280697768,-30.0,2
06:43,213112754.0,6106.372868528263,-3.75,7
06:45,252760664.0,5680.578449314307,-2.9,2
06:52,146909202.0,2177.597816096405,-43.42,5
06:52,647936800.0,3146.562587389062,-7.69,2
06:52,179173981.0,4150.561757054092,-34.8,9
06:54,221868392.0,4497.179455228289,-23.94,9
06:56,824916823.0,8063.166044502916,-9.47,7
06:57,364357875.0,6742.943502405524,-31.75,7
06:58,987656636.0,5458.671350773666,-17.47,5
07:02,511179916.0,6293.887934097415,-6.41,4
07:02,287480331.0,7004.773443968817,-7.61,7
07:02,651756497.0,11197.381250566825,-15.69,5
07:04,304455868.0,1944.707071564332,-16.9,5
07:05,769311479.0,5400.823512061511,-2.6,5
07:05,673025413.0,1731.4890491110243,-53.3,2
07:08,489964679.0,19273.419656636077,-10.14,7
07:10,315078351.0,6895.599375374218,-37.63,9
07:11,540159353.0,10223.888538566776,-5.25,5
07:15,519644021.0,2342.850033639502,-31.23,2
07:15,766941757.0,1641.289939716857,-35.34,9
07:20,259015404.0,475.72734766364226,-32.55,9
07:20,310375875.0,2333.5236549840283,-2.76,2
07:27,151968462.0,6058.854108525951,-35.28,5
07:30,290818242.0,6295.021781546166,-20.78,8
07:30,670102069.0,3110.263314617758,-30.23,9
07:30,679662108.0,15056.433286022178,-24.51,8
07:33,187111705.0,6071.836017804634,-51.92,5
07:33,586315521.0,11415.771282354315,-1.98,7
07:35,613729471.0,8280.482010735843,-72.9,2
07:36,510101371.0,12201.31898107361,-40.59,9
07:36,285220959.0,11078.566234119062,-4.12,7
07:36,672913754.0,10504.833424547156,-4.68,7
07:38,604288474.0,1966.1651755565215,-3.74,5
07:40,450896297.0,12217.487178954974,-2.93,4
07:42,905860285.0,7984.001419612363,-10.59,2
07:42,779376323.0,2521.713245819657,-2.1,7
07:43,203466392.0,2196.8043585605274,-26.79,4
07:44,386729293.0,30173.35048728466,-0.53,5
07:50,639549973.0,5921.471647577352,-10.76,2
07:50,851649498.0,9602.609164467263,-26.57,7
07:51,730002588.0,12000.427192418823,-15.18,5
07:53,639409800.0,33760.7948753895,-67.35,5
07:54,815385232.0,9242.019713515836,-0.73,5
07:54,718058208.0,1539.6863983836006,-3.53,5
07:55,873693307.0,8626.703750815668,-17.47,2
08:01,738958551.0,8375.67743560564,-68.67,2
08:01,601627384.0,3383.2551627609714,-11.23,2
08:04,951817450.0,8333.774888080869,-78.36,7
08:05,146909202.0,2169.697816096405,-7.9,9
08:06,454356905.0,720.9359132424262,-14.15,7
08:06,195895574.0,6522.48199286298,-23.93,9
08:07,256002321.0,5336.352715188635,-9.39,7
08:07,370521542.0,24858.896377342066,-6.72,7
08:09,305778936.0,8966.823539533712,-9.03,8
08:09,331450202.0,6710.5394933087955,-14.63,7
08:14,454129843.0,991.2210951665598,-5.1,9
08:16,854895960.0,2766.8991787487203,-13.82,7
08:18,229205098.0,6680.06559103321,-8.1,8
08:18,120634201.0,4146.395329403304,-50.46,2
08:20,235881534.0,12355.037436595478,-0.7,5
08:20,853907490.0,6336.219155627906,-14.45,2
08:21,534204159.0,5570.3605013505685,-10.08,5
08:22,113747882.0,11335.907992140128,-19.92,7
08:23,108812033.0,408.8520499999984,-37.89,5
08:25,885259672.0,2989.906571270459,-6.05,9
08:26,703478110.0,4565.039450637634,-52.27,5
08:30,554792076.0,26355.775355296737,-43.05,5
08:33,820686957.0,-985.036016311196,-32.88,5
08:34,704517789.0,16525.794679412043,-47.38,2
08:34,494156986.0,-810.0372543276651,-35.35,5
08:36,374994043.0,-2287.778050000001,-34.03,5
08:37,822135975.0,10227.822588215651,-0.78,5
08:38,550169791.0,19769.449344578195,-80.92,5
08:39,187111705.0,5962.300017804634,-109.54,5
08:39,493640090.0,-2603.698449999999,-25.34,5
08:44,180719578.0,-4326.422749999996,-49.75,5
08:44,986267641.0,6882.582436226643,-50.76,2
08:45,421881811.0,2115.0822049685607,-48.27,8
08:45,473820682.0,10349.78335984971,-52.24,2
08:47,213096759.0,-1543.8441082144395,-25.91,5
08:48,124102251.0,2894.990687332492,-6.89,8
08:50,706250160.0,11175.247756376608,-8.73,2
08:51,867679563.0,-175.52084629828414,-36.35,5
08:53,779816907.0,-2865.298582922912,-13.34,5
08:54,940569402.0,5083.522315013718,-33.24,8
08:55,143003091.0,21520.80119489144,-26.6,2
08:59,624563756.0,-711.1199712164437,-41.02,5
09:00,138609932.0,3075.3990032945853,-5.35,9
09:04,558875206.0,2250.6543108989517,-5.6,9
09:05,117273481.0,8486.339809844896,-7.1,9
09:06,683319988.0,6496.309816517251,-7.8,9
09:06,540159353.0,10217.738538566777,-6.15,9
09:08,832564361.0,15089.339067558069,-34.58,5
09:08,250957494.0,348.41709999999875,-141.9,5
09:09,960208650.0,16754.229421531825,-25.65,7
09:10,618138606.0,795.4666472714346,-5.4,9
09:12,609939116.0,6786.090178499847,-16.12,2
09:12,706361191.0,-119.495901505922,-134.9,5
09:12,506618547.0,15201.592234647982,-5.7,9
09:15,613729471.0,8274.782010735842,-5.7,9
09:16,383833857.0,23185.04280697768,-5.0,9
09:16,822250278.0,6448.028466152258,-292.6,4
09:17,370521542.0,24733.400377342063,-125.5,5
09:17,524425303.0,-783.2492000000011,-26.04,5
09:18,124102251.0,2889.190687332492,-5.8,9
09:18,690958123.0,19266.870683105368,-6.15,9
09:21,170637730.0,2194.94156631414,-12.05,7
09:21,933491926.0,2825.1323000000025,-68.84,5
09:21,169006407.0,10824.862717615484,-7.5,9
09:21,812012103.0,-1371.4843000000003,-43.94,5
09:23,290818242.0,6289.571781546166,-5.45,9
09:27,333054026.0,-121.18010597681,-26.08,2
09:28,667367404.0,8695.523031687253,-6.0,9
09:29,287480331.0,6994.215883968817,-10.56,4
09:31,417850087.0,15940.553450534491,-6.05,9
09:33,821971408.0,302.6271102355434,-14.69,5
09:34,215311171.0,5874.814724008948,-97.98,2
09:36,910730524.0,7436.244942456728,-30.73,8
09:37,475277431.0,900.8081369436192,-12.0,4
09:37,179173981.0,4118.617784622613,-31.94,5
09:39,909676212.0,284.8214045320274,-6.99,7
09:43,298007503.0,762.5851036256333,-28.37,7
09:43,703588001.0,-164.34695000000045,-80.56,5
09:46,409370545.0,1007.0692755455206,-6.02,7
09:47,277562576.0,428.275318105103,-115.86,2
09:56,570410059.0,1261.42264677631,-288.44,5
10:01,865748375.0,3357.408985149446,-32.99,1
10:02,776431321.0,3123.897258708011,-16.97,1
10:03,895331556.0,-759.5700000000008,-36.28,5
10:05,137822385.0,3443.531643181048,-7.6,9
10:08,246753533.0,-108.08230000000152,-14.34,5
10:08,812692024.0,3223.676857948953,-67.72,5
10:08,659415300.0,804.0550402507041,-5.0,9
10:15,570410059.0,1232.44264677631,-28.98,2
10:18,299871610.0,214.59565305876657,-49.99,2
10:20,822250278.0,6337.428466152258,-110.6,4
10:20,277562576.0,281.290318105103,-146.98,2
10:20,687135796.0,25725.787804985357,-30.26,1
10:21,618514666.0,19640.56808321062,-25.98,2
10:22,287480331.0,6988.815883968818,-5.4,9
10:36,454356905.0,517.9499132424262,-202.99,2
10:37,402438092.0,375.1447999999988,-97.93,5
10:37,570410059.0,1148.44264677631,-84.0,2
10:43,822250278.0,6121.128466152258,-216.3,7
10:46,348325817.0,9234.086135821097,-136.5,2
10:48,687135796.0,25714.30780498536,-11.48,4
10:51,519644021.0,2143.350033639502,-199.5,2
10:51,822250278.0,5995.8284661522575,-125.3,7
10:53,570410059.0,1094.95264677631,-53.49,2
10:56,348325817.0,9211.868225455904,-22.22,4
11:02,277562576.0,188.680318105103,-92.61,2
11:04,519644021.0,2110.2500336395015,-33.1,4
11:06,854895960.0,2744.8991787487203,-22.0,2
11:10,570410059.0,1031.97264677631,-62.98,2
11:19,910730524.0,7396.184942456727,-40.06,2
11:30,277562576.0,94.195318105103,-94.48,2
11:30,441142605.0,1948.9110388780311,-55.2,5
11:31,779946617.0,15389.601369036083,-112.0,2
11:33,570410059.0,990.98264677631,-40.99,2
11:40,472995101.0,1673.4844342428032,-7.49,4
11:52,570410059.0,952.00264677631,-38.98,2
11:56,766941757.0,1637.4112197168567,-3.88,4
12:01,448004226.0,1381.5867735099764,-76.98,2
12:04,592961759.0,-1534.4048000000005,-33.69,9
12:04,111137699.0,-356.2206999999995,-40.35,9
12:05,494156986.0,-823.5372543276651,-13.5,9
12:07,668175891.0,537.4719731584989,-149.98,2
12:08,822250278.0,5933.528466152257,-62.3,4
12:11,766941757.0,1567.9412197168567,-69.47,7
12:18,799286313.0,-1295.6118128758617,-25.68,9
12:20,570410059.0,882.00264677631,-70.0,2
12:24,822250278.0,5891.528466152257,-42.0,7
12:26,448004226.0,1359.5867735099764,-22.0,2
12:40,982286721.0,-3394.99302401773,-15.43,5
12:41,454356905.0,330.34991324242617,-187.6,2
12:42,672994751.0,-210.10370921398996,-25.0,2
12:44,392790315.0,-4385.3963943720655,-30.41,5
12:45,812692024.0,3205.7068579489533,-17.97,4
12:46,895750759.0,-867.6050380756658,-46.75,9
12:50,280130290.0,-29.049750000000405,-19.85,9
12:51,570410059.0,816.51264677631,-65.49,2
12:51,572384506.0,6570.836110927916,-22.74,8
12:55,308897841.0,815.4268999999989,-22.89,9
13:00,807098817.0,273.4629499999992,-116.39,5
13:02,657528784.0,-294.59809999999925,-133.66,5
13:03,189757473.0,-2171.3186499999997,-11.08,5
13:03,706301742.0,-2968.633149999998,-45.31,5
13:08,407574996.0,121.67433119583283,-6.1,9
13:13,688712152.0,5972.05201717615,-7.15,9
13:13,822250278.0,5614.3284661522575,-277.2,7
13:17,480557476.0,10395.253139263716,-5.7,9
13:19,585625048.0,1142.6226823533743,-4.7,9
13:20,277562576.0,87.395318105103,-6.8,9
13:26,910730524.0,7389.384942456727,-6.8,9
13:28,187111705.0,5955.800017804634,-6.5,9
13:33,668175891.0,509.47197315849894,-28.0,2
13:33,570323670.0,2658.7725344682112,-4.76,2
13:49,687135796.0,25697.157804985356,-17.15,9
13:58,380911501.0,-213.14060000000083,-62.42,5
13:59,890830949.0,1049.7881499999978,-94.2,5
14:10,596171893.0,-82.64440517448891,-6.99,7
14:14,282046994.0,-619.0246499999996,-143.3,5
14:47,293609137.0,-204.1875074255019,-98.01,5
14:53,779946617.0,15135.501369036085,-254.1,2
15:27,158414827.0,-1787.9600000000016,-6.14,5
15:44,679911053.0,2118.6634531827017,-21.95,2
15:45,668175891.0,443.4919731584989,-65.98,2
16:32,738958551.0,8338.08743560564,-37.59,9
16:36,192202372.0,228.7379338887978,-31.98,4
16:37,392270893.0,12059.906096424858,-229.6,2
16:40,551755686.0,6187.283212897711,-25.98,4
16:46,914806976.0,-101.75674981451328,-212.97,2
16:48,241459011.0,582.3566132723472,-42.37,5
16:50,399538448.0,6781.807794127588,-64.98,4
16:51,392270893.0,11968.92609642486,-90.98,2
16:51,151278285.0,-1103.7958000000003,-183.5,5
16:52,709608057.0,2301.479460014567,-31.2,7
16:56,587225252.0,4369.482806628824,-38.02,5
17:00,256045540.0,-3508.1488999999992,-58.44,5
17:01,627723633.0,-2118.0913280037626,-54.31,5
17:07,237493332.0,13314.829062092313,-9.95,2
17:07,296972867.0,-1036.381400000001,-73.88,5
17:09,383625050.0,3701.61324497699,-40.6,4
17:10,858989281.0,24954.65615236642,-15.29,9
17:13,873693307.0,8619.313750815669,-7.39,9
17:14,683078800.0,1436.910202944871,-21.97,7
17:16,779946617.0,14835.901369036084,-299.6,2
17:17,534097839.0,-3560.181049999998,-26.51,5
17:19,558119802.0,31020.036054817418,-24.34,9
17:22,441274121.0,10867.436085970745,-24.65,5
17:24,227104649.0,2474.1030343161774,-7.01,4
17:25,949032480.0,3900.77262685177,-20.34,9
17:25,690958123.0,19262.191364636416,-4.68,8
17:25,678330503.0,2088.0124987988856,-133.88,5
17:26,293191074.0,425.83814999999913,-80.0,2
17:28,824916823.0,8021.976044502916,-41.19,9
17:28,315546581.0,26337.155599178517,-2.07,5
17:30,897714622.0,8099.492945091412,-44.49,7
17:31,450896297.0,12178.865798954974,-38.62,4
17:31,534325901.0,5979.2302255328395,-32.76,1
17:32,450896297.0,12142.465798954974,-36.4,9
17:34,518474507.0,12234.620777477532,-40.04,7
17:36,131388684.0,20510.64109991112,-79.94,2
17:39,887853850.0,9816.883999102056,-0.79,2
17:39,558875206.0,2168.664310898952,-81.99,2
17:39,683319988.0,6354.9798165172515,-141.33,2
17:39,147474476.0,3313.7421570987963,-35.0,2
17:41,752362502.0,7755.247296919667,-22.66,2
17:42,857754342.0,629.041182099383,-16.98,7
17:44,899742927.0,11624.255545810744,-55.15,2
17:44,986267641.0,6788.232436226643,-94.35,2
17:51,703478110.0,4549.069450637634,-15.97,7
17:51,618514666.0,19612.912041064315,-27.66,5
17:51,653640811.0,15993.907540913871,-34.99,1
17:52,639409800.0,33535.4228753895,-225.37,2
17:52,822718326.0,10065.175522634276,-25.97,7
17:53,987163717.0,5446.938480000004,-77.0,4
17:55,919185264.0,2681.0722597631698,-25.98,2
17:57,916270283.0,1532.3242499999994,-76.98,2
17:57,653667523.0,3490.74129015913,-15.97,7
17:57,675231808.0,15976.712167590716,-13.98,4
17:59,482513594.0,5002.885999419677,-48.1,5
18:03,293191074.0,345.83814999999913,-80.0,2
18:03,237493332.0,13123.757062092312,-191.07,2
18:05,639409800.0,33423.4788753895,-111.94,2
18:06,874431242.0,7373.117734479947,-37.63,9
18:07,835736339.0,1581.68236209188,-88.16,2
18:08,796709231.0,-680.4180221037025,-39.05,9
18:09,667367404.0,8694.406061622496,-1.12,7
18:09,414454079.0,19.64785000000181,-34.59,9
18:13,703478110.0,4290.769450637634,-258.3,2
18:15,166019891.0,7234.39482304068,-74.23,8
18:16,215311171.0,5871.822481846508,-2.99,8
18:19,730002588.0,11987.477192418824,-12.95,9
18:22,678330503.0,2076.309376075447,-11.7,8
18:23,516051449.0,1091.5450389400978,-109.7,5
18:24,550169791.0,19759.45934457819,-9.99,9
18:24,165045150.0,-581.4089385971441,-39.1,9
18:28,758160963.0,7417.255026705332,-76.34,5
18:30,541639148.0,3324.4245735940317,-12.63,7
18:35,106601471.0,9864.115557590318,-26.69,7
18:37,956717493.0,991.5248610230713,-40.27,5
18:38,653640811.0,15929.227540913873,-64.68,5
18:39,996042490.0,5272.204006936873,-20.15,9
18:43,494789005.0,2638.294832211818,-18.17,5
18:44,835736339.0,1438.91036209188,-142.77,2
18:44,433917275.0,6679.5142848788855,-39.14,9
18:44,785210466.0,1712.0181569695471,-39.34,5
18:45,631111289.0,-710.8915000000007,-18.52,5
18:49,235881534.0,12324.867196595478,-30.17,7
18:52,322720763.0,5405.67926028549,-17.5,7
18:52,419550103.0,17408.039251821345,-14.28,5
18:53,380228542.0,-752.8382581844345,-199.34,5
18:54,500043411.0,12728.211357111337,-27.94,7
18:54,992204045.0,5442.72295404432,-76.13,7
18:55,493855007.0,-2653.4491315743926,-47.38,5
18:57,252701364.0,-3722.8586726779154,-15.72,5
18:58,647472692.0,23507.57987745408,-52.99,9
18:59,824916823.0,8016.326044502916,-5.65,7
19:01,691843653.0,-3090.3958999999936,-34.39,5
19:02,613729471.0,8255.882010735842,-18.9,5
19:05,741903302.0,1775.9068650141248,-108.85,5
19:14,256002321.0,5320.122715188635,-16.23,9
19:14,654329190.0,-227.30224905148071,-58.45,5
19:20,940569402.0,5045.932315013718,-37.59,5
19:22,858989281.0,24950.30465584946,-4.35,4
19:23,948069469.0,-922.481300000001,-55.3,5
19:24,948558249.0,8420.688081706883,-75.75,5
19:24,886921642.0,2740.2236584310185,-34.94,2
19:25,696758548.0,-3420.3728963201365,-14.47,5
19:26,433917275.0,6636.7360841659165,-42.78,7
19:28,214339619.0,-130.36464913164372,-93.63,5
19:33,651372390.0,-3530.100749999999,-34.17,5
19:33,851181128.0,3644.433217131575,-1.0,7
19:36,742223719.0,398.7851573048027,-128.6,5
19:39,221868392.0,4428.700829371215,-68.48,2
19:39,408057540.0,3893.95707280612,-40.35,9
19:40,392270893.0,11930.117089514704,-38.81,2
19:41,294474095.0,-2344.616286499239,-33.72,5
19:41,845648250.0,-33.26055000000056,-41.46,5
19:47,696333897.0,101.62244999999898,-36.8,9
19:48,691789577.0,-1018.5144,-257.59,5
19:51,949032480.0,3875.914846912644,-24.86,5
19:52,681955876.0,-1676.3281000000006,-48.74,5
19:55,954263768.0,-427.3290000000003,-56.07,5
20:08,667367404.0,8664.266061622497,-30.14,9
20:18,195895574.0,6456.450606515397,-66.03,7
20:19,699139822.0,1032.1480655647508,-22.08,7
20:22,169006407.0,10613.602717615484,-211.26,5
20:35,668692488.0,1517.9156285738093,-251.09,5
20:38,285428103.0,9109.739491187382,-23.07,5
20:39,121858569.0,102.2661500000025,-89.05,5
20:41,304455868.0,1919.817071564332,-24.89,9
20:43,851649498.0,9576.037164467263,-26.57,5
20:52,984783496.0,12882.358793203834,-16.34,9
20:53,286484726.0,384.7628267328863,-48.64,2
20:58,865748375.0,3337.299183847352,-20.11,5
20:58,534325901.0,5952.952225532839,-26.28,5
21:09,338022396.0,226.7749393757391,-25.89,9
21:17,285115279.0,-3170.1531607892875,-25.94,9
00:45,494789005.0,2605.4840613988026,-32.81,7
01:48,575652395.0,1997.281644045921,-3.02,7
01:52,987656636.0,5437.080590329662,-21.59,5
02:16,809499628.0,15769.10361846294,-9.99,9
02:31,187541224.0,872.3457620279239,-33.73,9
02:36,633345190.0,5348.637526581931,-30.43,9
02:37,534325901.0,5930.80222553284,-22.15,9
02:47,203466392.0,2196.128837121235,-0.68,5
02:49,473820682.0,10340.702220705403,-9.08,5
02:54,196289502.0,14400.91894336088,-18.19,9
02:59,421881811.0,2062.8300606408484,-52.25,5
03:02,489964679.0,19242.039656636076,-31.38,9
03:12,282837512.0,12664.049631613974,-33.34,9
03:14,679662108.0,15056.009990698702,-0.42,2
03:14,973086490.0,9130.52530337681,-7.5,9
03:15,259015404.0,431.8273476636423,-43.9,9
03:16,370521542.0,24689.241726018812,-44.16,7
03:19,480557476.0,10378.764771099692,-16.49,5
03:25,779946617.0,14816.177691225124,-19.72,2
03:37,910730524.0,7384.8491804257665,-4.54,2
03:49,169006407.0,10599.990184898435,-13.61,2
03:53,298000165.0,24530.18187905115,-32.84,8
03:53,216285378.0,22500.319384634913,-33.48,9
03:54,245690309.0,8640.324991542171,-22.37,5
03:55,549414742.0,6108.712488243714,-42.33,9
03:55,532478725.0,3969.534891851613,-30.74,9
03:55,124102251.0,2850.892014908387,-38.3,7
03:56,237493332.0,13120.840794337577,-2.92,2
03:57,324224854.0,2685.573422949689,-66.19,7
04:02,687135796.0,25677.881274960975,-19.28,2
04:02,450896297.0,12117.575798954977,-24.89,9
04:03,678330503.0,2070.4094777872087,-5.9,2
04:03,897714622.0,8094.782931456462,-4.71,7
04:04,414805878.0,11928.293574253385,-29.08,9
04:05,510101371.0,12154.968981073607,-46.35,9
04:05,558119802.0,30992.315529885924,-27.72,5
04:05,195895574.0,6424.570606515397,-31.88,9
04:06,766941757.0,1527.5512197168566,-40.39,9
04:07,633345190.0,5348.264573219799,-0.37,7
04:10,769311479.0,5371.1462309804,-29.68,2
04:16,668329719.0,7516.593319826285,-28.39,7
04:18,145387690.0,4216.522605616854,-17.9,9
04:21,673025413.0,1719.5676801019183,-11.92,5
04:21,402438092.0,356.9447999999988,-18.2,9
04:23,718058208.0,1515.9773494921126,-23.71,2
04:27,461990622.0,8277.57278946199,-0.24,2
04:30,120634201.0,4131.505329403303,-14.89,9
04:33,709608057.0,2258.459460014567,-43.02,9
04:36,195895574.0,6412.7082728119885,-11.86,7
04:37,518474507.0,12208.740777477533,-25.88,9
04:38,414805878.0,11893.470603515092,-34.82,2
04:42,221868392.0,4405.600829371215,-23.1,9
04:43,802697323.0,14491.279559920393,-36.13,9
04:44,987163717.0,5406.658480000005,-40.28,9
04:49,145387690.0,4156.6698643639265,-59.85,8
04:51,706250160.0,11140.369652615283,-34.88,5
04:59,419084831.0,-427.38727552610305,-25.38,9
05:00,179173981.0,4108.863199615602,-9.75,2
05:00,534204159.0,5552.703373797295,-17.66,5
05:02,867987292.0,1538.1086487849022,-13.51,7
05:04,973086490.0,9129.672788163594,-0.85,7
05:06,108563213.0,22454.16652276413,-26.31,2
05:06,809499628.0,15758.520584314188,-10.58,5
05:07,985188462.0,-903.1532112887752,-35.9,9
05:08,454356905.0,328.2640575521707,-2.09,5
05:08,113747882.0,11329.740584652494,-6.17,2
05:09,832564361.0,15089.191740226985,-0.15,8
05:10,639549973.0,5919.574827693168,-1.9,7
05:10,984783496.0,12867.008793203831,-15.35,9
05:11,853907490.0,6322.5837287189215,-13.64,7
05:16,519644021.0,2079.4392040383564,-30.81,7
05:21,213112754.0,6095.4728685282635,-10.9,9
05:23,699139822.0,999.1458778010284,-33.0,2
05:23,383625050.0,3635.602324880116,-66.01,2
05:25,785749304.0,7669.85687562203,-21.85,9
05:26,844835978.0,9285.13826400444,-40.64,2
05:32,683078800.0,1418.9702029448708,-17.94,9
05:32,229205098.0,6676.964514577053,-3.1,2
05:34,836110591.0,5813.796327623504,-37.61,9
05:34,146909202.0,2105.794548251867,-63.9,2
05:35,252760664.0,5664.911566976097,-15.67,8
05:36,285220959.0,11009.367739562334,-69.2,2
05:50,824916823.0,7989.226044502916,-27.1,9
05:51,433917275.0,6608.696084165917,-28.04,9
05:52,532478725.0,3966.6164880852975,-2.92,2
05:53,506618547.0,15197.899226135642,-3.69,2
05:53,779236304.0,-1013.0424045204678,-28.18,9
05:57,588565416.0,6895.909374156419,-8.71,2
06:04,749378808.0,3342.2972777407704,-21.8,7
06:06,556992209.0,10860.468573293392,-42.38,5
06:07,550169791.0,19724.891740407613,-34.57,7
06:07,992204045.0,5406.353145518725,-36.37,7
06:13,235881534.0,12320.962498724964,-3.9,2
06:15,930277104.0,9430.633213581945,-27.25,9
06:15,435984758.0,3786.7605637348056,-0.2,2
06:17,280268430.0,3970.7719129262496,-21.17,5
06:21,683319988.0,6317.409494580396,-37.57,7
06:22,308505160.0,11785.942019792346,-44.93,2
06:24,795847804.0,21768.43470088452,-38.8,5
06:28,108481285.0,8117.566412182218,-4.61,8
06:28,905860285.0,7981.2357109661725,-2.77,2
06:30,285873880.0,11250.711679930022,-23.66,7
06:33,213112754.0,6046.875730280725,-48.6,4
06:35,143003091.0,21518.426671132067,-2.37,7
06:35,500043411.0,12722.708054281142,-5.5,8
06:36,670102069.0,3079.1233146177583,-31.14,9
06:36,364357875.0,6702.289344863231,-40.65,2
06:36,290818242.0,6274.8014233771455,-14.77,7
06:39,108931112.0,13098.068476139531,-41.53,9
06:40,675806859.0,6284.687771240399,-39.07,5
06:43,601627384.0,3340.2551627609714,-43.0,9
06:45,912705941.0,17451.595693192317,-3.55,7
06:46,554792076.0,26342.180504823045,-13.59,7
06:47,187111705.0,5937.038536701918,-18.76,7
06:47,657139925.0,12723.180922515025,-17.25,9
06:52,842682241.0,4616.6624534927805,-31.42,2
06:52,475117511.0,7118.567249764253,-67.5,8
06:52,547010927.0,21408.81377390475,-33.47,7
06:55,391559884.0,-289.8348000000006,-31.01,9
06:57,822135975.0,10227.645132646723,-0.18,2
07:02,785749304.0,7669.5969453490525,-0.26,7
07:02,647936800.0,3117.6528703036743,-28.91,7
07:06,183888402.0,17167.564973285396,-27.94,9
07:08,518474507.0,12208.21458527091,-0.53,2
07:11,678330503.0,2062.9094777872087,-7.5,9
07:13,885259672.0,2984.0758770991806,-5.83,5
07:13,264550521.0,8875.093697760252,-28.86,2
07:14,887853850.0,9795.625586038366,-21.26,8
07:15,930277104.0,9391.755177189454,-38.88,7
07:18,776431321.0,3106.63933082259,-17.26,5
07:19,331450202.0,6684.250721469586,-26.29,2
07:24,344219145.0,7198.706151568211,-19.16,2
07:25,994214354.0,8868.169758529868,-31.44,9
07:26,256002321.0,5305.132715188635,-14.99,9
07:27,322221939.0,3242.942415574154,-12.52,2
07:29,730002588.0,11985.783079291945,-1.69,4
07:31,170637730.0,2174.248594676186,-20.69,2
07:36,899742927.0,11547.769255429514,-76.49,7
07:36,310375875.0,2297.683947345035,-35.84,7
07:42,572384506.0,6530.146110927916,-40.69,9
07:42,679943657.0,739.5178891801368,-27.51,2
07:44,196289502.0,14392.832636144783,-8.09,8
07:45,851181128.0,3634.3050925348703,-10.13,7
07:47,270374623.0,9083.147480647634,-20.13,5
07:47,366550080.0,24939.79645888409,-2.03,2
07:48,738958551.0,8274.631313404705,-63.46,7
07:50,449871732.0,9974.942550977836,-0.45,2
07:51,940569402.0,5041.127303655348,-4.81,5
07:52,482513594.0,4996.413690579941,-6.47,2
07:53,549414742.0,6081.623692739301,-27.09,2
07:56,851649498.0,9564.00369698076,-12.03,7
08:00,752362502.0,7733.509133753779,-21.74,7
08:00,705848712.0,25014.64745024443,-13.24,9
08:05,639409800.0,33386.930319681516,-36.55,7
08:07,143061865.0,6391.938140019383,-38.61,2
08:09,399538448.0,6776.757794127588,-5.05,9
08:11,336557504.0,1122.3458372010195,-7.8,9
08:14,901432314.0,3108.347297655635,-5.0,9
08:15,987229118.0,3438.20964483176,-18.02,8
08:15,806358207.0,11421.514315164395,-14.58,7
08:16,822250278.0,5594.934758387465,-19.39,5
08:17,948558249.0,8415.488081706882,-5.2,9
08:19,237493332.0,13086.736794337578,-34.1,5
08:19,408057540.0,3889.25707280612,-4.7,9
08:19,885259672.0,2978.4758770991807,-5.6,9
08:20,949032480.0,3867.3596611410007,-8.56,2
08:21,616924659.0,-167.6254201769147,-13.1,5
08:22,815385232.0,9233.67762024679,-8.34,5
08:22,873701090.0,226.91329480942431,-47.89,7
08:24,874431242.0,7367.152792640004,-5.96,7
08:24,134461671.0,5263.143988368079,-11.47,7
08:25,853907490.0,6274.479728718921,-48.1,5
08:28,891716230.0,99.8240513926162,-26.89,5
08:29,700138124.0,4835.710534192462,-0.97,7
08:29,504055745.0,-477.1327386582332,-47.55,5
08:29,613729471.0,8247.313871654334,-8.57,2
08:29,478986718.0,-1292.734500000001,-40.26,5
08:31,384497904.0,452.8984499999991,-23.5,5
08:31,971129830.0,-2143.750649999999,-13.71,5
08:32,127809299.0,877.2391534850559,-42.87,5
08:33,119993184.0,-2086.1444029108625,-26.68,5
08:34,834581602.0,210.963649999999,-131.91,5
08:37,647472692.0,23449.7887249002,-57.79,7
08:38,586315521.0,11404.324989956523,-11.45,5
08:39,248142083.0,-406.31556529748326,-39.44,5
08:40,158766229.0,-892.3568858934699,-86.24,5
08:41,138351025.0,-1192.1707500000002,-131.89,5
08:42,116169597.0,431.0889499999995,-241.08,5
08:43,873693307.0,8561.293473159485,-58.02,8
08:44,819515373.0,1363.0761360637916,-116.85,5
08:45,644751433.0,-1586.0281584655384,-30.11,5
08:46,651756497.0,11187.045680827676,-10.34,7
08:46,950234174.0,964.1710599724933,-99.01,5
08:47,461029994.0,6685.485411866108,-61.11,5
08:48,662610817.0,-1607.086831324928,-236.77,5
08:50,166019891.0,7233.615180098273,-0.78,2
08:51,534325901.0,5930.161536619809,-0.64,2
08:53,534908754.0,-1033.6455500000002,-65.82,5
08:54,556631012.0,193.1380730856782,-45.43,5
08:54,986267641.0,6768.802418732709,-19.43,2
08:58,344219145.0,7173.002151568211,-25.7,5
09:00,235881534.0,12181.648498724964,-139.31,5
09:00,506618547.0,15192.54922613564,-5.35,9
09:01,999752672.0,634.7768935333347,-7.5,9
09:02,417850087.0,15935.503450534492,-5.05,9
09:04,117273481.0,8480.239809844896,-6.1,9
09:04,540159353.0,10212.238538566777,-5.5,9
09:06,259015404.0,427.82477187307825,-4.0,5
09:06,690958123.0,19256.391364636416,-5.8,9
09:07,138609932.0,3069.6990032945855,-5.7,9
09:09,876890798.0,2619.4122206999323,-20.55,5
09:09,683319988.0,6312.409494580396,-5.0,9
09:10,618138606.0,790.1166472714345,-5.35,9
09:11,169006407.0,10595.290184898437,-4.7,9
09:13,572384506.0,6415.843110927916,-114.3,5
09:14,383833857.0,23179.39280697768,-5.65,9
09:15,441274121.0,10861.736085970744,-5.7,9
09:17,866941383.0,1166.096950000006,-83.51,5
09:17,613729471.0,8240.963871654334,-6.35,9
09:18,767447966.0,4293.404065512112,-6.01,4
09:19,851649498.0,9557.95369698076,-6.05,9
09:20,586315521.0,11397.424989956524,-6.9,9
09:21,558875206.0,2162.714310898952,-5.95,9
09:23,534204159.0,5478.413453797295,-74.29,4
09:24,500043411.0,12625.282054281142,-97.43,5
09:26,903663593.0,863.3207198350957,-18.97,7
09:26,727417797.0,5098.351500000012,-47.99,2
09:27,170637730.0,2113.5566146761857,-60.69,4
09:27,799453072.0,-468.16760000000113,-62.42,5
09:29,919185264.0,2674.08225976317,-6.99,1
09:31,425730826.0,1348.69690938872,-23.6,5
09:32,541639148.0,3319.72901818923,-4.7,7
09:32,259015404.0,295.5247718730783,-132.3,2
09:35,570269025.0,2582.027800644421,-38.81,5
09:35,279149837.0,879.3160499999985,-4.99,7
09:37,744398361.0,351.7609999999998,-64.5,2
09:38,462962606.0,2724.2500499999987,-68.0,5
09:42,970298834.0,2538.18202299727,-126.69,2
09:43,304455868.0,1917.6529395154853,-2.16,7
09:45,215311171.0,5845.862481846508,-25.96,1
09:47,856957948.0,9120.038187619512,-8.98,4
09:47,700138124.0,4739.110534192461,-96.6,2
09:49,264550521.0,8865.033697760253,-10.06,7
09:50,903663593.0,748.9457198350957,-114.38,2
09:53,987656636.0,5395.800590329663,-41.28,2
09:54,116169597.0,222.48894999999956,-208.6,2
09:54,165691047.0,-507.014600000001,-45.7,5
09:55,618514666.0,19599.932041064316,-12.98,7
09:56,718058208.0,1500.9623494921125,-15.01,4
09:56,916270283.0,1511.3542499999994,-20.97,1
09:58,865748375.0,3264.513183847352,-72.79,2
09:58,143003091.0,21209.726671132063,-308.7,2
10:02,903663593.0,604.5707198350957,-144.38,2
10:10,700138124.0,4690.110534192461,-49.0,2
10:12,977899503.0,-623.7531064191473,-113.19,5
10:14,538003940.0,1065.1200000000083,-61.98,6
10:17,792845450.0,422.36615000000097,-39.98,4
10:20,744398361.0,329.2709999999998,-22.49,2
10:21,116169597.0,25.116949999999576,-197.37,2
10:24,865748375.0,3232.355183847352,-32.16,2
10:25,441142605.0,1935.9210388780311,-12.99,2
10:25,137822385.0,3436.931643181048,-6.6,9
10:30,143003091.0,21039.654671132063,-170.07,2
10:32,680773155.0,131.2441833310917,-32.55,5
10:35,596171893.0,-93.62440517448891,-10.98,1
10:38,749378808.0,3319.0472777407704,-23.25,2
10:39,609939116.0,6589.299178499847,-196.79,5
10:41,700138124.0,4543.110534192461,-147.0,2
10:42,534204159.0,5448.993453797295,-29.42,7
10:47,744398361.0,279.2709999999998,-50.0,2
10:52,143003091.0,20889.168671132065,-150.49,2
10:53,679943657.0,603.0808891801368,-136.44,5
10:56,519644021.0,1995.3342040383563,-84.1,5
10:57,910730524.0,7258.891180425767,-125.96,2
10:58,722358036.0,490.6162406270829,-79.99,2
11:00,596171893.0,-125.61440517448892,-31.99,2
11:03,348325817.0,9198.541755977154,-13.33,5
11:05,407574996.0,95.25145357602092,-26.42,5
11:06,609939116.0,6571.0211041748435,-18.28,7
11:11,910730524.0,7045.419180425767,-213.47,2
11:13,149684419.0,152.74299999999806,-28.53,5
11:24,520447032.0,7670.857589177682,-21.82,7
11:25,744398361.0,171.29099999999977,-107.98,2
11:25,143003091.0,20711.438671132066,-177.73,2
11:30,462962606.0,2689.2700499999987,-34.98,1
11:40,687135796.0,25669.521274960975,-8.36,4
11:46,767447966.0,4176.623065512112,-116.78,5
11:51,143003091.0,20585.452671132065,-125.99,2
11:57,246753533.0,-145.4154000000015,-37.33,5
12:02,996042490.0,5270.43070483161,-1.77,7
12:03,776431321.0,3053.1593308225906,-53.48,4
12:04,744398361.0,56.310999999999765,-114.98,2
12:11,749378808.0,3298.6572777407705,-20.39,9
12:11,508518911.0,-148.16524972098955,-37.69,9
12:14,956717493.0,985.5348610230712,-5.99,2
12:18,941285623.0,1267.7963990667702,-5.99,2
12:23,956717493.0,937.5448610230712,-47.99,2
12:25,744398361.0,-110.66900000000024,-166.98,2
12:33,116169597.0,-91.7410500000004,-116.86,2
12:35,970298834.0,2471.68202299727,-66.5,2
12:39,163470640.0,624.5450999999997,-79.97,4
12:52,348460748.0,247.4375499999991,-34.09,5
12:53,661295096.0,2813.400513321748,-96.59,2
12:55,970298834.0,2375.08202299727,-96.6,2
12:56,138969884.0,617.3259499999994,-120.56,5
12:58,277562576.0,81.495318105103,-5.9,9
13:02,744398361.0,-195.14900000000023,-84.48,2
13:02,191161970.0,-3772.823999999996,-60.02,5
13:03,799286313.0,-1405.6959128758615,-110.08,5
13:03,262767079.0,-1323.8466500000002,-49.6,5
13:07,903663593.0,561.4457198350957,-43.12,2
13:07,175452235.0,-925.8007499999997,-52.67,5
13:09,688712152.0,5965.45201717615,-6.6,9
13:12,585625048.0,1136.9726823533742,-5.65,9
13:14,348325817.0,9193.141755977154,-5.4,9
13:14,843174694.0,-4840.280999999998,-17.31,5
13:15,722358036.0,485.6162406270829,-5.0,9
13:20,322221939.0,3236.842415574154,-6.1,9
13:21,259015404.0,155.5247718730783,-140.0,2
13:22,340321732.0,1213.0970000000032,-5.4,9
13:30,744398361.0,-317.11900000000026,-121.97,2
13:40,932820758.0,-2567.779066775554,-17.47,5
13:43,578131296.0,376.8956194440438,-74.39,5
13:44,903663593.0,499.5707198350957,-61.88,2
13:44,936917570.0,-2792.9674999999975,-38.71,5
13:57,259015404.0,-5.4752281269217065,-161.0,2
14:03,147341222.0,-1916.0802753207952,-115.43,5
14:06,744211756.0,-4161.295749999994,-24.95,5
14:12,409370545.0,974.9292755455206,-32.14,7
14:16,744398361.0,-403.0990000000003,-85.98,2
14:40,809499628.0,15694.920584314188,-63.6,2
14:53,744398361.0,-586.5990000000003,-183.5,2
15:14,744398361.0,-665.5990000000003,-79.0,2
15:17,639549973.0,5895.534827693168,-24.04,4
15:24,625281433.0,-955.5247573707568,-16.98,9
15:35,744398361.0,-770.0790000000003,-104.48,2
15:47,625658193.0,-806.2086202437831,-131.1,5
15:53,744398361.0,-904.5690000000004,-134.49,2
15:54,321372947.0,-567.6181507890993,-26.29,5
15:55,517934629.0,861.1276787084264,-178.5,2
16:07,792845450.0,410.38615000000095,-11.98,1
16:08,128033695.0,1245.6043471173675,-12.94,2
16:10,158414827.0,-1804.9950000000017,-17.04,5
16:12,399144202.0,1137.2681037292184,-23.33,9
16:28,564744955.0,-678.999941411158,-81.74,5
16:29,517934629.0,821.1276787084264,-40.0,2
16:29,183186021.0,-380.79754999999886,-35.51,5
16:29,698076160.0,5707.142401975248,-9.99,4
16:32,713641917.0,719.827167877851,-54.99,2
16:32,912584712.0,-14.05138045526682,-12.98,7
16:34,227104649.0,2451.093034316177,-23.01,7
16:37,605116158.0,1986.136800000002,-22.97,5
16:47,170233640.0,-301.01376005010275,-49.99,4
16:48,744398361.0,-955.5590000000004,-50.99,2
16:51,399144202.0,1109.9804286305048,-27.29,8
16:53,885259672.0,2963.460877099181,-15.01,4
16:55,603721739.0,713.760899483184,-63.98,6
16:56,517934629.0,743.6276787084264,-77.5,2
17:12,475117511.0,7093.607249764253,-24.96,1
17:12,970298834.0,2170.01002299727,-205.07,2
17:13,683319988.0,6283.019494580396,-29.39,9
17:18,744398361.0,-1008.0290000000005,-52.47,2
17:19,558119802.0,30965.215529885925,-27.1,9
17:25,709608057.0,2172.799460014567,-85.66,2
17:25,633345190.0,5318.554573219799,-29.71,2
17:25,858560423.0,11135.935909769358,-13.23,2
17:27,780463728.0,2743.8689709422397,-57.98,2
17:28,815993333.0,5982.006559061408,-72.06,4
17:28,846550094.0,919.7747715014136,-6.99,4
17:28,854513972.0,1003.8655499999998,-32.95,7
17:31,237493332.0,13070.586794337578,-16.15,9
17:31,386729293.0,30121.36048728466,-51.99,2
17:32,719586818.0,16333.480078056851,-43.8,5
17:32,786879739.0,-2342.413294120557,-54.56,5
17:32,536924114.0,-917.2122555930962,-69.35,5
17:33,581655972.0,38642.466920588966,-2.83,2
17:33,984783496.0,12841.103738794529,-25.91,7
17:34,355602925.0,1209.7465451313744,-30.95,7
17:34,762896656.0,-250.4450018481413,-25.56,5
17:36,166019891.0,7202.003180098273,-31.61,5
17:36,834581602.0,68.473649999999,-142.49,2
17:36,143061865.0,6330.958140019384,-60.98,2
17:39,126929801.0,1766.962106340476,-108.21,5
17:40,822135975.0,10222.055132646725,-5.59,4
17:41,975345315.0,32585.311968376373,-61.98,2
17:42,120634201.0,4124.485329403303,-7.02,7
17:43,824916823.0,7959.07021990334,-30.16,7
17:43,876890798.0,2588.452220699932,-30.96,1
17:43,454129843.0,984.2310951665598,-6.99,7
17:44,833499132.0,1890.948150000001,-16.98,7
17:45,940569402.0,5024.777303655348,-16.35,9
17:47,887853850.0,9638.825586038369,-156.8,2
17:48,970298834.0,2027.22402299727,-142.79,2
17:48,835736339.0,1381.81332209188,-57.1,4
17:48,994214354.0,8856.452798266431,-11.72,7
17:48,506618547.0,15182.46922613564,-10.08,7
17:49,500043411.0,12565.202054281142,-60.08,2
17:49,420109571.0,330.62381071667954,-47.98,2
17:49,361201224.0,2692.5553223161437,-6.01,7
17:50,868377987.0,2400.0219958778507,-37.98,2
17:51,442070890.0,843.0124124443711,-11.98,1
17:52,780463728.0,2492.5829709422396,-251.29,2
17:52,489964679.0,19128.339656636075,-113.7,2
17:52,287480331.0,6828.3119036114485,-16.61,7
17:53,511179916.0,6282.520846297541,-11.37,5
17:53,704517789.0,16481.984484648685,-43.81,7
17:55,405945930.0,4446.771189413555,-26.97,7
17:59,151968462.0,6054.17102887951,-4.68,7
18:02,310375875.0,2260.0939473450353,-37.59,9
18:03,834581602.0,23.983649999998995,-44.49,2
18:03,670102069.0,3063.8068156965214,-15.32,2
18:07,131388684.0,20454.55709991112,-56.08,5
18:07,858989281.0,24864.078946665537,-10.49,9
18:08,887853850.0,9472.225586038368,-166.6,2
18:09,324224854.0,2633.073422949689,-52.5,2
18:09,768271776.0,-755.6198967665795,-16.7,9
18:12,656317661.0,-360.54835845859714,-96.38,5
18:13,780463728.0,2330.8969709422395,-161.69,2
18:15,556992209.0,10851.960073293392,-8.51,7
18:15,698076160.0,5590.487401975248,-116.66,5
18:15,587225252.0,4262.0888066288235,-107.39,5
18:16,975345315.0,32492.05796837637,-93.25,5
18:17,610450243.0,-973.6845999999998,-28.42,5
18:18,886921642.0,2724.7836584310185,-15.44,9
18:19,282102606.0,-330.18023757717367,-105.04,5
18:28,166019891.0,7199.9366400982735,-2.07,7
18:29,960208650.0,16737.41027566779,-16.82,7
18:30,587225252.0,4235.858806628824,-26.23,9
18:34,280098744.0,-78.14262212833438,-60.86,5
18:35,628470485.0,-430.8129700998768,-242.47,5
18:38,200080192.0,8502.606708857646,-100.79,5
18:40,196289502.0,14386.702636144784,-6.13,7
18:42,202320275.0,-985.4599000000004,-100.03,5
18:45,383833857.0,23177.680844414077,-1.71,2
18:46,651756497.0,11146.495680827677,-40.55,7
18:47,130154096.0,1274.4750017058784,-39.58,7
18:51,510101371.0,12148.57898107361,-6.39,7
18:55,627622066.0,2828.4649547156614,-79.96,5
18:56,104832000.0,-2994.8823589058443,-43.58,5
18:58,887853850.0,9437.095586038367,-35.13,9
19:00,929044080.0,-701.3111084943718,-16.84,5
19:02,779620857.0,-485.1313463851759,-137.56,5
19:02,491392945.0,4306.0055000000075,-59.99,5
19:03,897714622.0,8070.832931456463,-23.95,9
19:03,417850087.0,15879.659945728828,-55.84,2
19:04,245690309.0,8567.426991542172,-72.9,5
19:06,873693307.0,8479.757473159485,-81.54,5
19:07,613729471.0,8194.427871654334,-46.54,5
19:08,344522228.0,-2874.639488208393,-13.85,5
19:10,305778936.0,8949.843539533713,-16.98,9
19:11,832564361.0,15049.165740226985,-40.03,5
19:14,851181128.0,3605.7350925348705,-28.57,9
19:15,409971170.0,2274.014507858067,-3.68,7
19:21,169006407.0,10576.390184898435,-18.9,9
19:25,221868392.0,4403.163679326759,-2.44,8
19:31,969697937.0,-4717.115265670551,-28.17,5
19:31,690523499.0,-856.2214999999998,-78.76,5
19:35,522188082.0,7141.700267685198,-27.03,7
19:36,874431242.0,7346.382792640004,-20.77,9
19:37,517190750.0,1271.0585899154128,-26.46,5
19:39,147474476.0,3169.224357098796,-144.52,5
19:39,653640811.0,15906.998817254644,-22.23,8
19:40,736340277.0,8123.949999286669,-11.8,9
19:41,496395938.0,11208.51760054571,-9.62,5
19:41,925659248.0,-893.3708392295712,-75.31,5
19:46,441274121.0,10836.15080916843,-25.59,7
19:51,311467864.0,-915.324000000001,-68.57,5
19:59,859603181.0,2539.7914836712457,-3.21,4
20:09,679911053.0,2103.6219425350955,-15.04,5
20:10,129018172.0,8327.942351104692,-6.88,7
20:16,672913754.0,10387.170424547156,-117.66,5
20:21,865748375.0,3118.8291838473524,-113.53,5
20:26,806358207.0,11345.767315164396,-75.75,5
20:27,806358207.0,11307.317315164397,-38.45,9
20:32,585596026.0,2775.5779838766703,-95.28,5
20:38,471897866.0,6860.7300802245345,-18.71,5
20:42,315546581.0,26324.89975529389,-12.26,7
20:50,399538448.0,6729.225135479294,-47.53,7
20:53,287480331.0,6802.071903611449,-26.24,9
20:56,392270893.0,11859.662089514704,-70.45,5
20:58,305778936.0,8919.261675391153,-30.58,2
20:58,398429109.0,242.1990000000011,-84.91,5
20:58,433917275.0,6602.254685163898,-6.44,5
21:00,282837512.0,12645.849298582614,-18.2,4
00:32,779946617.0,14793.415029765752,-22.76,5
01:10,421881811.0,2060.8213942146067,-2.01,5
01:16,108931112.0,13066.888476139531,-31.18,9
01:19,699139822.0,984.8151023826446,-14.33,7
02:09,679662108.0,14998.734201742143,-57.28,2
02:21,570323670.0,2621.1525344682113,-37.62,9
02:38,687135796.0,25640.955937214418,-28.57,5
02:42,414805878.0,11855.540603515092,-37.93,9
02:42,779236304.0,-1051.4924045204675,-38.45,9
02:44,348325817.0,9152.111755977154,-41.03,9
02:45,310375875.0,2226.003947345035,-34.09,9
02:49,264550521.0,8843.478392792733,-21.56,2
02:50,705848712.0,24998.407450244427,-16.24,9
02:50,433917275.0,6575.074685163898,-27.18,9
02:58,670102069.0,3025.0668156965216,-38.74,9
02:59,949032480.0,3836.631386746058,-30.73,7
03:06,510101371.0,12110.44898107361,-38.13,9
03:13,370521542.0,24609.445966453462,-79.8,2
03:20,873693307.0,8463.317473159485,-16.44,9
03:21,705848712.0,24988.93244201934,-9.48,2
03:27,221868392.0,4371.313679326759,-31.85,9
03:29,128033695.0,1213.1243471173675,-32.48,9
03:32,183888402.0,17127.934973285395,-39.63,9
03:34,203466392.0,2173.0156022693727,-23.11,5
03:37,235881534.0,12169.990311306206,-11.66,5
03:39,549414742.0,6041.843692739301,-39.78,9
03:42,678330503.0,2035.0856704242235,-27.82,5
03:46,822250278.0,5579.165788919265,-15.77,2
03:47,355733816.0,4750.4885060489905,-15.97,2
03:49,940569402.0,5012.626530911727,-12.15,7
03:51,336171116.0,-917.9375500000006,-26.23,9
03:51,873693307.0,8453.785031722035,-9.53,8
03:55,657139925.0,12703.180922515025,-20.0,9
03:55,973086490.0,9110.422788163594,-19.25,9
03:57,704517789.0,16472.542678264446,-9.44,4
03:58,221868392.0,4352.766083037777,-18.55,5
04:00,216285378.0,22463.929384634914,-36.39,9
04:03,256002321.0,5293.192715188636,-11.94,9
04:05,383833857.0,23162.341482552867,-15.34,2
04:08,169006407.0,10533.54383382257,-42.85,5
04:10,520447032.0,7637.947589177682,-32.91,9
04:15,106601471.0,9833.849831507374,-30.27,7
04:17,290818242.0,6272.59215721821,-2.21,8
04:19,113747882.0,11293.200584652492,-36.54,9
04:20,310375875.0,2210.754141603703,-15.25,2
04:21,237493332.0,13054.755191354265,-15.83,2
04:21,324224854.0,2631.034413235426,-2.04,2
04:26,604288474.0,1964.8862516983504,-1.28,5
04:30,120634201.0,4112.535329403303,-11.95,9
04:33,639409800.0,33343.29493852247,-43.64,7
04:37,738958551.0,8268.827622395524,-5.8,8
04:37,651756497.0,11135.580101533424,-10.92,2
04:37,851181128.0,3588.0450925348705,-17.69,9
04:40,518474507.0,12163.92458527091,-44.29,9
04:41,623156843.0,3768.0224018740328,-31.39,2
04:43,639549973.0,5869.180593046276,-26.35,7
04:45,601627384.0,3294.963926059094,-43.18,9
04:45,960208650.0,16705.315784005386,-32.09,5
04:49,973086490.0,9097.476190486688,-12.95,7
04:50,994214354.0,8826.43279826643,-30.02,9
04:51,858989281.0,24857.977829731302,-6.1,2
04:56,683319988.0,6277.222105371325,-5.8,5
05:00,647936800.0,3103.5376087754826,-14.12,7
05:03,613729471.0,8180.63586773975,-13.79,2
05:09,719586818.0,16302.607427932044,-30.87,8
05:10,494789005.0,2578.592403064033,-26.89,2
05:11,520447032.0,7560.783804636963,-77.16,2
05:12,146909202.0,2104.252254688442,-1.54,2
05:13,213112754.0,6030.343107703058,-16.53,4
05:13,482513594.0,4982.963690579942,-13.45,9
05:13,874431242.0,7264.004119491882,-82.38,8
05:16,575652395.0,1989.0680174267784,-8.21,2
05:20,187111705.0,5896.070180474733,-40.97,5
05:20,500043411.0,12560.893022643584,-4.31,7
05:23,667367404.0,8655.802887951839,-8.46,8
05:26,414805878.0,11852.713598603916,-2.83,5
05:26,887853850.0,9431.115247999413,-5.98,5
05:28,984783496.0,12826.623738794528,-14.48,9
05:33,836110591.0,5779.446327623504,-34.35,9
05:33,435984758.0,3783.989653051455,-2.77,8
05:39,809499628.0,15681.490584314188,-13.43,9
05:39,506618547.0,15166.12922613564,-16.34,9
05:45,842682241.0,4611.900376716941,-4.76,7
05:48,761272540.0,-221.6601000000012,-27.4,9
05:49,471897866.0,6820.6315114339,-40.1,2
05:49,489964679.0,19091.399656636077,-36.94,9
05:51,473820682.0,10291.27772356148,-49.42,2
05:55,187541224.0,839.2257620279239,-33.12,9
05:56,145387690.0,4134.969864363927,-21.7,9
05:57,482513594.0,4978.760460209768,-4.2,7
05:59,305778936.0,8895.581675391153,-23.68,9
05:59,519644021.0,1959.6068134173013,-35.73,4
06:03,151968462.0,6007.565435311451,-46.61,5
06:04,196289502.0,14368.722636144785,-17.98,9
06:04,836110591.0,5775.836902443037,-3.61,2
06:06,951817450.0,8300.90318383635,-32.87,2
06:06,766941757.0,1488.8512197168566,-38.7,9
06:06,587225252.0,4204.218806628824,-31.64,9
06:10,752362502.0,7673.804988940375,-59.7,8
06:10,252760664.0,5652.961566976097,-11.95,9
06:12,383625050.0,3631.848957821763,-3.75,5
06:21,108481285.0,8060.0111205834655,-57.56,7
06:21,673025413.0,1711.6176800294063,-7.95,8
06:27,785210466.0,1682.712819997711,-29.31,8
06:27,905860285.0,7951.746183304647,-29.49,8
06:30,987656636.0,5327.181572499223,-68.62,2
06:30,624500124.0,2883.926215918163,-28.39,7
06:32,718058208.0,1482.4847600534524,-18.48,7
06:35,758160963.0,7399.643467961575,-17.61,2
06:36,532478725.0,3927.1264880852978,-39.49,9
06:36,322221939.0,3225.003472786763,-11.84,2
06:36,522188082.0,7139.7112710410265,-1.99,2
06:38,586315521.0,11369.860534727824,-27.56,2
06:40,899742927.0,11524.249702202816,-23.52,7
06:41,409971170.0,2270.3640302557333,-3.65,2
06:44,730002588.0,11958.23335981337,-27.55,2
06:44,987163717.0,5360.2384800000045,-46.42,9
06:47,518474507.0,12126.99025893078,-36.93,7
06:47,461990622.0,8275.158912323324,-2.41,8
06:48,700138124.0,4524.183244903046,-18.93,4
06:50,256002321.0,5287.972914898286,-5.22,2
06:53,956717493.0,931.892172224932,-5.65,7
06:58,795847804.0,21758.99684782688,-9.44,7
07:04,670102069.0,2980.357900551894,-44.71,2
07:04,108563213.0,22449.29910273803,-4.87,2
07:05,853907490.0,6271.427974366304,-3.05,8
07:06,549414742.0,6015.618173833174,-26.23,7
07:09,113747882.0,11287.748203184456,-5.45,2
07:12,885259672.0,2893.2901774726265,-70.17,7
07:12,124102251.0,2835.4848825525014,-15.41,8
07:13,407574996.0,40.15160938093659,-55.1,5
07:15,179173981.0,4106.01937491627,-2.84,8
07:16,832564361.0,15040.70769520703,-8.46,7
07:16,930277104.0,9321.231566831137,-70.52,2
07:17,480557476.0,10353.902092586242,-24.86,2
07:18,259015404.0,-9.283470924809963,-3.81,5
07:18,450896297.0,12083.958270938076,-33.62,7
07:31,270374623.0,9041.85176908947,-41.3,7
07:32,441274121.0,10833.73040965328,-2.42,8
07:33,315546581.0,26320.812807237697,-4.09,4
07:36,198946608.0,3046.2927505660086,-30.88,7
07:39,865748375.0,3117.2643856426007,-1.56,5
07:39,822135975.0,10212.735154741844,-9.32,2
07:44,550169791.0,19724.36786649697,-0.52,5
07:47,308505160.0,11769.4210110956,-16.52,2
07:49,785749304.0,7623.498117978305,-46.1,7
07:50,851649498.0,9507.99872476494,-49.95,2
07:51,252760664.0,5645.484989419166,-7.48,5
07:53,392270893.0,11833.997269699728,-25.66,7
07:56,581655972.0,38620.54916426255,-21.92,5
07:57,282837512.0,12639.51225818337,-6.34,2
07:59,237684254.0,5278.961526877966,-9.85,2
08:01,769311479.0,5352.468727842394,-18.68,8
08:04,399538448.0,6722.7751354792945,-6.45,9
08:04,285220959.0,10974.225819738966,-35.14,5
08:04,386729293.0,30108.09126111289,-13.27,7
08:06,454129843.0,979.18109516656,-5.05,9
08:14,336557504.0,1116.3958372010195,-5.95,9
08:18,885259672.0,2888.2401774726263,-5.05,9
08:19,506618547.0,15152.333300709992,-13.8,5
08:22,678851253.0,2905.514628857003,-18.21,2
08:23,970298834.0,1957.581018555666,-69.64,7
08:24,486495235.0,1234.0721393887163,-34.03,5
08:25,749378808.0,3234.801252468336,-63.86,7
08:29,387957305.0,-2639.346105980079,-21.64,5
08:31,762859681.0,283.8400999999988,-30.43,5
08:34,854895960.0,2685.8751787487204,-59.02,5
08:38,660789920.0,-2451.5183473823727,-22.18,5
08:38,564214408.0,-258.07251527427394,-29.37,5
08:41,235663459.0,-78.23607018798481,-38.8,5
08:44,534325901.0,5891.616239605498,-38.55,5
08:44,511179916.0,6266.771223049649,-15.75,8
08:45,499410772.0,-2868.0168629051623,-37.29,5
08:46,815385232.0,9221.717730876488,-11.96,4
08:48,366550080.0,24901.861951738392,-37.93,5
08:51,979892433.0,-1583.496900000001,-29.37,5
08:51,229205098.0,6671.691076244722,-5.27,8
08:51,364357875.0,6656.689519152498,-45.6,2
08:52,824916823.0,7936.419785309926,-22.65,7
08:52,992204045.0,5351.627145518725,-54.73,5
08:53,978951113.0,-1055.691342590419,-150.62,5
08:56,266777719.0,128.97893378023957,-51.4,5
09:01,801500539.0,-3431.0236999999993,-81.15,5
09:01,117273481.0,8474.939809844896,-5.3,9
09:01,821971408.0,244.1771102355434,-58.45,5
09:02,506618547.0,15144.433300709992,-7.9,9
09:07,142791593.0,-342.3413500000004,-98.69,5
09:07,558875206.0,2157.2643108989523,-5.45,9
09:08,215311171.0,5831.1197666026865,-14.74,5
09:10,822718326.0,10029.111522634275,-36.06,5
09:13,613729471.0,8173.53586773975,-7.1,9
09:13,383833857.0,23156.99148255287,-5.35,9
09:13,170637730.0,2080.947647947797,-32.61,7
09:15,322221939.0,3140.6884727867628,-84.31,5
09:15,290818242.0,6266.84215721821,-5.75,9
09:16,417850087.0,15874.559945728826,-5.1,9
09:17,690958123.0,19250.741364636415,-5.65,9
09:17,124102251.0,2830.434882552501,-5.05,9
09:19,764450279.0,19390.301570615626,-12.28,7
09:19,225210798.0,359.2727737592086,-112.64,5
09:21,192202372.0,61.09493388879784,-167.64,5
09:21,149684419.0,76.81329999999805,-75.93,5
09:21,355733816.0,4708.538506048991,-41.95,7
09:22,570323670.0,2573.1125344682114,-48.04,2
09:22,540159353.0,10204.738538566777,-7.5,9
09:24,143061865.0,6214.156140019384,-116.8,5
09:25,903953091.0,3051.717038995665,-79.97,4
09:25,162162212.0,938.4645433273088,-153.3,5
09:26,425730826.0,1300.70690938872,-47.99,2
09:30,727417797.0,5033.371500000012,-64.98,4
09:30,715068825.0,1058.0044999999998,-92.9,5
09:32,828532554.0,150.3668765071483,-59.98,2
09:32,176922958.0,509.9395471976496,-97.29,2
09:33,600585971.0,61.98959999999953,-90.65,5
09:33,910730524.0,7015.501823152911,-29.92,5
09:38,225210798.0,269.30277375920855,-89.97,2
09:42,194745206.0,342.6063720912431,-163.74,2
09:44,409370545.0,825.8292755455205,-149.1,2
09:46,909676212.0,264.85140453202735,-19.97,7
09:46,280268430.0,3934.640985239604,-36.13,2
09:47,216286013.0,-86.37674334606001,-103.92,5
09:49,987656636.0,5168.281572499223,-158.9,2
09:50,919185264.0,2656.11225976317,-17.97,7
09:54,279149837.0,869.3260499999985,-9.99,1
09:58,117308635.0,517.6317165181451,-12.37,2
09:59,403383649.0,1303.7328048612508,-248.47,2
10:07,172084472.0,-120.35072159571854,-121.98,2
10:08,137822385.0,3431.431643181048,-5.5,9
10:09,769319491.0,1305.3569999999993,-14.09,5
10:10,176922958.0,335.6955471976496,-174.24,2
10:20,409370545.0,735.5292755455206,-90.3,2
10:20,822250278.0,5511.956538919265,-67.21,4
10:24,348325817.0,9086.485715977156,-65.63,4
10:26,194745206.0,178.1623720912431,-164.44,2
10:28,403383649.0,1144.8888048612507,-158.84,2
10:31,108931112.0,12994.088476139534,-72.8,2
10:34,473820682.0,10214.45972356148,-76.82,5
10:38,172084472.0,-294.84072159571855,-174.49,2
10:42,987656636.0,5077.981572499223,-90.3,2
10:48,117308635.0,500.06171651814515,-17.57,4
10:49,145387690.0,4095.527228150636,-39.44,5
10:49,108931112.0,12917.788476139534,-76.3,2
10:53,668175891.0,441.9919731584989,-1.5,4
10:54,494789005.0,2570.192403064033,-8.4,5
10:55,143003091.0,20565.89448258988,-19.56,2
10:56,409370545.0,582.2292755455206,-153.3,2
10:56,534204159.0,5373.042873916345,-75.95,7
11:00,194745206.0,45.89037209124311,-132.27,2
11:02,280268430.0,3868.160985239603,-66.48,4
11:03,117308635.0,461.9217165181451,-38.14,2
11:07,609939116.0,6529.022421642336,-42.0,4
11:09,503575533.0,6152.3988869387695,-22.02,2
11:13,270374623.0,9035.72176908947,-6.13,4
11:17,409370545.0,523.4292755455207,-58.8,2
11:23,718058208.0,1472.4847600534524,-10.0,1
11:25,497772347.0,564.6637999999979,-68.49,5
11:30,792845450.0,382.38615000000095,-28.0,2
11:31,322221939.0,3109.5384727867627,-31.15,7
11:35,815993333.0,5899.770559061408,-82.24,5
11:35,987656636.0,4965.981572499223,-112.0,2
11:47,586041848.0,-100.8123000000012,-240.1,2
11:50,355940285.0,7268.392978189683,-120.0,4
11:56,497772347.0,431.6637999999979,-133.0,2
11:56,134461671.0,5261.598820495439,-1.55,7
11:57,194745206.0,-155.68162790875687,-201.57,2
12:03,987656636.0,4777.681572499223,-188.3,2
12:04,172084472.0,-387.3107215957185,-92.47,2
12:07,492850697.0,-778.3689133341363,-33.28,9
12:09,142791593.0,-364.37135000000035,-22.03,9
12:15,270374623.0,9020.78176908947,-14.94,9
12:21,586041848.0,-208.6123000000012,-107.8,2
12:25,172084472.0,-491.3007215957185,-103.99,2
12:25,520447032.0,7501.713804636964,-59.07,2
12:29,298000165.0,24324.38187905115,-205.8,2
12:29,987656636.0,4494.881572499223,-282.8,2
12:30,669503912.0,-210.69944965118276,-24.98,9
12:34,766941757.0,1448.1911074467778,-40.66,2
12:39,168414279.0,-412.70271572507863,-14.09,5
12:40,172084472.0,-590.7907215957185,-99.49,2
12:44,298000165.0,24163.38187905115,-161.0,2
12:45,298007503.0,704.6251036256333,-57.96,5
12:47,766941757.0,1416.591107446778,-31.6,6
12:48,569687509.0,-2161.6104,-42.49,5
12:49,985188462.0,-934.4032112887752,-31.25,9
12:53,172084472.0,-773.2707215957186,-182.48,2
12:53,866941383.0,1106.116950000006,-59.98,4
12:57,987656636.0,4099.381572499223,-395.5,2
13:00,187111705.0,5891.370180474733,-4.7,9
13:03,259015404.0,-14.583470924809966,-5.3,9
13:10,277562576.0,74.995318105103,-6.5,9
13:16,586041848.0,-438.2123000000011,-229.6,2
13:18,499244466.0,-581.5671812834223,-96.24,5
13:20,585625048.0,1131.9726823533742,-5.0,9
13:22,322221939.0,3103.5384727867627,-6.0,9
13:23,172084472.0,-861.2507215957186,-87.98,2
13:25,598586358.0,-3429.842449999996,-52.75,5
13:26,941285623.0,1157.0423990667705,-110.75,5
13:26,824218857.0,-3583.0211608454283,-72.07,5
13:37,987656636.0,3810.9815724992222,-288.4,2
13:41,596171893.0,-130.6044051744889,-4.99,7
13:41,586041848.0,-528.5123000000011,-90.3,2
13:42,409370545.0,401.6292755455206,-121.8,2
13:46,668175891.0,372.0672231584989,-69.92,5
13:47,172084472.0,-969.2407215957186,-107.99,2
13:52,828750680.0,1066.2523452136795,-6.99,4
13:56,172084472.0,-1036.7007215957185,-67.46,2
13:58,409370545.0,303.62927554552067,-98.0,2
14:26,583558311.0,-1064.7652152486676,-64.76,5
14:27,503575533.0,6146.3988869387695,-6.0,2
14:28,919185264.0,2649.757631239692,-6.35,5
14:30,172084472.0,-1189.1907215957183,-152.49,2
14:33,497772347.0,375.6637999999979,-56.0,2
14:45,575652395.0,1959.0180174267784,-30.05,2
14:59,497772347.0,285.36379999999787,-90.3,2
14:59,987656636.0,3526.0815724992226,-284.9,2
15:05,172084472.0,-1235.6807215957183,-46.49,2
15:15,987656636.0,3234.881572499223,-291.2,2
15:25,172084472.0,-1412.6607215957183,-176.98,2
15:50,172084472.0,-1581.6507215957186,-168.99,2
15:57,409370545.0,172.02927554552068,-131.6,2
16:00,538003940.0,1026.7800000000086,-38.34,9
16:04,987656636.0,3009.4815724992227,-225.4,2
16:07,565175333.0,-3674.1610227298265,-44.72,5
16:08,788740658.0,1477.1490810387163,-13.46,2
16:13,718058208.0,1353.7507600534525,-118.73,5
16:18,376271050.0,777.6628069057438,-11.98,4
16:22,679911053.0,1956.9579425350955,-146.66,5
16:24,901037631.0,304.29932309640714,-39.8,9
16:29,286484726.0,362.7628267328863,-22.0,2
16:31,409370545.0,34.1292755455207,-137.9,2
16:32,345582855.0,-295.80234717945075,-44.09,5
16:35,987656636.0,2821.1815724992225,-188.3,2
16:36,180616589.0,465.9265281236176,-16.51,5
16:36,570575024.0,-1196.1342000000006,-66.37,5
16:38,867987292.0,1510.9181464624444,-27.19,5
16:39,762700245.0,-514.8922999999975,-48.89,5
16:44,409370545.0,-21.8707244544793,-56.0,2
16:45,172084472.0,-1612.6207215957186,-30.97,2
16:47,456221621.0,-559.7438326973719,-60.98,5
16:51,409370545.0,-217.8707244544793,-196.0,2
16:53,817294757.0,-2706.9633,-46.01,5
17:00,519935524.0,-222.90265026248096,-49.74,5
17:01,399144202.0,1107.4796104668903,-2.5,2
17:04,497772347.0,49.46379999999789,-235.9,2
17:06,131388684.0,20441.61709991112,-12.94,9
17:08,987656636.0,2702.8815724992223,-118.3,2
17:10,492215823.0,896.588573815444,-12.23,1
17:13,858989281.0,24851.977829731302,-6.0,9
17:19,603721739.0,688.760899483184,-25.0,2
17:20,951817450.0,8278.91318383635,-21.99,7
17:21,113747882.0,11267.178203184456,-20.57,4
17:21,496395938.0,11182.643207567611,-25.87,2
17:22,196289502.0,14364.023909829368,-4.7,7
17:22,758160963.0,7387.603467961575,-12.04,7
17:22,698076160.0,5579.0574645031475,-11.43,2
17:22,221868392.0,4347.616083037778,-5.15,7
17:22,996042490.0,5262.93070483161,-7.5,7
17:23,897714622.0,8053.836037853761,-17.0,5
17:25,836110591.0,5760.196902443036,-15.64,4
17:26,172084472.0,-1661.1207215957186,-48.5,2
17:27,296770890.0,1454.884010379083,-60.98,2
17:27,409370545.0,-280.8707244544793,-63.0,2
17:28,854513972.0,918.8855499999996,-84.98,2
17:28,854895960.0,2632.8751787487204,-53.0,2
17:28,534325901.0,5876.716239605498,-14.9,9
17:28,429556122.0,5374.168478442135,-150.44,2
17:28,887853850.0,9402.085247999412,-29.03,9
17:30,471897866.0,6785.181511433901,-35.45,2
17:31,683319988.0,6240.842105371325,-36.38,9
17:32,417850087.0,15854.373205305044,-20.19,7
17:33,999752672.0,629.7868935333347,-4.99,7
17:33,433917275.0,6528.863168734938,-46.21,2
17:33,603721739.0,660.8008994831839,-27.96,1
17:33,844835978.0,9267.93226400444,-17.21,5
17:35,752362502.0,7645.704988940374,-28.1,7
17:35,653640811.0,15903.415972154506,-3.58,8
17:35,408057540.0,3827.36707280612,-61.89,2
17:35,497772347.0,-156.3362000000021,-205.8,2
17:37,113747882.0,11249.668203184456,-17.51,7
17:40,899692478.0,-1997.8665935240072,-60.31,5
17:40,138609932.0,3057.7590032945855,-11.94,4
17:42,500043411.0,12520.543022643584,-40.35,7
17:45,558119802.0,30947.1144140673,-18.1,4
17:45,859603181.0,2511.611483671246,-28.18,9
17:46,441274121.0,10805.08640965328,-28.64,4
17:47,471897866.0,6746.741511433901,-38.44,7
17:48,698955014.0,234.88476695166673,-5.99,4
17:48,117273481.0,8457.959809844897,-16.98,7
17:48,844835978.0,9165.07426400444,-102.86,2
17:49,955035930.0,1402.833479171477,-30.99,2
17:50,147474476.0,3146.264357098796,-22.96,7
17:52,633345190.0,5300.544573219799,-18.01,7
17:52,124125096.0,-1.1386056121976935,-86.28,5
17:53,315078351.0,6742.299375374218,-153.3,2
17:53,172084472.0,-1756.5907215957186,-95.47,2
17:53,414805878.0,11846.453598603915,-6.26,2
17:56,769311479.0,5313.088727842394,-39.38,1
17:56,858989281.0,24845.6878297313,-6.29,1
17:57,409370545.0,-391.4707244544793,-110.6,2
17:58,550832673.0,2066.744016395508,-31.61,8
17:59,551755686.0,5931.783212897711,-255.5,7
18:00,647936800.0,3070.5976087754825,-32.94,9
18:02,785749304.0,7601.198117978305,-22.3,9
18:03,858560423.0,11004.013909769355,-131.92,5
18:05,824916823.0,7909.139785309926,-27.28,9
18:07,226703987.0,1746.7712999999997,-36.89,5
18:09,949032480.0,3799.781386746058,-36.85,9
18:09,308505160.0,11682.6350110956,-86.79,2
18:10,200080192.0,8489.816708857645,-12.79,9
18:11,409370545.0,-558.0707244544793,-166.6,2
18:12,868377987.0,2308.5219958778507,-91.5,2
18:12,586041848.0,-816.9123000000011,-288.4,2
18:13,315078351.0,6474.913375374217,-267.39,2
18:17,195895574.0,6396.018272811989,-16.69,9
18:19,235663459.0,-103.8760701879848,-25.64,9
18:20,987656636.0,2515.9815724992222,-186.9,2
18:21,736340277.0,8087.157999286668,-36.79,5
18:23,308505160.0,11647.6350110956,-35.0,2
18:26,373163757.0,9939.005129575917,-12.01,7
18:28,255814263.0,3185.3807315504905,-41.48,7
18:33,704517789.0,16255.549678264446,-216.99,5
18:33,124102251.0,2750.0468825525013,-80.39,5
18:34,551755686.0,5737.18321289771,-194.6,4
18:35,833899961.0,966.3477442498694,-73.91,5
18:36,687135796.0,25624.715937214416,-16.24,9
18:37,987656636.0,2390.681572499222,-125.3,2
18:39,857754342.0,587.071182099383,-41.97,4
18:40,461029994.0,6633.995411866108,-51.49,4
18:40,992204045.0,5303.436843923262,-48.19,7
18:40,893134725.0,488.4506819367792,-28.41,5
18:42,308505160.0,11552.4490110956,-95.19,2
18:43,286484726.0,340.0628267328863,-22.7,9
18:44,886921642.0,2663.5196584310183,-61.26,5
18:45,868377987.0,2211.0219958778507,-97.5,2
18:45,151968462.0,5914.556435311451,-93.01,5
18:50,897592348.0,14289.036902342945,-13.79,7
18:50,433917275.0,6526.726948734938,-2.14,7
18:50,170233640.0,-313.9812600501027,-12.97,5
18:51,886921642.0,2661.192618188277,-2.33,7
18:54,709608057.0,2135.469460014567,-37.33,9
18:59,802697323.0,14447.67955992039,-43.6,9
19:00,679911053.0,1901.4496351562752,-15.53,7
19:02,128030172.0,-733.0629274498499,-83.93,5
19:05,213096759.0,-1663.8741082144395,-120.03,5
19:05,670427480.0,-66.24234999999858,-30.14,9
19:05,768271776.0,-839.3300967665795,-83.71,5
19:07,308505160.0,11452.3770110956,-100.07,2
19:12,744968736.0,-1671.8118265694238,-17.41,5
19:13,195895574.0,6367.728465656536,-28.29,2
19:14,596463612.0,-1026.8451047251388,-19.34,5
19:15,137822385.0,3347.900993181048,-83.53,5
19:17,520239952.0,-1812.6531266547631,-185.97,5
19:22,541639148.0,3273.981727739646,-45.75,7
19:26,245690309.0,8541.06918443104,-26.36,5
19:29,450896297.0,12043.418270938077,-40.54,9
19:31,856957948.0,9060.629187619514,-59.41,5
19:34,252701364.0,-3764.288672677915,-41.43,5
19:35,706250160.0,11133.774062993043,-6.6,2
19:37,189757473.0,-2209.20115,-37.88,5
19:44,639420537.0,-1621.6189499999998,-12.22,5
19:45,585596026.0,2761.8684075044066,-13.71,5
19:45,308505160.0,11348.0910110956,-104.29,2
19:49,633345190.0,5271.144573219799,-29.4,9
19:54,668329719.0,7513.936479390111,-2.66,5
19:56,140893085.0,5307.593056365462,-219.41,5
19:57,738958551.0,8223.397622395523,-45.43,9
19:58,305778936.0,8893.929428511952,-1.65,5
20:01,675806859.0,6268.115463712811,-16.57,7
20:05,131388684.0,20364.12453738197,-77.49,8
20:07,990461108.0,-68.27923137938895,-24.14,5
20:11,859603181.0,2501.245462443221,-10.37,8
20:18,673025413.0,1647.4836800294063,-64.13,5
20:20,633345190.0,5269.506313780516,-1.64,5
20:22,119943495.0,-1616.300062112858,-27.72,5
20:31,518474507.0,12010.48225893078,-116.51,5
20:31,940569402.0,4999.176530911727,-13.45,9
20:32,122884111.0,-2469.0060830729694,-24.88,5
20:38,314980178.0,2605.6408500000057,-78.71,5
20:40,170637730.0,1989.471647947797,-91.48,5
20:45,605116158.0,1976.467700000002,-9.67,5
20:50,547010927.0,21397.695519193763,-11.12,5
20:56,547010927.0,21357.515519193763,-40.18,9
21:19,259015404.0,-44.00347092480997,-29.42,9
21:23,994947671.0,1093.9457000000004,-29.09,9
22:40,373163757.0,9933.289273794211,-5.72,8
01:35,117308635.0,453.43610147833925,-8.49,5
02:32,678851253.0,2890.9697740836345,-14.54,5
02:41,858989281.0,24824.457829731306,-21.23,9
02:42,518474507.0,11979.64225893078,-30.84,9
02:45,874431242.0,7239.024119491883,-24.98,9
02:45,586315521.0,11319.807323977217,-50.05,5
02:48,970298834.0,1953.3988889772097,-4.18,7
02:49,399144202.0,1074.5896104668902,-32.89,9
02:51,572384506.0,6380.063110927917,-35.78,9
02:51,179173981.0,4078.87937491627,-27.14,9
03:00,752362502.0,7611.478171356165,-34.23,2
03:04,308505160.0,11335.16836416044,-12.92,7
03:07,435984758.0,3736.503327263323,-47.49,5
03:16,657139925.0,12688.290922515023,-14.89,9
03:20,718058208.0,1348.2013820310724,-5.55,5
03:22,858989281.0,24812.052004514713,-12.41,5
03:26,510101371.0,12071.25898107361,-39.19,9
03:29,477216513.0,-657.0621999999994,-23.9,9
03:31,809499628.0,15667.990584314188,-13.5,9
03:33,886921642.0,2627.5836407669503,-33.61,2
03:41,433917275.0,6502.976948734938,-23.75,9
03:42,940569402.0,4975.543403469522,-23.63,7
03:47,237684254.0,5274.774518360488,-4.19,5
03:48,986267641.0,6680.184737795557,-13.17,5
03:49,216285378.0,22428.78938463491,-35.14,9
03:51,305778936.0,8884.063401823794,-9.87,8
03:52,675806859.0,6249.214223119867,-18.9,2
03:52,414805878.0,11811.823598603916,-34.63,9
03:54,256002321.0,5266.122914898286,-21.85,9
03:57,802697323.0,14404.93955992039,-42.74,9
04:04,987163717.0,5319.788480000005,-40.45,9
04:07,633345190.0,5231.686313780517,-37.82,9
04:10,601627384.0,3259.3739260590937,-35.59,9
04:10,704517789.0,16223.475270368344,-32.07,2
04:13,960208650.0,16671.135353642032,-34.18,4
04:14,304455868.0,1895.768884902949,-21.88,5
04:14,183888402.0,17086.484973285395,-41.45,9
04:15,229205098.0,6648.523700397496,-23.17,2
04:18,758160963.0,7340.166659895692,-47.44,2
04:24,719586818.0,16285.290645357682,-17.32,2
04:25,256002321.0,5258.420299594668,-7.7,5
04:25,779946617.0,14773.370246864248,-20.04,2
04:29,480557476.0,10351.603734432334,-2.3,7
04:33,910730524.0,6964.333084357647,-51.17,5
04:35,147508204.0,-835.1952822181134,-25.73,9
04:37,170637730.0,1925.9327233774484,-63.54,2
04:40,639409800.0,33338.88758015887,-4.41,2
04:42,520447032.0,7480.533804636963,-21.18,9
04:45,282837512.0,12606.38225818337,-33.13,9
04:50,547010927.0,21326.195519193763,-31.32,9
04:53,873693307.0,8421.024485696034,-32.76,2
05:00,633345190.0,5226.515569796938,-5.17,2
05:00,124102251.0,2719.358476281629,-30.69,7
05:00,482513594.0,4964.6367963282555,-14.12,7
05:03,766941757.0,1393.861107446778,-22.73,9
05:04,587225252.0,4168.168806628823,-36.05,9
05:04,836110591.0,5734.716902443037,-25.48,9
05:08,994214354.0,8810.091922212494,-16.34,2
05:09,331450202.0,6681.65301461979,-2.6,2
05:12,383833857.0,23150.328349579693,-6.66,4
05:13,601627384.0,3251.9977180560086,-7.38,7
05:16,441274121.0,10765.96280860348,-39.12,2
05:17,187111705.0,5857.183978010008,-34.19,2
05:18,108931112.0,12882.198476139534,-35.59,9
05:19,709608057.0,2099.9094600145672,-35.56,9
05:21,547010927.0,21315.798607226243,-10.4,7
05:23,522188082.0,7064.938788918866,-74.77,5
05:26,108563213.0,22432.314033848583,-16.99,5
05:29,549414742.0,5985.428173833175,-30.19,9
05:30,203466392.0,2083.217060898908,-89.8,2
05:31,417850087.0,15853.802573815065,-0.57,2
05:34,766941757.0,1380.8825563110238,-12.98,5
05:37,853907490.0,6262.477974366304,-8.95,9
05:39,851181128.0,3537.4541976680252,-50.59,5
05:39,196289502.0,14347.973909829368,-16.05,9
05:41,550169791.0,19722.04571272626,-2.32,4
05:43,822250278.0,5493.4467601064725,-18.51,5
05:43,812692024.0,3143.9207066639287,-61.79,5
05:44,699139822.0,922.4381321022856,-62.38,2
05:45,851181128.0,3502.364197668025,-35.09,9
05:47,534325901.0,5868.610805301986,-8.11,5
05:49,355602925.0,1200.9930765753274,-8.75,7
05:49,587225252.0,4146.054489328436,-22.11,8
05:50,558119802.0,30917.954377136597,-29.16,8
05:50,570323670.0,2518.5719989754143,-54.54,7
05:51,433917275.0,6465.043989483604,-37.93,4
05:52,187541224.0,801.0857620279239,-38.14,9
05:57,213112754.0,6009.153107703059,-21.19,9
06:00,506618547.0,15086.76665141032,-57.67,5
06:05,145387690.0,4046.15732168314,-49.37,7
06:08,985188462.0,-971.6232112887752,-37.22,9
06:09,549414742.0,5980.230866138574,-5.2,8
06:10,706250160.0,11100.53432723221,-33.24,7
06:12,259015404.0,-84.38347092480997,-40.38,9
06:12,108931112.0,12877.264330715969,-4.93,2
06:17,835736339.0,1338.5660961464716,-43.25,2
06:20,520447032.0,7474.384874953675,-6.15,7
06:20,749378808.0,3198.3845628834,-36.42,5
06:22,419550103.0,17377.79234539194,-30.25,2
06:23,670102069.0,2947.067900551894,-33.29,9
06:23,151968462.0,5846.628933377063,-67.93,2
06:25,120634201.0,4095.795329403303,-16.74,9
06:25,510101371.0,12051.91456100842,-19.34,2
06:28,853907490.0,6259.938713722927,-2.54,5
06:30,581655972.0,38587.6781127175,-32.87,7
06:30,749378808.0,3177.4345628834003,-20.95,9
06:32,169006407.0,10492.007451568295,-41.54,8
06:39,899742927.0,11506.37198491985,-17.88,2
06:39,887853850.0,9369.045247999413,-33.04,9
06:40,489964679.0,19055.519656636076,-35.88,9
06:41,541639148.0,3234.318094597818,-39.66,2
06:41,361201224.0,2689.6178865338543,-2.94,2
06:43,683319988.0,6207.9621053713245,-32.88,9
06:44,282837512.0,12538.06999555665,-68.31,2
06:44,822135975.0,10184.537570493165,-28.2,7
06:46,785749304.0,7579.948117978305,-21.25,9
06:46,593378953.0,174.92965000000513,-29.04,9
06:47,524425303.0,-792.2292000000011,-8.98,9
06:48,235881534.0,12165.105955903276,-4.88,5
06:49,166019891.0,7183.824854297785,-16.11,7
06:52,512989907.0,-2398.2644039753663,-21.98,9
06:54,221868392.0,4311.4860830377775,-36.13,9
06:59,613729471.0,8170.931732232132,-2.6,4
07:00,134461671.0,5245.56175964285,-16.04,8
07:02,554792076.0,26338.741680600175,-3.44,7
07:05,705848712.0,24974.582442019346,-14.35,9
07:05,667367404.0,8650.725431172234,-5.08,2
07:06,280268430.0,3843.4842397641646,-24.68,2
07:07,951817450.0,8261.469290138217,-17.44,4
07:09,874431242.0,7237.75925917591,-1.26,5
07:10,285220959.0,10948.934269973175,-25.29,7
07:10,887853850.0,9358.214257143383,-10.83,8
07:12,885259672.0,2879.1690799396806,-9.07,2
07:12,322720763.0,5395.890156162169,-9.79,7
07:15,324224854.0,2629.803830000291,-1.23,5
07:15,290818242.0,6249.527733060693,-17.31,8
07:15,769311479.0,5272.653400308871,-40.44,5
07:16,264550521.0,8832.757877622367,-10.72,2
07:21,532478725.0,3904.486488085298,-22.64,9
07:24,195895574.0,6358.593698897368,-9.13,5
07:29,370521542.0,24607.573017220508,-1.87,4
07:32,930277104.0,9308.61651217506,-12.62,7
07:38,912705941.0,17410.313358706277,-8.31,7
07:38,930277104.0,9271.42651217506,-37.19,9
07:39,730002588.0,11924.973458718312,-33.26,2
07:39,409971170.0,2262.7590888382592,-7.6,5
07:40,657139925.0,12679.834617838544,-8.46,2
07:42,809499628.0,15648.58847692268,-19.4,5
07:42,213112754.0,5994.060164037908,-15.09,7
07:46,815385232.0,9218.495006511042,-3.22,2
07:48,873701090.0,216.70723512622547,-10.21,2
07:49,842682241.0,4589.542463299564,-22.36,4
07:52,987656636.0,2357.9169210684145,-32.76,5
07:54,943329213.0,1362.4731925635554,-11.93,2
07:56,473820682.0,10203.515161713303,-10.94,7
07:57,651756497.0,11100.557617387862,-35.02,5
07:59,532478725.0,3883.847341364342,-20.64,7
08:02,450896297.0,12025.488270938076,-17.93,9
08:02,461990622.0,8251.608657423734,-23.55,7
08:05,503575533.0,6133.570251971302,-12.83,5
08:07,668329719.0,7511.614275603303,-2.32,8
08:13,609939116.0,6524.012319265507,-5.01,7
08:19,905860285.0,7947.682179620352,-4.06,4
08:20,259015404.0,-103.328085124812,-18.94,7
08:21,897714622.0,8041.237319295886,-12.6,7
08:31,237493332.0,13040.24975427634,-14.51,7
08:32,519644021.0,1932.012949020856,-27.59,2
08:32,752362502.0,7536.298171356165,-75.18,5
08:32,108812033.0,295.4562499999984,-113.4,5
08:35,820686957.0,-1078.282316311196,-93.25,5
08:37,699997811.0,36.2792500000036,-15.56,5
08:39,345514953.0,-1925.2753000000007,-31.92,5
08:40,511179916.0,6252.774716687824,-14.0,2
08:41,108481285.0,8048.795641371236,-11.22,8
08:42,675806859.0,6098.119223119867,-151.09,5
08:43,703478110.0,4151.896450637634,-138.87,5
08:44,871866387.0,-468.9817000000007,-63.53,5
08:44,188263947.0,-361.5482499999995,-138.47,5
08:48,696758548.0,-3446.0078963201368,-25.63,5
08:49,496395938.0,11119.794133098598,-62.85,8
08:50,554792076.0,26301.221680600174,-37.52,5
08:51,383625050.0,3604.278474764899,-27.57,8
08:51,969804197.0,-411.2412500000007,-32.32,5
08:52,896821055.0,-572.3482407329176,-65.64,5
08:52,647936800.0,3039.319908850954,-31.28,2
08:52,241459011.0,568.6709132723472,-13.69,5
08:54,298000165.0,24099.750891963085,-63.63,5
08:54,979135922.0,-192.32169940954924,-36.65,5
08:57,277562576.0,-85.81498189489702,-160.81,5
08:58,812839908.0,-1787.0123500000002,-43.96,5
08:58,245690309.0,8494.37623750056,-46.69,5
08:59,518474507.0,11959.909202379427,-19.73,8
09:00,807714284.0,770.7370607359999,-76.24,5
09:01,366550080.0,24897.70340023588,-4.16,2
09:02,982286721.0,-3434.04552401773,-39.05,5
09:04,727417797.0,4988.759049492958,-44.61,2
09:06,454356905.0,293.68547686295557,-34.58,8
09:12,673025413.0,1578.5223180850976,-68.96,7
09:14,361201224.0,2658.5378865338544,-31.08,7
09:14,945054126.0,-485.0219,-36.78,5
09:14,383833857.0,23144.228349579695,-6.1,9
09:16,409370545.0,-709.7117244544793,-151.64,5
09:18,287230540.0,781.4022932932661,-24.96,7
09:19,534204159.0,5293.447945250038,-79.59,2
09:20,348525881.0,-1058.6933754050638,-33.44,5
09:20,994214354.0,8701.952722212494,-108.14,4
09:22,655730067.0,-499.9495500000005,-42.45,5
09:22,816685391.0,-820.3851037084263,-26.05,5
09:22,611143859.0,1133.2613000000113,-106.21,5
09:23,500051919.0,1251.4396966505903,-21.96,7
09:24,500043411.0,12519.491749981897,-1.05,7
09:24,824916823.0,7902.989785309926,-6.15,7
09:25,344219145.0,7144.596151568211,-28.41,5
09:26,730002588.0,11807.821458718312,-117.15,5
09:26,667367404.0,8508.625431172233,-142.1,2
09:27,856957948.0,9042.689187619511,-17.94,4
09:29,596171893.0,-162.5644051744889,-31.96,7
09:30,217540156.0,-3424.8323199999945,-16.18,5
09:31,423208402.0,666.3369500000025,-134.0,2
09:32,718058208.0,1316.2113820310724,-31.99,4
09:32,506618547.0,15066.59665141032,-20.17,2
09:32,581655972.0,38572.698112717495,-14.98,7
09:32,672913754.0,10369.200424547156,-17.97,7
09:34,532525712.0,-750.1318000000003,-54.78,5
09:34,767447966.0,4135.563065512111,-41.06,2
09:34,690958123.0,19157.816364636416,-92.92,5
09:35,730002588.0,11790.571458718312,-17.25,7
09:35,285428103.0,9020.783491187382,-88.96,5
09:36,785749304.0,7553.067518301996,-26.88,2
09:37,736340277.0,8061.497999286668,-25.66,7
09:37,279149837.0,836.3760499999985,-32.95,7
09:38,844835978.0,9133.46226400444,-31.61,5
09:39,698076160.0,5546.230168577104,-32.83,7
09:39,162162212.0,816.4745433273089,-121.99,2
09:40,876890798.0,2560.452220699932,-28.0,2
09:43,824916823.0,7895.567959540049,-7.42,2
09:44,700138124.0,4339.383244903046,-184.8,2
09:45,270374623.0,8953.160593469458,-5.09,7
09:46,832564361.0,15005.737071055206,-34.97,2
09:46,146909202.0,2082.6658872084827,-21.59,7
09:47,970298834.0,1947.3988889772097,-6.0,2
09:48,741269136.0,3158.8784500000006,-22.0,2
09:48,166019891.0,7163.398854297785,-20.43,5
09:49,417850087.0,15803.662573815063,-50.14,2
09:49,179173981.0,4071.066266502152,-7.81,7
09:50,466649401.0,-13.978688602108576,-44.0,4
09:50,456246119.0,19399.463643821,-19.97,2
09:50,479366718.0,1774.711447632401,-29.99,4
09:52,480198977.0,10939.809720897709,-31.97,4
09:52,187111705.0,5822.963978010008,-34.22,7
09:53,510101371.0,12032.61456100842,-19.3,4
09:53,454356905.0,232.7518768629556,-60.93,4
09:53,237493332.0,13013.32975427634,-26.92,2
09:54,471897866.0,6697.531511433901,-49.21,5
09:54,611143859.0,955.4893000000112,-177.77,2
09:54,605116158.0,1964.977700000002,-11.49,4
09:54,758160963.0,7327.096659895692,-13.07,2
09:54,425730826.0,1158.95690938872,-141.75,2
09:55,903663593.0,495.9949583025629,-3.58,4
09:55,398429109.0,199.26900000000109,-42.93,7
09:59,287480331.0,6801.140120514973,-0.93,5
10:00,242218612.0,149.16630000000058,-134.98,2
10:01,836110591.0,5708.272631629315,-26.44,2
10:03,108563213.0,22409.194033848587,-23.12,2
10:03,667367404.0,8342.025431172233,-166.6,2
10:04,575652395.0,1946.0834239991657,-12.93,7
10:07,792845450.0,264.135150000001,-118.25,5
10:07,192202372.0,-8.885066111202164,-69.98,2
10:08,423208402.0,495.3369500000025,-171.0,2
10:08,703588001.0,-206.34695000000045,-42.0,2
10:10,424397946.0,3372.363783605399,-240.1,2
10:10,237493332.0,13007.119754276342,-6.21,2
10:11,639549973.0,5848.27267862225,-20.91,4
10:12,141521177.0,6654.597900000015,-31.99,2
10:13,742223719.0,378.7951573048027,-19.99,2
10:14,912705941.0,17368.179258706277,-42.13,4
10:16,407574996.0,-28.448390619063403,-68.6,2
10:16,425730826.0,1091.83190938872,-67.12,2
10:16,611143859.0,695.7893000000113,-259.7,2
10:19,433917275.0,6443.263989483604,-21.78,4
10:21,683078800.0,1310.9902029448708,-107.98,2
10:22,949032480.0,3769.971386746058,-29.81,1
10:22,297823329.0,102.20644999999917,-35.98,2
10:22,108481285.0,8028.805641371237,-19.99,7
10:22,516051449.0,1053.5950389400978,-37.95,1
10:22,700138124.0,4280.583244903046,-58.8,2
10:23,216285378.0,22371.509384634915,-57.28,2
10:24,420109571.0,264.6538107166796,-65.97,4
10:26,873693307.0,8394.424485696034,-26.6,2
10:27,679911053.0,1893.4494772024625,-8.0,7
10:30,604288474.0,1944.1662516983504,-20.72,5
10:32,858560423.0,10991.023909769356,-12.99,2
10:32,667367404.0,8195.025431172233,-147.0,2
10:32,604334058.0,213.8164999999994,-84.0,2
10:34,475277431.0,895.8181369436193,-4.99,4
10:34,709142813.0,838.9005499999993,-56.44,5
10:38,703588001.0,-285.84695000000045,-79.5,2
10:38,651756497.0,11023.34061738786,-77.22,5
10:39,425730826.0,1017.58190938872,-74.25,2
10:39,859603181.0,2497.4429705412563,-3.8,7
10:39,910730524.0,6901.273084357646,-63.06,4
10:39,623156843.0,3757.375568283228,-10.65,2
10:39,315546581.0,26311.8028072377,-9.01,4
10:40,785210466.0,1591.155619997711,-91.56,5
10:40,425964226.0,3247.287650000002,-28.96,1
10:40,949032480.0,3740.0850818784934,-29.89,8
10:45,331450202.0,6550.72301461979,-130.93,2
10:45,424397946.0,3199.463783605399,-172.9,2
10:47,516051449.0,1038.6050389400978,-14.99,4
10:48,611143859.0,596.4033000000113,-99.39,2
10:50,196289502.0,14332.352609829368,-15.62,4
10:51,678330503.0,2030.9130520085384,-4.17,8
10:51,441142605.0,1926.9210388780311,-9.0,4
10:54,423208402.0,425.3369500000025,-70.0,2
10:54,604334058.0,134.8164999999994,-79.0,2
10:56,897592348.0,14251.086902342942,-37.95,1
10:58,500043411.0,12502.931749981895,-16.56,2
11:00,558875206.0,2150.2743108989525,-6.99,1
11:00,570269025.0,2550.037800644421,-31.99,2
11:00,700138124.0,4077.583244903046,-203.0,2
11:03,152488934.0,1394.5109573137306,-25.0,2
11:05,441274121.0,10752.33280860348,-13.63,7
11:06,992204045.0,5290.99201893627,-12.44,7
11:08,429556122.0,5339.068478442135,-35.1,2
11:09,425730826.0,984.20690938872,-33.38,2
11:12,496395938.0,11061.644133098598,-58.15,2
11:13,424397946.0,2981.063783605399,-218.4,2
11:14,604288474.0,1940.3039173637676,-3.86,7
11:17,331450202.0,6490.32701461979,-60.4,5
11:19,113747882.0,11198.078203184456,-51.59,2
11:20,611143859.0,413.7033000000113,-182.7,2
11:21,184430449.0,1677.7439276932644,-25.96,1
11:24,627622066.0,2808.4749547156616,-19.99,6
11:24,237684254.0,5252.402518360488,-22.37,2
11:27,588565416.0,6891.479140782739,-4.43,5
11:27,604334058.0,52.816499999999394,-82.0,2
11:30,815385232.0,9154.193006511045,-64.3,5
11:32,700138124.0,3973.983244903046,-103.6,2
11:35,108931112.0,12844.514030715967,-32.75,4
11:35,450896297.0,11981.738376690671,-43.75,2
11:38,795847804.0,21696.690073014463,-62.31,2
11:44,667367404.0,7990.625431172233,-204.4,2
11:45,229205098.0,6566.623700397497,-81.9,2
11:47,822135975.0,10172.347570493164,-12.19,4
11:47,308897841.0,799.333899999999,-16.09,5
11:49,611143859.0,238.03130000001136,-175.67,2
11:49,833899961.0,780.8477442498694,-185.5,4
11:51,407574996.0,-226.5483906190634,-198.1,2
11:53,237684254.0,5099.144518360488,-153.26,2
11:53,196289502.0,14306.8449707713,-25.51,5
11:54,700138124.0,3946.6832449030458,-27.3,2
11:56,851649498.0,9459.19472476494,-48.8,5
11:58,310375875.0,2016.154141603703,-194.6,2
11:58,741269136.0,3078.845950000001,-80.03,5
12:00,414805878.0,11808.449120750673,-3.37,2
12:01,667367404.0,7945.125431172233,-45.5,2
12:01,270374623.0,8912.340593469458,-40.82,2
12:08,874431242.0,7210.149259175911,-27.61,1
12:09,534204159.0,5234.647945250038,-58.8,2
12:10,435984758.0,3730.475297263324,-6.03,4
12:12,833899961.0,665.8477442498694,-115.0,7
12:12,407574996.0,-513.5483906190634,-287.0,2
12:12,795847804.0,21657.090073014464,-39.6,1
12:12,757115616.0,704.5600000000037,-42.38,9
12:15,221868392.0,4290.866083037778,-20.62,1
12:15,611143859.0,80.53130000001136,-157.5,2
12:16,806358207.0,11306.805540280591,-0.51,7
12:20,417850087.0,15772.582573815063,-31.08,2
12:21,221868392.0,4283.389946864532,-7.48,5
12:22,322221939.0,3097.7551642545477,-5.78,2
12:23,943329213.0,1324.6931925635554,-37.78,9
12:23,435984758.0,3658.275297263324,-72.2,2
12:23,667367404.0,7878.625431172233,-66.5,2
12:23,424397946.0,2720.6637836053987,-260.4,2
12:26,166019891.0,7111.428854297785,-51.97,4
12:26,454129843.0,973.19109516656,-5.99,1
12:27,166019891.0,7086.978854297785,-24.45,9
12:30,460463595.0,-881.2329454185789,-43.45,9
12:30,683319988.0,6205.76857761093,-2.19,5
12:33,604334058.0,-52.183500000000606,-105.0,2
12:34,200080192.0,8475.524892970516,-14.29,5
12:35,322720763.0,5295.800156162169,-100.09,2
12:38,321372947.0,-596.5988507890993,-28.98,5
12:38,534204159.0,4963.747945250038,-270.9,2
12:38,856461967.0,-465.44764647050744,-44.04,5
12:39,699313649.0,-2223.8083991419057,-25.7,5
12:40,624500124.0,2848.520215918163,-35.41,5
12:41,116598243.0,-1208.0037782225504,-75.1,5
12:42,833499132.0,1856.508150000001,-34.44,9
12:42,145387690.0,4016.76732168314,-29.39,9
12:45,424397946.0,2493.8637836053986,-226.8,2
12:46,250895529.0,120.3059824692883,-110.26,5
12:48,979122276.0,-1189.0280377056713,-51.66,5
12:49,973086490.0,9077.986190486688,-19.49,9
12:52,726913482.0,-1343.9399985264763,-84.69,5
12:52,414454079.0,-16.03214999999819,-35.68,9
12:56,843174694.0,-4884.860999999998,-44.58,5
12:56,494404688.0,-2668.838265336208,-47.89,5
12:58,611143859.0,-16.068699999988638,-96.6,2
13:00,175452235.0,-966.7087499999996,-40.91,5
13:00,291580432.0,-474.4422499999997,-32.88,5
13:01,585625048.0,1126.2726823533742,-5.7,9
13:02,994947671.0,913.4557000000004,-180.49,2
13:03,348325817.0,9080.135715977154,-6.35,9
13:03,219399150.0,-918.0625269529268,-32.89,9
13:04,822135975.0,10143.857570493165,-28.49,2
13:04,407574996.0,-691.3483906190634,-177.8,2
13:07,812012103.0,-1401.9043000000004,-30.42,5
13:08,992204045.0,5240.96201893627,-50.03,2
13:10,993663752.0,-126.65055758960352,-108.41,5
13:11,187111705.0,5818.663978010008,-4.3,9
13:11,851649498.0,9458.431045782592,-0.76,7
13:14,587202562.0,-51.68205058293137,-81.85,5
13:16,423208402.0,199.3369500000025,-226.0,2
13:17,424397946.0,2348.2637836053987,-145.6,2
13:18,454129843.0,963.20109516656,-9.99,2
13:20,982949451.0,-3668.9516670525086,-42.95,5
13:20,425730826.0,855.5819093887199,-128.62,2
13:21,322221939.0,3091.7051642545475,-6.05,9
13:23,812692024.0,3136.4207066639287,-7.5,9
13:23,833899961.0,526.3477442498694,-139.5,4
13:24,667367404.0,7784.125431172233,-94.5,2
13:24,117273481.0,8415.149065335241,-42.81,5
13:24,480557476.0,10345.903734432331,-5.7,9
13:24,703588001.0,-432.8469500000005,-147.0,2
13:27,815385232.0,9147.203006511045,-6.99,9
13:27,534204159.0,4873.447945250038,-90.3,2
13:27,264550521.0,8799.577877622367,-33.18,7
13:30,611143859.0,-66.44069999998862,-50.37,2
13:32,285428103.0,8983.843491187381,-36.94,7
13:32,143003091.0,20482.26723316504,-83.63,5
13:33,500051919.0,1108.4696966505903,-142.97,2
13:35,113747882.0,11189.41538012952,-8.66,8
13:36,534204159.0,4650.847945250038,-222.6,2
13:36,406862520.0,-37.08167346258958,-178.47,5
13:36,287480331.0,6766.200120514974,-34.94,9
13:37,240643705.0,93.64361737398076,-33.5,5
13:38,490868147.0,-640.5992208786985,-121.4,5
13:40,986774156.0,1188.3369316257692,-36.65,9
13:42,282837512.0,12526.74999555665,-11.32,1
13:45,423208402.0,20.836950000002503,-178.5,2
13:46,705848712.0,24972.582195098643,-2.0,5
13:49,703588001.0,-603.8469500000004,-171.0,2
13:51,667367404.0,7576.225431172234,-207.9,2
13:52,822135975.0,10106.237570493164,-37.62,1
13:52,424397946.0,2257.2637836053987,-91.0,2
13:54,874431242.0,7155.651979175911,-54.5,4
13:56,310375875.0,1918.154141603703,-98.0,2
13:56,494789005.0,2568.670323064033,-1.52,4
13:57,121113546.0,-86.25184393013029,-129.65,5
13:57,497772347.0,-190.5762000000021,-34.24,9
13:58,425730826.0,729.2069093887199,-126.38,2
13:58,833899961.0,479.3477442498694,-47.0,7
14:05,867987292.0,1510.341117669841,-0.58,5
14:07,424397946.0,2014.3637836053983,-242.9,2
14:09,425730826.0,653.0819093887199,-76.12,2
14:11,534204159.0,4524.847945250038,-126.0,2
14:12,703588001.0,-784.8469500000004,-181.0,2
14:16,667367404.0,7429.225431172234,-147.0,2
14:28,611143859.0,-268.71269999998856,-202.27,2
14:30,424397946.0,1812.0637836053984,-202.3,2
14:38,604334058.0,-112.1835000000006,-60.0,2
14:39,903953091.0,3035.7370389956645,-15.98,7
14:42,703588001.0,-924.3469500000004,-139.5,2
14:51,667367404.0,7394.225431172234,-35.0,2
14:54,851649498.0,9417.281045782593,-41.15,7
14:56,124102251.0,2706.358476281629,-13.0,2
15:02,604334058.0,-224.1835000000006,-112.0,2
15:03,425730826.0,522.5819093887199,-130.5,2
15:05,611143859.0,-319.79869999998857,-51.09,2
15:10,310375875.0,1705.354141603703,-212.8,2
15:14,315546581.0,26301.732687237694,-10.07,4
15:15,237684254.0,5043.858518360488,-55.29,2
15:17,698955014.0,162.77318020319692,-72.11,7
15:20,310375875.0,1497.4541416037032,-207.9,2
15:27,949032480.0,3713.4350818784937,-26.65,2
15:27,998390769.0,-536.8356490594758,-126.87,5
15:30,425730826.0,405.58190938871985,-117.0,2
15:38,424397946.0,1588.7637836053989,-223.3,2
15:43,425730826.0,346.33190938871985,-59.25,2
15:44,151968462.0,5833.608933377062,-13.02,2
15:51,310375875.0,1424.6541416037032,-72.8,2
15:57,668692488.0,1511.9256285738093,-5.99,4
16:11,611143859.0,-392.5986999999886,-72.8,2
16:11,425730826.0,297.95690938871985,-48.38,2
16:12,424397946.0,1449.4637836053987,-139.3,2
16:19,200080192.0,8437.164892970515,-38.36,2
16:19,444428189.0,820.2742000000027,-151.9,2
16:22,948558249.0,8386.133631737077,-29.35,8
16:23,903953091.0,3025.7470389956648,-9.99,2
16:24,310375875.0,1243.3541416037033,-181.3,2
16:28,611143859.0,-568.9846999999886,-176.39,2
16:33,475277431.0,890.3181369436193,-5.5,4
16:37,611143859.0,-627.7846999999886,-58.8,2
16:42,587225252.0,4123.574489328436,-22.48,2
16:43,310375875.0,1076.054141603703,-167.3,2
16:45,613427466.0,5747.581956011865,-53.98,2
16:48,444428189.0,699.8882000000027,-120.39,2
16:54,994214354.0,8667.212722212495,-34.74,9
17:02,444428189.0,617.3022000000027,-82.59,2
17:17,310375875.0,982.9541416037032,-93.1,2
17:18,604334058.0,-278.6835000000006,-54.5,2
17:22,478651121.0,-443.6315204015303,-46.44,5
17:23,252760664.0,5613.8245805348015,-31.66,2
17:26,256002321.0,5250.834539594668,-7.59,4
17:28,424397946.0,1224.0637836053988,-225.4,2
17:33,444428189.0,566.9302000000027,-50.37,2
17:35,198630866.0,-325.7984235612686,-118.96,5
17:41,280268430.0,3823.0042397641646,-20.48,9
17:41,604334058.0,-375.1835000000006,-96.5,2
17:44,618514666.0,19515.932041064316,-84.0,2
17:47,187541224.0,783.6957620279239,-17.39,7
17:48,310375875.0,736.5541416037033,-246.4,2
17:54,424397946.0,1140.0637836053988,-84.0,2
17:59,538003940.0,1000.8000000000086,-25.98,4
18:01,444428189.0,430.4442000000027,-136.49,2
18:01,611143859.0,-701.9566999999886,-74.17,2
18:04,738958551.0,8186.599481877437,-36.8,2
18:07,424397946.0,1050.463783605399,-89.6,2
18:12,425730826.0,249.20690938871985,-48.75,2
18:12,618514666.0,19487.274041064316,-28.66,2
18:15,316793091.0,202.11426005495093,-53.43,5
18:28,956717493.0,930.392172224932,-1.5,7
18:30,679662108.0,14998.60219957018,-0.13,7
18:31,454356905.0,200.5618768629556,-32.19,9
18:33,424397946.0,984.4397836053988,-66.02,5
18:34,143003091.0,20480.76723316504,-1.5,7
18:35,558119802.0,30873.2663771366,-44.69,5
18:35,845648250.0,-61.15065000000057,-27.89,5
18:37,475117511.0,7078.907249764253,-14.7,5
18:37,522188082.0,7040.809788918866,-24.13,5
18:38,215426302.0,-878.3675959743081,-8.4,5
18:43,687135796.0,25613.205937214418,-11.51,7
18:50,522188082.0,6880.0497889188655,-160.76,7
18:50,984783496.0,12806.60447724168,-18.19,9
18:50,941285623.0,1103.5623990667702,-53.48,7
18:51,760704118.0,318.28031271748875,-105.04,5
18:52,687135796.0,25594.31593721442,-18.89,9
18:57,653640811.0,15857.175799549275,-46.24,2
19:02,668329719.0,7476.796275603303,-34.82,5
19:12,960208650.0,16625.88035364203,-45.25,5
19:14,556992209.0,10849.76062447272,-2.2,4
19:17,308897841.0,780.7271999999989,-18.61,5
19:23,996042490.0,5203.500704831609,-59.43,5
19:26,865748375.0,3079.2934522395635,-37.97,8
19:29,889916166.0,158.89340141322668,-19.0,9
19:36,722358036.0,413.1179406270829,-72.5,5
19:40,129018172.0,8146.250351104692,-181.69,5
19:55,687135796.0,25581.450380478323,-12.87,7
19:56,924045955.0,1106.8605126586644,-111.52,5
20:01,610645022.0,-948.5411626449184,-46.35,5
20:02,872286364.0,-1267.7153458130997,-66.97,5
20:10,493571342.0,-2537.758380907048,-39.85,5
20:16,648644594.0,-337.14360000000084,-37.14,9
20:43,395284483.0,308.9283402113085,-60.42,5
20:43,370521542.0,24592.63301722051,-14.94,9
20:50,129018172.0,8137.812321236932,-8.44,7
20:54,198946608.0,2972.0399270270486,-74.25,5
00:11,853907490.0,6246.938713722927,-13.0,9
00:13,822135975.0,10102.899092407097,-3.34,7
00:13,548907062.0,-531.4165112317115,-22.95,9
00:17,874431242.0,7133.011979175911,-22.64,9
00:22,534204159.0,4479.251913251566,-45.6,7
00:22,473820682.0,10200.220647162669,-3.29,4
00:28,575652395.0,1939.3773392058272,-6.71,2
00:37,601627384.0,3217.6077180560087,-34.39,9
00:42,853907490.0,6214.145311368314,-32.79,2
00:42,417850087.0,15724.83041777858,-47.75,5
00:46,482513594.0,4897.110286173564,-67.53,5
00:46,450896297.0,11944.938376690674,-36.8,9
00:46,857997794.0,478.5396651508872,-15.95,9
00:52,940569402.0,4959.043403469522,-16.5,9
00:54,776431321.0,3043.2959447979492,-9.86,7
00:54,719586818.0,16283.304532684851,-1.99,5
00:55,380911501.0,-255.38060000000084,-42.24,9
00:55,685959099.0,894.0068660992422,-39.98,9
00:56,651756497.0,11019.07832179027,-4.26,8
01:00,196289502.0,14291.8449707713,-15.0,9
01:00,618138606.0,760.7297028700659,-29.39,5
01:05,887853850.0,9347.446013407643,-10.77,7
01:08,572384506.0,6340.133110927916,-39.93,9
01:09,324224854.0,2608.053329608421,-21.75,8
01:15,905860285.0,7942.780502279925,-4.9,7
01:15,169006407.0,10456.23059561467,-35.78,5
01:16,435984758.0,3584.3509200649396,-73.92,8
01:21,421881811.0,1994.010745269335,-66.81,7
01:33,851181128.0,3467.9141976680253,-34.45,9
01:39,586315521.0,11316.637671918665,-3.17,5
01:39,345514953.0,-2215.2753000000007,-290.0,3
01:48,940569402.0,4946.561903312661,-12.48,4
01:48,679911053.0,1854.9404852860157,-38.51,8
01:50,304455868.0,1876.014600503294,-19.75,7
01:50,237493332.0,13003.244361061918,-3.88,2
01:52,540159353.0,10142.058082442603,-62.68,2
01:53,836110591.0,5695.726717132505,-12.55,2
01:53,987163717.0,5290.118480000005,-29.67,9
01:53,832564361.0,14984.37430876284,-21.36,7
01:54,264550521.0,8781.877404375527,-17.7,7
01:57,639409800.0,33308.60526662725,-30.28,7
01:58,655368335.0,4344.62468959931,-3.56,7
02:03,647936800.0,2984.6136423119165,-54.71,7
02:03,835736339.0,1303.8560961464716,-34.71,9
02:03,450896297.0,11915.027610535928,-29.91,4
02:13,290818242.0,6246.686470772659,-2.84,7
02:14,730002588.0,11748.910289769809,-41.66,8
02:16,496395938.0,11042.293525827856,-19.35,5
02:27,419550103.0,17373.969440036475,-3.82,5
02:28,270374623.0,8911.035479236425,-1.31,7
02:33,348325817.0,9052.005715977157,-28.13,9
02:38,630691258.0,1.6265448748412936,-31.09,9
02:39,441274121.0,10741.38280860348,-10.95,9
02:42,113747882.0,11188.54984730264,-0.87,8
02:43,858989281.0,24798.56200451471,-13.49,9
02:43,994214354.0,8633.612722212494,-33.6,9
02:44,449871732.0,9973.052105247052,-1.89,8
02:48,216285378.0,22330.309384634915,-41.2,9
02:55,601627384.0,3205.6869352837116,-11.92,5
02:58,856957948.0,9038.153154533906,-4.54,7
03:00,145387690.0,3998.6832236130263,-18.08,8
03:04,912705941.0,17292.9954895309,-75.18,7
03:04,705848712.0,24965.192195098643,-7.39,9
03:06,766941757.0,1330.7125563110235,-50.17,9
03:06,235881534.0,12133.205243312428,-31.9,7
03:08,196289502.0,14289.593181548547,-2.25,2
03:10,282837512.0,12497.56999555665,-29.18,9
03:10,679662108.0,14982.541276492368,-16.06,2
03:12,973086490.0,9066.996190486689,-10.99,9
03:12,108563213.0,22405.299159520077,-3.89,4
03:13,815385232.0,9143.452756826611,-3.75,4
03:14,994214354.0,8624.66136476982,-8.95,2
03:17,510101371.0,12001.17456100842,-31.44,9
03:18,554792076.0,26280.229517186264,-20.99,8
03:19,668329719.0,7428.785499206169,-48.01,8
03:21,950234174.0,929.0410599724931,-35.13,9
03:24,315078351.0,6466.802293308265,-8.11,7
03:25,633345190.0,5189.085569796937,-37.43,9
03:26,285220959.0,10941.2355320173,-7.7,8
03:28,709608057.0,2063.0594600145673,-36.85,9
03:29,930277104.0,9244.28651217506,-27.14,9
03:30,213112754.0,5957.7633650308,-36.3,2
03:31,887853850.0,9331.506013407645,-15.94,9
03:36,670102069.0,2911.627900551894,-35.44,9
03:40,558119802.0,30848.2863771366,-24.98,9
03:41,836110591.0,5657.626717132504,-38.1,9
03:42,873693307.0,8384.341674247968,-10.08,7
03:43,973086490.0,9025.329408019765,-41.67,7
03:44,534325901.0,5853.630805301987,-14.98,9
03:46,987656636.0,2345.6853207833656,-12.23,2
03:47,187541224.0,751.905762027924,-31.79,9
03:48,221868392.0,4255.759946864532,-27.63,9
03:48,134461671.0,5213.44773257015,-32.11,5
03:49,383833857.0,23136.15566925685,-8.07,2
03:49,667367404.0,7382.348831005084,-11.88,5
03:58,519644021.0,1908.3505033719775,-23.66,8
03:58,183888402.0,17053.004973285395,-33.48,9
03:59,897714622.0,8018.597319295885,-22.64,9
04:00,128033695.0,1175.6056295968417,-37.52,7
04:00,930277104.0,9209.714716173576,-34.57,7
04:01,950234174.0,889.4451330716998,-39.6,7
04:06,518474507.0,11918.669202379428,-41.24,9
04:10,570323670.0,2508.8172522809064,-9.75,7
04:10,842682241.0,4577.082526351669,-12.46,5
04:11,195895574.0,6351.647954739071,-6.95,7
04:12,673025413.0,1537.3708116269015,-41.15,7
04:13,949032480.0,3709.90558703208,-3.53,2
04:14,108931112.0,12796.764030715967,-47.75,9
04:15,534325901.0,5842.377066832737,-11.25,5
04:18,613729471.0,8129.894593155225,-41.04,2
04:19,506618547.0,15036.542391203424,-30.05,7
04:20,520447032.0,7444.613539471188,-29.77,5
04:24,699139822.0,896.577787831875,-25.86,7
04:29,749378808.0,3157.2445628834,-20.19,9
04:30,785749304.0,7536.417518301996,-16.65,9
04:30,897714622.0,8010.996581429642,-7.6,5
04:31,910730524.0,6878.460048377861,-22.81,2
04:32,657139925.0,12652.644617838543,-27.19,9
04:32,858989281.0,24761.6546531568,-36.91,7
04:35,986267641.0,6659.949097983285,-20.24,7
04:35,705848712.0,24945.28729636619,-19.9,7
04:40,960208650.0,16582.427739456994,-43.45,5
04:41,550169791.0,19711.34571272626,-10.7,9
04:42,541639148.0,3227.972332215694,-6.35,2
04:44,675806859.0,6081.709821972908,-16.41,7
04:44,851181128.0,3455.6113933861184,-12.3,8
04:53,308505160.0,11330.506839282723,-4.66,2
04:54,441274121.0,10669.8821898644,-71.5,7
04:54,245690309.0,8453.10731627081,-41.27,4
04:56,200080192.0,8434.504147777818,-2.66,7
04:56,500043411.0,12489.147993864644,-13.78,8
04:57,287480331.0,6747.010120514974,-19.19,9
05:02,179173981.0,4070.532236604333,-0.53,4
05:07,779946617.0,14732.488219137496,-40.88,7
05:09,310375875.0,706.6241416037034,-29.93,9
05:09,510101371.0,11987.844394288017,-13.33,7
05:09,802697323.0,14360.85955992039,-44.08,9
05:11,683319988.0,6181.27857761093,-24.49,9
05:12,550169791.0,19687.865147589564,-23.48,8
05:14,670102069.0,2897.378796318032,-14.25,4
05:14,647472692.0,23438.774026680538,-11.01,7
05:16,108481285.0,8019.386783541127,-9.42,2
05:20,795847804.0,21630.26337433101,-26.83,8
05:23,899742927.0,11448.32371734252,-58.05,2
05:26,120634201.0,4075.815329403303,-19.98,9
05:30,752362502.0,7474.60117893203,-61.7,5
05:31,874431242.0,7074.796739581782,-58.22,8
05:31,331450202.0,6480.153467775089,-10.17,7
05:33,532478725.0,3851.677341364342,-32.17,9
05:34,785749304.0,7524.438147790986,-11.98,5
05:35,687135796.0,25572.500380478323,-8.95,9
05:40,383625050.0,3600.1374900240403,-4.14,8
05:44,287480331.0,6710.177966422371,-36.83,2
05:46,259015404.0,-139.928085124812,-36.6,9
05:47,588565416.0,6842.18642296422,-49.29,7
05:49,511179916.0,6243.16350928465,-9.61,5
05:49,822250278.0,5481.931587469491,-11.52,5
05:51,544961962.0,-62.055676994390886,-29.15,9
05:52,414805878.0,11770.759120750672,-37.69,9
05:52,516051449.0,1015.5687746508286,-23.04,7
05:59,985188462.0,-1001.5132112887752,-29.89,9
05:59,221868392.0,4215.449670749729,-40.31,4
06:08,558119802.0,30817.460985508777,-30.83,4
06:08,399538448.0,6714.553173652622,-8.22,2
06:14,229205098.0,6562.290441349247,-4.33,2
06:16,572384506.0,6290.253796173857,-49.88,2
06:17,305778936.0,8867.428723088844,-16.63,8
06:18,518474507.0,11911.562357855048,-7.11,8
06:18,886921642.0,2577.8626178229097,-49.72,2
06:20,769311479.0,5218.129656441541,-54.52,7
06:21,547010927.0,21311.386424744553,-4.41,7
06:23,348325817.0,9048.162896593622,-3.84,5
06:25,639549973.0,5783.871324855562,-64.4,7
06:31,532478725.0,3824.461236666423,-27.22,7
06:35,549414742.0,5941.050866138574,-39.18,9
06:40,489964679.0,19011.889656636075,-43.63,9
06:42,124102251.0,2675.4493301770467,-30.91,2
06:49,399144202.0,1045.19961046689,-29.39,9
06:50,749378808.0,3145.8219987550324,-11.42,8
06:56,252760664.0,5604.876197478476,-8.95,4
07:04,809499628.0,15630.88847692268,-17.7,9
07:06,549414742.0,5915.968415838726,-25.08,2
07:11,489964679.0,18993.56864268225,-18.32,5
07:12,987229118.0,3420.0060847372083,-18.2,2
07:13,718058208.0,1314.2352455576538,-1.98,7
07:15,706250160.0,11100.465239481133,-0.07,7
07:21,678851253.0,2828.187061975324,-62.78,7
07:27,876890798.0,2527.0222206999324,-33.43,9
07:30,779236304.0,-1083.3824045204678,-31.89,9
07:30,984783496.0,12787.35447724168,-19.25,9
07:37,806358207.0,11265.396377527924,-41.41,8
07:40,633345190.0,5154.420676387944,-34.66,7
07:42,405945930.0,4396.336275568805,-50.43,7
07:43,704517789.0,16162.75295344272,-60.72,7
07:44,456246119.0,19397.98190973857,-1.48,7
07:48,433917275.0,6420.430946984234,-22.83,2
07:52,851649498.0,9368.189323238996,-49.09,2
07:54,873701090.0,160.88358509815367,-55.82,8
07:58,285873880.0,11248.60191723042,-2.11,5
07:59,282837512.0,12494.092731979754,-3.48,7
08:13,187111705.0,5816.278776691649,-2.39,7
08:15,203466392.0,2017.5300950772569,-65.69,2
08:17,170637730.0,1895.8059580252268,-30.13,4
08:28,868377987.0,2188.049909635548,-22.97,7
08:39,687135796.0,25539.02769962421,-33.47,2
09:04,143003091.0,20424.545945637263,-56.22,8
09:08,975345315.0,32462.03268146795,-30.03,7
09:13,322221939.0,3056.0061509088664,-35.7,5
09:17,215311171.0,5797.623484045012,-33.5,7
09:19,987163717.0,5156.638480000005,-133.48,6
09:25,572384506.0,6245.388196173857,-44.87,4
09:27,660874296.0,2169.557449960848,-5.99,4
09:28,663479159.0,4349.563541827712,-13.98,7
09:34,933491926.0,2810.1523000000025,-14.98,7
09:34,364357875.0,6644.648196083689,-12.04,2
09:40,414805878.0,11758.7727236329,-11.99,5
09:44,461990622.0,8186.673031620664,-64.94,7
09:44,960208650.0,16457.127739456995,-125.3,2
09:47,806358207.0,11241.410117527925,-23.99,4
09:48,146909202.0,2070.247723090562,-12.42,2
09:54,776431321.0,2939.065944797949,-104.23,2
09:55,833899961.0,441.4077442498694,-37.94,1
09:55,700138124.0,3917.507655464608,-29.18,2
09:58,506618547.0,15002.282391203424,-34.26,7
10:04,987656636.0,2327.5853207833657,-18.1,7
10:05,199016328.0,3985.206606911702,-230.3,2
10:05,170637730.0,1867.685958025227,-28.12,7
10:05,454129843.0,737.8150951665599,-225.39,2
10:05,583579399.0,993.0286999999992,-35.98,6
10:09,960208650.0,16161.727739456996,-295.4,2
10:10,408057540.0,3750.36707280612,-77.0,7
10:12,486495235.0,1222.0921393887163,-11.98,2
10:13,698076160.0,5488.310168577104,-57.92,1
10:13,776431321.0,2909.105944797949,-29.96,1
10:14,166019891.0,7068.664749705453,-18.31,5
10:18,435984758.0,3548.972920064939,-35.38,5
10:18,705848712.0,24911.757296366195,-33.53,2
10:19,398429109.0,35.779000000001076,-163.49,2
10:22,647472692.0,23417.730766680535,-21.04,4
10:22,373163757.0,9926.289273794211,-7.0,1
10:22,828750680.0,1029.2723452136795,-36.98,4
10:22,224215364.0,-1756.3775920882788,-26.68,5
10:23,604288474.0,1859.8459173637675,-80.46,2
10:23,408057540.0,3723.06707280612,-27.3,4
10:24,555804115.0,-1415.6735475587034,-14.54,5
10:24,551196328.0,3607.01841862956,-88.99,2
10:24,897592348.0,14111.116902342945,-139.97,2
10:24,627917561.0,3384.1850500000046,-12.98,7
10:25,224112146.0,117.35559999999862,-42.85,5
10:26,454129843.0,599.2150951665599,-138.6,2
10:27,143061865.0,6144.176140019385,-69.98,4
10:29,657139925.0,12649.629279857178,-3.02,5
10:31,815993333.0,5869.670559061407,-30.1,2
10:31,223207876.0,-431.6728999999997,-102.14,5
10:31,421881811.0,1869.9507452693351,-124.06,2
10:32,874506295.0,-1652.371756245572,-40.31,5
10:33,240643705.0,91.65361737398077,-1.99,4
10:34,138609932.0,3037.8090032945856,-19.95,4
10:34,409971170.0,2165.499088838259,-97.26,2
10:35,957821152.0,-1813.4329535715497,-15.55,5
10:35,461029994.0,6632.495411866108,-1.5,4
10:35,960208650.0,15927.927739456996,-233.8,2
10:35,660874296.0,2159.567449960848,-9.99,2
10:41,581655972.0,38539.71811271749,-32.98,2
10:42,989506909.0,-2520.8848707594375,-50.28,5
10:43,298007503.0,663.0251036256333,-41.6,2
10:44,490790931.0,92.21764999999856,-84.85,5
10:44,408057540.0,3615.26707280612,-107.8,2
10:44,776431321.0,2785.219944797949,-123.89,2
10:44,262767079.0,-1386.8288000000002,-62.98,5
10:45,604288474.0,1788.4599173637675,-71.39,2
10:45,967989787.0,-330.3120673592728,-31.88,5
10:45,454129843.0,542.5430951665599,-56.67,2
10:47,254853117.0,1717.4206520607834,-31.99,1
10:48,519644021.0,1854.1405033719775,-54.21,2
10:49,895331556.0,-768.2150000000008,-8.64,5
10:49,779376323.0,2441.913245819657,-79.8,4
10:49,859603181.0,2439.1259705412563,-58.32,5
10:49,130154096.0,1192.4950017058784,-81.98,2
10:49,904154012.0,821.777458120432,-20.93,4
10:50,799861885.0,-312.0188000000012,-161.85,5
10:51,621181115.0,-497.63424957077115,-103.21,5
10:53,314980178.0,2585.650850000006,-19.99,2
10:54,196289502.0,14278.363181548548,-11.23,4
10:54,454129843.0,396.94309516655983,-145.6,2
10:54,456246119.0,19318.00190973857,-79.98,4
10:56,398429109.0,-35.71099999999893,-71.49,2
10:57,699997811.0,-34.5033499999964,-70.78,5
10:57,315078351.0,6348.502293308265,-118.3,2
10:59,680773155.0,82.22038333109171,-49.02,5
11:01,192202372.0,-189.48506611120217,-180.6,2
11:01,540159353.0,10113.638082442603,-28.42,5
11:01,750094757.0,-2088.2593000000006,-63.77,5
11:02,639409800.0,33217.18974662725,-91.42,4
11:04,670427480.0,-203.15919999999855,-136.92,5
11:10,858989281.0,24744.874653156803,-16.78,7
11:11,454129843.0,257.6430951665599,-139.3,2
11:12,815993333.0,5834.530559061407,-35.14,2
11:12,315078351.0,6277.116293308264,-71.39,2
11:13,804317849.0,-3803.33163302052,-61.31,5
11:13,653640811.0,15788.517984132346,-68.66,2
11:14,425730826.0,201.47690938871983,-47.73,5
11:15,631111289.0,-717.8865000000008,-7.0,5
11:16,832564361.0,14914.15030876284,-70.22,5
11:17,711045550.0,3124.3093500000036,-19.99,2
11:17,408057540.0,3552.26707280612,-63.0,2
11:17,117273481.0,8307.37706533524,-107.77,2
11:21,170637730.0,1852.515478025227,-15.17,4
11:22,315546581.0,26280.28504062054,-21.45,8
11:22,492215823.0,886.3885738154439,-10.2,2
11:23,941285623.0,1023.0903990667704,-80.47,2
11:23,146686559.0,-738.5120111734778,-28.97,5
11:24,285428103.0,8913.863491187381,-69.98,2
11:25,235881534.0,12000.925243312427,-132.28,4
11:26,609939116.0,6512.396926289659,-11.62,2
11:28,286484726.0,320.0728267328863,-19.99,2
11:28,358836279.0,-12.898907192414155,-101.9,5
11:30,117273481.0,8179.30506533524,-128.07,2
11:30,454129843.0,170.18509516655988,-87.46,2
11:33,285428103.0,8861.873491187382,-51.99,2
11:34,285428103.0,8842.320621063915,-19.55,2
11:35,227104649.0,2429.053034316177,-22.04,2
11:36,715068825.0,1009.6294999999998,-48.38,2
11:37,604288474.0,1509.8599173637676,-278.6,2
11:40,454129843.0,100.19909516655989,-69.99,2
11:40,815385232.0,9096.00275682661,-47.45,2
11:42,688712152.0,5842.482017176149,-122.97,2
11:42,475277431.0,866.3481369436192,-23.97,4
11:45,480557476.0,10321.413734432334,-24.49,7
11:45,254853117.0,1635.3606520607834,-82.06,2
11:49,482513594.0,4794.320286173564,-102.79,2
11:50,683319988.0,6120.676097347717,-60.6,8
11:51,117273481.0,8090.44706533524,-88.86,2
11:52,555393405.0,-1054.5005,-31.12,5
11:55,929044080.0,-741.5561084943718,-40.24,5
11:56,941285623.0,995.7903990667704,-27.3,2
11:58,213112754.0,5875.9633650308,-81.8,2
11:59,822135975.0,10079.687092407095,-23.21,5
12:00,449871732.0,9848.459105247051,-124.59,5
12:00,454129843.0,-17.400904833440123,-117.6,2
12:01,558119802.0,30787.210985508777,-30.25,7
12:02,920830317.0,-655.8739793625188,-289.2,5
12:03,524425303.0,-862.7990000000011,-70.57,5
12:03,604288474.0,1335.5879173637677,-174.27,2
12:04,873693307.0,8362.451674247968,-21.89,9
12:05,366550080.0,24888.61188738318,-9.09,2
12:05,715068825.0,864.5044999999998,-145.12,2
12:09,866941383.0,1040.126950000006,-65.99,2
12:10,489964679.0,18948.78264268225,-44.79,2
12:15,184430449.0,1653.4539276932644,-24.29,9
12:18,408057540.0,3489.26707280612,-63.0,7
12:19,454129843.0,-59.40090483344012,-42.0,2
12:20,130154096.0,1137.4950017058784,-55.0,2
12:22,819515373.0,1351.0961360637916,-11.98,1
12:23,941285623.0,940.4903990667704,-55.3,2
12:24,117273481.0,8035.14706533524,-55.3,2
12:24,909676212.0,162.74940453202734,-102.1,5
12:24,192202372.0,-336.45706611120215,-146.97,2
12:25,558875206.0,2118.2843108989528,-31.99,2
12:26,491392945.0,4269.055500000008,-36.95,1
12:29,489964679.0,18847.28264268225,-101.5,2
12:30,699139822.0,877.837787831875,-18.74,9
12:30,454129843.0,-142.67290483344013,-83.27,2
12:30,715068825.0,834.5044999999998,-30.0,2
12:30,517190750.0,1245.8385899154127,-25.22,9
12:32,711045550.0,3013.933350000003,-110.38,5
12:33,117273481.0,7993.16106533524,-41.99,2
12:36,298000165.0,24084.013194838342,-15.74,2
12:37,130154096.0,994.9950017058784,-142.5,2
12:39,310620484.0,-211.12880490780168,-35.39,9
12:39,213112754.0,5858.0633650308,-17.9,9
12:41,280098744.0,-144.22962212833437,-66.09,5
12:42,290818242.0,6219.414470772659,-27.27,5
12:45,454129843.0,-151.05890483344012,-8.39,2
12:46,496674181.0,-1422.6885723307223,-22.92,5
12:46,586315521.0,11252.007671918664,-64.63,2
12:50,116169597.0,-141.6710500000004,-49.93,7
12:52,195895574.0,6315.167954739071,-36.48,9
12:52,923322792.0,-825.7268317536376,-53.34,5
12:53,197865285.0,-229.4558382687798,-90.45,5
12:54,132400709.0,432.66208515393976,-98.07,5
12:55,408057540.0,3433.9670728061196,-55.3,4
12:56,151968462.0,5828.993840687484,-4.62,7
12:56,998405607.0,-785.9414999999981,-55.56,5
12:56,941285623.0,822.2183990667704,-118.27,2
12:58,471897866.0,6690.14685798675,-7.38,7
12:59,241459011.0,541.9778132723472,-26.69,5
13:03,315078351.0,6231.050053308264,-46.07,4
13:03,570269025.0,2464.067800644422,-85.97,2
13:03,417850087.0,15698.77041777858,-26.06,2
13:06,454356905.0,168.4718768629556,-32.09,9
13:07,158414827.0,-1808.2450000000017,-3.25,5
13:08,322221939.0,3048.5061509088664,-7.5,9
13:08,887853850.0,9265.416013407645,-66.09,2
13:09,727417797.0,4958.769049492958,-29.99,2
13:09,145387690.0,3966.803223613026,-31.88,2
13:10,605711527.0,-452.1994861674163,-25.18,5
13:10,897714622.0,7995.806581429642,-15.19,7
13:11,454129843.0,-300.83090483344006,-149.77,2
13:14,478986718.0,-1312.884500000001,-20.15,9
13:15,585625048.0,1120.9226823533745,-5.35,9
13:17,595800644.0,-1207.9906500000002,-115.79,5
13:18,117273481.0,7820.975065335239,-69.3,2
13:18,489964679.0,18791.98264268225,-55.3,7
13:19,348325817.0,9041.56289659362,-6.6,9
13:21,824916823.0,7862.21368714994,-33.35,8
13:21,454129843.0,-441.51690483344,-140.69,2
13:22,754141345.0,-2908.6753351157613,-28.78,5
13:23,199016328.0,3847.3066069117017,-137.9,2
13:29,575652395.0,1826.1573392058272,-113.22,2
13:29,408057540.0,3270.8670728061197,-163.1,2
13:32,297823329.0,86.22644999999916,-15.98,1
13:34,117273481.0,7793.675065335239,-27.3,2
13:36,199016328.0,3700.3066069117017,-147.0,2
13:37,938992364.0,54.43764373139953,-155.44,5
13:40,948069469.0,-1030.623600000001,-108.14,5
13:42,653640811.0,15658.443984132346,-130.07,5
13:43,867679563.0,-200.75094629828413,-25.23,5
13:44,489964679.0,18701.72464268225,-90.26,4
13:46,833899961.0,431.4177442498694,-9.99,2
13:47,586315521.0,11241.597671918664,-10.41,7
13:52,285428103.0,8798.320621063915,-44.0,4
13:55,655450953.0,-2837.9573784555296,-56.03,5
13:56,454129843.0,-484.90290483344006,-43.39,2
13:57,859264768.0,87.72113378193839,-130.59,5
13:58,623156843.0,3705.395568283228,-51.98,4
14:01,742223719.0,359.8251573048027,-18.97,4
14:02,824916823.0,7831.52368714994,-30.69,9
14:02,117273481.0,7739.089065335239,-54.59,2
14:05,644751433.0,-1661.7031584655383,-75.68,5
14:11,344219145.0,7084.660330975841,-59.94,2
14:12,412823730.0,-96.93977414951028,-55.82,5
14:15,138609932.0,2974.8290032945856,-62.98,2
14:17,943329213.0,1296.5931925635557,-28.1,2
14:20,117273481.0,7633.403065335239,-105.69,2
14:21,421881811.0,1862.719875269335,-7.23,4
14:22,135937041.0,-1750.7128482684118,-107.01,5
14:23,130154096.0,947.4950017058784,-47.5,2
14:24,454129843.0,-552.78890483344,-67.89,2
14:28,489964679.0,18660.42464268225,-41.3,7
14:32,866941383.0,1023.156950000006,-16.97,7
14:34,504055745.0,-517.5115386582331,-40.38,5
14:34,558875206.0,2076.3043108989527,-41.98,2
14:36,624563756.0,-750.7406712164436,-39.62,5
14:36,130154096.0,847.4950017058784,-100.0,2
14:39,760753808.0,-549.9953000000005,-119.44,5
14:39,454129843.0,-622.08890483344,-69.3,2
14:41,199016328.0,3457.4066069117016,-242.9,2
14:42,651756497.0,10932.81832179027,-86.26,2
14:44,776431321.0,2636.1199447979493,-149.1,2
14:47,780463728.0,2190.628520942239,-140.27,5
14:50,581655972.0,38534.728112717494,-4.99,7
14:51,117273481.0,7597.71706533524,-35.69,2
14:56,661295096.0,2793.410513321748,-19.99,4
14:57,355733816.0,4680.538506048991,-28.0,2
15:00,703478110.0,4140.916450637635,-10.98,7
15:00,678330503.0,2000.74345086859,-30.17,2
15:02,489964679.0,18564.53864268225,-95.89,4
15:08,795847804.0,21596.49537433101,-33.77,5
15:10,454129843.0,-697.66090483344,-75.57,2
15:15,986267641.0,6639.7988179832855,-20.15,4
15:15,849096144.0,705.3300207513419,-73.19,5
15:16,130154096.0,679.4950017058784,-168.0,2
15:18,559995067.0,3499.0965555904245,-14.18,2
15:18,358846516.0,180.2922225272177,-105.02,5
15:19,237684254.0,5042.6988392911135,-1.16,5
15:22,117273481.0,7529.831065335239,-67.89,2
15:29,409971170.0,2153.710681852495,-11.79,5
15:33,408057540.0,3188.26707280612,-82.6,2
15:40,117273481.0,7501.845065335239,-27.99,2
15:40,454129843.0,-752.9609048334399,-55.3,2
15:41,310375875.0,682.3931454554977,-24.23,5
15:42,639409800.0,33209.14974662725,-8.04,4
15:43,245690309.0,8448.037316270811,-5.07,7
15:43,489964679.0,18509.238642682252,-55.3,7
15:47,846550094.0,852.7947715014136,-66.98,2
15:50,575652395.0,1803.5922992058272,-22.57,4
15:54,802697323.0,14316.809559920392,-44.05,7
15:55,570269025.0,2461.917072911829,-2.15,7
15:56,229205098.0,6509.258441349247,-53.03,5
15:57,336557504.0,1088.3958372010195,-28.0,2
15:57,199016328.0,3311.8066069117017,-145.6,2
15:58,408057540.0,3055.26707280612,-133.0,2
16:01,192202372.0,-541.515066111202,-205.06,2
16:01,454129843.0,-765.54690483344,-12.59,2
16:03,489964679.0,18399.352642682257,-109.89,4
16:09,941285623.0,768.3323990667704,-53.89,2
16:10,173335108.0,3617.854,-9.48,4
16:13,408057540.0,2866.9670728061196,-188.3,2
16:17,785210466.0,1571.165619997711,-19.99,4
16:24,199016328.0,3050.706606911702,-261.1,2
16:27,738958551.0,8175.542214804064,-11.06,8
16:31,192202372.0,-635.3010661112021,-93.79,2
16:32,487051121.0,696.4055683486918,-27.96,7
16:34,106601471.0,9811.869831507374,-21.98,7
16:34,489964679.0,18309.052642682254,-90.3,2
16:36,587225252.0,4090.094489328436,-33.48,9
16:37,941285623.0,617.1463990667705,-151.19,2
16:38,551755686.0,5709.1932128977105,-27.99,2
16:40,121858569.0,59.2961500000025,-42.97,6
16:41,893134725.0,415.4806819367792,-72.97,2
16:42,199016328.0,2861.706606911702,-189.0,2
16:44,475117511.0,7077.350813767921,-1.56,2
16:44,408057540.0,2831.9670728061196,-35.0,2
16:50,489964679.0,18231.366642682253,-77.69,2
16:59,233981231.0,1836.880881960624,-62.97,2
17:04,489964679.0,18101.18064268225,-130.19,2
17:05,130154096.0,550.4950017058784,-129.0,2
17:10,736340277.0,8045.375340984612,-16.12,2
17:11,365608668.0,-190.63074797581123,-153.29,2
17:13,435984758.0,3521.7846000649392,-27.19,4
17:15,408057540.0,2673.0670728061195,-158.9,2
17:15,587225252.0,4059.937941409512,-30.16,5
17:20,522188082.0,6869.1512409641855,-10.9,8
17:27,809499628.0,15614.679818686818,-16.21,2
17:31,618514666.0,19457.284041064315,-29.99,4
17:32,365608668.0,-401.31674797581127,-210.69,2
17:33,788740658.0,1471.1490810387163,-6.0,7
17:34,454356905.0,127.8920459891282,-40.58,4
17:35,408057540.0,2540.0670728061195,-133.0,2
17:36,489964679.0,18009.48064268225,-91.7,2
17:36,331450202.0,6450.533467775089,-29.62,7
17:40,310375875.0,663.0738354554977,-19.32,4
17:45,365608668.0,-471.2607479758113,-69.94,2
17:47,522188082.0,6846.908580964186,-22.24,4
17:52,489964679.0,17982.18064268225,-27.3,2
17:53,117273481.0,7458.473065335239,-43.37,2
17:57,956717493.0,723.8921722249321,-206.5,2
18:03,324224854.0,2586.083329608421,-21.97,9
18:09,117273481.0,7326.173065335239,-132.3,2
18:11,489964679.0,17856.880642682252,-125.3,2
18:18,912584712.0,-44.64138045526682,-30.59,9
18:21,860360312.0,-167.49584111731963,-31.44,9
18:22,956717493.0,481.8921722249321,-242.0,2
18:25,256002321.0,5235.634539594668,-15.2,9
18:27,305778936.0,8846.798723088845,-20.63,9
18:29,489964679.0,17758.208642682253,-98.67,2
18:33,117273481.0,7312.887065335239,-13.29,2
18:38,494156462.0,-1132.4858364817603,-32.44,9
19:07,489964679.0,17666.536642682255,-91.67,2
19:11,117273481.0,7270.915065335239,-41.97,2
19:14,709608057.0,2043.6297336606851,-19.43,2
19:24,535744551.0,-8.658034004373988,-35.14,9
19:36,547010927.0,21270.996424744553,-40.39,9
19:42,117273481.0,7160.315065335239,-110.6,2
19:45,399144202.0,999.2864323096984,-45.91,7
19:47,460463595.0,-911.2229454185788,-29.99,9
19:51,473820682.0,10185.230647162669,-14.99,9
20:46,885259672.0,2835.2489770256407,-43.92,2
20:51,867987292.0,1497.2024124885286,-13.14,2
21:04,106601471.0,9809.123315055996,-2.75,5
23:07,901432314.0,3091.417297655635,-16.93,9
00:10,417850087.0,15683.975418973014,-14.79,4
00:15,282837512.0,12467.152731979751,-26.94,9
00:17,858989281.0,24733.9246531568,-10.95,9
00:20,874431242.0,7054.915291314599,-19.88,2
00:20,822135975.0,10073.92585392638,-5.76,2
00:20,500051919.0,1085.5696966505902,-22.9,9
00:22,179173981.0,4048.465177605412,-22.07,8
00:25,987163717.0,5121.098480000005,-35.54,9
00:29,518474507.0,11879.762357855048,-31.8,9
00:35,124102251.0,2671.125931770645,-4.32,5
00:47,581655972.0,38533.9105927346,-0.82,2
00:51,113747882.0,11155.94984730264,-32.6,9
00:52,985188462.0,-1037.2032112887753,-35.69,9
00:54,254853117.0,1576.16240552982,-59.2,4
00:55,897714622.0,7994.457759345146,-1.35,2
00:57,824916823.0,7797.14368714994,-34.38,9
00:59,235881534.0,11997.697701941355,-3.23,5
01:00,699139822.0,875.9029940975392,-1.93,2
01:01,116598243.0,-1222.7837782225504,-14.78,9
01:01,633345190.0,5123.630676387944,-30.79,9
01:02,221868392.0,4189.726193864469,-25.72,7
01:07,586315521.0,11226.370782146652,-15.23,4
01:10,519644021.0,1852.4351061006803,-1.71,7
01:12,858989281.0,24715.79401068411,-18.13,2
01:13,950234174.0,877.5597007763017,-11.89,2
01:15,836110591.0,5655.162629936911,-2.46,7
01:18,196289502.0,14268.963181548548,-9.4,9
01:19,679911053.0,1832.464996848116,-22.48,5
01:21,949032480.0,3680.531381370712,-29.37,7
01:22,113747882.0,11151.398335899716,-4.55,5
01:23,429556122.0,5330.911093344285,-8.16,7
01:24,815385232.0,9082.140998514882,-13.86,7
01:27,322720763.0,5238.487530649673,-57.31,5
01:34,912705941.0,17284.060006425163,-8.94,4
01:37,131388684.0,20350.402404171044,-13.72,7
01:41,534325901.0,5841.610827926202,-0.77,8
01:47,534325901.0,5827.670827926202,-13.94,9
01:47,540159353.0,10107.98755002838,-5.65,7
01:56,667367404.0,7360.130475987557,-22.22,5
01:59,213112754.0,5812.850714981926,-45.21,5
02:09,586315521.0,11197.980782146651,-28.39,9
02:10,836110591.0,5617.722629936911,-37.44,9
02:14,651756497.0,10923.147429093731,-9.67,7
02:16,237684254.0,5037.876264650488,-4.82,7
02:17,383833857.0,23117.71566925685,-18.44,9
02:20,718058208.0,1300.5694056841016,-13.67,4
02:23,769311479.0,5197.293450440403,-20.84,7
02:26,795847804.0,21562.1724011482,-34.32,7
02:33,383625050.0,3591.395998080969,-8.74,2
02:46,705848712.0,24896.817296366196,-14.94,9
02:47,256002321.0,5211.404539594669,-24.23,9
02:48,383833857.0,23092.54807313749,-25.17,2
02:51,604288474.0,1325.993254314403,-9.59,8
02:51,145387690.0,3938.7032236130262,-28.1,9
02:52,785749304.0,7511.487188755868,-12.95,2
02:54,264550521.0,8759.387707926946,-22.49,7
02:56,433917275.0,6411.652599557121,-8.78,5
03:04,489964679.0,17632.886642682253,-33.65,9
03:07,930277104.0,9187.374716173576,-22.34,9
03:12,678851253.0,2805.2611511800064,-22.93,7
03:13,822250278.0,5481.180452233903,-0.75,5
03:13,639409800.0,33171.214067568246,-37.94,8
03:24,191161970.0,-3795.713999999996,-22.89,9
03:28,844206657.0,-250.5000948534302,-42.94,9
03:30,441274121.0,10607.599608681418,-62.28,4
03:40,705848712.0,24867.90165893289,-28.92,7
03:40,851649498.0,9313.782100252867,-54.41,5
03:42,482513594.0,4792.408395404903,-1.91,7
03:42,930277104.0,9170.965789839109,-16.41,5
03:45,187541224.0,714.905762027924,-37.0,9
03:46,237493332.0,13002.252601788789,-0.99,2
03:50,887853850.0,9252.74819927105,-12.67,7
03:53,940569402.0,4922.121903312662,-24.44,9
03:57,802697323.0,14279.429559920392,-37.38,9
04:02,282837512.0,12466.765666860903,-0.39,4
04:02,824916823.0,7754.780871788896,-42.36,7
04:02,195895574.0,6290.439739193592,-24.73,2
04:04,308505160.0,11312.040311250406,-18.47,2
04:05,550169791.0,19626.9871382298,-60.88,7
04:08,108481285.0,7952.038419748105,-67.35,7
04:08,108563213.0,22403.974698421574,-1.32,2
04:11,450896297.0,11873.857610535928,-41.17,9
04:12,558119802.0,30786.82427953777,-0.39,7
04:15,647936800.0,2966.882312087023,-11.72,7
04:23,419550103.0,17351.837966827068,-22.13,5
04:23,844835978.0,9133.143205781897,-0.32,2
04:27,305778936.0,8802.692694253537,-44.11,2
04:29,216285378.0,22289.929384634914,-40.38,9
04:33,719586818.0,16266.903390435376,-16.4,2
04:36,259015404.0,-170.158085124812,-30.23,9
04:38,706250160.0,11084.32794542191,-16.14,7
04:39,146909202.0,2017.7798069257592,-52.47,8
04:40,657139925.0,12624.879279857178,-24.75,9
04:42,450896297.0,11842.970438170629,-30.89,2
04:44,859603181.0,2437.68141805621,-1.44,2
04:44,851181128.0,3423.4813933861183,-32.13,9
04:45,399144202.0,961.1464323096984,-38.14,9
04:48,520447032.0,7416.913539471188,-27.7,9
04:48,601627384.0,3163.846935283711,-41.84,9
04:52,639549973.0,5764.07744069219,-19.79,7
04:52,899742927.0,11432.953844995449,-15.37,5
04:55,549414742.0,5909.209304588834,-6.76,4
04:56,534204159.0,4450.601913251567,-28.65,9
04:58,709608057.0,2021.6397336606851,-21.99,9
05:00,287480331.0,6704.168461335948,-6.01,2
05:02,532478725.0,3819.594363500429,-4.87,8
05:05,298007503.0,626.5851036256333,-36.44,9
05:07,973086490.0,9013.329138664994,-12.0,8
05:08,245690309.0,8400.985504889453,-47.05,7
05:09,324224854.0,2501.7274861103624,-84.36,7
05:19,541639148.0,3223.626273251511,-4.35,7
05:20,678330503.0,1995.2874575453309,-5.46,7
05:21,145387690.0,3901.715538843199,-36.99,8
05:22,802697323.0,14211.012999175817,-68.42,2
05:24,873693307.0,8344.445204862104,-18.01,7
05:26,630468201.0,-811.4193338897016,-27.54,9
05:30,624500124.0,2805.419932376807,-43.1,5
05:35,796709231.0,-714.9080221037025,-34.49,9
05:40,506618547.0,14972.159340603388,-30.12,5
05:43,510101371.0,11951.504394288017,-36.34,9
05:45,679662108.0,14947.390764633932,-35.15,7
05:46,200080192.0,8411.50394335687,-23.0,5
05:46,994214354.0,8568.27466127905,-56.39,8
05:49,348325817.0,8999.37289659362,-42.19,9
05:52,500043411.0,12480.020883276266,-9.13,8
05:56,187111705.0,5807.996274588873,-8.28,4
06:02,853907490.0,6151.559900253657,-62.59,8
06:07,940569402.0,4901.690733387892,-20.43,7
06:07,414805878.0,11721.5327236329,-37.24,9
06:15,842682241.0,4522.802563077287,-54.28,2
06:19,700138124.0,3901.757655464608,-15.75,9
06:20,675806859.0,6058.191395126431,-23.52,7
06:25,461990622.0,8173.9859177766,-12.69,8
06:26,749378808.0,3119.3919987550325,-26.43,9
06:30,572384506.0,6204.188196173857,-41.2,9
06:32,736340277.0,8023.825340984612,-21.55,9
06:34,886921642.0,2539.462761793125,-38.4,5
06:43,885259672.0,2826.2005948840615,-9.05,5
06:45,832564361.0,14876.081992274056,-38.07,4
06:45,496395938.0,11041.523499614326,-0.77,2
06:49,143003091.0,20414.93514316596,-9.61,5
06:50,910730524.0,6878.28165616398,-0.18,7
06:51,609939116.0,6506.293895204708,-6.1,5
06:52,613729471.0,8109.244593155226,-20.65,9
06:53,657139925.0,12619.468044418749,-5.41,2
06:53,366550080.0,24872.17258252998,-16.44,2
06:55,108931112.0,12766.594030715967,-30.17,9
06:58,668329719.0,7419.570983673097,-9.21,8
07:00,285220959.0,10924.748088690518,-16.49,8
07:00,183888402.0,17020.264973285393,-32.74,9
07:01,766941757.0,1298.2325563110237,-32.48,9
07:01,480557476.0,10319.641450120916,-1.77,2
07:01,128033695.0,1154.4094613548766,-21.2,7
07:03,256002321.0,5203.091936426854,-8.31,2
07:04,331450202.0,6433.1229337023005,-17.41,8
07:07,187541224.0,643.8674566485395,-71.04,8
07:07,678330503.0,1989.7874575453309,-5.5,9
07:07,670102069.0,2854.188796318032,-43.19,9
07:07,575652395.0,1773.254895139576,-30.34,7
07:10,147474476.0,3069.139102832959,-77.13,7
07:12,687135796.0,25521.378076322148,-17.65,2
07:19,120634201.0,4051.665329403303,-24.15,9
07:20,549414742.0,5874.419304588834,-34.79,9
07:23,749378808.0,3059.74574211275,-59.65,7
07:26,169006407.0,10451.063346400357,-5.17,5
07:31,987656636.0,2267.950449251695,-59.63,5
07:38,290818242.0,6168.073515158666,-51.34,5
07:40,510101371.0,11917.55835765167,-33.95,2
07:43,865748375.0,3051.5299394953536,-27.76,8
07:43,683319988.0,6118.557532319105,-2.12,7
07:49,414805878.0,11709.724236601,-11.81,2
07:50,992204045.0,5236.075143107405,-4.89,7
07:51,670102069.0,2840.8094868328203,-13.38,4
07:52,252760664.0,5588.87953149661,-16.0,7
07:54,364357875.0,6642.739637533428,-1.91,2
08:07,421881811.0,1857.0763419645607,-5.64,2
08:08,960208650.0,15861.65055244046,-66.28,7
08:11,613729471.0,8100.637574149953,-8.61,8
08:15,280268430.0,3814.933637538199,-8.07,7
08:18,587225252.0,4019.597941409512,-40.34,9
08:18,673025413.0,1524.1099520157418,-13.26,5
08:22,564214408.0,-289.03491527427394,-30.96,5
08:23,885259672.0,2819.4005948840613,-6.8,9
08:24,965038148.0,-717.5075143676722,-18.43,5
08:26,215426302.0,-938.497595974308,-60.13,5
08:26,822718326.0,9992.725522634277,-36.39,5
08:28,340680761.0,-3125.6805999999974,-29.45,5
08:28,391688371.0,-147.8297004314769,-74.07,5
08:29,141521177.0,6602.713900000015,-51.88,5
08:29,651372390.0,-3544.725749999999,-14.62,5
08:31,204855464.0,-1576.500738639616,-86.08,5
08:32,654329190.0,-245.19739905148072,-17.9,5
08:33,421475159.0,-540.3547373255874,-67.47,5
08:33,975200042.0,-3068.387699999997,-26.24,5
08:34,601627384.0,3128.499943042775,-35.35,2
08:36,259015404.0,-179.2579917115167,-9.1,8
08:38,666952234.0,-559.7354018755132,-67.75,5
08:38,392270893.0,11795.306791126486,-38.69,7
08:40,503575533.0,6092.4732519713025,-41.1,5
08:40,494977194.0,-345.2049294024219,-168.5,5
08:41,648644594.0,-488.8434000000009,-151.7,5
08:42,383833857.0,23059.27007313749,-33.28,5
08:42,776431321.0,2584.0819447979493,-52.04,5
08:43,308897841.0,727.1547999999989,-53.57,5
08:44,683078800.0,1199.5694529448708,-111.42,5
08:45,851181128.0,3416.674104496361,-6.81,2
08:45,198946608.0,2954.571988556173,-17.47,7
08:47,905860285.0,7935.389047618993,-7.39,2
08:48,234952520.0,481.3913999999989,-46.16,5
08:48,124377686.0,-2727.317399999998,-39.46,5
08:49,337771621.0,-2801.282649999999,-38.69,5
08:50,480557476.0,10229.439450120915,-90.2,5
08:52,550832673.0,1994.882016395508,-71.86,5
08:52,752362502.0,7472.310296457524,-2.29,7
08:52,587225252.0,4001.941123365891,-17.66,5
08:53,252760664.0,5532.8235314966105,-56.06,5
08:54,486495235.0,1081.1453893887162,-140.95,5
08:54,518746136.0,39.69277176308349,-12.6,5
08:56,925037906.0,556.8238000000015,-105.92,5
08:57,373163757.0,9636.489273794212,-289.8,5
08:59,191161970.0,-3832.421999999996,-36.71,5
09:00,738958551.0,8144.536956564501,-31.01,7
09:03,667367404.0,7354.080475987557,-6.05,9
09:03,851649498.0,9305.88210025287,-7.9,9
09:05,169006407.0,10445.713346400356,-5.35,9
09:06,690958123.0,19149.916364636418,-7.9,9
09:07,308505160.0,11226.549311250406,-85.49,5
09:09,165691047.0,-574.379100000001,-67.36,5
09:10,180616589.0,421.5745281236176,-44.35,5
09:11,467207141.0,131.5808670482637,-120.4,5
09:12,744211756.0,-4189.848249999994,-28.55,5
09:13,581655972.0,38528.31059273461,-5.6,9
09:14,578131296.0,244.3877194440438,-132.51,5
09:14,119943495.0,-1708.250062112858,-91.95,5
09:14,901432314.0,3050.033297655635,-41.38,5
09:15,683319988.0,6112.507532319105,-6.05,9
09:15,290818242.0,6161.473515158666,-6.6,9
09:15,229502829.0,-3638.793224186248,-75.87,5
09:16,570269025.0,2441.9270729118293,-19.99,4
09:16,152616936.0,125.6670078630647,-84.15,5
09:16,558875206.0,2068.8043108989527,-7.5,9
09:16,799453072.0,-546.6708500000011,-78.5,5
09:17,117273481.0,7155.265065335238,-5.05,9
09:19,198946608.0,2917.511988556173,-37.06,7
09:19,417850087.0,15678.975418973014,-5.0,9
09:20,163470640.0,516.8150999999997,-107.73,5
09:21,618138606.0,754.3797028700659,-6.35,9
09:21,546296727.0,-288.56227269738145,-61.01,5
09:24,683078800.0,1193.969452944871,-5.6,9
09:24,478986718.0,-1385.263100000001,-72.38,5
09:25,540159353.0,10101.38755002838,-6.6,9
09:27,454356905.0,-1.6079540108717936,-129.5,2
09:29,987656636.0,2232.710449251695,-35.24,2
09:31,366550080.0,24790.93258252998,-81.24,4
09:31,151916463.0,-1529.8674444008311,-35.87,5
09:31,133755851.0,-174.0314583819886,-146.48,2
09:31,407574996.0,-827.7433906190633,-136.39,5
09:34,287480331.0,6644.788961335948,-59.38,4
09:35,254853117.0,1368.01040552982,-208.15,5
09:36,212560376.0,-512.1288742208978,-143.53,5
09:37,304455868.0,1829.089490457602,-46.93,4
09:39,727417797.0,4823.928049492958,-134.84,5
09:42,788740658.0,1454.9283901948525,-16.22,2
09:44,979892433.0,-1679.429800000001,-95.93,5
09:47,904154012.0,815.787458120432,-5.99,7
09:48,305778936.0,8717.982694253538,-84.71,2
09:48,987229118.0,664.7040847372083,-85.3,5
09:50,892354433.0,-1351.6999606343386,-63.11,5
09:51,890830949.0,974.8181499999978,-74.97,2
09:51,399144202.0,957.5320723147196,-3.61,7
09:53,473820682.0,10149.055957162667,-36.17,4
09:54,941285623.0,615.6463990667705,-1.5,4
09:54,129018172.0,8126.832321236932,-10.98,1
09:57,165045150.0,-631.0139385971441,-49.61,5
10:00,133755851.0,-319.0214583819886,-144.99,2
10:00,857997794.0,450.6306651508872,-27.91,5
10:05,924045955.0,1056.8405126586645,-50.02,2
10:07,383833857.0,23037.67007313749,-21.6,1
10:07,137822385.0,3215.400993181048,-132.5,2
10:08,684988568.0,-744.4861734272015,-42.07,5
10:13,322221939.0,3021.5051324203614,-27.0,5
10:15,480557476.0,10168.129450120918,-61.31,2
10:16,444428189.0,2493.4642000000026,-16.98,7
10:19,890830949.0,919.8281499999978,-54.99,2
10:21,596171893.0,-196.5144051744889,-33.95,7
10:23,256002321.0,5169.721936426854,-33.37,2
10:24,494156986.0,-869.2227543276651,-45.69,5
10:24,741903302.0,1750.9568650141248,-24.95,7
10:26,128033695.0,1134.2194613548766,-20.19,4
10:32,522188082.0,6840.5397347018115,-6.37,2
10:33,444428189.0,2432.4842000000026,-60.98,2
10:35,215311171.0,5713.665484045013,-83.96,5
10:35,137822385.0,3147.900993181048,-67.5,2
10:35,741903302.0,1680.9768650141248,-69.98,4
10:36,340321732.0,1099.0970000000032,-114.0,2
10:39,766941757.0,1294.2077113863136,-4.02,5
10:39,890830949.0,832.8481499999978,-86.98,2
10:39,941285623.0,582.6463990667705,-33.0,7
10:43,479456865.0,996.3256995833046,-32.97,4
10:43,472995101.0,1639.0108342428032,-34.47,5
10:46,355733816.0,4668.464832674864,-12.07,5
10:47,180616589.0,370.0945281236176,-51.48,4
10:48,613427466.0,5697.5919560118655,-49.99,4
10:49,133755851.0,-377.00145838198864,-57.98,2
10:50,613729471.0,8076.367574149953,-24.27,7
10:53,340321732.0,900.0970000000032,-199.0,2
10:56,585625048.0,1020.9326823533744,-99.99,2
10:58,588565416.0,6781.769422964219,-60.42,5
10:58,970298834.0,1797.1188889772095,-150.28,2
11:01,762896656.0,-276.74750184814127,-26.3,5
11:06,441142605.0,1874.9310388780311,-51.99,2
11:08,924045955.0,1039.8235126586644,-17.02,4
11:08,585625048.0,974.3502320528412,-46.58,2
11:13,538003940.0,970.8400000000086,-29.96,1
11:22,133755851.0,-505.49145838198865,-128.49,2
11:23,711045550.0,2895.6333500000032,-118.3,7
11:25,613427466.0,5670.419455264375,-27.17,4
11:28,779946617.0,14709.777279709511,-22.71,8
11:51,647472692.0,23401.330766680538,-16.4,2
11:51,228136274.0,1313.1804999999993,-104.5,7
11:51,856147482.0,-1160.5129485986247,-162.35,5
12:01,494789005.0,2533.978323064033,-34.69,5
12:05,454356905.0,-23.945234010871776,-22.34,4
12:07,828532554.0,120.2168765071483,-30.15,9
12:09,395654270.0,-2066.2212028122003,-28.7,5
12:10,948558249.0,8357.183631737076,-28.95,1
12:13,903663593.0,478.0249583025628,-17.97,7
12:19,137822385.0,2940.900993181048,-207.0,2
12:19,179173981.0,4009.265177605412,-39.2,2
12:27,973086490.0,8995.579138664994,-17.75,9
12:28,644751433.0,-1680.6931584655383,-18.99,9
12:33,433837402.0,-474.5458684641881,-35.2,9
12:37,655368335.0,4328.89216486482,-15.73,2
12:41,446720287.0,-703.2625591815945,-60.99,5
12:54,254853117.0,1267.92040552982,-100.09,2
12:56,737547541.0,-402.09540043222574,-110.96,5
12:56,252419513.0,-2163.828685813416,-45.42,5
12:58,264550521.0,8747.243287926945,-12.14,4
13:03,613427466.0,5665.429455264375,-4.99,7
13:04,136770968.0,-535.5634000000005,-47.42,5
13:04,218795010.0,-1186.3750500000006,-131.53,5
13:05,815993333.0,5810.448337166158,-24.08,7
13:06,910730524.0,6872.93165616398,-5.35,9
13:09,890830949.0,825.8581499999977,-6.99,2
13:10,366550080.0,24733.56058252998,-57.37,5
13:10,364396689.0,-814.89825,-53.02,5
13:10,170233640.0,-350.95126005010275,-36.97,4
13:11,688712152.0,5836.78201717615,-5.7,9
13:12,711045550.0,2640.1333500000032,-255.5,7
13:18,691843653.0,-3113.2558999999937,-22.86,5
13:19,195895574.0,6080.439739193592,-210.0,2
13:29,317161035.0,-3641.9625999999967,-91.64,5
13:30,711045550.0,2465.833350000003,-174.3,4
13:35,305778936.0,8680.382694253538,-37.6,1
13:41,137822385.0,2814.400993181048,-126.5,2
13:41,890830949.0,730.8681499999977,-94.99,2
13:54,298000165.0,24077.73004701912,-6.28,7
14:02,980500334.0,-793.0344338929041,-60.22,5
14:07,700138124.0,3885.2415078469744,-16.52,7
14:09,133755851.0,-635.4814583819887,-129.99,2
14:18,162162212.0,716.4845433273089,-99.99,2
14:19,834383043.0,5253.562095132721,-16.49,4
14:21,695607232.0,-742.6005053894401,-71.55,5
14:37,259015404.0,-196.95799171151668,-17.7,7
14:58,984783496.0,12708.298914240922,-79.06,5
14:58,819515373.0,1294.1161360637916,-56.98,4
15:05,901432314.0,3031.9601863887688,-18.07,2
15:05,890830949.0,705.8681499999977,-25.0,2
15:23,556992209.0,10831.76062447272,-18.0,4
15:31,388862238.0,926.811528473194,-37.99,2
15:33,678330503.0,1927.007457545331,-62.78,2
15:33,421881811.0,1844.8763419645609,-12.2,4
15:34,742223719.0,231.2001573048027,-128.62,7
15:36,715068825.0,802.5144999999998,-31.99,2
15:38,890830949.0,650.8881499999977,-54.98,2
15:47,133755851.0,-821.4714583819887,-185.99,2
15:49,743630833.0,-170.33068671529878,-71.98,2
16:00,409971170.0,1973.110681852495,-180.6,2
16:01,742223719.0,89.0751573048027,-142.12,4
16:05,145553416.0,-2636.915649999999,-17.69,5
16:07,170637730.0,1850.622120181274,-1.89,5
16:14,108481285.0,7879.988419748105,-72.05,2
16:17,492058070.0,335.13596874047073,-37.94,7
16:20,899742927.0,11151.028844995448,-281.92,5
16:24,340321732.0,818.5970000000032,-81.5,2
16:24,720742759.0,-177.28101911699258,-111.2,5
16:25,743630833.0,-191.3006867152988,-20.97,1
16:27,532478725.0,3783.734363500429,-35.86,9
16:27,133755851.0,-933.4614583819888,-111.99,2
16:31,296972867.0,-1102.336100000001,-65.95,5
16:34,227104649.0,2419.043034316177,-10.01,2
16:49,133755851.0,-1086.9414583819887,-153.48,2
16:53,603721739.0,520.1288994831839,-140.67,2
16:53,340321732.0,646.5970000000032,-172.0,2
16:54,738958551.0,8109.096956564502,-35.44,2
16:54,570323670.0,2457.787252280906,-51.03,2
16:56,534097839.0,-3577.416049999998,-17.23,5
16:57,345582855.0,-336.31414717945074,-40.51,5
16:57,355940285.0,7241.542978189683,-26.85,9
17:00,421881811.0,1816.9463419645608,-27.93,9
17:09,516051449.0,966.5687746508286,-49.0,2
17:13,986267641.0,6611.832197421561,-27.97,2
17:13,433917275.0,6382.022599557121,-29.63,9
17:15,890830949.0,604.8981499999977,-45.99,2
17:16,294474095.0,-2380.518786499239,-35.9,5
17:16,133755851.0,-1189.9114583819887,-102.97,2
17:17,350921975.0,-595.6086789261257,-78.9,5
17:17,435984758.0,3518.977041931543,-2.81,5
17:21,949032480.0,3639.591381370712,-40.94,9
17:23,603721739.0,390.6428994831839,-129.49,2
17:24,106601471.0,9767.08461466168,-42.04,5
17:26,730002588.0,11713.657676378682,-35.25,5
17:26,822718326.0,9975.745522634275,-16.98,1
17:26,874431242.0,7024.815291314599,-30.1,9
17:27,237493332.0,12953.582601788788,-48.67,7
17:30,516051449.0,917.5687746508286,-49.0,2
17:31,690958123.0,19138.916364636418,-11.0,4
17:32,835736339.0,1243.7660661464715,-60.09,4
17:33,822135975.0,10012.84585392638,-61.08,2
17:33,587225252.0,3899.751123365891,-102.19,2
17:34,836110591.0,5610.412629936911,-7.31,7
17:34,574548998.0,-937.7693500000008,-32.9,5
17:35,152488934.0,1381.5209573137306,-12.99,2
17:35,893134725.0,357.1468819367792,-58.33,5
17:36,842682241.0,4391.202563077287,-131.6,2
17:36,215311171.0,5678.829709504651,-34.84,5
17:38,994214354.0,8538.144661279051,-30.13,9
17:38,108563213.0,22303.720698421577,-100.25,5
17:39,596328017.0,-2536.0553499999987,-56.48,5
17:41,742223719.0,-23.4248426951973,-52.5,4
17:42,417850087.0,15665.005418973014,-13.97,4
17:42,419550103.0,17277.651966827067,-74.19,2
17:43,890830949.0,446.8981499999977,-158.0,2
17:46,956717493.0,450.5440722249321,-31.35,5
17:46,482513594.0,4700.938395404903,-91.47,2
17:46,170233640.0,-374.9112600501027,-23.96,7
17:46,373163757.0,9631.499273794212,-4.99,7
17:47,871200314.0,-121.72222575736164,-79.9,5
17:48,386729293.0,30106.697898860184,-1.39,7
17:49,809499628.0,15604.69981868682,-9.98,9
17:50,785749304.0,7502.537188755869,-8.95,9
17:51,822718326.0,9945.900117637952,-29.85,5
17:52,987163717.0,5095.428480000005,-25.67,2
17:54,651756497.0,10868.347429093732,-54.8,2
17:56,355602925.0,1037.4930765753274,-163.5,2
17:57,842682241.0,4272.202563077287,-119.0,2
17:57,703478110.0,4139.864731849387,-1.05,7
17:58,835736339.0,1211.7460661464715,-32.02,2
17:58,417850087.0,15624.905418973014,-40.1,2
17:58,742223719.0,-132.9248426951973,-109.5,7
17:59,500843551.0,124.17354999999952,-29.98,9
18:00,890830949.0,421.8981499999977,-25.0,2
18:00,832564361.0,14746.471992274057,-129.61,2
18:02,349614277.0,540.4245499999997,-74.97,5
18:03,237493332.0,12902.790601788787,-50.79,5
18:04,516051449.0,722.2687746508286,-195.3,2
18:04,344219145.0,7023.438330975841,-61.22,5
18:05,163470640.0,403.1900999999997,-113.62,2
18:05,954263768.0,-459.6214000000003,-32.29,5
18:08,270374623.0,8869.187560638891,-41.85,5
18:08,683319988.0,6088.367532319105,-24.14,9
18:12,315546581.0,26259.294438925783,-20.99,5
18:12,603721739.0,277.9848994831839,-112.66,2
18:12,419550103.0,17123.651966827067,-154.0,2
18:14,890830949.0,373.4081499999977,-48.49,2
18:21,146909202.0,1984.5998069257591,-33.18,9
18:26,229205098.0,6467.334987048672,-41.92,5
18:27,355602925.0,932.9930765753274,-104.5,2
18:28,496395938.0,10975.765499614326,-65.76,5
18:30,510101371.0,11898.25835765167,-19.3,7
18:31,878989510.0,3502.36188614179,-176.2,5
18:33,237493332.0,12893.30060178879,-9.49,9
18:34,245690309.0,8392.179504889453,-8.81,5
18:34,583579399.0,976.0486999999991,-16.98,7
18:36,321372947.0,-644.9842507890993,-48.39,5
18:36,558119802.0,30753.64427953777,-33.18,9
18:36,152488934.0,1338.5287073137306,-42.99,5
18:37,163470640.0,324.8150999999997,-78.38,2
18:37,478651121.0,-529.9152704015303,-86.28,5
18:38,873693307.0,8331.445204862104,-13.0,9
18:39,867987292.0,1490.0782258263746,-7.12,5
18:39,270374623.0,8863.56756063889,-5.62,7
18:41,885259672.0,2744.285554884061,-75.12,7
18:43,873701090.0,158.87758509815367,-2.01,7
18:43,975345315.0,32416.06268146795,-45.97,7
18:45,127809299.0,839.7730534850559,-37.47,5
18:46,245690309.0,8376.705824889454,-15.47,7
18:48,603721739.0,67.99889948318389,-209.99,2
18:49,471897866.0,6688.442589899985,-1.7,7
18:51,668329719.0,7364.186983673097,-55.38,5
18:52,310375875.0,640.645288396645,-22.43,8
18:55,786141370.0,-546.2152000000008,-16.33,5
18:57,824916823.0,7751.700871788896,-3.08,7
18:59,296770890.0,1408.7470103790831,-46.14,5
18:59,625281433.0,-1060.5814573707569,-105.06,5
19:00,163470640.0,313.5650999999997,-11.25,2
19:01,656812046.0,142.75275373251887,-170.88,5
19:02,426474982.0,-3787.50475,-60.16,5
19:02,897592348.0,14095.91877258173,-15.2,2
19:05,518474507.0,11876.7041040494,-3.06,2
19:10,585133606.0,4359.3744181394695,-42.54,9
19:11,203466392.0,1945.3600950772568,-72.17,5
19:12,838830098.0,228.95319208778432,-86.92,5
19:13,473820682.0,10132.53298739157,-16.52,8
19:16,409971170.0,1959.6029930886289,-13.51,7
19:17,311467864.0,-989.677650000001,-74.35,5
19:18,248625662.0,-1239.4469157151475,-68.09,5
19:28,163470640.0,246.4400999999997,-67.12,2
19:29,868014990.0,-3382.2335999999964,-29.6,5
19:32,149684419.0,40.323299999998056,-36.49,9
19:33,352291960.0,870.657053303574,-132.97,5
19:34,335698481.0,-2309.5904966949392,-53.89,5
19:37,158414827.0,-1828.8700000000017,-20.62,5
19:38,758160963.0,7271.026659895692,-56.07,5
19:44,491392945.0,4201.351500000008,-67.7,5
19:48,554792076.0,26236.44941729656,-43.78,2
19:48,163470640.0,229.5650999999997,-16.88,2
19:49,392270893.0,11708.408791126489,-86.9,5
19:50,336557504.0,972.4264872010194,-115.97,5
19:51,845648250.0,-212.0524500000006,-150.9,5
19:53,637433131.0,-340.13740000000087,-163.59,5
19:53,623156843.0,3438.5485682832277,-266.85,5
20:05,511179916.0,6195.11550928465,-48.05,5
20:06,387957305.0,-2677.3411059800787,-37.99,5
20:06,511179916.0,6124.056556016983,-71.06,2
20:08,196289502.0,14218.53330954302,-50.43,2
20:12,880546403.0,-1588.0495000000017,-26.62,5
20:14,441274121.0,10556.135608681418,-51.46,5
20:18,151968462.0,5824.223077630014,-4.77,2
20:21,779816907.0,-2890.4985829229117,-25.2,5
20:21,876890798.0,2511.082170699932,-15.94,5
20:23,844835978.0,9071.739205781896,-61.4,5
20:26,246753533.0,-160.71040000000153,-15.3,5
20:34,951817450.0,8207.633533599885,-53.84,4
20:35,429556122.0,3215.1550933442854,-105.76,5
20:36,659415300.0,711.5867902507041,-92.47,5
20:36,520418719.0,453.7329000000035,-132.11,5
20:37,690523499.0,-974.7444499999998,-118.52,5
20:37,642924505.0,123.94467018352611,-88.32,5
20:46,653667523.0,3448.9628995700145,-41.78,5
20:47,887853850.0,9213.528199271052,-39.22,9
20:48,639420537.0,-1644.16395,-22.54,5
20:49,771125520.0,1328.654799999999,-35.93,9
20:53,623156843.0,3431.6560148285967,-6.89,5
20:55,618514666.0,19412.83404106431,-44.45,5
21:10,287480331.0,6616.548961335949,-28.24,9
21:34,310375875.0,614.365288396645,-26.28,9
00:16,480557476.0,13820.097256498184,-4.03,2
00:33,305778936.0,11592.028387623008,-6.35,4
00:35,399144202.0,930.1420723147196,-27.39,9
00:56,252760664.0,5526.470289540872,-6.35,2
01:04,973086490.0,8978.97188133701,-16.61,2
01:11,305778936.0,11568.888387623008,-23.14,9
01:17,399144202.0,892.3267510573887,-37.82,5
01:18,984783496.0,16024.748914240923,-16.55,9
01:23,973086490.0,8966.58188133701,-12.39,9
01:40,613729471.0,11386.143371309963,-23.22,7
01:44,588565416.0,9473.173245597263,-2.6,8
02:19,500043411.0,12467.780883276266,-12.24,9
02:32,679662108.0,19682.619623259117,-43.77,2
02:39,482513594.0,7480.448395404903,-10.49,9
02:47,489964679.0,17601.746642682254,-31.14,9
02:48,887853850.0,9187.928199271051,-25.6,9
02:48,899742927.0,11148.212261510602,-2.82,5
02:50,779236304.0,2574.677595479532,-26.94,9
02:52,637649383.0,2110.9584499999983,-25.68,9
03:02,183888402.0,16976.864973285392,-43.4,9
03:02,601627384.0,4687.999943042775,-36.5,9
03:04,766941757.0,2965.8406711219077,-3.37,7
03:10,482513594.0,7449.737881267248,-30.71,2
03:11,383345285.0,-1142.992373588076,-33.34,9
03:14,146909202.0,1961.1305234278968,-23.47,8
03:19,454356905.0,-26.187993251768297,-2.24,2
03:20,195895574.0,8087.642970993026,-13.8,5
03:21,738958551.0,10377.28982675186,-4.81,5
03:23,609939116.0,7337.967164867907,-28.33,5
03:29,873693307.0,12274.195204862104,-14.25,9
03:31,282837512.0,15355.175666860903,-29.59,9
03:32,730002588.0,15665.72276213962,-4.93,7
03:36,450896297.0,14966.790438170625,-39.18,9
03:41,704517789.0,16144.439983787388,-11.84,5
03:41,520447032.0,7387.429870071265,-29.48,9
03:44,766941757.0,2933.4006711219076,-32.44,9
03:46,853907490.0,9622.359900253658,-14.2,9
03:48,550169791.0,24366.687176500847,-39.3,7
03:48,475277431.0,846.4481369436193,-19.9,9
03:51,510101371.0,14635.98835765167,-42.27,9
03:52,886921642.0,2529.960347401557,-9.5,2
03:52,639549973.0,9048.994710464143,-0.08,2
03:54,456221621.0,-570.0338326973718,-10.29,9
03:56,851181128.0,3397.694104496361,-18.98,9
03:58,912705941.0,17243.81040351887,-40.25,5
04:00,290818242.0,8708.20617264442,-53.27,2
04:02,769311479.0,7975.011405832966,-5.28,5
04:03,905860285.0,7895.392490170939,-40.0,8
04:04,678851253.0,5084.166823570851,-14.09,2
04:05,324224854.0,5443.378731530835,-28.35,2
04:16,370521542.0,29356.643017220507,-14.99,9
04:16,987163717.0,7355.538480000005,-31.89,9
04:17,705848712.0,24854.421658932886,-13.48,9
04:17,853907490.0,9620.438084602149,-1.92,7
04:20,842682241.0,7045.575867997249,-6.63,5
04:24,187541224.0,604.7874566485394,-39.08,9
04:24,461990622.0,11696.131415786323,-19.85,2
04:25,237684254.0,6697.300099428765,-15.58,7
04:26,873693307.0,12272.51621457702,-1.68,7
04:26,822250278.0,5457.750452233903,-23.43,9
04:28,679911053.0,1816.5854874448005,-15.88,2
04:31,709608057.0,1988.259733660685,-33.38,9
04:34,352291960.0,2783.1270533035736,-37.53,9
04:37,806358207.0,11214.029482859392,-27.38,7
04:39,414454079.0,1589.0178500000018,-44.95,9
04:39,196289502.0,17580.58330954302,-13.95,9
04:40,799861885.0,503.5411999999988,-44.44,9
04:43,673025413.0,4808.028827897366,-16.08,5
04:43,282837512.0,15318.22803676936,-36.95,7
04:43,836110591.0,5572.282629936911,-38.13,9
04:44,179173981.0,5808.025177605412,-26.24,9
04:46,145387690.0,4464.175538843198,-27.54,9
04:54,506618547.0,20133.337831742112,-40.82,8
04:57,383625050.0,3561.1041116357414,-30.29,8
04:58,383833857.0,27809.280073137492,-7.39,9
04:59,203466392.0,1923.2790149115997,-22.08,8
05:03,581655972.0,38493.105576326845,-35.21,7
05:04,547010927.0,25617.206424744552,-28.79,9
05:07,108931112.0,16572.92403071597,-32.67,9
05:11,699139822.0,812.308303900892,-63.59,5
05:12,851181128.0,3374.6257411140086,-23.07,2
05:12,170637730.0,1785.655442363077,-64.97,7
05:14,256002321.0,8485.821936426853,-16.9,9
05:15,943329213.0,1273.1124079471697,-23.48,4
05:17,675806859.0,8831.72964676597,-6.46,7
05:18,229205098.0,6444.175393821419,-23.16,7
05:24,108481285.0,9436.356506313525,-27.63,2
05:30,822250278.0,5457.706656585267,-0.04,7
05:33,758160963.0,10049.83850706394,-11.19,7
05:34,461029994.0,9388.57709409678,-16.92,8
05:37,383833857.0,27806.062214960693,-3.22,7
05:37,949032480.0,3617.46685353582,-22.12,5
05:38,348325817.0,13131.116963952172,-35.26,8
05:42,280268430.0,6107.124113114099,-0.81,8
05:42,994214354.0,8504.954661279051,-33.19,9
05:45,252964502.0,-789.5513724913005,-28.39,9
05:45,256002321.0,8481.910712079818,-3.91,4
05:46,558119802.0,36557.56765512669,-29.08,5
05:47,975345315.0,38199.02723928243,-50.04,4
05:48,809499628.0,19336.50981868682,-18.19,9
05:50,198946608.0,2910.5066200786778,-7.01,5
05:51,857754342.0,585.4700762798142,-1.6,5
05:53,187111705.0,9130.801347754888,-10.52,2
05:54,549414742.0,5843.549304588834,-30.87,9
06:02,489964679.0,17565.28103909183,-36.47,8
06:04,985188462.0,-253.88321128877527,-46.68,9
06:06,264550521.0,9730.383918170084,-26.86,4
06:07,441274121.0,14000.13274065768,-15.0,5
06:08,308505160.0,14965.269117773048,-11.28,2
06:09,718058208.0,2767.337411281471,-33.23,5
06:10,670102069.0,2440.2740814522413,-5.54,2
06:14,950234174.0,830.9424520465926,-46.62,4
06:15,270374623.0,11948.951823069165,-40.62,2
06:15,885259672.0,2666.0135078203043,-78.27,7
06:18,822135975.0,9983.55294389752,-29.29,7
06:19,166019891.0,9935.407483832563,-50.26,5
06:21,441142605.0,2964.9410388780316,-29.99,9
06:22,547010927.0,25551.76955551212,-65.44,5
06:23,113747882.0,13604.643251158268,-21.76,5
06:23,520447032.0,7370.532739645661,-16.9,5
06:25,532478725.0,3752.864363500429,-30.87,9
06:26,623156843.0,6347.084806328898,-2.57,2
06:34,719586818.0,20165.12953871163,-3.77,5
06:36,785749304.0,10359.125054393551,-13.41,8
06:37,858989281.0,24694.15401068411,-21.64,9
06:39,414805878.0,11685.284236601,-24.44,9
06:39,331450202.0,9466.579804480114,-54.29,2
06:42,951817450.0,8184.671998099163,-22.96,5
06:45,802697323.0,17717.532999175815,-35.48,9
06:45,310375875.0,2265.4352883966453,-23.93,9
06:47,572384506.0,7847.188196173857,-40.0,9
06:49,235881534.0,14573.089790498232,-24.61,2
06:50,237493332.0,16640.307430347126,-1.99,7
06:50,779946617.0,19061.018843893387,-23.76,4
06:56,678330503.0,2549.7312302291302,-37.28,2
06:56,518474507.0,15589.8241040494,-35.88,9
06:57,475117511.0,7027.459746759019,-49.89,8
06:58,940569402.0,4882.586671678788,-19.1,2
06:59,466649401.0,1917.3227935520877,-18.7,7
06:59,549414742.0,5821.453033394708,-22.1,5
07:05,120634201.0,6635.175329403303,-17.49,9
07:07,127809299.0,1380.9751394027735,-38.8,5
07:08,647936800.0,2955.6535782431506,-11.23,7
07:09,435984758.0,5700.7510956604365,-68.23,2
07:10,575652395.0,3372.446925783769,-10.81,2
07:10,108563213.0,26024.18070262166,-28.54,7
07:14,128033695.0,1125.6696783420678,-8.55,2
07:15,749378808.0,3030.430434499769,-29.32,5
07:19,668329719.0,10142.021970977376,-2.17,8
07:23,865748375.0,2991.3302089245226,-60.2,5
07:27,706250160.0,14609.746143813774,-16.58,7
07:28,419550103.0,17053.367875059783,-70.28,2
07:38,441142605.0,2959.6864422757276,-5.25,5
07:41,705848712.0,24821.784106468684,-32.64,2
07:42,518474507.0,15571.277859928596,-18.55,7
07:43,667367404.0,10471.801021342286,-8.28,7
07:50,815385232.0,12071.752019340862,-9.39,5
07:52,858989281.0,24693.451002058413,-0.7,5
07:52,532478725.0,3738.136652309636,-14.73,7
07:54,215311171.0,5678.554255150088,-0.28,8
07:55,322221939.0,2992.3728685078886,-29.13,7
07:58,838830098.0,489.8031920877844,-6.15,9
08:00,585596026.0,2725.4398509019893,-36.43,2
08:00,386729293.0,35016.56623741818,-66.13,5
08:02,213112754.0,5733.020560569874,-79.83,2
08:04,647472692.0,28178.003746878352,-2.33,5
08:09,395284483.0,1957.0283402113084,-6.9,9
08:12,587225252.0,6667.761123365892,-31.99,9
08:12,336557504.0,965.6264872010196,-6.8,9
08:17,297823329.0,1756.1764499999992,-5.05,9
08:19,885259672.0,2660.963507820304,-5.05,9
08:20,987229118.0,629.6984611877247,-35.01,2
08:21,897714622.0,10784.551237939904,-18.91,5
08:25,969697937.0,-4732.482765670551,-15.37,5
08:27,146909202.0,1954.030523427897,-7.1,9
08:29,621652856.0,-130.6200303894599,-78.48,5
08:31,657528784.0,-411.2110999999993,-116.61,5
08:32,494156462.0,-1193.9318364817602,-61.45,5
08:32,285115279.0,-3329.1945607892876,-159.04,5
08:33,401293808.0,-381.6895000000008,-108.01,5
08:33,993039226.0,-4282.264499999995,-51.93,5
08:33,987656636.0,4863.882655690603,-38.83,2
08:34,215832575.0,-355.6094637442196,-46.16,5
08:34,970298834.0,1756.798622447603,-40.32,7
08:35,299871610.0,174.94315305876657,-39.65,5
08:36,700138124.0,6799.475633830919,-3.77,7
08:37,534204159.0,6447.383624115158,-3.22,5
08:41,331048953.0,-476.0816320215064,-71.55,5
08:42,943829984.0,-1240.380490886543,-63.52,5
08:44,895331556.0,896.4109999999991,-10.37,5
08:44,795847804.0,25047.63583544917,-56.54,2
08:45,304455868.0,3421.1650076846076,-3.92,2
08:45,986267641.0,10352.958177602224,-8.87,5
08:45,169006407.0,10436.033960695757,-9.68,8
08:46,996042490.0,7408.837733173505,-44.66,2
08:46,722971557.0,-541.6002791569243,-86.42,5
08:47,556992209.0,14134.26862447272,-30.49,5
08:48,293609137.0,94.88949257449808,-160.92,5
08:48,216285378.0,22102.567384634913,-156.91,5
08:50,285220959.0,13788.988155841264,-4.76,7
08:54,857754342.0,481.80987627981415,-103.66,5
08:56,200080192.0,8406.518465199804,-4.99,7
08:57,709632525.0,-414.89235000000065,-91.94,5
09:01,473820682.0,13217.409099980869,-41.12,7
09:02,816685391.0,-838.6992037084264,-18.31,5
09:03,540159353.0,10094.88755002838,-6.5,9
09:03,690958123.0,22591.116364636415,-6.8,9
09:07,441274121.0,13994.08274065768,-6.05,9
09:07,117273481.0,10526.91506533524,-4.35,9
09:07,586315521.0,11192.680782146654,-5.3,9
09:08,943329213.0,1161.2454079471695,-111.87,5
09:08,657139925.0,16103.26926991504,-1.2,7
09:09,581655972.0,38486.30557632684,-6.8,9
09:10,169006407.0,10431.033960695757,-5.0,9
09:11,683078800.0,3063.8694529448708,-6.1,9
09:13,851649498.0,9299.532100252867,-6.35,9
09:14,667367404.0,10464.701021342284,-7.1,9
09:15,101531259.0,1112.2946999999997,-54.99,6
09:16,604288474.0,1285.309254314403,-40.68,5
09:18,688328251.0,228.85587464517292,-19.97,7
09:18,446720287.0,204.7574408184055,-11.98,2
09:19,143383029.0,103.89333065233863,-35.95,7
09:19,757115616.0,2335.5800000000036,-63.98,2
09:19,385685918.0,936.4699408415522,-44.98,2
09:20,399144202.0,857.0067510573887,-35.32,2
09:20,857455726.0,-213.01831412431576,-15.98,7
09:22,258201793.0,-289.8723000000002,-37.99,2
09:22,449387287.0,1066.8326938351015,-31.99,2
09:23,657139925.0,16086.469269915042,-16.8,9
09:23,642015139.0,249.1538374656383,-49.98,2
09:23,308505160.0,14959.269117773048,-6.0,9
09:24,127809299.0,1252.9851394027737,-127.99,2
09:24,586041848.0,236.1076999999989,-36.98,2
09:24,936813994.0,1496.4284608327882,-32.95,1
09:24,398429109.0,2593.828550000001,-143.46,5
09:25,506618547.0,20127.18783174211,-6.15,9
09:25,152616936.0,1287.6870078630648,-87.98,2
09:25,108812033.0,1075.4562499999984,-50.0,2
09:25,760753808.0,1310.0246999999997,-39.98,2
09:25,138351025.0,-117.17075000000024,-50.0,2
09:25,310740977.0,832.6865265073347,-9.99,2
09:26,441142605.0,2948.6864422757276,-11.0,4
09:26,799286313.0,-5.675912875861499,-69.98,2
09:27,250957494.0,1090.4270999999987,-37.99,2
09:27,933491926.0,4825.162300000003,-5.99,7
09:27,709935470.0,431.9907376997723,-79.99,2
09:28,706361191.0,745.514098494078,-74.99,2
09:28,979892433.0,-63.40980000000102,-63.98,2
09:31,519644021.0,1835.8655638509267,-16.57,7
09:31,266777719.0,111.94893378023956,-17.03,7
09:31,149684419.0,1297.343299999998,-62.98,2
09:31,703537476.0,1350.303249999999,-63.04,2
09:32,494156986.0,943.2872456723348,-29.99,2
09:32,105375973.0,179.46965281894057,-32.09,2
09:32,101531259.0,1052.3146999999997,-59.98,4
09:33,169689461.0,2158.2831499999993,-31.99,2
09:33,414454079.0,1577.8378500000017,-11.18,4
09:34,546296727.0,390.44772730261855,-40.99,2
09:34,554792076.0,30517.62141729656,-93.83,5
09:34,912584712.0,1492.868619544733,-4.99,1
09:35,127809299.0,1183.0051394027737,-69.98,2
09:36,761272540.0,443.4298999999989,-74.91,1
09:36,572136270.0,1226.2920115880231,-11.98,1
09:36,555393405.0,223.4994999999999,-35.0,2
09:36,706361191.0,695.524098494078,-49.99,2
09:36,552980092.0,109.2687191193376,-11.97,4
09:36,282837512.0,15285.17803676936,-33.05,2
09:37,430910686.0,1406.1942000000004,-52.91,7
09:39,245198540.0,1406.6713988017796,-29.96,1
09:39,709935470.0,360.01073769977233,-71.98,2
09:39,433837402.0,259.4841315358119,-305.97,2
09:41,522188082.0,6810.513465607423,-30.03,7
09:41,886921642.0,2515.274347401557,-14.69,5
09:41,446720287.0,126.76744081840552,-77.99,2
09:41,659415300.0,3516.5967902507045,-4.99,4
09:42,609939116.0,7052.3671648679065,-285.6,2
09:43,322221939.0,2941.7811285078888,-50.59,4
09:43,688328251.0,172.88587464517292,-55.97,6
09:43,903468956.0,1937.5625999999993,-29.99,2
09:43,760753808.0,1290.0546999999997,-19.97,1
09:43,348460748.0,855.4475499999991,-51.99,2
09:44,923322792.0,121.2831682463624,-12.99,2
09:44,703537476.0,1300.273249999999,-50.03,2
09:44,441142605.0,2933.7064422757276,-14.98,7
09:44,518466565.0,1930.8375999999992,-22.98,2
09:45,108812033.0,1047.4562499999984,-28.0,2
09:45,610450243.0,676.3154000000002,-25.0,2
09:45,333054026.0,1029.76989402319,-19.05,7
09:46,211493028.0,1455.5414499999993,-147.98,6
09:46,250957494.0,1058.4670999999987,-31.96,1
09:47,757115616.0,2318.610000000004,-16.97,7
09:47,212560376.0,-27.158874220897843,-25.03,7
09:48,873701090.0,144.89331015431063,-13.98,2
09:48,216286013.0,431.64325665393994,-151.98,6
09:48,449387287.0,1036.8426938351015,-29.99,2
09:49,843537309.0,48.96028220836822,-41.98,2
09:49,895331556.0,883.4309999999991,-12.98,4
09:49,604288474.0,1281.8271172444213,-3.48,2
09:49,857455726.0,-276.99831412431575,-63.98,2
09:50,137822385.0,2747.9748015410655,-66.43,2
09:51,138351025.0,-129.11075000000022,-11.94,4
09:51,444371478.0,980.6579999999988,-79.98,2
09:51,136770968.0,54.45659999999954,-29.98,4
09:52,779620857.0,591.8886536148241,-177.98,2
09:52,414454079.0,1567.6878500000016,-10.15,2
09:52,564744955.0,896.010058588842,-99.99,2
09:53,761272540.0,402.4498999999988,-40.98,2
09:53,245198540.0,1346.6813988017796,-59.99,2
09:53,254018059.0,164.5352,-25.0,2
09:53,285873880.0,11234.86707204068,-13.73,2
09:54,945054126.0,1111.9981,-77.98,2
09:54,246753533.0,1538.2995999999985,-6.99,4
09:55,555393405.0,197.5394999999999,-25.96,1
09:57,180616589.0,332.0845281236176,-38.01,5
09:57,696333897.0,1440.162449999999,-43.96,7
09:58,257633312.0,513.7783499999991,-45.97,2
09:58,575652395.0,3322.346925783769,-50.1,2
09:59,155867488.0,1028.1446999999985,-31.99,2
10:00,348460748.0,795.477549999999,-59.97,2
10:00,175452235.0,281.7012500000003,-61.59,2
10:00,414454079.0,1539.2378500000016,-28.45,2
10:00,494156986.0,868.3172456723348,-74.97,2
10:00,518466565.0,1899.887599999999,-30.95,1
10:00,552980092.0,79.28871911933759,-29.98,2
10:00,250957494.0,1056.9670999999987,-1.5,4
10:01,524425303.0,807.2009999999989,-5.0,4
10:03,494789005.0,2490.94179685031,-43.04,7
10:04,895331556.0,836.4309999999991,-47.0,2
10:06,299871610.0,104.06815305876655,-70.88,2
10:07,609939116.0,6773.767164867906,-278.6,2
10:07,508518911.0,615.8647502790104,-155.97,2
10:10,333054026.0,952.46989402319,-77.3,2
10:10,280130290.0,333.9502499999996,-57.0,2
10:10,212560376.0,-104.37887422089784,-77.22,2
10:10,433837402.0,233.9841315358119,-25.5,2
10:11,799453072.0,682.3591499999989,-25.97,2
10:11,382862215.0,316.29899999999986,-9.99,2
10:13,105375973.0,127.38965281894056,-52.08,1
10:13,555393405.0,65.5594999999999,-131.98,2
10:13,973388795.0,1261.5936761636217,-35.03,2
10:14,409370545.0,1173.1682755455208,-27.12,7
10:14,246753533.0,1533.2995999999985,-5.0,9
10:14,598793068.0,1887.5888499999985,-51.98,4
10:14,945054126.0,1082.0481,-29.95,7
10:15,760753808.0,1226.0746999999994,-63.98,2
10:15,310620484.0,406.66119509219834,-32.21,2
10:15,197050303.0,210.21943256349505,-95.0,2
10:16,895331556.0,781.4409999999991,-54.99,2
10:17,211493028.0,1398.5514499999992,-56.99,6
10:17,642015139.0,219.1938374656383,-29.96,1
10:18,659415300.0,3511.1967902507045,-5.4,9
10:20,799286313.0,-33.6759128758615,-28.0,2
10:22,287480331.0,8206.14896133595,-6.4,9
10:23,508518911.0,573.8947502790104,-41.97,4
10:24,679943657.0,3465.7608891801365,-55.32,2
10:24,598793068.0,1866.6188499999985,-20.97,7
10:26,588565416.0,7998.183245597264,-54.99,2
10:26,433837402.0,198.3341315358119,-35.65,1
10:28,223207876.0,1103.1171000000004,-45.21,2
10:29,572384506.0,7775.15479961452,-72.03,5
10:29,299871610.0,33.20065305876658,-70.87,2
10:30,980500334.0,-145.03443389290408,-22.0,2
10:30,738958551.0,10280.989826751862,-96.3,6
10:31,310620484.0,387.5611950921983,-19.1,1
10:32,414454079.0,1533.1478500000017,-6.09,2
10:34,233981231.0,3627.400881960624,-51.98,4
10:34,382862215.0,196.31899999999985,-119.98,2
10:35,108812033.0,997.4662499999984,-49.99,2
10:35,519649533.0,1221.9718163706625,-33.99,2
10:35,766812921.0,1215.0894499999993,-5.99,4
10:35,444371478.0,958.6579999999988,-22.0,2
10:37,364357875.0,7447.512657277089,-35.23,2
10:39,386277162.0,1522.2699999999995,-74.98,2
10:39,610450243.0,584.3254000000002,-91.99,2
10:40,403383649.0,2788.8888048612507,-36.0,1
10:40,280990953.0,842.1996999999985,-41.95,1
10:40,280130290.0,319.97024999999957,-13.98,7
10:41,555804115.0,13.84645244129662,-112.98,2
10:41,621181115.0,57.37575042922886,-74.99,2
10:42,310740977.0,732.6965265073347,-99.99,2
10:42,879091637.0,811.697523737977,-68.13,2
10:42,936813994.0,1433.4584608327882,-62.97,2
10:46,155867488.0,991.1946999999984,-36.95,7
10:46,382862215.0,171.31899999999985,-25.0,2
10:47,444371478.0,928.6679999999988,-29.99,2
10:49,519649533.0,1204.0018163706625,-17.97,1
10:50,348460748.0,642.487549999999,-152.99,2
10:50,216286013.0,418.65325665393993,-12.99,2
10:51,310740977.0,694.7165265073347,-37.98,2
10:51,652048867.0,1350.425299999999,-14.99,4
10:51,508518911.0,553.9047502790104,-19.99,2
10:53,761272540.0,370.4598999999988,-31.99,2
10:55,973388795.0,1121.4836761636216,-140.11,2
10:57,299871610.0,-52.65934694123341,-85.86,2
10:57,216286013.0,345.6832566539399,-72.97,2
10:57,257633312.0,440.8083499999991,-72.97,2
10:58,555804115.0,-25.08354755870338,-38.93,1
10:58,799453072.0,612.3791499999988,-69.98,4
11:02,923322792.0,-91.6868317536376,-212.97,2
11:02,980500334.0,-165.02443389290409,-19.99,2
11:03,519649533.0,1183.0218163706622,-20.98,4
11:05,818552503.0,1585.986999999999,-72.98,6
11:05,155867488.0,985.2046999999984,-5.99,2
11:05,799286313.0,-63.665912875861494,-29.99,2
11:06,169689461.0,2028.3131499999993,-129.97,2
11:06,895750759.0,76.41496192433421,-15.98,7
11:06,280130290.0,302.99024999999955,-16.98,7
11:07,766812921.0,1145.1194499999992,-69.97,2
11:07,527842638.0,1374.1005926329835,-64.98,2
11:07,155317149.0,604.0823999999991,-27.96,7
11:10,257633312.0,434.8183499999991,-5.99,4
11:10,305778936.0,11542.718387623008,-26.17,2
11:11,973388795.0,1083.4936761636216,-37.99,1
11:12,696333897.0,1434.172449999999,-5.99,7
11:16,546296727.0,379.4677273026185,-10.98,7
11:16,637649383.0,2080.9684499999985,-29.99,2
11:18,494156986.0,801.3372456723348,-66.98,2
11:19,527842638.0,1346.1005926329835,-28.0,2
11:20,257633312.0,425.8483499999991,-8.97,4
11:21,299871610.0,-71.01934694123341,-18.36,2
11:21,879091637.0,752.717523737977,-58.98,2
11:21,348460748.0,602.507549999999,-39.98,2
11:22,116169597.0,1370.8489499999996,-29.98,4
11:23,497772347.0,805.4237999999979,-24.0,4
11:25,280130290.0,253.0002499999995,-49.99,2
11:25,779236304.0,2552.387595479532,-22.29,2
11:28,879091637.0,720.187523737977,-32.53,2
11:28,534583529.0,1970.7792880547652,-71.12,5
11:31,552980092.0,-58.6912808806624,-137.98,2
11:31,132400709.0,782.6720851539397,-19.99,2
11:32,223207876.0,1024.7271000000003,-78.39,2
11:33,994947671.0,1976.4657000000004,-124.99,2
11:33,444371478.0,923.6779999999987,-4.99,4
11:35,497772347.0,760.4537999999978,-44.97,4
11:36,257633312.0,398.8883499999991,-26.96,7
11:38,895750759.0,51.41496192433421,-25.0,2
11:38,480557476.0,13787.407256498183,-32.69,2
11:41,923322792.0,-104.6668317536376,-12.98,1
11:44,637649383.0,2017.9984499999985,-62.97,2
11:45,980500334.0,-171.0144338929041,-5.99,2
11:45,727417797.0,6356.438049492958,-9.99,4
11:46,444371478.0,899.7079999999987,-23.97,7
11:47,984783496.0,16008.633934240925,-16.11,4
11:48,587225252.0,6658.4829399365035,-9.28,7
11:49,133755851.0,918.0985416180112,-29.99,4
11:50,444428189.0,4375.598200000002,-102.89,2
11:50,508518911.0,513.9247502790104,-39.98,2
11:51,145387690.0,4432.041957375697,-32.13,8
11:52,799453072.0,529.3891499999988,-82.99,2
11:53,524425303.0,749.2109999999989,-57.99,2
11:55,904154012.0,1382.327458120432,-103.46,2
11:55,449387287.0,1030.8526938351015,-5.99,7
11:59,696333897.0,1389.1924499999989,-44.98,2
12:00,727417797.0,6336.468049492958,-19.97,7
12:01,668175891.0,374.1072231584989,-27.96,1
12:02,421881811.0,3951.4472619645608,-15.5,4
12:05,169689461.0,2018.3331499999993,-9.98,1
12:07,382862215.0,104.83899999999984,-66.48,4
12:12,834383043.0,5013.490095132721,-240.07,2
12:14,421475159.0,-184.1447373255874,-33.79,9
12:15,648644594.0,978.1565999999992,-44.0,2
12:18,598793068.0,1839.6488499999984,-26.97,4
12:19,280990953.0,744.2196999999985,-97.98,2
12:22,879091637.0,631.727523737977,-88.46,2
12:24,444428189.0,4340.598200000002,-35.0,2
12:28,259015404.0,-200.24284427916143,-3.28,2
12:30,904154012.0,1304.8474581204318,-77.48,2
12:31,910730524.0,6844.406918730645,-28.52,2
12:34,834383043.0,4981.530095132721,-31.96,7
12:36,637649383.0,1905.0184499999984,-112.98,2
12:36,749378808.0,3011.230434499769,-19.2,9
12:40,960208650.0,16815.47055244046,-206.18,2
12:41,454356905.0,-47.46799325176829,-21.28,9
12:42,564744955.0,845.3902585888419,-50.62,5
12:46,338022396.0,155.2541893757391,-71.52,5
12:49,799453072.0,511.4191499999988,-17.97,1
12:50,479366718.0,1716.731447632401,-57.98,2
12:51,155317149.0,598.0923999999991,-5.99,2
12:51,433837402.0,111.6541315358119,-86.68,2
12:53,455831435.0,-1880.6296048014945,-24.59,5
12:54,610450243.0,555.2904000000002,-29.04,5
12:57,670102069.0,2406.974081452241,-33.3,9
13:00,444428189.0,4250.298200000002,-90.3,2
13:02,479366718.0,1702.7514476324006,-13.98,4
13:02,930277104.0,11762.625789839109,-37.34,9
13:03,299871610.0,-204.1443469412334,-133.12,2
13:04,382862215.0,-17.151000000000153,-121.99,2
13:05,948558249.0,8326.143631737075,-31.04,9
13:06,637649383.0,1858.0384499999984,-46.98,2
13:07,180719578.0,-4358.875249999996,-32.45,5
13:08,380911501.0,-382.1828000000008,-126.8,5
13:09,696333897.0,1339.2024499999989,-49.99,4
13:10,788740658.0,3109.9383901948527,-19.99,7
13:11,688712152.0,5830.88201717615,-5.9,9
13:11,155867488.0,924.2246999999984,-60.98,2
13:11,984783496.0,15970.93597704301,-37.7,4
13:12,494156986.0,796.3372456723348,-5.0,9
13:14,799286313.0,-93.65591287586147,-29.99,2
13:16,258201793.0,-309.86230000000023,-19.99,2
13:17,709142813.0,755.5095499999993,-83.39,5
13:17,406862520.0,-63.021673462589575,-25.94,9
13:17,280990953.0,703.2296999999985,-40.99,2
13:17,155317149.0,576.0923999999991,-22.0,2
13:18,834383043.0,4943.550095132721,-37.98,2
13:23,933491926.0,4765.172300000003,-59.99,5
13:23,910730524.0,6839.356918730645,-5.05,9
13:23,923322792.0,-152.65683175363762,-47.99,2
13:24,637649383.0,1838.0684499999984,-19.97,1
13:28,583558311.0,-1215.4822152486677,-150.72,5
13:31,444428189.0,4234.912200000002,-15.39,2
13:33,930277104.0,11744.744912356202,-17.88,2
13:36,136770968.0,-62.523400000000464,-116.98,2
13:38,916225911.0,-2279.6667500000012,-46.53,5
13:40,570323670.0,3780.600172280906,-107.19,4
13:42,223207876.0,851.8871000000003,-172.84,2
13:44,298000165.0,23969.32804701912,-108.4,5
13:45,254018059.0,97.5452,-6.99,7
13:45,298000165.0,23962.091067013534,-7.24,7
13:49,637649383.0,1800.0884499999984,-37.98,2
13:50,923322792.0,-237.64683175363763,-84.99,2
13:56,444428189.0,4069.7262000000014,-165.19,2
13:59,895750759.0,-4.4701380756657905,-33.98,2
14:02,348460748.0,597.517549999999,-4.99,1
14:09,895750759.0,-32.47013807566579,-28.0,2
14:11,766812921.0,1139.1294499999992,-5.99,1
14:11,348325817.0,13092.366963952172,-38.75,9
14:13,955035930.0,3948.843479171477,-54.99,6
14:14,155867488.0,920.2446999999984,-3.98,4
14:17,433837402.0,63.7141315358119,-47.94,2
14:19,216286013.0,275.6932566539399,-69.99,2
14:20,444428189.0,3951.4542000000015,-118.27,2
14:20,834383043.0,4713.964095132721,-229.59,2
14:21,348460748.0,553.537549999999,-43.98,2
14:25,605711527.0,-605.6464861674164,-153.45,5
14:28,299871610.0,-276.4968469412334,-72.35,2
14:30,136770968.0,-114.50340000000044,-51.98,2
14:35,572136270.0,1202.524911588023,-23.77,5
14:35,444428189.0,3863.9822000000017,-87.47,2
14:39,904154012.0,1211.3674581204318,-93.48,2
14:39,570323670.0,3756.0032934962505,-24.6,7
14:41,823208989.0,1933.6414638695312,-20.51,4
14:44,834383043.0,4602.706095132721,-111.26,2
14:45,792845450.0,1730.655150000001,-33.48,4
14:47,444428189.0,3766.7242000000015,-97.26,2
14:52,258201793.0,-379.86230000000023,-70.0,2
14:54,299871610.0,-358.2468469412334,-81.75,2
15:02,444428189.0,3704.4242000000017,-62.3,2
15:06,444371478.0,747.7279999999987,-151.98,2
15:13,895750759.0,-90.4401380756658,-57.97,2
15:13,546296727.0,373.4777273026185,-5.99,4
15:16,904154012.0,1176.8774581204318,-34.49,2
15:18,299871610.0,-464.35684694123336,-106.11,2
15:22,180616589.0,302.0945281236176,-29.99,2
15:23,776108637.0,2127.6546536574956,-70.0,2
15:26,546296727.0,223.4877273026185,-149.99,2
15:29,305778936.0,11490.368387623008,-52.35,2
15:30,444428189.0,3649.124200000001,-55.3,2
15:31,299871610.0,-534.0843469412333,-69.73,2
15:32,904154012.0,1112.3874581204318,-64.49,2
15:34,551755686.0,7294.203212897711,-99.99,2
15:34,409971170.0,3663.163298994342,-2.44,7
15:36,352899149.0,1129.4150499999987,-52.93,7
15:36,340295966.0,-484.2244500000004,-56.0,2
15:38,105375973.0,49.17965281894055,-78.21,2
15:39,868033067.0,-2412.455786451082,-30.05,5
15:41,904154012.0,978.9074581204318,-133.48,2
15:45,399144202.0,785.3467510573887,-71.66,2
15:46,796709231.0,1084.1119778962975,-19.98,1
15:49,433837402.0,8.644131535811901,-55.07,2
15:50,550832673.0,4565.892016395508,-29.99,4
15:51,895750759.0,-163.41013807566577,-72.97,2
15:53,901037631.0,2091.209323096407,-32.09,2
15:55,904154012.0,919.4274581204318,-59.48,2
16:02,280990953.0,661.2496999999985,-41.98,2
16:02,299871610.0,-586.9368469412333,-52.85,2
16:02,280130290.0,243.01024999999953,-9.99,2
16:03,901037631.0,2085.1993230964067,-6.01,2
16:04,939972497.0,1504.2919586000107,-68.99,2
16:07,366550080.0,24690.59380041608,-42.97,7
16:15,624500124.0,2792.9331023768073,-12.49,4
16:16,354894456.0,829.4699999999996,-43.98,2
16:16,939972497.0,1463.3019586000107,-40.99,2
16:22,299871610.0,-638.6643469412332,-51.73,2
16:22,250957494.0,1034.9670999999987,-22.0,2
16:22,632065391.0,-230.5586499999995,-71.88,5
16:23,901037631.0,2075.1793230964067,-10.02,2
16:24,551755686.0,7276.223212897711,-17.98,4
16:28,631111289.0,907.1234999999992,-49.99,2
16:30,939972497.0,1461.8019586000107,-1.5,4
16:31,880546403.0,152.56049999999823,-5.99,2
16:35,796709231.0,994.1219778962976,-89.99,2
16:35,413557825.0,759.0523499999995,-12.99,2
16:36,736310094.0,-998.371024027426,-23.1,5
16:38,284905540.0,6995.980716283519,-203.1,5
16:40,310375875.0,2190.0349638516345,-75.4,8
16:44,785210466.0,1537.215619997711,-33.95,1
16:46,641764023.0,-111.60630377200458,-67.98,2
16:46,478412511.0,12115.38807019746,-12.99,2
16:49,477216513.0,985.9778000000006,-31.96,7
16:51,224112146.0,2270.4687999999987,-156.89,5
16:54,299871610.0,-713.2443469412333,-74.58,2
16:54,631111289.0,881.5434999999992,-25.58,5
16:55,812692024.0,3069.836706663929,-66.58,5
16:57,478412511.0,12085.39807019746,-29.99,2
16:58,939972497.0,1399.861958600011,-35.98,6
17:05,683319988.0,8356.147532319106,-26.22,9
17:07,901037631.0,1989.9393230964067,-85.24,2
17:07,224112146.0,2205.478799999999,-64.99,2
17:09,414454079.0,1530.0978500000017,-3.05,4
17:09,296972867.0,536.6938999999991,-35.97,2
17:11,631111289.0,819.5634999999992,-61.98,6
17:15,224112146.0,2180.478799999999,-25.0,2
17:15,113747882.0,13577.193251158267,-27.45,9
17:17,624563756.0,957.2693287835564,-112.99,2
17:18,151968462.0,5775.830119038496,-48.39,2
17:19,413557825.0,743.0723499999995,-15.98,1
17:19,558119802.0,36526.81765512669,-30.75,9
17:21,143061865.0,8630.237470227928,-22.94,5
17:22,891716230.0,49.85405139261621,-49.97,4
17:22,403902116.0,1664.3782499999993,-26.96,7
17:22,255814263.0,3147.4407315504905,-37.94,1
17:23,220183538.0,2234.7539999999995,-91.98,2
17:23,858560423.0,10959.543909769358,-31.48,4
17:23,994214354.0,8490.529197714328,-14.43,5
17:23,299871610.0,-737.6043469412333,-24.36,2
17:24,859264768.0,1152.9011337819384,-89.82,4
17:24,296972867.0,462.70389999999907,-73.99,2
17:24,478986718.0,492.76689999999894,-163.97,2
17:26,336171116.0,723.1024499999994,-28.96,1
17:27,574548998.0,632.240649999999,-9.99,4
17:29,524425303.0,639.2309999999989,-109.98,2
17:30,990894155.0,352.67040867884157,-63.0,2
17:30,904154012.0,909.4374581204318,-9.99,7
17:31,441274121.0,13965.39044065768,-28.69,4
17:31,365608668.0,1345.2392520241888,-16.5,4
17:32,699997811.0,2402.506650000004,-4.99,7
17:32,631111289.0,722.5834999999992,-96.98,2
17:33,420109571.0,119.68381071667956,-144.97,2
17:34,851649498.0,9288.717052227274,-10.82,7
17:34,627936697.0,894.7203000000002,-105.99,2
17:36,478412511.0,12056.35807019746,-29.04,9
17:36,340295966.0,-556.1944500000004,-71.97,2
17:36,683319988.0,8354.881684069265,-1.27,7
17:37,656317661.0,572.4716415414027,-81.98,2
17:37,165045150.0,1348.9960614028555,-29.99,2
17:38,641764023.0,-129.58630377200458,-17.98,4
17:40,667367404.0,10390.188441342283,-74.51,4
17:40,213112754.0,5705.790560569874,-27.23,7
17:41,416060965.0,1126.7922547005803,-31.99,2
17:41,435984758.0,5633.313095660436,-67.44,5
17:43,624500124.0,2762.763102376807,-30.17,5
17:45,165045150.0,1227.0060614028555,-121.99,2
17:47,187541224.0,571.0174566485395,-33.77,7
17:47,224112146.0,2135.538799999999,-44.94,1
17:48,500043411.0,12436.700883276266,-31.08,4
17:48,581655972.0,38474.32557632684,-11.98,7
17:48,631111289.0,688.6334999999991,-33.95,1
17:50,859603181.0,2434.2908529249994,-3.39,8
17:50,445240363.0,-982.2910559632736,-44.25,5
17:51,138609932.0,2913.2570032945855,-61.57,2
17:52,940569402.0,4861.614671678788,-20.97,5
17:53,785749304.0,10306.919054393553,-52.21,5
17:53,940569402.0,4845.174671678788,-16.44,9
17:53,951817450.0,8155.859998099163,-28.81,5
17:55,280990953.0,659.7496999999985,-1.5,4
17:56,506618547.0,20059.59783174211,-67.59,2
17:56,605116158.0,1940.386000000002,-24.59,5
17:56,117273481.0,10476.92506533524,-49.99,4
17:56,449871732.0,12704.200665309869,-14.26,5
17:56,930271460.0,-139.83995246422376,-50.79,5
17:56,403902116.0,1606.3882499999993,-57.99,2
17:58,880546403.0,72.59049999999823,-79.97,2
17:59,299871610.0,-836.9718469412333,-99.37,2
17:59,904154012.0,755.4374581204318,-154.0,2
18:00,939972497.0,1369.8719586000109,-29.99,2
18:00,914806976.0,1398.7932501854866,-41.95,7
18:02,835736339.0,2977.7690661464712,-48.87,5
18:02,409971170.0,3640.173298994342,-22.99,9
18:03,500843551.0,2187.8498999999997,-86.32,5
18:03,742223719.0,-215.8170926951973,-82.89,5
18:05,887853850.0,9144.544615192666,-43.38,7
18:07,534325901.0,8420.620597027031,-7.05,5
18:09,815385232.0,12062.662019340862,-9.09,7
18:12,425964226.0,5190.797650000002,-36.49,9
18:12,221868392.0,6333.736193864469,-35.99,9
18:18,138609932.0,2693.4850032945856,-219.77,2
18:21,904154012.0,609.9574581204317,-145.48,2
18:23,128033695.0,1087.4896783420677,-38.18,9
18:24,687135796.0,30299.38460378836,-0.99,4
18:25,308068836.0,-66.65147743180776,-71.8,5
18:26,822135975.0,9883.886943897522,-99.67,5
18:32,688328251.0,122.89587464517292,-49.99,7
18:32,421881811.0,3945.723343886144,-5.72,7
18:33,534325901.0,8403.17059702703,-17.45,9
18:34,933491926.0,4750.172300000003,-15.0,7
18:35,633345190.0,5089.4906763879435,-34.14,9
18:35,860360312.0,-196.9819411173196,-29.49,5
18:38,672913754.0,13115.981994680928,-33.22,7
18:38,659008214.0,-3368.357602290423,-27.8,5
18:42,822135975.0,9880.84694389752,-3.04,7
18:43,509627909.0,139.38464999999897,-34.35,9
18:44,596463612.0,-1056.1776047251387,-29.33,5
18:44,785749304.0,10291.169054393553,-15.75,9
18:45,907987693.0,-2539.5819999999985,-18.57,5
18:45,832564361.0,14745.785167228869,-0.69,4
18:47,339791565.0,-3576.028699999997,-43.98,5
18:48,718058208.0,2749.647411281471,-17.69,9
18:51,496395938.0,10922.487479880634,-53.28,5
18:51,586315521.0,11185.44599513684,-7.23,5
18:52,690958123.0,22564.139485522544,-26.98,2
18:53,604334058.0,1247.8464999999994,-31.97,7
18:55,679662108.0,19570.35362325912,-112.27,5
18:56,143606916.0,-109.85254597081033,-171.97,5
18:58,605116158.0,1899.076200000002,-41.31,5
18:58,448004226.0,1269.5125235099763,-90.07,5
18:59,138609932.0,2675.4850032945856,-18.0,7
18:59,550644516.0,-309.68345000000136,-42.49,5
19:00,450896297.0,14958.828118178668,-7.96,7
19:00,679662108.0,19546.153623259117,-24.2,9
19:04,492215823.0,3765.988573815444,-155.4,5
19:07,241459011.0,514.2340132723473,-27.74,5
19:08,395284483.0,1918.6403402113085,-38.39,5
19:09,246753533.0,1506.9788999999985,-26.32,5
19:10,788740658.0,3109.7103729050564,-0.23,2
19:11,540159353.0,10024.056098906443,-70.83,8
19:13,390747457.0,114.728399999998,-73.26,5
19:15,133755851.0,913.0492481382522,-5.05,7
19:22,736340277.0,7975.553340984612,-48.27,5
19:26,471897866.0,6655.790451551252,-32.65,7
19:29,259015404.0,-239.93284427916143,-39.69,9
19:32,518746136.0,466.5727717630835,-33.12,5
19:32,472213568.0,-816.0682442060532,-123.15,5
19:33,979122276.0,-1216.2680377056713,-27.24,9
19:36,510101371.0,14619.28106800894,-16.71,2
19:37,603721739.0,15.3308994831839,-52.67,5
19:39,553734946.0,1251.0862999999983,-107.66,5
19:41,874431242.0,10706.56615688029,-67.25,7
19:41,551196328.0,5267.58841862956,-164.43,5
19:42,871866387.0,1159.7070999999992,-83.31,5
19:47,678851253.0,4932.3158235708515,-151.85,5
19:55,901432314.0,3011.968186388769,-19.99,5
19:55,898104045.0,-1909.068050000002,-97.86,5
19:58,195895574.0,8070.302970993026,-17.34,9
19:59,534325901.0,8357.86659702703,-45.3,5
20:10,956717493.0,2919.1693722249324,-31.37,5
20:13,678726554.0,-994.9242476516102,-54.77,5
20:13,517190750.0,353.3585899154127,-42.48,5
20:15,414805878.0,11681.496788668612,-3.79,7
20:16,221356538.0,1871.9365,-81.64,5
20:18,482513594.0,7410.285881267248,-39.45,5
20:19,633345190.0,5063.398091301468,-26.09,7
20:30,675231808.0,19156.143167590715,-58.57,5
20:30,893134725.0,336.0138376616679,-21.13,5
20:35,601627384.0,4647.3326445163575,-40.67,5
20:36,992204045.0,8666.332773209304,-2.74,7
20:41,550169791.0,24354.737176500847,-11.95,9
20:54,651756497.0,15242.236420283429,-1.11,2
20:57,835736339.0,2953.829066146471,-23.94,9
20:57,290818242.0,8612.698172644421,-95.51,5
20:59,752362502.0,9389.98031733032,-7.33,5
21:00,131388684.0,20348.808016033392,-1.59,7
21:00,675231808.0,19126.80218733025,-29.34,5
21:05,586041848.0,204.9576999999989,-31.15,9
00:00,298000165.0,27654.091067013534,-475.0,0
00:00,500043411.0,14835.700883276266,-839.0,0
00:00,130154096.0,1402.4950017058782,-996.0,0
00:00,687135796.0,29784.38460378836,-515.0,0
00:00,456221621.0,440.966167302628,-664.0,0
00:00,287230540.0,1690.4022932932662,-1383.0,0
00:00,627936697.0,164.72030000000018,-730.0,0
00:00,607629901.0,-4313.088319908144,-1193.0,0
00:00,293191074.0,862.8381499999991,-796.0,0
00:00,581655972.0,43687.32557632684,-620.0,0
00:00,994214354.0,10895.529197714328,-594.0,0
00:00,754141345.0,-2926.6753351157613,-1181.0,0
00:00,659415300.0,2180.1967902507045,-1331.0,0
00:00,324224854.0,4975.378731530835,-468.0,0
00:00,169689461.0,1433.3331499999993,-585.0,0
00:00,843174694.0,-5228.860999999998,-1300.0,0
00:00,627622066.0,4129.474954715662,-989.0,0
00:00,648644594.0,526.1565999999991,-452.0,0
00:00,169006407.0,12781.033960695757,-520.0,0
00:00,154246234.0,283.48489210210414,-702.0,0
00:00,889916166.0,520.8934014132267,-613.0,0
00:00,898104045.0,-1522.9680500000022,-584.0,0
00:00,442070890.0,1480.1124124443709,-1351.0,0
00:00,587202562.0,814.3179494170686,-1214.0,0
00:00,208381936.0,-482.7655782217451,-544.0,0
00:00,680773155.0,1042.2203833310916,-746.0,0
00:00,846550094.0,1974.7947715014136,-1170.0,0
00:00,111137699.0,-11.220699999999397,-660.0,0
00:00,158414827.0,-1305.8700000000017,-1296.0,0
00:00,672994751.0,274.89629078601,-520.0,0
00:00,585133606.0,5797.3744181394695,-882.0,0
00:00,822718326.0,12079.900117637952,-1199.0,0
00:00,496674181.0,-1986.6885723307223,-564.0,0
00:00,204855464.0,-945.900738639616,-646.0,0
00:00,851181128.0,5696.625741114009,-448.0,0
00:00,531186970.0,5494.339464432307,-753.0,0
00:00,657139925.0,15217.469269915042,-869.0,0
00:00,951817450.0,9849.859998099164,-1014.0,0
00:00,668692488.0,2848.9256285738093,-543.0,0
00:00,146686559.0,-364.51201117347784,-1301.0,0
00:00,663479159.0,5055.563541827712,-1044.0,0
00:00,706250160.0,13611.746143813774,-998.0,0
00:00,585596026.0,3347.4398509019893,-938.0,0
00:00,499244466.0,-232.4671812834224,-621.0,0
00:00,630691258.0,487.1265448748414,-617.0,0
00:00,930271460.0,454.1600475357763,-1116.0,0
00:00,215426302.0,312.00240402569193,-592.0,0
00:00,880546403.0,-1208.4095000000018,-1281.0,0
00:00,147474476.0,3901.139102832959,-473.0,0
00:00,424397946.0,3023.439783605399,-1041.0,0
00:00,987163717.0,6836.538480000005,-519.0,0
00:00,984783496.0,15328.93597704301,-642.0,0
00:00,199016328.0,4798.706606911702,-863.0,0
00:00,713641917.0,1555.827167877851,-451.0,0
00:00,316793091.0,1102.114260054951,-475.0,0
00:00,943829984.0,-160.38049088654293,-595.0,0
00:00,494789005.0,3744.8617968503095,-485.0,0
00:00,816685391.0,-547.6992037084264,-1384.0,0
00:00,370521542.0,28550.643017220507,-806.0,0
00:00,297823329.0,1079.1764499999992,-677.0,0
00:00,673818591.0,1861.0321753758408,-469.0,0
00:00,235663459.0,591.1239298120151,-901.0,0
00:00,834383043.0,5840.706095132721,-783.0,0
00:00,555393405.0,-608.4405000000002,-674.0,0
00:00,625281433.0,-391.5814573707569,-700.0,0
00:00,344219145.0,9075.43833097584,-728.0,0
00:00,183186021.0,-1189.7975499999989,-809.0,0
00:00,198051483.0,-851.356910408857,-624.0,0
00:00,992204045.0,8158.332773209304,-508.0,0
00:00,854513972.0,2222.88555,-571.0,0
00:00,478986718.0,-785.2331000000011,-1278.0,0
00:00,779946617.0,17761.018843893387,-1300.0,0
00:00,452974357.0,-3544.7889499999947,-1322.0,0
00:00,336557504.0,2130.2864872010196,-967.0,0
00:00,141521177.0,8512.713900000015,-1090.0,0
00:00,990894155.0,-268.32959132115843,-621.0,0
00:00,781554833.0,1606.523225563967,-985.0,0
00:00,555804115.0,-1066.0835475587037,-1041.0,0
00:00,853907490.0,8510.438084602149,-1110.0,0
00:00,134847904.0,5594.892044386296,-515.0,0
00:00,256002321.0,7553.910712079818,-928.0,0
00:00,554792076.0,30001.62141729656,-516.0,0
00:00,691789577.0,-690.5144,-883.0,0
00:00,867679563.0,223.24905370171587,-1201.0,0
00:00,183546640.0,234.75069734773388,-883.0,0
00:00,480198977.0,13126.809720897709,-731.0,0
00:00,737547541.0,727.9045995677743,-545.0,0
00:00,143061865.0,7929.237470227928,-701.0,0
00:00,534325901.0,7748.86659702703,-609.0,0
00:00,596328017.0,-2311.0553499999987,-1090.0,0
00:00,822250278.0,7350.706656585267,-801.0,0
00:00,796709231.0,46.121977896297494,-948.0,0
00:00,842682241.0,6533.575867997249,-512.0,0
00:00,949032480.0,5264.46685353582,-645.0,0
00:00,270374623.0,11407.951823069165,-541.0,0
00:00,473820682.0,12760.409099980869,-457.0,0
00:00,736340277.0,9695.553340984612,-752.0,0
00:00,120634201.0,5696.175329403303,-939.0,0
00:00,564214408.0,34.965084725726,-1351.0,0
00:00,499410772.0,-2754.0168629051623,-1168.0,0
00:00,892354433.0,-629.6999606343386,-1324.0,0
00:00,405416860.0,2723.0133568809033,-882.0,0
00:00,564744955.0,273.3902585888419,-572.0,0
00:00,220183538.0,965.7539999999996,-1269.0,0
00:00,386277162.0,455.2699999999995,-1067.0,0
00:00,639420537.0,-1323.16395,-684.0,0
00:00,713910252.0,507.8061257285413,-1213.0,0
00:00,322221939.0,4832.781128507889,-803.0,0
00:00,176922958.0,1703.6955471976498,-653.0,0
00:00,256045540.0,-3592.0488999999993,-1294.0,0
00:00,454129843.0,754.4530951665602,-790.0,0
00:00,308897841.0,1508.1547999999989,-1219.0,0
00:00,895331556.0,-46.55900000000088,-828.0,0
00:00,134461671.0,6823.44773257015,-530.0,0
00:00,688712152.0,7318.882017176151,-887.0,0
00:00,843537309.0,-618.0397177916318,-667.0,0
00:00,913127700.0,2054.2488380111163,-621.0,0
00:00,514362267.0,779.1398191070602,-829.0,0
00:00,893134725.0,1340.0138376616678,-1296.0,0
00:00,255814263.0,4151.44073155049,-795.0,0
00:00,655368335.0,5271.89216486482,-682.0,0
00:00,821971408.0,1455.1771102355433,-464.0,0
00:00,730002588.0,14492.72276213962,-1173.0,0
00:00,358846516.0,1233.2922225272175,-1257.0,0
00:00,266777719.0,1825.9489337802397,-806.0,0
00:00,644751433.0,-1432.6931584655383,-952.0,0
00:00,866941383.0,2776.486950000006,-750.0,0
00:00,444428189.0,2731.124200000001,-918.0,0
00:00,461990622.0,10380.131415786323,-1316.0,0
00:00,699997811.0,1062.506650000004,-1340.0,0
00:00,233981231.0,2769.400881960624,-858.0,0
00:00,656781737.0,-5395.939999999995,-917.0,0
00:00,956717493.0,1678.1693722249324,-1241.0,0
00:00,315078351.0,8603.050053308263,-959.0,0
00:00,142791593.0,135.62864999999965,-475.0,0
00:00,593378953.0,1746.259650000005,-932.0,0
00:00,570575024.0,-911.1342000000006,-730.0,0
00:00,766812921.0,293.1294499999992,-846.0,0
00:00,509627909.0,183.38464999999903,-961.0,0
00:00,553734946.0,432.08629999999835,-819.0,0
00:00,331450202.0,8835.579804480114,-631.0,0
00:00,225210798.0,1262.8027737592083,-849.0,0
00:00,170637730.0,3173.655442363077,-633.0,0
00:00,336171116.0,-361.8975500000006,-1085.0,0
00:00,558119802.0,35492.81765512669,-1034.0,0
00:00,200080192.0,10385.518465199804,-821.0,0
00:00,844206657.0,117.49990514656974,-1307.0,0
00:00,766692943.0,-1982.27675,-952.0,0
00:00,517190750.0,2454.4585899154126,-547.0,0
00:00,214339619.0,801.2353508683561,-985.0,0
00:00,385685918.0,458.4699408415522,-478.0,0
00:00,722971557.0,223.39972084307556,-910.0,0
00:00,492058070.0,-686.8640312595294,-1356.0,0
00:00,414805878.0,14304.246788668612,-465.0,0
00:00,592961759.0,-1625.9048000000005,-1194.0,0
00:00,741269136.0,2840.845950000001,-1268.0,0
00:00,500843551.0,1518.8498999999997,-669.0,0
00:00,441274121.0,13445.39044065768,-520.0,0
00:00,424927189.0,153.6108327441052,-890.0,0
00:00,430910686.0,930.1942000000004,-476.0,0
00:00,370757362.0,1645.221589812676,-644.0,0
00:00,551196328.0,4700.58841862956,-567.0,0
00:00,786141370.0,159.78479999999922,-1237.0,0
00:00,768271776.0,-301.3300967665796,-632.0,0
00:00,162162212.0,996.484543327309,-1395.0,0
00:00,626989363.0,1231.9210633173752,-577.0,0
00:00,925037906.0,1802.8238000000017,-587.0,0
00:00,833499132.0,2887.5081500000015,-837.0,0
00:00,350921975.0,121.89132107387422,-665.0,0
00:00,700138124.0,5905.475633830919,-894.0,0
00:00,373163757.0,11844.499273794212,-554.0,0
00:00,218795010.0,-445.37505000000056,-514.0,0
00:00,534908754.0,-900.6455500000002,-1143.0,0
00:00,722358036.0,784.117940627083,-1304.0,0
00:00,245198540.0,498.6813988017795,-848.0,0
00:00,834581602.0,840.9836499999992,-715.0,0
00:00,743630833.0,558.6993132847012,-925.0,0
00:00,873693307.0,11305.51621457702,-967.0,0
00:00,610645022.0,-292.54116264491836,-988.0,0
00:00,698955014.0,1441.5231802031967,-539.0,0
00:00,245690309.0,10605.705824889454,-479.0,0
00:00,955035930.0,2601.843479171477,-1347.0,0
00:00,455052690.0,260.48373994862766,-594.0,0
00:00,189335192.0,-819.8190017578604,-650.0,0
00:00,376271050.0,1711.2628069057437,-813.0,0
00:00,172084472.0,-2409.5907215957186,-1296.0,0
00:00,979892433.0,-1272.409800000001,-1209.0,0
00:00,858560423.0,13084.543909769358,-745.0,0
00:00,828532554.0,750.2168765071483,-995.0,0
00:00,627917561.0,4376.185050000005,-856.0,0
00:00,851649498.0,11614.717052227274,-673.0,0
00:00,799453072.0,-82.58085000000119,-594.0,0
00:00,472995101.0,2755.340834242803,-887.0,0
00:00,913801979.0,511.9297799144938,-641.0,0
00:00,744398361.0,-276.02900000000034,-608.0,0
00:00,642924505.0,728.9446701835261,-460.0,0
00:00,467207141.0,1098.5808670482638,-693.0,0
00:00,308505160.0,14350.269117773048,-609.0,0
00:00,618138606.0,1844.379702870066,-570.0,0
00:00,240643705.0,1051.653617373981,-998.0,0
00:00,257633312.0,-187.1116500000009,-586.0,0
00:00,366550080.0,28221.59380041608,-636.0,0
00:00,361955473.0,279.1670452440844,-711.0,0
00:00,162370388.0,-2343.3828999999996,-1286.0,0
00:00,203466392.0,4092.939014911599,-672.0,0
00:00,812692024.0,4423.336706663929,-489.0,0
00:00,581618317.0,-4925.554201873206,-1204.0,0
00:00,252760664.0,7694.070289540872,-749.0,0
00:00,284905540.0,9243.98071628352,-446.0,0
00:00,818552503.0,920.986999999999,-665.0,0
00:00,435984758.0,4939.313095660436,-694.0,0
00:00,919185264.0,4466.757631239692,-683.0,0
00:00,709608057.0,3435.259733660685,-553.0,0
00:00,624500124.0,3933.763102376807,-654.0,0
00:00,815385232.0,11519.662019340862,-543.0,0
00:00,277562576.0,733.1850181051029,-856.0,0
00:00,478651121.0,-194.91527040153028,-1340.0,0
00:00,285220959.0,12670.988155841264,-1118.0,0
00:00,971010829.0,588.6750564442452,-815.0,0
00:00,858989281.0,28987.251002058412,-999.0,0
00:00,520418719.0,772.7329000000036,-588.0,0
00:00,494156986.0,-203.6627543276652,-1000.0,0
00:00,987229118.0,1965.698461187725,-489.0,0
00:00,832564361.0,17687.785167228867,-600.0,0
00:00,896821055.0,250.65175926708253,-889.0,0
00:00,308068836.0,1551.348522568192,-854.0,0
00:00,228136274.0,1829.6804999999997,-1026.0,0
00:00,873701090.0,1226.8933101543107,-462.0,0
00:00,824916823.0,9873.700871788897,-795.0,0
00:00,152488934.0,2330.6287073137305,-826.0,0
00:00,962295212.0,-2923.005149999997,-761.0,0
00:00,939972497.0,2071.8719586000107,-557.0,0
00:00,274818272.0,860.7251785671315,-517.0,0
00:00,282102606.0,499.8197624228264,-812.0,0
00:00,119993184.0,-2027.1444029108625,-1223.0,0
00:00,909676212.0,1282.7494045320273,-780.0,0
00:00,741903302.0,2794.976865014125,-684.0,0
00:00,758885184.0,1454.9371822743449,-561.0,0
00:00,101531259.0,193.31469999999968,-859.0,0
00:00,652048867.0,775.425299999999,-575.0,0
00:00,940569402.0,6821.174671678788,-1149.0,0
00:00,489964679.0,21635.08103909183,-613.0,0
00:00,188263947.0,723.4517500000006,-1310.0,0
00:00,656317661.0,80.47164154140273,-492.0,0
00:00,760753808.0,155.07469999999944,-1071.0,0
00:00,479366718.0,2478.7514476324004,-997.0,0
00:00,618514666.0,22667.83404106431,-495.0,0
00:00,361201224.0,4242.537886533854,-665.0,0
00:00,668329719.0,9647.021970977376,-495.0,0
00:00,724537117.0,-1215.5685500000004,-1176.0,0
00:00,354894456.0,76.46999999999957,-753.0,0
00:00,365608668.0,676.2392520241888,-669.0,0
00:00,345514953.0,-860.2753000000007,-1247.0,0
00:00,604334058.0,745.8464999999994,-502.0,0
00:00,237493332.0,16055.307430347126,-585.0,0
00:00,519649533.0,284.02181637066224,-899.0,0
00:00,613729471.0,10908.143371309963,-478.0,0
00:00,734161378.0,-2707.1701694342128,-1043.0,0
00:00,194745206.0,676.3183720912432,-508.0,0
00:00,977899503.0,516.2468935808527,-469.0,0
00:00,887853850.0,11453.204615192666,-533.0,0
00:00,435313070.0,3089.0413330332203,-1148.0,0
00:00,491392945.0,6051.101500000008,-1238.0,0
00:00,986267641.0,9080.958177602224,-1272.0,0
00:00,776108637.0,1561.6546536574956,-566.0,0
00:00,637649383.0,1170.0884499999984,-630.0,0
00:00,711045550.0,2709.933350000003,-1376.0,0
00:00,920830317.0,-118.87397936251864,-1361.0,0
00:00,598793068.0,1176.6488499999982,-663.0,0
00:00,833899961.0,1541.4177442498694,-530.0,0
00:00,380228542.0,466.6617418155656,-623.0,0
00:00,957821152.0,-1379.4329535715497,-951.0,0
00:00,964702094.0,1476.423037640289,-456.0,0
00:00,982949451.0,-3803.9516670525086,-1130.0,0
00:00,876890798.0,4136.082170699932,-575.0,0
00:00,667367404.0,9905.188441342283,-485.0,0
00:00,241459011.0,1403.334013272347,-731.0,0
00:00,184430449.0,2911.4539276932646,-692.0,0
00:00,137822385.0,3873.974801541066,-957.0,0
00:00,213112754.0,7440.790560569874,-1135.0,0
00:00,835736339.0,2453.829066146471,-500.0,0
00:00,570269025.0,3953.927072911829,-488.0,0
00:00,129018172.0,10261.432321236933,-782.0,0
00:00,915666111.0,-4485.752074772037,-1269.0,0
00:00,624563756.0,135.26932878355638,-822.0,0
00:00,703588001.0,29.65304999999944,-1004.0,0
00:00,871866387.0,453.7070999999992,-706.0,0
00:00,574548998.0,-29.75935000000095,-662.0,0
00:00,769319491.0,441.3569999999993,-864.0,0
00:00,999752672.0,2005.7868935333345,-652.0,0
00:00,654329190.0,273.8026009485193,-1144.0,0
00:00,383833857.0,27136.062214960693,-670.0,0
00:00,859603181.0,4206.290852925,-700.0,0
00:00,221356538.0,1142.9364999999998,-729.0,0
00:00,550644516.0,-34.58345000000145,-1065.0,0
00:00,503575533.0,8877.473251971303,-965.0,0
00:00,331684336.0,-1428.8163699513211,-990.0,0
00:00,901432314.0,4386.468186388769,-468.0,0
00:00,520447032.0,9173.53273964566,-891.0,0
00:00,785749304.0,9504.169054393553,-787.0,0
00:00,819515373.0,2824.1161360637916,-491.0,0
00:00,429556122.0,4976.155093344285,-503.0,0
00:00,138351025.0,-699.1107500000003,-570.0,0
00:00,855129444.0,11.090204562627832,-846.0,0
00:00,516051449.0,1893.2687746508288,-504.0,0
00:00,660874296.0,3398.5674499608485,-611.0,0
00:00,647472692.0,27311.003746878352,-867.0,0
00:00,450896297.0,14473.828118178668,-485.0,0
00:00,357651163.0,-598.2800000000007,-1008.0,0
00:00,950234174.0,2824.9424520465927,-596.0,0
00:00,433917275.0,8550.02259955712,-912.0,0
00:00,355733816.0,5844.464832674864,-664.0,0
00:00,366477356.0,1157.3688499999998,-1120.0,0
00:00,196289502.0,17068.58330954302,-512.0,0
00:00,117273481.0,9579.92506533524,-897.0,0
00:00,750094757.0,-1634.2593000000006,-1226.0,0
00:00,472213568.0,-246.06824420605335,-600.0,0
00:00,108931112.0,15636.92403071597,-936.0,0
00:00,930277104.0,11272.744912356202,-472.0,0
00:00,683078800.0,2445.8694529448708,-618.0,0
00:00,835829467.0,-2197.764749999999,-491.0,0
00:00,462962606.0,1640.2700499999987,-1049.0,0
00:00,138969884.0,954.3259499999996,-619.0,0
00:00,610450243.0,-525.7095999999998,-1081.0,0
00:00,461029994.0,8527.577094096781,-861.0,0
00:00,641764023.0,-999.5863037720046,-870.0,0
00:00,719586818.0,19613.12953871163,-552.0,0
00:00,534583529.0,1342.7792880547652,-628.0,0
00:00,742223719.0,889.1829073048027,-479.0,0
00:00,605116158.0,2930.1762000000017,-589.0,0
00:00,352899149.0,659.4150499999987,-470.0,0
00:00,872286364.0,-546.7153458130997,-991.0,0
00:00,314980178.0,4388.400850000005,-1285.0,0
00:00,637433131.0,383.862599999999,-982.0,0
00:00,403383649.0,2317.8888048612507,-471.0,0
00:00,229205098.0,8489.175393821419,-464.0,0
00:00,675231808.0,18548.80218733025,-578.0,0
00:00,246753533.0,830.9788999999985,-676.0,0
00:00,670427480.0,926.8408000000012,-1247.0,0
00:00,455831435.0,-1584.5296048014943,-674.0,0
00:00,886921642.0,3970.274347401557,-591.0,0
00:00,303843160.0,659.8380000000016,-778.0,0
00:00,398429109.0,1561.828550000001,-1032.0,0
00:00,588565416.0,7497.183245597264,-501.0,0
00:00,477216513.0,-365.02219999999943,-1351.0,0
00:00,226703987.0,3021.771299999999,-1017.0,0
00:00,187111705.0,7743.801347754887,-1387.0,0
00:00,250895529.0,1815.305982469288,-525.0,0
00:00,860360312.0,488.5180588826804,-477.0,0
00:00,121858569.0,2093.2961500000024,-776.0,0
00:00,104832000.0,-2850.8823589058443,-861.0,0
00:00,550169791.0,23190.737176500847,-1164.0,0
00:00,709632525.0,-1457.8923500000003,-1043.0,0
00:00,565175333.0,-3864.1610227298265,-1204.0,0
00:00,338022396.0,837.554189375739,-881.0,0
00:00,838415080.0,-3362.766499999999,-928.0,0
00:00,321372947.0,-212.9842507890994,-1262.0,0
00:00,886837068.0,1335.7080999999994,-802.0,0
00:00,973086490.0,11284.58188133701,-850.0,0
00:00,215832575.0,-1232.6094637442195,-877.0,0
00:00,496395938.0,13203.147479880634,-561.0,0
00:00,681955876.0,-1340.3281000000006,-1004.0,0
00:00,558875206.0,3837.804310898953,-1356.0,0
00:00,812839908.0,-1638.5123500000002,-1004.0,0
00:00,386729293.0,34366.56623741818,-650.0,0
00:00,639549973.0,8337.994710464145,-711.0,0
00:00,933491926.0,4165.172300000003,-585.0,0
00:00,402438092.0,1257.9447999999988,-774.0,0
00:00,285428103.0,10848.420621063917,-598.0,0
00:00,137913631.0,995.0121999999996,-476.0,0
00:00,416060965.0,668.7922547005803,-458.0,0
00:00,340295966.0,-1406.1944500000004,-850.0,0
00:00,166019891.0,9029.407483832563,-906.0,0
00:00,679662108.0,18998.153623259117,-548.0,0
00:00,688328251.0,-812.1041253548271,-935.0,0
00:00,535804582.0,-1224.2321500000012,-1164.0,0
00:00,998390769.0,75.16435094052417,-1013.0,0
00:00,878989510.0,5192.36188614179,-782.0,0
00:00,629078930.0,332.92947972560205,-531.0,0
00:00,807714284.0,1634.237060736,-679.0,0
00:00,752362502.0,8283.980317330319,-1106.0,0
00:00,691012931.0,-1605.482250000001,-1335.0,0
00:00,504055745.0,586.4884613417669,-608.0,0
00:00,703478110.0,5855.864731849387,-1201.0,0
00:00,675806859.0,8183.729646765971,-648.0,0
00:00,925659248.0,-563.3708392295712,-1270.0,0
00:00,948069469.0,-563.623600000001,-1239.0,0
00:00,865748375.0,4589.330208924523,-485.0,0
00:00,857754342.0,1531.559876279814,-1268.0,0
00:00,479456865.0,2254.4056995833043,-635.0,0
00:00,466649401.0,1213.3227935520877,-704.0,0
00:00,868377987.0,3388.049909635548,-650.0,0
00:00,133755851.0,-195.9507518617478,-1109.0,0
00:00,261894284.0,-2426.883799999997,-558.0,0
00:00,647936800.0,3014.313578243151,-1393.0,0
00:00,758160963.0,9474.83850706394,-575.0,0
00:00,478412511.0,13172.35807019746,-559.0,0
00:00,844835978.0,10906.839205781896,-813.0,0
00:00,448279144.0,1524.5449999999992,-496.0,0
00:00,995615876.0,2279.3220396983884,-637.0,0
00:00,345582855.0,667.1858528205494,-539.0,0
00:00,859264768.0,583.9011337819384,-569.0,0
00:00,567499591.0,-1329.8553000000004,-1000.0,0
00:00,296972867.0,-763.2961000000009,-1226.0,0
00:00,954263768.0,28.37859999999978,-1057.0,0
00:00,135937041.0,-1034.7128482684118,-517.0,0
00:00,221868392.0,5739.736193864469,-594.0,0
00:00,975345315.0,37427.02723928243,-772.0,0
00:00,280200287.0,-1845.130453386949,-465.0,0
00:00,521611005.0,127.07536414895344,-1194.0,0
00:00,388862238.0,1849.811528473194,-446.0,0
00:00,817294757.0,-2403.4633,-1359.0,0
00:00,124102251.0,4111.725931770645,-476.0,0
00:00,349614277.0,1962.4245499999995,-661.0,0
00:00,475277431.0,1839.4481369436191,-632.0,0
00:00,736310094.0,-567.371024027426,-856.0,0
00:00,264208990.0,1088.4094499999987,-1266.0,0
00:00,286484726.0,1250.0728267328864,-745.0,0
00:00,390747457.0,762.3283999999978,-1269.0,0
00:00,885259672.0,3882.4635078203046,-621.0,0
00:00,779620857.0,-112.11134638517592,-614.0,0
00:00,661295096.0,3822.410513321748,-646.0,0
00:00,122884111.0,-3442.0060830729694,-973.0,0
00:00,903663593.0,1403.3249583025631,-578.0,0
00:00,971129830.0,-1042.750649999999,-569.0,0
00:00,550832673.0,3579.892016395508,-986.0,0
00:00,131388684.0,24002.808016033392,-721.0,0
00:00,596463612.0,-2068.1776047251387,-1012.0,0
00:00,994947671.0,1386.4657000000004,-590.0,0
00:00,449871732.0,11999.200665309869,-705.0,0
00:00,383625050.0,3469.204111635742,-930.0,0
00:00,822135975.0,12372.59694389752,-596.0,0
00:00,639409800.0,37920.214067568246,-877.0,0
00:00,348325817.0,11883.366963952172,-1209.0,0
00:00,426466211.0,-3277.50575,-1248.0,0
00:00,903468956.0,1308.5625999999993,-629.0,0
00:00,487051121.0,1549.4055683486918,-759.0,0
00:00,769311479.0,7065.011405832966,-910.0,0
00:00,572136270.0,368.5249115880233,-834.0,0
00:00,785210466.0,2684.2156199977107,-678.0,0
00:00,197865285.0,644.5441617312204,-1276.0,0
00:00,559995067.0,3010.846555590424,-1266.0,0
00:00,165691047.0,613.120899999999,-655.0,0
00:00,524425303.0,-277.76900000000114,-917.0,0
00:00,474301748.0,-2720.099005683968,-553.0,0
00:00,776431321.0,3582.0819447979493,-502.0,0
00:00,744968736.0,-1381.8118265694238,-1294.0,0
00:00,422955974.0,336.4131349990498,-1089.0,0
00:00,535744551.0,1269.341965995626,-472.0,0
00:00,480557476.0,12840.407256498183,-947.0,0
00:00,130522384.0,-126.6638156208603,-847.0,0
00:00,713057426.0,-836.2817500000002,-647.0,0
00:00,183888402.0,20296.864973285392,-847.0,0
00:00,534097839.0,-4268.416049999998,-691.0,0
00:00,544961962.0,1327.944323005609,-553.0,0
00:00,586315521.0,13502.44599513684,-653.0,0
00:00,690523499.0,194.2555500000003,-578.0,0
00:00,809499628.0,18691.50981868682,-645.0,0
00:00,631111289.0,-262.3665000000009,-951.0,0
00:00,471897866.0,8628.790451551253,-499.0,0
00:00,540159353.0,12227.946098906445,-921.0,0
00:00,633345190.0,6809.398091301468,-1334.0,0
00:00,651372390.0,-3614.225749999999,-1222.0,0
00:00,979135922.0,1476.6783005904508,-551.0,0
00:00,291580432.0,221.5577500000004,-1156.0,0
00:00,355940285.0,8111.872978189684,-1233.0,0
00:00,945054126.0,495.0481,-587.0,0
00:00,173335108.0,2778.854,-839.0,0
00:00,623156843.0,5279.084806328898,-1068.0,0
00:00,684988568.0,-196.4861734272015,-457.0,0
00:00,151278285.0,-1122.7958000000003,-1009.0,0
00:00,180616589.0,1299.0945281236177,-736.0,0
00:00,874431242.0,10254.56615688029,-452.0,0
00:00,290751280.0,754.0927466748255,-614.0,0
00:00,556992209.0,13143.26862447272,-991.0,0
00:00,604288474.0,2453.1271172444212,-912.0,0
00:00,986774156.0,1924.3369316257697,-939.0,0
00:00,672913754.0,12370.981994680928,-745.0,0
00:00,490790931.0,606.2176499999987,-701.0,0
00:00,656812046.0,1376.752753732519,-926.0,0
00:00,996042490.0,6907.837733173505,-501.0,0
00:00,576188756.0,-4124.079,-597.0,0
00:00,482513594.0,6760.2858812672475,-650.0,0
00:00,854895960.0,4228.87517874872,-1006.0,0
00:00,290818242.0,7981.698172644421,-631.0,0
00:00,519933553.0,263.51100415072847,-880.0,0
00:00,340321732.0,2209.5970000000034,-461.0,0
00:00,705848712.0,28771.584106468683,-1343.0,0
00:00,486495235.0,2600.1453893887165,-631.0,0
00:00,425964226.0,4391.797650000002,-799.0,0
00:00,522188082.0,9050.513465607422,-540.0,0
00:00,799286313.0,-869.6559128758615,-776.0,0
00:00,497809732.0,654.1098695525952,-1327.0,0
00:00,163470640.0,1399.5650999999998,-1094.0,0
00:00,151968462.0,8375.830119038495,-776.0,0
00:00,897714622.0,9827.551237939904,-957.0,0
00:00,696333897.0,811.2024499999989,-528.0,0
00:00,780463728.0,4071.628520942239,-508.0,0
23:59,298000165.0,27638.101067013537,-15.99,1
23:59,298000165.0,27630.111067013535,-7.99,7
23:59,298000165.0,27611.121067013533,-18.99,6
23:59,298000165.0,27511.121067013533,-100.0,6
23:59,155317149.0,563.1023999999991,-12.99,1
23:59,155317149.0,550.1123999999991,-12.99,1
23:59,155317149.0,544.1223999999991,-5.99,1
23:59,155317149.0,531.132399999999,-12.99,1
23:59,155317149.0,512.142399999999,-18.99,6
23:59,155317149.0,504.15239999999903,-7.99,1
23:59,155317149.0,488.162399999999,-15.99,1
23:59,500043411.0,14827.710883276266,-7.99,7
23:59,500043411.0,14811.720883276266,-15.99,1
23:59,500043411.0,14792.730883276266,-18.99,6
23:59,500043411.0,14692.730883276266,-100.0,6
23:59,600185455.0,144.17000224748148,-12.99,1
23:59,600185455.0,129.18000224748147,-14.99,1
23:59,600185455.0,113.19000224748147,-15.99,1
23:59,600185455.0,105.20000224748148,-7.99,7
23:59,130154096.0,1386.5050017058782,-15.99,1
23:59,887156614.0,-845.2896710407738,-18.99,6
23:59,887156614.0,-853.2796710407738,-7.99,7
23:59,887156614.0,-869.2696710407738,-15.99,1
23:59,887156614.0,-884.2596710407738,-14.99,1
23:59,887156614.0,-899.2496710407738,-14.99,1
23:59,887156614.0,-905.2396710407738,-5.99,1
23:59,252701364.0,-3771.288672677915,-7.0,1
23:59,252701364.0,-3784.278672677915,-12.99,1
23:59,252701364.0,-3791.278672677915,-7.0,1
23:59,252701364.0,-3797.268672677915,-5.99,1
23:59,252701364.0,-3813.2586726779145,-15.99,1
23:59,252701364.0,-3832.2486726779143,-18.99,6
23:59,469330905.0,126.73206802921553,-14.99,1
23:59,469330905.0,120.74206802921552,-5.99,1
23:59,469330905.0,113.74206802921552,-7.0,1
23:59,469330905.0,94.75206802921552,-18.99,6
23:59,469330905.0,86.76206802921553,-7.99,7
23:59,687135796.0,29776.39460378836,-7.99,1
23:59,687135796.0,29763.404603788356,-12.99,1
23:59,687135796.0,29750.414603788355,-12.99,1
23:59,687135796.0,29744.424603788353,-5.99,1
23:59,425730826.0,2712.48690938872,-18.99,6
23:59,456221621.0,424.976167302628,-15.99,1
23:59,456221621.0,416.986167302628,-7.99,1
23:59,456221621.0,397.996167302628,-18.99,6
23:59,993039226.0,-4298.254499999995,-15.99,1
23:59,993039226.0,-4306.244499999994,-7.99,1
23:59,993039226.0,-4312.234499999994,-5.99,1
23:59,993039226.0,-4319.234499999994,-7.0,1
23:59,993039226.0,-4325.224499999994,-5.99,1
23:59,993039226.0,-4344.214499999994,-18.99,6
23:59,287230540.0,1682.4122932932662,-7.99,1
23:59,287230540.0,1666.4222932932662,-15.99,1
23:59,287230540.0,1647.4322932932662,-18.99,6
23:59,287230540.0,1641.4422932932662,-5.99,1
23:59,287230540.0,1634.4422932932662,-7.0,1
23:59,287230540.0,1619.4522932932662,-14.99,1
23:59,901037631.0,1889.9393230964067,-100.0,6
23:59,901037631.0,1881.9493230964067,-7.99,1
23:59,901037631.0,1865.9593230964067,-15.99,1
23:59,901037631.0,1846.9693230964067,-18.99,6
23:59,627936697.0,145.73030000000017,-18.99,6
23:59,627936697.0,132.74030000000016,-12.99,1
23:59,627936697.0,125.74030000000016,-7.0,1
23:59,627936697.0,118.74030000000016,-7.0,1
23:59,627936697.0,102.75030000000017,-15.99,1
23:59,607629901.0,-4332.068319908143,-5.99,1
23:59,607629901.0,-4338.058319908143,-5.99,1
23:59,607629901.0,-4353.048319908143,-14.99,1
23:59,607629901.0,-4369.0383199081425,-15.99,1
23:59,607629901.0,-4469.0383199081425,-100.0,6
23:59,293191074.0,846.8481499999991,-15.99,1
23:59,293191074.0,833.8581499999991,-12.99,1
23:59,293191074.0,826.8581499999991,-7.0,1
23:59,293191074.0,813.8681499999991,-12.99,1
23:59,293191074.0,800.8781499999991,-12.99,1
23:59,117308635.0,1645.4461014783392,-7.99,1
23:59,117308635.0,1626.4561014783392,-18.99,6
23:59,117308635.0,1611.4661014783392,-14.99,1
23:59,117308635.0,1605.4761014783392,-5.99,1
23:59,117308635.0,1505.4761014783392,-100.0,6
23:59,581655972.0,43671.33557632684,-15.99,1
23:59,581655972.0,43652.34557632684,-18.99,6
23:59,510101371.0,14611.29106800894,-7.99,1
23:59,510101371.0,14595.30106800894,-15.99,1
23:59,994214354.0,10879.539197714328,-15.99,1
23:59,994214354.0,10871.549197714328,-7.99,7
23:59,994214354.0,10858.559197714329,-12.99,1
23:59,994214354.0,10852.569197714329,-5.99,1
23:59,706361191.0,679.534098494078,-15.99,1
23:59,706361191.0,666.544098494078,-12.99,1
23:59,706361191.0,647.554098494078,-18.99,6
23:59,761272540.0,362.4698999999988,-7.99,1
23:59,761272540.0,346.4798999999988,-15.99,1
23:59,761272540.0,340.4898999999988,-5.99,1
23:59,761272540.0,327.4998999999988,-12.99,1
23:59,761272540.0,308.50989999999877,-18.99,6
23:59,754141345.0,-2942.665335115761,-15.99,1
23:59,754141345.0,-2950.655335115761,-7.99,7
23:59,754141345.0,-2963.6453351157606,-12.99,1
23:59,754141345.0,-2969.6353351157604,-5.99,1
23:59,754141345.0,-2975.62533511576,-5.99,1
23:59,754141345.0,-2981.61533511576,-5.99,1
23:59,754141345.0,-3000.60533511576,-18.99,6
23:59,754141345.0,-3100.60533511576,-100.0,6
23:59,659415300.0,2167.2067902507047,-12.99,1
23:59,659415300.0,2148.216790250705,-18.99,6
23:59,659415300.0,2132.226790250705,-15.99,1
23:59,324224854.0,4959.388731530835,-15.99,1
23:59,169689461.0,1417.3431499999992,-15.99,1
23:59,169689461.0,1409.3531499999992,-7.99,7
23:59,169689461.0,1309.3531499999992,-100.0,6
23:59,169689461.0,1290.3631499999992,-18.99,6
23:59,843174694.0,-5247.850999999998,-18.99,6
23:59,627622066.0,4110.484954715662,-18.99,6
23:59,627622066.0,4102.494954715662,-7.99,1
23:59,627622066.0,4095.494954715662,-7.0,1
23:59,627622066.0,4082.5049547156623,-12.99,1
23:59,627622066.0,4067.5149547156625,-14.99,1
23:59,627622066.0,3967.5149547156625,-100.0,6
23:59,648644594.0,519.1565999999991,-7.0,1
23:59,648644594.0,504.1665999999991,-14.99,1
23:59,648644594.0,489.1765999999991,-14.99,1
23:59,648644594.0,473.1865999999991,-15.99,1
23:59,648644594.0,373.1865999999991,-100.0,6
23:59,169006407.0,12765.043960695755,-15.99,1
23:59,169006407.0,12746.053960695755,-18.99,6
23:59,154246234.0,264.49489210210413,-18.99,6
23:59,154246234.0,248.50489210210412,-15.99,1
23:59,889916166.0,512.9034014132267,-7.99,1
23:59,569687509.0,-2168.6104,-7.0,1
23:59,569687509.0,-2184.6004,-15.99,1
23:59,569687509.0,-2203.5903999999996,-18.99,6
23:59,548549094.0,-562.0736299265087,-14.99,1
23:59,548549094.0,-569.0736299265087,-7.0,1
23:59,548549094.0,-585.0636299265087,-15.99,1
23:59,632065391.0,-249.5486499999995,-18.99,6
23:59,116598243.0,2278.2262217774496,-14.99,1
23:59,116598243.0,2272.23622177745,-5.99,1
23:59,116598243.0,2266.24622177745,-5.99,1
23:59,116598243.0,2253.2562217774503,-12.99,1
23:59,116598243.0,2237.2662217774505,-15.99,1
23:59,898104045.0,-1541.9580500000022,-18.99,6
23:59,898104045.0,-1557.9480500000022,-15.99,1
23:59,898104045.0,-1565.9380500000022,-7.99,7
23:59,898104045.0,-1572.9380500000022,-7.0,1
23:59,442070890.0,1472.1224124443709,-7.99,1
23:59,442070890.0,1453.1324124443709,-18.99,6
23:59,586041848.0,197.9576999999989,-7.0,1
23:59,586041848.0,182.9676999999989,-14.99,1
23:59,586041848.0,175.9676999999989,-7.0,1
23:59,586041848.0,156.9776999999989,-18.99,6
23:59,586041848.0,148.98769999999888,-7.99,1
23:59,587202562.0,795.3279494170686,-18.99,6
23:59,587202562.0,787.3379494170686,-7.99,1
23:59,587202562.0,772.3479494170685,-14.99,1
23:59,587202562.0,757.3579494170685,-14.99,1
23:59,779816907.0,-2898.4885829229115,-7.99,7
23:59,779816907.0,-2906.4785829229113,-7.99,1
23:59,779816907.0,-2919.468582922911,-12.99,1
23:59,779816907.0,-2932.458582922911,-12.99,1
23:59,779816907.0,-2947.44858292291,-14.99,1
23:59,779816907.0,-2960.4385829229104,-12.99,1
23:59,779816907.0,-2979.42858292291,-18.99,6
23:59,208381936.0,-501.7555782217452,-18.99,6
23:59,208381936.0,-517.7455782217452,-15.99,1
23:59,208381936.0,-525.7355782217452,-7.99,7
23:59,680773155.0,942.2203833310916,-100.0,6
23:59,680773155.0,926.2303833310916,-15.99,1
23:59,680773155.0,918.2403833310916,-7.99,7
23:59,680773155.0,899.2503833310916,-18.99,6
23:59,846550094.0,1958.8047715014136,-15.99,1
23:59,846550094.0,1950.8147715014136,-7.99,7
23:59,846550094.0,1943.8147715014136,-7.0,1
23:59,846550094.0,1928.8247715014136,-14.99,1
23:59,846550094.0,1915.8347715014131,-12.99,1
23:59,846550094.0,1902.844771501413,-12.99,1
23:59,846550094.0,1883.854771501413,-18.99,6
23:59,871200314.0,-137.71222575736164,-15.99,1
23:59,871200314.0,-145.70222575736165,-7.99,7
23:59,871200314.0,-164.69222575736163,-18.99,6
23:59,871200314.0,-170.68222575736166,-5.99,1
23:59,871200314.0,-177.68222575736166,-7.0,1
23:59,871200314.0,-183.67222575736167,-5.99,1
23:59,871200314.0,-198.66222575736168,-14.99,1
23:59,871200314.0,-298.6622257573617,-100.0,6
23:59,111137699.0,-27.2106999999994,-15.99,1
23:59,111137699.0,-46.2006999999994,-18.99,6
23:59,395654270.0,-2085.2112028122,-18.99,6
23:59,395654270.0,-2101.2012028122,-15.99,1
23:59,916225911.0,-2285.656750000001,-5.99,1
23:59,916225911.0,-2298.646750000001,-12.99,1
23:59,916225911.0,-2311.6367500000006,-12.99,1
23:59,916225911.0,-2327.6267500000004,-15.99,1
23:59,916225911.0,-2346.61675,-18.99,6
23:59,158414827.0,-1405.8700000000017,-100.0,6
23:59,158414827.0,-1421.8600000000015,-15.99,1
23:59,158414827.0,-1440.8500000000015,-18.99,6
23:59,158414827.0,-1447.8500000000015,-7.0,1
23:59,536924114.0,-552.7022555930962,-7.99,1
23:59,536924114.0,-560.6922555930962,-7.99,7
23:59,536924114.0,-660.6922555930962,-100.0,6
23:59,536924114.0,-673.6822555930962,-12.99,1
23:59,536924114.0,-688.6722555930962,-14.99,1
23:59,536924114.0,-707.6622555930962,-18.99,6
23:59,672994751.0,266.90629078601,-7.99,1
23:59,672994751.0,258.91629078601,-7.99,7
23:59,672994751.0,239.92629078601,-18.99,6
23:59,511179916.0,8385.066556016984,-15.99,1
23:59,511179916.0,8377.076556016984,-7.99,1
23:59,511179916.0,8370.076556016984,-7.0,1
23:59,511179916.0,8363.076556016984,-7.0,1
23:59,511179916.0,8350.086556016984,-12.99,1
23:59,585133606.0,5781.38441813947,-15.99,1
23:59,585133606.0,5773.39441813947,-7.99,7
23:59,585133606.0,5754.40441813947,-18.99,6
23:59,585133606.0,5741.41441813947,-12.99,1
23:59,585133606.0,5728.424418139471,-12.99,1
23:59,585133606.0,5713.434418139471,-14.99,1
23:59,585133606.0,5700.444418139471,-12.99,1
23:59,822718326.0,12063.910117637952,-15.99,1
23:59,822718326.0,12055.920117637952,-7.99,1
23:59,822718326.0,12048.920117637952,-7.0,1
23:59,822718326.0,12041.920117637952,-7.0,1
23:59,822718326.0,12028.930117637952,-12.99,1
23:59,496674181.0,-2002.6785723307223,-15.99,1
23:59,496674181.0,-2017.6685723307223,-14.99,1
23:59,496674181.0,-2023.6585723307223,-5.99,1
23:59,496674181.0,-2042.6485723307223,-18.99,6
23:59,407323346.0,-2524.1504325553124,-7.0,1
23:59,407323346.0,-2537.140432555312,-12.99,1
23:59,407323346.0,-2550.130432555312,-12.99,1
23:59,407323346.0,-2569.1204325553117,-18.99,6
23:59,204855464.0,-951.890738639616,-5.99,1
23:59,204855464.0,-957.880738639616,-5.99,1
23:59,204855464.0,-970.870738639616,-12.99,1
23:59,204855464.0,-983.860738639616,-12.99,1
23:59,204855464.0,-999.850738639616,-15.99,1
23:59,204855464.0,-1018.840738639616,-18.99,6
23:59,204855464.0,-1118.840738639616,-100.0,6
23:59,979122276.0,-555.2580377056713,-18.99,6
23:59,979122276.0,-568.2480377056713,-12.99,1
23:59,979122276.0,-581.2380377056713,-12.99,1
23:59,979122276.0,-597.2280377056713,-15.99,1
23:59,979122276.0,-605.2180377056713,-7.99,7
23:59,851181128.0,5681.635741114009,-14.99,1
23:59,851181128.0,5675.645741114009,-5.99,1
23:59,851181128.0,5660.655741114009,-14.99,1
23:59,851181128.0,5654.6657411140095,-5.99,1
23:59,851181128.0,5638.67574111401,-15.99,1
23:59,851181128.0,5630.68574111401,-7.99,7
23:59,851181128.0,5611.69574111401,-18.99,6
23:59,531186970.0,5486.349464432307,-7.99,7
23:59,531186970.0,5467.3594644323075,-18.99,6
23:59,657139925.0,15210.469269915042,-7.0,1
23:59,657139925.0,15197.479269915042,-12.99,1
23:59,657139925.0,15191.489269915042,-5.99,1
23:59,657139925.0,15172.499269915044,-18.99,6
23:59,657139925.0,15164.509269915045,-7.99,1
23:59,657139925.0,15148.519269915045,-15.99,1
23:59,951817450.0,9841.869998099164,-7.99,7
23:59,951817450.0,9826.879998099164,-14.99,1
23:59,668692488.0,2832.9356285738095,-15.99,1
23:59,668692488.0,2813.9456285738097,-18.99,6
23:59,146686559.0,-380.50201117347785,-15.99,1
23:59,146686559.0,-388.49201117347786,-7.99,7
23:59,146686559.0,-488.49201117347786,-100.0,6
23:59,146686559.0,-507.4820111734779,-18.99,6
23:59,426474982.0,-3803.49475,-15.99,1
23:59,737537711.0,-442.12196639846434,-12.99,1
23:59,737537711.0,-455.11196639846435,-12.99,1
23:59,663479159.0,5039.573541827712,-15.99,1
23:59,493571342.0,-2556.7483809070477,-18.99,6
23:59,493571342.0,-2572.7383809070475,-15.99,1
23:59,493571342.0,-2580.7283809070473,-7.99,7
23:59,259015404.0,1977.0771557208384,-15.99,1
23:59,259015404.0,1969.0871557208384,-7.99,7
23:59,259015404.0,1954.0971557208384,-14.99,1
23:59,259015404.0,1948.1071557208384,-5.99,1
23:59,259015404.0,1941.1071557208384,-7.0,1
23:59,259015404.0,1926.1171557208384,-14.99,1
23:59,259015404.0,1907.1271557208383,-18.99,6
23:59,364357875.0,9274.02265727709,-15.99,1
23:59,364357875.0,9266.03265727709,-7.99,7
23:59,364357875.0,9253.04265727709,-12.99,1
23:59,364357875.0,9247.05265727709,-5.99,1
23:59,364357875.0,9228.06265727709,-18.99,6
23:59,679943657.0,3449.7708891801367,-15.99,1
23:59,679943657.0,3430.780889180137,-18.99,6
23:59,679943657.0,3415.790889180137,-14.99,1
23:59,679943657.0,3409.8008891801373,-5.99,1
23:59,706250160.0,13595.756143813776,-15.99,1
23:59,706250160.0,13587.766143813777,-7.99,7
23:59,549414742.0,8507.463033394708,-7.99,1
23:59,549414742.0,8491.473033394708,-15.99,1
23:59,549414742.0,8476.483033394708,-14.99,1
23:59,549414742.0,8463.493033394709,-12.99,1
23:59,549414742.0,8448.503033394709,-14.99,1
23:59,549414742.0,8435.513033394709,-12.99,1
23:59,585596026.0,3339.4498509019895,-7.99,1
23:59,585596026.0,3323.4598509019897,-15.99,1
23:59,585596026.0,3304.46985090199,-18.99,6
23:59,585596026.0,3291.47985090199,-12.99,1
23:59,124377686.0,-2746.307399999998,-18.99,6
23:59,124377686.0,-2754.2973999999977,-7.99,1
23:59,124377686.0,-2770.2873999999974,-15.99,1
23:59,124377686.0,-2870.2873999999974,-100.0,6
23:59,762859681.0,267.8500999999988,-15.99,1
23:59,762859681.0,248.8600999999988,-18.99,6
23:59,749371623.0,-2619.4666535173424,-7.99,1
23:59,499244466.0,-248.4571812834224,-15.99,1
23:59,499244466.0,-263.4471812834224,-14.99,1
23:59,499244466.0,-278.43718128342243,-14.99,1
23:59,499244466.0,-297.42718128342244,-18.99,6
23:59,324046160.0,-165.33433321307098,-5.99,1
23:59,324046160.0,-180.324333213071,-14.99,1
23:59,324046160.0,-195.314333213071,-14.99,1
23:59,324046160.0,-202.314333213071,-7.0,1
23:59,324046160.0,-218.304333213071,-15.99,1
23:59,324046160.0,-237.294333213071,-18.99,6
23:59,279149837.0,2372.3860499999987,-7.99,1
23:59,279149837.0,2272.3860499999987,-100.0,6
23:59,630691258.0,471.1365448748413,-15.99,1
23:59,630691258.0,452.1465448748413,-18.99,6
23:59,630691258.0,439.1565448748413,-12.99,1
23:59,630691258.0,432.1565448748413,-7.0,1
23:59,630691258.0,417.1665448748413,-14.99,1
23:59,630691258.0,410.1665448748413,-7.0,1
23:59,520239952.0,-1195.6431266547631,-7.99,1
23:59,520239952.0,-1203.6331266547631,-7.99,7
23:59,520239952.0,-1222.6231266547632,-18.99,6
23:59,248142083.0,127.69443470251674,-15.99,1
23:59,248142083.0,121.70443470251676,-5.99,1
23:59,248142083.0,102.71443470251675,-18.99,6
23:59,235310449.0,14.461184830310012,-5.99,1
23:59,235310449.0,-0.5288151696899881,-14.99,1
23:59,235310449.0,-16.518815169689987,-15.99,1
23:59,930271460.0,435.17004753577635,-18.99,6
23:59,698076160.0,7144.320168577105,-18.99,6
23:59,880546403.0,-1216.3995000000018,-7.99,7
23:59,880546403.0,-1224.3895000000018,-7.99,1
23:59,880546403.0,-1243.3795000000018,-18.99,6
23:59,880546403.0,-1343.3795000000018,-100.0,6
23:59,802697323.0,17709.542999175814,-7.99,7
23:59,802697323.0,17694.552999175812,-14.99,1
23:59,802697323.0,17681.56299917581,-12.99,1
23:59,802697323.0,17666.57299917581,-14.99,1
23:59,802697323.0,17651.582999175807,-14.99,1
23:59,899983008.0,-3090.9961499999968,-15.99,1
23:59,899983008.0,-3098.9861499999965,-7.99,1
23:59,899983008.0,-3117.9761499999963,-18.99,6
23:59,899983008.0,-3130.966149999996,-12.99,1
23:59,899983008.0,-3143.956149999996,-12.99,1
23:59,899983008.0,-3150.956149999996,-7.0,1
23:59,899983008.0,-3250.956149999996,-100.0,6
23:59,147474476.0,3893.149102832959,-7.99,7
23:59,147474476.0,3874.159102832959,-18.99,6
23:59,147474476.0,3861.16910283296,-12.99,1
23:59,147474476.0,3854.16910283296,-7.0,1
23:59,518474507.0,15565.287859928596,-5.99,1
23:59,518474507.0,15559.297859928596,-5.99,1
23:59,518474507.0,15552.297859928596,-7.0,1
23:59,518474507.0,15523.317859928597,-15.99,1
23:59,762896656.0,424.2624981518587,-18.99,6
23:59,762896656.0,408.2724981518587,-15.99,1
23:59,762896656.0,401.2724981518587,-7.0,1
23:59,762896656.0,395.2824981518587,-5.99,1
23:59,424397946.0,3004.4497836053993,-18.99,6
23:59,424397946.0,2989.4597836053995,-14.99,1
23:59,424397946.0,2974.4697836053997,-14.99,1
23:59,424397946.0,2961.4797836054,-12.99,1
23:59,424397946.0,2946.4897836054,-14.99,1
23:59,891513205.0,916.2968796590692,-12.99,1
23:59,891513205.0,909.2968796590692,-7.0,1
23:59,891513205.0,893.3068796590691,-15.99,1
23:59,891513205.0,885.3168796590691,-7.99,1
23:59,891513205.0,866.326879659069,-18.99,6
23:59,891513205.0,766.326879659069,-100.0,6
23:59,180719578.0,-4374.865249999996,-15.99,1
23:59,180719578.0,-4382.855249999996,-7.99,7
23:59,180719578.0,-4401.845249999996,-18.99,6
23:59,180719578.0,-4414.8352499999955,-12.99,1
23:59,180719578.0,-4427.825249999995,-12.99,1
23:59,180719578.0,-4440.815249999995,-12.99,1
23:59,180719578.0,-4455.805249999995,-14.99,1
23:59,262767079.0,-865.8188000000002,-18.99,6
23:59,262767079.0,-881.8088000000002,-15.99,1
23:59,262767079.0,-887.7988000000003,-5.99,1
23:59,262767079.0,-987.7988000000004,-100.0,6
23:59,987163717.0,6736.538480000005,-100.0,6
23:59,987163717.0,6720.548480000005,-15.99,1
23:59,261793952.0,980.3532602038148,-15.99,1
23:59,261793952.0,972.3632602038148,-7.99,1
23:59,261793952.0,953.3732602038148,-18.99,6
23:59,261793952.0,938.3832602038148,-14.99,1
23:59,261793952.0,838.3832602038149,-100.0,6
23:59,984783496.0,15315.94597704301,-12.99,1
23:59,984783496.0,15309.95597704301,-5.99,1
23:59,984783496.0,15293.96597704301,-15.99,1
23:59,984783496.0,15274.97597704301,-18.99,6
23:59,984783496.0,15174.97597704301,-100.0,6
23:59,709151315.0,433.2292183741599,-12.99,1
23:59,709151315.0,418.2392183741599,-14.99,1
23:59,709151315.0,402.2492183741599,-15.99,1
23:59,709151315.0,383.2592183741599,-18.99,6
23:59,199016328.0,4782.716606911702,-15.99,1
23:59,199016328.0,4776.726606911702,-5.99,1
23:59,199016328.0,4770.736606911702,-5.99,1
23:59,199016328.0,4764.746606911703,-5.99,1
23:59,199016328.0,4751.756606911703,-12.99,1
23:59,713641917.0,1539.837167877851,-15.99,1
23:59,713641917.0,1531.847167877851,-7.99,7
23:59,713641917.0,1512.857167877851,-18.99,6
23:59,517934629.0,727.6376787084264,-15.99,1
23:59,517934629.0,719.6476787084264,-7.99,1
23:59,517934629.0,700.6576787084264,-18.99,6
23:59,316793091.0,1083.124260054951,-18.99,6
23:59,316793091.0,1067.134260054951,-15.99,1
23:59,316793091.0,1059.144260054951,-7.99,7
23:59,943829984.0,-179.37049088654294,-18.99,6
23:59,943829984.0,-279.37049088654294,-100.0,6
23:59,943829984.0,-295.36049088654295,-15.99,1
23:59,494789005.0,3729.8717968503097,-14.99,1
23:59,494789005.0,3723.88179685031,-5.99,1
23:59,494789005.0,3704.89179685031,-18.99,6
23:59,494789005.0,3688.9017968503103,-15.99,1
23:59,322720763.0,7051.4975306496735,-7.99,1
23:59,970298834.0,3070.8086224476033,-15.99,1
23:59,970298834.0,3051.8186224476035,-18.99,6
23:59,816685391.0,-566.6892037084264,-18.99,6
23:59,816685391.0,-574.6792037084264,-7.99,1
23:59,816685391.0,-589.6692037084264,-14.99,1
23:59,816685391.0,-602.6592037084264,-12.99,1
23:59,370521542.0,28542.653017220506,-7.99,1
23:59,370521542.0,28526.663017220504,-15.99,1
23:59,370521542.0,28507.673017220503,-18.99,6
23:59,108481285.0,10068.366506313523,-7.99,1
23:59,108481285.0,10060.376506313523,-7.99,7
23:59,108481285.0,10041.386506313524,-18.99,6
23:59,297823329.0,1071.1864499999992,-7.99,1
23:59,297823329.0,1055.1964499999992,-15.99,1
23:59,297823329.0,1049.2064499999992,-5.99,1
23:59,297823329.0,1042.2064499999992,-7.0,1
23:59,297823329.0,1029.2164499999992,-12.99,1
23:59,297823329.0,1010.2264499999992,-18.99,6
23:59,535273662.0,114.02739999999947,-18.99,6
23:59,535273662.0,98.03739999999948,-15.99,1
23:59,535273662.0,90.04739999999948,-7.99,7
23:59,535273662.0,75.05739999999949,-14.99,1
23:59,535273662.0,60.06739999999949,-14.99,1
23:59,874506295.0,-1281.361756245572,-18.99,6
23:59,874506295.0,-1297.351756245572,-15.99,1
23:59,874506295.0,-1303.341756245572,-5.99,1
23:59,874506295.0,-1310.341756245572,-7.0,1
23:59,874506295.0,-1410.341756245572,-100.0,6
23:59,673818591.0,1845.0421753758408,-15.99,1
23:59,673818591.0,1832.0521753758408,-12.99,1
23:59,673818591.0,1826.0621753758408,-5.99,1
23:59,673818591.0,1820.0721753758407,-5.99,1
23:59,235663459.0,575.1339298120151,-15.99,1
23:59,235663459.0,568.1339298120151,-7.0,1
23:59,235663459.0,561.1339298120151,-7.0,1
23:59,834383043.0,5821.716095132721,-18.99,6
23:59,834383043.0,5805.726095132722,-15.99,1
23:59,834383043.0,5792.736095132722,-12.99,1
23:59,834383043.0,5777.746095132722,-14.99,1
23:59,834383043.0,5764.756095132722,-12.99,1
23:59,834383043.0,5664.756095132722,-100.0,6
23:59,795847804.0,25031.64583544917,-15.99,1
23:59,795847804.0,25016.655835449168,-14.99,1
23:59,795847804.0,25001.665835449166,-14.99,1
23:59,795847804.0,24995.675835449165,-5.99,1
23:59,795847804.0,24980.685835449163,-14.99,1
23:59,795847804.0,24961.69583544916,-18.99,6
23:59,555393405.0,-627.4305000000002,-18.99,6
23:59,555393405.0,-635.4205000000002,-7.99,1
23:59,555393405.0,-651.4105000000002,-15.99,1
23:59,555393405.0,-664.4005000000002,-12.99,1
23:59,555393405.0,-677.3905000000002,-12.99,1
23:59,555393405.0,-684.3905000000002,-7.0,1
23:59,555393405.0,-699.3805000000002,-14.99,1
23:59,555393405.0,-799.3805000000002,-100.0,6
23:59,625281433.0,-407.5714573707569,-15.99,1
23:59,625281433.0,-415.5614573707569,-7.99,1
23:59,625281433.0,-434.5514573707569,-18.99,6
23:59,625281433.0,-447.5414573707569,-12.99,1
23:59,625281433.0,-547.5414573707569,-100.0,6
23:59,872874909.0,-2131.751897899587,-7.99,1
23:59,837876918.0,-2187.6452914654205,-7.99,1
23:59,837876918.0,-2195.6352914654203,-7.99,7
23:59,546296727.0,215.4977273026185,-7.99,7
23:59,546296727.0,207.5077273026185,-7.99,1
23:59,546296727.0,188.51772730261848,-18.99,6
23:59,546296727.0,173.52772730261847,-14.99,1
23:59,546296727.0,158.53772730261846,-14.99,1
23:59,546296727.0,58.537727302618464,-100.0,6
23:59,793781222.0,2243.7488789474046,-18.99,6
23:59,793781222.0,2235.758878947405,-7.99,1
23:59,793781222.0,2227.768878947405,-7.99,7
23:59,793781222.0,2127.768878947405,-100.0,6
23:59,793781222.0,2120.768878947405,-7.0,1
23:59,793781222.0,2107.7788789474052,-12.99,1
23:59,793781222.0,2094.7888789474055,-12.99,1
23:59,793781222.0,2088.7988789474057,-5.99,1
23:59,143606916.0,611.1574540291897,-18.99,6
23:59,405945930.0,6002.346275568805,-18.99,6
23:59,405945930.0,5986.356275568805,-15.99,1
23:59,405945930.0,5978.366275568806,-7.99,7
23:59,311467864.0,-585.667650000001,-5.99,1
23:59,311467864.0,-598.657650000001,-12.99,1
23:59,311467864.0,-613.647650000001,-14.99,1
23:59,311467864.0,-619.637650000001,-5.99,1
23:59,311467864.0,-635.627650000001,-15.99,1
23:59,344219145.0,9059.448330975842,-15.99,1
23:59,474951915.0,-2578.2160952340114,-18.99,6
23:59,474951915.0,-2584.206095234011,-5.99,1
23:59,474951915.0,-2599.196095234011,-14.99,1
23:59,519935524.0,1433.107349737519,-18.99,6
23:59,519935524.0,1426.107349737519,-7.0,1
23:59,413557825.0,643.0723499999995,-100.0,6
23:59,183186021.0,-1205.7875499999989,-15.99,1
23:59,183186021.0,-1224.7775499999989,-18.99,6
23:59,198051483.0,-864.346910408857,-12.99,1
23:59,198051483.0,-879.336910408857,-14.99,1
23:59,198051483.0,-895.326910408857,-15.99,1
23:59,418717120.0,-2002.5606465372296,-100.0,6
23:59,418717120.0,-2010.5506465372296,-7.99,1
23:59,992204045.0,8142.342773209304,-15.99,1
23:59,992204045.0,8136.352773209304,-5.99,1
23:59,992204045.0,8117.362773209305,-18.99,6
23:59,992204045.0,8017.362773209305,-100.0,6
23:59,912584712.0,1485.868619544733,-7.0,1
23:59,912584712.0,1469.878619544733,-15.99,1
23:59,727417797.0,6328.478049492958,-7.99,1
23:59,727417797.0,6320.488049492958,-7.99,7
23:59,727417797.0,6314.498049492959,-5.99,1
23:59,727417797.0,6308.508049492959,-5.99,1
23:59,727417797.0,6289.518049492959,-18.99,6
23:59,854513972.0,2206.89555,-15.99,1
23:59,854513972.0,2187.9055500000004,-18.99,6
23:59,478986718.0,-793.2231000000011,-7.99,7
23:59,478986718.0,-812.2131000000011,-18.99,6
23:59,478986718.0,-912.2131000000012,-100.0,6
23:59,779946617.0,17745.028843893386,-15.99,1
23:59,779946617.0,17737.038843893384,-7.99,7
23:59,779946617.0,17718.048843893383,-18.99,6
23:59,779946617.0,17705.05884389338,-12.99,1
23:59,779946617.0,17690.06884389338,-14.99,1
23:59,779946617.0,17683.06884389338,-7.0,1
23:59,660561861.0,796.28478743765,-15.99,1
23:59,660561861.0,781.29478743765,-14.99,1
23:59,660561861.0,762.30478743765,-18.99,6
23:59,879091637.0,612.737523737977,-18.99,6
23:59,879091637.0,596.747523737977,-15.99,1
23:59,452974357.0,-3560.7789499999944,-15.99,1
23:59,452974357.0,-3579.768949999994,-18.99,6
23:59,452974357.0,-3594.758949999994,-14.99,1
23:59,452974357.0,-3694.758949999994,-100.0,6
23:59,336557504.0,2114.29648720102,-15.99,1
23:59,141521177.0,8493.723900000015,-18.99,6
23:59,990894155.0,-284.31959132115844,-15.99,1
23:59,990894155.0,-292.30959132115845,-7.99,1
23:59,990894155.0,-311.29959132115846,-18.99,6
23:59,128030172.0,-461.0529274498499,-7.99,7
23:59,128030172.0,-477.0429274498499,-15.99,1
23:59,781554833.0,1587.5332255639669,-18.99,6
23:59,781554833.0,1574.5432255639666,-12.99,1
23:59,781554833.0,1559.5532255639666,-14.99,1
23:59,781554833.0,1552.5532255639666,-7.0,1
23:59,781554833.0,1539.5632255639666,-12.99,1
23:59,781554833.0,1523.5732255639666,-15.99,1
23:59,555804115.0,-1079.0735475587037,-12.99,1
23:59,555804115.0,-1086.0735475587037,-7.0,1
23:59,555804115.0,-1093.0735475587037,-7.0,1
23:59,555804115.0,-1112.0635475587037,-18.99,6
23:59,987656636.0,4847.8926556906035,-15.99,1
23:59,987656636.0,4839.902655690604,-7.99,1
23:59,987656636.0,4820.912655690604,-18.99,6
23:59,987656636.0,4807.922655690604,-12.99,1
23:59,460463595.0,-207.2129454185789,-5.99,1
23:59,460463595.0,-214.2129454185789,-7.0,1
23:59,460463595.0,-221.2129454185789,-7.0,1
23:59,853907490.0,8410.438084602149,-100.0,6
23:59,853907490.0,8394.448084602149,-15.99,1
23:59,969804197.0,-427.2312500000007,-15.99,1
23:59,969804197.0,-435.22125000000074,-7.99,7
23:59,969804197.0,-454.21125000000075,-18.99,6
23:59,969804197.0,-469.2012500000007,-14.99,1
23:59,969804197.0,-482.1912500000008,-12.99,1
23:59,134847904.0,5578.902044386296,-15.99,1
23:59,134847904.0,5570.912044386297,-7.99,7
23:59,134847904.0,5551.922044386297,-18.99,6
23:59,134847904.0,5451.922044386297,-100.0,6
23:59,264550521.0,11389.393918170084,-15.99,1
23:59,264550521.0,11381.403918170085,-7.99,7
23:59,264550521.0,11366.413918170085,-14.99,1
23:59,256002321.0,7538.920712079818,-14.99,1
23:59,256002321.0,7531.920712079818,-7.0,1
23:59,256002321.0,7512.930712079819,-18.99,6
23:59,554792076.0,29986.63141729656,-14.99,1
23:59,554792076.0,29973.641417296556,-12.99,1
23:59,554792076.0,29960.65141729655,-12.99,1
23:59,554792076.0,29954.661417296553,-5.99,1
23:59,554792076.0,29938.67141729655,-15.99,1
23:59,691789577.0,-709.5044,-18.99,6
23:59,918160369.0,-897.2936500000004,-7.99,7
23:59,918160369.0,-916.2836500000004,-18.99,6
23:59,711140907.0,1236.4584999999993,-14.99,1
23:59,711140907.0,1221.4684999999993,-14.99,1
23:59,711140907.0,1215.4784999999993,-5.99,1
23:59,711140907.0,1202.4884999999992,-12.99,1
23:59,711140907.0,1186.4984999999992,-15.99,1
23:59,711140907.0,1167.5084999999992,-18.99,6
23:59,454356905.0,2319.542006748232,-7.99,1
23:59,406772240.0,-1275.9710500000003,-18.99,6
23:59,406772240.0,-1283.9610500000003,-7.99,1
23:59,406772240.0,-1299.9510500000004,-15.99,1
23:59,406772240.0,-1305.9410500000004,-5.99,1
23:59,867679563.0,207.25905370171583,-15.99,1
23:59,867679563.0,199.26905370171585,-7.99,1
23:59,867679563.0,180.27905370171584,-18.99,6
23:59,183546640.0,215.76069734773387,-18.99,6
23:59,183546640.0,208.76069734773387,-7.0,1
23:59,183546640.0,179.78069734773385,-15.99,1
23:59,183546640.0,171.79069734773384,-7.99,7
23:59,480198977.0,13113.819720897707,-12.99,1
23:59,480198977.0,13098.829720897707,-14.99,1
23:59,480198977.0,13091.829720897707,-7.0,1
23:59,480198977.0,13076.839720897708,-14.99,1
23:59,480198977.0,13060.849720897708,-15.99,1
23:59,480198977.0,13041.859720897708,-18.99,6
23:59,712474734.0,-1910.461831236004,-7.99,1
23:59,712474734.0,-1929.451831236004,-18.99,6
23:59,849096144.0,2322.3400207513423,-7.99,1
23:59,849096144.0,2306.3500207513425,-15.99,1
23:59,849096144.0,2287.3600207513427,-18.99,6
23:59,849096144.0,2274.370020751343,-12.99,1
23:59,849096144.0,2259.380020751343,-14.99,1
23:59,849096144.0,2159.380020751343,-100.0,6
23:59,737547541.0,708.9145995677743,-18.99,6
23:59,143061865.0,7913.247470227929,-15.99,1
23:59,143061865.0,7905.257470227929,-7.99,1
23:59,143061865.0,7890.267470227929,-14.99,1
23:59,143061865.0,7884.277470227929,-5.99,1
23:59,143061865.0,7865.28747022793,-18.99,6
23:59,534325901.0,7729.876597027031,-18.99,6
23:59,534325901.0,7721.886597027031,-7.99,1
23:59,534325901.0,7708.896597027031,-12.99,1
23:59,534325901.0,7702.906597027031,-5.99,1
23:59,534325901.0,7695.906597027031,-7.0,1
23:59,534325901.0,7680.916597027032,-14.99,1
23:59,534325901.0,7580.916597027032,-100.0,6
23:59,596328017.0,-2319.0453499999985,-7.99,7
23:59,596328017.0,-2326.0453499999985,-7.0,1
23:59,596328017.0,-2333.0453499999985,-7.0,1
23:59,596328017.0,-2339.0353499999983,-5.99,1
23:59,596328017.0,-2345.025349999998,-5.99,1
23:59,596328017.0,-2364.015349999998,-18.99,6
23:59,596328017.0,-2464.015349999998,-100.0,6
23:59,822250278.0,7334.716656585268,-15.99,1
23:59,822250278.0,7326.726656585268,-7.99,1
23:59,796709231.0,40.13197789629749,-5.99,1
23:59,796709231.0,34.14197789629749,-5.99,1
23:59,796709231.0,19.15197789629749,-14.99,1
23:59,796709231.0,4.161977896297488,-14.99,1
23:59,796709231.0,-3.828022103702512,-7.99,1
23:59,796709231.0,-22.81802210370251,-18.99,6
23:59,842682241.0,6517.585867997249,-15.99,1
23:59,842682241.0,6509.595867997249,-7.99,7
23:59,842682241.0,6503.605867997249,-5.99,1
23:59,444371478.0,731.7379999999987,-15.99,1
23:59,444371478.0,712.7479999999987,-18.99,6
23:59,949032480.0,5251.47685353582,-12.99,1
23:59,949032480.0,5232.48685353582,-18.99,6
23:59,949032480.0,5216.49685353582,-15.99,1
23:59,270374623.0,11399.961823069165,-7.99,1
23:59,270374623.0,11392.961823069165,-7.0,1
23:59,270374623.0,11292.961823069165,-100.0,6
23:59,270374623.0,11273.971823069163,-18.99,6
23:59,285873880.0,13176.87707204068,-7.99,1
23:59,285873880.0,13169.87707204068,-7.0,1
23:59,285873880.0,13162.87707204068,-7.0,1
23:59,285873880.0,13149.88707204068,-12.99,1
23:59,285873880.0,13143.89707204068,-5.99,1
23:59,736340277.0,9679.563340984612,-15.99,1
23:59,736340277.0,9673.573340984613,-5.99,1
23:59,736340277.0,9667.583340984613,-5.99,1
23:59,120634201.0,5680.1853294033035,-15.99,1
23:59,120634201.0,5673.1853294033035,-7.0,1
23:59,564214408.0,15.975084725726004,-18.99,6
23:59,564214408.0,7.985084725726003,-7.99,7
23:59,564214408.0,1.9950847257260025,-5.99,1
23:59,564214408.0,-3.994915274273998,-5.99,1
23:59,564214408.0,-10.994915274273998,-7.0,1
23:59,179173981.0,5792.035177605412,-15.99,1
23:59,179173981.0,5784.045177605412,-7.99,7
23:59,179173981.0,5765.055177605413,-18.99,6
23:59,179173981.0,5665.055177605413,-100.0,6
23:59,499410772.0,-2767.006862905162,-12.99,1
23:59,499410772.0,-2774.006862905162,-7.0,1
23:59,499410772.0,-2786.996862905162,-12.99,1
23:59,499410772.0,-2886.996862905162,-100.0,6
23:59,493640090.0,-2619.6884499999987,-15.99,1
23:59,493640090.0,-2627.6784499999985,-7.99,7
23:59,493640090.0,-2727.6784499999985,-100.0,6
23:59,892354433.0,-645.6899606343386,-15.99,1
23:59,892354433.0,-653.6799606343386,-7.99,7
23:59,892354433.0,-660.6799606343386,-7.0,1
23:59,892354433.0,-666.6699606343386,-5.99,1
23:59,892354433.0,-687.6499606343386,-5.99,1
23:59,294474095.0,-2386.508786499239,-5.99,1
23:59,294474095.0,-2399.4987864992386,-12.99,1
23:59,294474095.0,-2406.4987864992386,-7.0,1
23:59,294474095.0,-2421.4887864992384,-14.99,1
23:59,294474095.0,-2437.478786499238,-15.99,1
23:59,294474095.0,-2456.468786499238,-18.99,6
23:59,506618547.0,18908.60783174211,-7.99,1
23:59,506618547.0,18900.617831742107,-7.99,7
23:59,506618547.0,18881.627831742106,-18.99,6
23:59,506618547.0,18781.627831742106,-100.0,6
23:59,217540156.0,-3440.8223199999943,-15.99,1
23:59,217540156.0,-3540.8223199999943,-100.0,6
23:59,217540156.0,-3555.812319999994,-14.99,1
23:59,217540156.0,-3568.802319999994,-12.99,1
23:59,217540156.0,-3574.7923199999937,-5.99,1
23:59,217540156.0,-3593.7823199999934,-18.99,6
23:59,750898750.0,-458.0994653199005,-7.99,1
23:59,750898750.0,-466.0894653199005,-7.99,7
23:59,750898750.0,-485.0794653199005,-18.99,6
23:59,750898750.0,-498.0694653199006,-12.99,1
23:59,750898750.0,-513.0594653199005,-14.99,1
23:59,750898750.0,-519.0494653199005,-5.99,1
23:59,405416860.0,2717.0233568809035,-5.99,1
23:59,405416860.0,2711.0333568809037,-5.99,1
23:59,405416860.0,2698.043356880904,-12.99,1
23:59,405416860.0,2685.053356880904,-12.99,1
23:59,405416860.0,2666.0633568809044,-18.99,6
23:59,405416860.0,2650.0733568809046,-15.99,1
23:59,564744955.0,173.3902585888419,-100.0,6
23:59,564744955.0,157.4002585888419,-15.99,1
23:59,564744955.0,149.41025858884188,-7.99,7
23:59,173317688.0,-2311.528734884285,-15.99,1
23:59,173317688.0,-2319.5187348842846,-7.99,7
23:59,173317688.0,-2325.5087348842844,-5.99,1
23:59,173317688.0,-2332.5087348842844,-7.0,1
23:59,173317688.0,-2338.498734884284,-5.99,1
23:59,173317688.0,-2353.488734884284,-14.99,1
23:59,198946608.0,4891.516620078678,-18.99,6
23:59,220183538.0,949.7639999999994,-15.99,1
23:59,220183538.0,941.7739999999994,-7.99,1
23:59,386277162.0,439.2799999999995,-15.99,1
23:59,386277162.0,432.2799999999995,-7.0,1
23:59,386277162.0,419.2899999999995,-12.99,1
23:59,386277162.0,406.2999999999995,-12.99,1
23:59,386277162.0,387.3099999999995,-18.99,6
23:59,216285378.0,25470.57738463491,-7.99,7
23:59,216285378.0,25455.58738463491,-14.99,1
23:59,216285378.0,25436.597384634908,-18.99,6
23:59,639420537.0,-1342.15395,-18.99,6
23:59,639420537.0,-1350.14395,-7.99,7
23:59,639420537.0,-1358.13395,-7.99,1
23:59,639420537.0,-1364.12395,-5.99,1
23:59,639420537.0,-1379.11395,-14.99,1
23:59,639420537.0,-1394.10395,-14.99,1
23:59,420109571.0,663.6938107166795,-15.99,1
23:59,420109571.0,655.7038107166795,-7.99,7
23:59,420109571.0,649.7138107166795,-5.99,1
23:59,420109571.0,630.7238107166795,-18.99,6
23:59,168414279.0,248.30728427492136,-18.99,6
23:59,168414279.0,240.31728427492135,-7.99,1
23:59,168414279.0,225.32728427492137,-14.99,1
23:59,168414279.0,219.33728427492133,-5.99,1
23:59,168414279.0,212.33728427492133,-7.0,1
23:59,280130290.0,227.02024999999952,-15.99,1
23:59,280130290.0,219.0302499999995,-7.99,7
23:59,280130290.0,200.0402499999995,-18.99,6
23:59,419084831.0,-99.38727552610317,-7.0,1
23:59,419084831.0,-105.37727552610316,-5.99,1
23:59,419084831.0,-113.36727552610316,-7.99,1
23:59,419084831.0,-132.35727552610317,-18.99,6
23:59,713910252.0,501.8161257285413,-5.99,1
23:59,713910252.0,486.8261257285412,-14.99,1
23:59,713910252.0,479.8261257285412,-7.0,1
23:59,713910252.0,472.8261257285412,-7.0,1
23:59,713910252.0,456.8361257285412,-15.99,1
23:59,713910252.0,448.8461257285412,-7.99,1
23:59,322221939.0,4816.791128507889,-15.99,1
23:59,322221939.0,4808.801128507889,-7.99,7
23:59,322221939.0,4802.811128507889,-5.99,1
23:59,322221939.0,4789.82112850789,-12.99,1
23:59,322221939.0,4770.83112850789,-18.99,6
23:59,176922958.0,1684.7055471976498,-18.99,6
23:59,176922958.0,1668.7155471976498,-15.99,1
23:59,176922958.0,1660.7255471976498,-7.99,7
23:59,256045540.0,-3611.038899999999,-18.99,6
23:59,454129843.0,739.4630951665602,-14.99,1
23:59,454129843.0,713.4730951665601,-18.99,6
23:59,454129843.0,705.4830951665601,-7.99,7
23:59,308897841.0,1492.1647999999989,-15.99,1
23:59,391559884.0,341.1751999999994,-18.99,6
23:59,391559884.0,325.1851999999994,-15.99,1
23:59,546760202.0,-1913.330527675968,-18.99,6
23:59,546760202.0,-1929.320527675968,-15.99,1
23:59,152616936.0,1279.6970078630648,-7.99,1
23:59,152616936.0,1263.7070078630647,-15.99,1
23:59,152616936.0,1163.7070078630647,-100.0,6
23:59,706301742.0,-2974.6231499999976,-5.99,1
23:59,706301742.0,-2989.6131499999974,-14.99,1
23:59,706301742.0,-2996.6131499999974,-7.0,1
23:59,706301742.0,-3009.603149999997,-12.99,1
23:59,706301742.0,-3025.593149999997,-15.99,1
23:59,706301742.0,-3033.5831499999967,-7.99,1
23:59,706301742.0,-3052.5731499999965,-18.99,6
23:59,706301742.0,-3152.5731499999965,-100.0,6
23:59,895331556.0,-146.55900000000088,-100.0,6
23:59,895331556.0,-162.5490000000009,-15.99,1
23:59,895331556.0,-169.5490000000009,-7.0,1
23:59,895331556.0,-176.5490000000009,-7.0,1
23:59,895331556.0,-189.5390000000009,-12.99,1
23:59,895331556.0,-208.5290000000009,-18.99,6
23:59,134461671.0,6815.45773257015,-7.99,7
23:59,134461671.0,6796.4677325701505,-18.99,6
23:59,134461671.0,6783.477732570151,-12.99,1
23:59,134461671.0,6777.487732570151,-5.99,1
23:59,134461671.0,6764.497732570151,-12.99,1
23:59,134461671.0,6664.497732570151,-100.0,6
23:59,688712152.0,7302.892017176151,-15.99,1
23:59,688712152.0,7294.902017176151,-7.99,1
23:59,688712152.0,7275.912017176152,-18.99,6
23:59,688712152.0,7260.922017176152,-14.99,1
23:59,843537309.0,-633.0297177916318,-14.99,1
23:59,843537309.0,-639.0197177916318,-5.99,1
23:59,843537309.0,-654.0097177916318,-14.99,1
23:59,843537309.0,-668.9997177916318,-14.99,1
23:59,843537309.0,-684.9897177916318,-15.99,1
23:59,843537309.0,-703.9797177916319,-18.99,6
23:59,913127700.0,2035.2588380111165,-18.99,6
23:59,913127700.0,2019.2688380111165,-15.99,1
23:59,913127700.0,2011.278838011116,-7.99,7
23:59,514362267.0,771.1498191070602,-7.99,1
23:59,514362267.0,755.1598191070602,-15.99,1
23:59,419550103.0,19685.47787505978,-15.99,1
23:59,419550103.0,19677.487875059775,-7.99,1
23:59,419550103.0,19664.497875059777,-12.99,1
23:59,893134725.0,1321.0238376616678,-18.99,6
23:59,893134725.0,1305.0338376616678,-15.99,1
23:59,893134725.0,1292.0438376616678,-12.99,1
23:59,255814263.0,4143.450731550491,-7.99,7
23:59,655368335.0,5252.90216486482,-18.99,6
23:59,655368335.0,5244.912164864821,-7.99,1
23:59,655368335.0,5237.912164864821,-7.0,1
23:59,655368335.0,5230.912164864821,-7.0,1
23:59,753525749.0,-2337.790899999999,-5.99,1
23:59,821971408.0,1439.1871102355433,-15.99,1
23:59,821971408.0,1431.1971102355433,-7.99,1
23:59,821971408.0,1412.2071102355433,-18.99,6
23:59,730002588.0,14476.73276213962,-15.99,1
23:59,730002588.0,14457.74276213962,-18.99,6
23:59,552980092.0,-74.6812808806624,-15.99,1
23:59,552980092.0,-82.6712808806624,-7.99,7
23:59,552980092.0,-101.6612808806624,-18.99,6
23:59,552980092.0,-116.65128088066238,-14.99,1
23:59,358846516.0,1227.3022225272175,-5.99,1
23:59,358846516.0,1212.3122225272175,-14.99,1
23:59,358846516.0,1199.3222225272175,-12.99,1
23:59,358846516.0,1193.3322225272177,-5.99,1
23:59,358846516.0,1177.3422225272177,-15.99,1
23:59,358846516.0,1158.3522225272177,-18.99,6
23:59,762700245.0,1144.1177000000023,-15.99,1
23:59,762700245.0,1138.1277000000025,-5.99,1
23:59,762700245.0,1119.1377000000025,-18.99,6
23:59,266777719.0,1806.9589337802397,-18.99,6
23:59,408057540.0,5362.73707280612,-18.99,6
23:59,408057540.0,5346.74707280612,-15.99,1
23:59,408057540.0,5246.74707280612,-100.0,6
23:59,408057540.0,5231.75707280612,-14.99,1
23:59,408057540.0,5224.75707280612,-7.0,1
23:59,408057540.0,5209.76707280612,-14.99,1
23:59,337184232.0,-1582.7690000000005,-100.0,6
23:59,337184232.0,-1601.7590000000005,-18.99,6
23:59,337184232.0,-1608.7590000000005,-7.0,1
23:59,337184232.0,-1621.7490000000005,-12.99,1
23:59,337184232.0,-1627.7390000000005,-5.99,1
23:59,337184232.0,-1642.7290000000005,-14.99,1
23:59,779376323.0,4268.423245819657,-15.99,1
23:59,779376323.0,4168.423245819657,-100.0,6
23:59,644751433.0,-1448.6831584655383,-15.99,1
23:59,644751433.0,-1456.6731584655383,-7.99,7
23:59,644751433.0,-1475.6631584655383,-18.99,6
23:59,644751433.0,-1482.6631584655383,-7.0,1
23:59,812012103.0,-789.8943000000004,-7.99,7
23:59,812012103.0,-796.8943000000004,-7.0,1
23:59,812012103.0,-811.8843000000004,-14.99,1
23:59,812012103.0,-817.8743000000004,-5.99,1
23:59,767447966.0,5794.5730655121115,-15.99,1
23:59,767447966.0,5786.583065512112,-7.99,1
23:59,767447966.0,5767.593065512112,-18.99,6
23:59,767447966.0,5667.593065512112,-100.0,6
23:59,600585971.0,475.99959999999953,-15.99,1
23:59,600585971.0,457.0095999999995,-18.99,6
23:59,600585971.0,357.0095999999995,-100.0,6
23:59,866941383.0,2760.496950000006,-15.99,1
23:59,866941383.0,2741.5069500000063,-18.99,6
23:59,866941383.0,2728.5169500000065,-5.99,1
23:59,866941383.0,2722.5269500000068,-5.99,1
23:59,224524792.0,-2239.025682430848,-18.99,6
23:59,224524792.0,-2255.015682430848,-15.99,1
23:59,989506909.0,-2536.8748707594373,-15.99,1
23:59,656389634.0,-3025.7193404219856,-7.99,1
23:59,656389634.0,-3044.7093404219854,-18.99,6
23:59,857997794.0,1544.6406651508871,-15.99,1
23:59,857997794.0,1536.650665150887,-7.99,7
23:59,857997794.0,1517.660665150887,-18.99,6
23:59,857997794.0,1511.670665150887,-5.99,1
23:59,857997794.0,1504.670665150887,-7.0,1
23:59,475117511.0,8927.45974675902,-100.0,6
23:59,475117511.0,8911.46974675902,-15.99,1
23:59,475117511.0,8904.46974675902,-7.0,1
23:59,475117511.0,8898.47974675902,-5.99,1
23:59,475117511.0,8883.48974675902,-14.99,1
23:59,475117511.0,8877.49974675902,-5.99,1
23:59,475117511.0,8858.50974675902,-18.99,6
23:59,625658193.0,-814.1986202437831,-7.99,1
23:59,625658193.0,-833.1886202437831,-18.99,6
23:59,625658193.0,-846.1786202437831,-12.99,1
23:59,625658193.0,-852.1686202437832,-5.99,1
23:59,625658193.0,-858.1586202437832,-5.99,1
23:59,444428189.0,2715.1342000000013,-15.99,1
23:59,444428189.0,2708.1342000000013,-7.0,1
23:59,444428189.0,2701.1342000000013,-7.0,1
23:59,444428189.0,2688.1442000000015,-12.99,1
23:59,444428189.0,2681.1442000000015,-7.0,1
23:59,444428189.0,2662.1542000000018,-18.99,6
23:59,595800644.0,-836.9806500000002,-18.99,6
23:59,595800644.0,-844.9706500000002,-7.99,1
23:59,595800644.0,-860.9606500000002,-15.99,1
23:59,771125520.0,1312.664799999999,-15.99,1
23:59,771125520.0,1297.674799999999,-14.99,1
23:59,771125520.0,1278.6847999999993,-18.99,6
23:59,771125520.0,1178.6847999999993,-100.0,6
23:59,339791565.0,-3592.018699999997,-15.99,1
23:59,339791565.0,-3598.0086999999967,-5.99,1
23:59,339791565.0,-3616.998699999997,-18.99,6
23:59,339791565.0,-3716.998699999997,-100.0,6
23:59,461990622.0,10364.141415786324,-15.99,1
23:59,461990622.0,10356.151415786324,-7.99,7
23:59,461990622.0,10350.161415786324,-5.99,1
23:59,461990622.0,10331.171415786324,-18.99,6
23:59,699997811.0,1046.516650000004,-15.99,1
23:59,699997811.0,1038.526650000004,-7.99,1
23:59,699997811.0,1019.536650000004,-18.99,6
23:59,856461967.0,148.56235352949255,-5.99,1
23:59,856461967.0,129.57235352949257,-18.99,6
23:59,856461967.0,113.58235352949256,-15.99,1
23:59,856461967.0,105.59235352949256,-7.99,7
23:59,223207876.0,835.8971000000003,-15.99,1
23:59,223207876.0,816.9071000000002,-18.99,6
23:59,223207876.0,716.9071000000002,-100.0,6
23:59,223207876.0,701.9171000000002,-14.99,1
23:59,223207876.0,694.9171000000002,-7.0,1
23:59,233981231.0,2750.410881960624,-18.99,6
23:59,233981231.0,2734.420881960624,-15.99,1
23:59,490868147.0,20.410779121301527,-18.99,6
23:59,490868147.0,7.420779121301527,-12.99,1
23:59,490868147.0,1.4307791213015264,-5.99,1
23:59,490868147.0,-11.559220878698474,-12.99,1
23:59,490868147.0,-27.54922087869847,-15.99,1
23:59,490868147.0,-35.53922087869847,-7.99,1
23:59,890567652.0,416.5556996796006,-7.99,1
23:59,656781737.0,-5414.929999999995,-18.99,6
23:59,656781737.0,-5430.919999999995,-15.99,1
23:59,656781737.0,-5438.909999999994,-7.99,7
23:59,956717493.0,1659.1793722249324,-18.99,6
23:59,956717493.0,1646.1893722249324,-12.99,1
23:59,956717493.0,1638.1993722249324,-7.99,1
23:59,956717493.0,1630.2093722249324,-7.99,7
23:59,956717493.0,1530.2093722249324,-100.0,6
23:59,315078351.0,8587.060053308263,-15.99,1
23:59,315078351.0,8568.070053308264,-18.99,6
23:59,272538745.0,17300.569900000028,-15.99,1
23:59,272538745.0,17281.579900000026,-18.99,6
23:59,272538745.0,17268.589900000024,-12.99,1
23:59,272538745.0,17261.589900000024,-7.0,1
23:59,272538745.0,17161.589900000024,-100.0,6
23:59,142791593.0,116.63864999999966,-18.99,6
23:59,142791593.0,100.64864999999966,-15.99,1
23:59,142791593.0,93.64864999999966,-7.0,1
23:59,142791593.0,78.65864999999967,-14.99,1
23:59,142791593.0,65.66864999999967,-12.99,1
23:59,142791593.0,58.66864999999967,-7.0,1
23:59,142791593.0,-41.33135000000033,-100.0,6
23:59,593378953.0,1738.269650000005,-7.99,1
23:59,593378953.0,1722.279650000005,-15.99,1
23:59,593378953.0,1709.289650000005,-12.99,1
23:59,593378953.0,1696.299650000005,-12.99,1
23:59,923322792.0,-253.63683175363764,-15.99,1
23:59,923322792.0,-261.62683175363765,-7.99,7
23:59,923322792.0,-280.61683175363765,-18.99,6
23:59,923322792.0,-293.60683175363766,-12.99,1
23:59,923322792.0,-306.5968317536377,-12.99,1
23:59,923322792.0,-312.5868317536377,-5.99,1
23:59,923322792.0,-412.5868317536377,-100.0,6
23:59,570575024.0,-927.1242000000008,-15.99,1
23:59,570575024.0,-935.1142000000008,-7.99,7
23:59,570575024.0,-954.1042000000008,-18.99,6
23:59,766812921.0,277.1394499999992,-15.99,1
23:59,766812921.0,258.1494499999992,-18.99,6
23:59,766812921.0,251.1494499999992,-7.0,1
23:59,766812921.0,238.1594499999992,-12.99,1
23:59,766812921.0,223.1694499999992,-14.99,1
23:59,766812921.0,210.1794499999992,-12.99,1
23:59,509627909.0,164.39464999999905,-18.99,6
23:59,509627909.0,148.40464999999904,-15.99,1
23:59,509627909.0,140.41464999999903,-7.99,7
23:59,509627909.0,125.42464999999903,-14.99,1
23:59,509627909.0,118.42464999999903,-7.0,1
23:59,509627909.0,112.43464999999904,-5.99,1
23:59,509627909.0,97.44464999999904,-14.99,1
23:59,553734946.0,416.09629999999834,-15.99,1
23:59,553734946.0,316.09629999999834,-100.0,6
23:59,553734946.0,303.1062999999983,-12.99,1
23:59,553734946.0,288.1162999999983,-14.99,1
23:59,553734946.0,275.1262999999983,-12.99,1
23:59,553734946.0,256.1362999999983,-18.99,6
23:59,331450202.0,8827.589804480114,-7.99,1
23:59,331450202.0,8812.599804480114,-14.99,1
23:59,331450202.0,8799.609804480115,-12.99,1
23:59,331450202.0,8793.619804480115,-5.99,1
23:59,331450202.0,8774.629804480115,-18.99,6
23:59,225210798.0,1246.8127737592083,-15.99,1
23:59,225210798.0,1238.8227737592083,-7.99,7
23:59,225210798.0,1219.8327737592083,-18.99,6
23:59,170637730.0,3157.665442363077,-15.99,1
23:59,170637730.0,3149.6754423630773,-7.99,1
23:59,336171116.0,-368.8975500000006,-7.0,1
23:59,298007503.0,2322.595103625634,-15.99,1
23:59,298007503.0,2303.605103625634,-18.99,6
23:59,993663752.0,535.3594424103965,-7.99,1
23:59,993663752.0,527.3694424103965,-7.99,7
23:59,126929801.0,1923.4721063404756,-15.99,1
23:59,126929801.0,1915.4821063404756,-7.99,1
23:59,126929801.0,1900.4921063404756,-14.99,1
23:59,126929801.0,1800.4921063404756,-100.0,6
23:59,126929801.0,1781.5021063404756,-18.99,6
23:59,558119802.0,35476.82765512669,-15.99,1
23:59,558119802.0,35468.83765512669,-7.99,7
23:59,558119802.0,35455.847655126694,-12.99,1
23:59,558119802.0,35449.857655126696,-5.99,1
23:59,558119802.0,35443.8676551267,-5.99,1
23:59,558119802.0,35430.8776551267,-12.99,1
23:59,200080192.0,10285.518465199804,-100.0,6
23:59,200080192.0,10269.528465199804,-15.99,1
23:59,200080192.0,10261.538465199805,-7.99,7
23:59,200080192.0,10242.548465199803,-18.99,6
23:59,263882093.0,-1057.1738000000005,-15.99,1
23:59,263882093.0,-1063.1638000000005,-5.99,1
23:59,263882093.0,-1078.1538000000005,-14.99,1
23:59,263882093.0,-1178.1538000000005,-100.0,6
23:59,263882093.0,-1197.1438000000005,-18.99,6
23:59,903953091.0,4723.757038995665,-7.99,1
23:59,903953091.0,4707.767038995666,-15.99,1
23:59,903953091.0,4688.777038995666,-18.99,6
23:59,903953091.0,4681.777038995666,-7.0,1
23:59,903953091.0,4675.787038995666,-5.99,1
23:59,903953091.0,4662.797038995666,-12.99,1
23:59,903953091.0,4562.797038995666,-100.0,6
23:59,844206657.0,98.50990514656976,-18.99,6
23:59,844206657.0,-1.49009485343025,-100.0,6
23:59,844206657.0,-9.48009485343025,-7.99,7
23:59,844206657.0,-25.47009485343025,-15.99,1
23:59,844206657.0,-31.46009485343025,-5.99,1
23:59,844206657.0,-38.46009485343025,-7.0,1
23:59,844206657.0,-45.46009485343025,-7.0,1
23:59,333054026.0,936.47989402319,-15.99,1
23:59,333054026.0,928.48989402319,-7.99,1
23:59,333054026.0,913.49989402319,-14.99,1
23:59,333054026.0,906.49989402319,-7.0,1
23:59,333054026.0,893.5098940231901,-12.99,1
23:59,333054026.0,874.5198940231901,-18.99,6
23:59,570323670.0,3740.013293496251,-15.99,1
23:59,570323670.0,3732.023293496251,-7.99,1
23:59,570323670.0,3713.033293496251,-18.99,6
23:59,517190750.0,2354.4585899154126,-100.0,6
23:59,517190750.0,2347.4585899154126,-7.0,1
23:59,517190750.0,2334.468589915413,-12.99,1
23:59,517190750.0,2321.478589915413,-12.99,1
23:59,517190750.0,2305.4885899154133,-15.99,1
23:59,826597014.0,-2433.016940602929,-100.0,6
23:59,826597014.0,-2440.016940602929,-7.0,1
23:59,826597014.0,-2455.0069406029284,-14.99,1
23:59,826597014.0,-2469.996940602928,-14.99,1
23:59,826597014.0,-2477.986940602928,-7.99,7
23:59,826597014.0,-2493.9769406029277,-15.99,1
23:59,826597014.0,-2512.9669406029275,-18.99,6
23:59,965038148.0,-115.49751436767222,-7.99,1
23:59,965038148.0,-134.48751436767222,-18.99,6
23:59,616924659.0,384.3845798230852,-7.99,1
23:59,616924659.0,376.3945798230852,-7.99,7
23:59,214339619.0,793.2453508683561,-7.99,7
23:59,214339619.0,787.2553508683561,-5.99,1
23:59,214339619.0,781.2653508683561,-5.99,1
23:59,403765849.0,-2431.960499999998,-7.0,1
23:59,403765849.0,-2437.9504999999976,-5.99,1
23:59,403765849.0,-2452.9404999999974,-14.99,1
23:59,403765849.0,-2468.930499999997,-15.99,1
23:59,403765849.0,-2476.920499999997,-7.99,1
23:59,403765849.0,-2495.910499999997,-18.99,6
23:59,385685918.0,442.4799408415522,-15.99,1
23:59,385685918.0,434.4899408415522,-7.99,7
23:59,385685918.0,415.4999408415522,-18.99,6
23:59,385685918.0,408.4999408415522,-7.0,1
23:59,385685918.0,393.5099408415522,-14.99,1
23:59,722971557.0,207.40972084307555,-15.99,1
23:59,722971557.0,199.4197208430755,-7.99,7
23:59,722971557.0,180.42972084307553,-18.99,6
23:59,492058070.0,-705.8540312595294,-18.99,6
23:59,492058070.0,-721.8440312595294,-15.99,1
23:59,492058070.0,-728.8440312595294,-7.0,1
23:59,492058070.0,-743.8340312595294,-14.99,1
23:59,414805878.0,14288.256788668612,-15.99,1
23:59,414805878.0,14280.266788668612,-7.99,1
23:59,414805878.0,14261.276788668612,-18.99,6
23:59,836655156.0,-3012.2939552191556,-18.99,6
23:59,836655156.0,-3018.2839552191554,-5.99,1
23:59,836655156.0,-3033.273955219155,-14.99,1
23:59,836655156.0,-3040.273955219155,-7.0,1
23:59,836655156.0,-3048.263955219155,-7.99,7
23:59,836655156.0,-3148.263955219155,-100.0,6
23:59,224112146.0,2119.548799999999,-15.99,1
23:59,224112146.0,2100.5587999999993,-18.99,6
23:59,224112146.0,2094.5687999999996,-5.99,1
23:59,224112146.0,2088.5788,-5.99,1
23:59,224112146.0,2081.5788,-7.0,1
23:59,592961759.0,-1633.8948000000005,-7.99,1
23:59,592961759.0,-1649.8848000000005,-15.99,1
23:59,914806976.0,1382.8032501854866,-15.99,1
23:59,914806976.0,1363.8132501854866,-18.99,6
23:59,914806976.0,1357.8232501854866,-5.99,1
23:59,914806976.0,1342.8332501854866,-14.99,1
23:59,914806976.0,1327.8432501854866,-14.99,1
23:59,914806976.0,1320.8432501854866,-7.0,1
23:59,914806976.0,1220.8432501854866,-100.0,6
23:59,121113546.0,315.7581560698697,-7.99,1
23:59,121113546.0,296.7681560698697,-18.99,6
23:59,780859359.0,-732.5100000000002,-18.99,6
23:59,780859359.0,-740.5000000000002,-7.99,7
23:59,780859359.0,-840.5000000000002,-100.0,6
23:59,929044080.0,-9.546108494371756,-7.99,1
23:59,929044080.0,-28.536108494371753,-18.99,6
23:59,929044080.0,-43.526108494371755,-14.99,1
23:59,929044080.0,-56.51610849437176,-12.99,1
23:59,741269136.0,2824.855950000001,-15.99,1
23:59,741269136.0,2816.8659500000012,-7.99,7
23:59,741269136.0,2797.8759500000015,-18.99,6
23:59,500843551.0,1418.8498999999997,-100.0,6
23:59,500843551.0,1402.8598999999997,-15.99,1
23:59,500843551.0,1396.8698999999997,-5.99,1
23:59,500843551.0,1390.8798999999997,-5.99,1
23:59,500843551.0,1383.8798999999997,-7.0,1
23:59,500843551.0,1364.8898999999997,-18.99,6
23:59,441274121.0,13345.39044065768,-100.0,6
23:59,441274121.0,13326.40044065768,-18.99,6
23:59,441274121.0,13310.41044065768,-15.99,1
23:59,441274121.0,13302.42044065768,-7.99,1
23:59,441274121.0,13295.42044065768,-7.0,1
23:59,441274121.0,13288.42044065768,-7.0,1
23:59,441274121.0,13273.43044065768,-14.99,1
23:59,441274121.0,13266.43044065768,-7.0,1
23:59,682194230.0,-2335.990849999999,-18.99,6
23:59,682194230.0,-2343.980849999999,-7.99,1
23:59,682194230.0,-2358.970849999999,-14.99,1
23:59,572384506.0,9149.16479961452,-15.99,1
23:59,572384506.0,9141.17479961452,-7.99,7
23:59,572384506.0,9122.18479961452,-18.99,6
23:59,572384506.0,9115.18479961452,-7.0,1
23:59,424927189.0,137.6208327441052,-15.99,1
23:59,424927189.0,129.6308327441052,-7.99,7
23:59,424927189.0,122.6308327441052,-7.0,1
23:59,149684419.0,1281.353299999998,-15.99,1
23:59,149684419.0,1266.363299999998,-14.99,1
23:59,149684419.0,1259.363299999998,-7.0,1
23:59,149684419.0,1252.363299999998,-7.0,1
23:59,430910686.0,914.2042000000004,-15.99,1
23:59,430910686.0,906.2142000000003,-7.99,7
23:59,414454079.0,1511.1078500000017,-18.99,6
23:59,414454079.0,1503.1178500000017,-7.99,7
23:59,417850087.0,18733.915418973014,-15.99,1
23:59,417850087.0,18714.925418973013,-18.99,6
23:59,417850087.0,18708.93541897301,-5.99,1
23:59,417850087.0,18695.94541897301,-12.99,1
23:59,370757362.0,1630.231589812676,-14.99,1
23:59,370757362.0,1624.241589812676,-5.99,1
23:59,370757362.0,1608.251589812676,-15.99,1
23:59,370757362.0,1589.261589812676,-18.99,6
23:59,551196328.0,4681.59841862956,-18.99,6
23:59,551196328.0,4673.60841862956,-7.99,7
23:59,551196328.0,4657.61841862956,-15.99,1
23:59,551196328.0,4650.61841862956,-7.0,1
23:59,551196328.0,4635.628418629561,-14.99,1
23:59,551196328.0,4622.638418629561,-12.99,1
23:59,551196328.0,4616.648418629561,-5.99,1
23:59,310620484.0,372.5711950921983,-14.99,1
23:59,310620484.0,356.5811950921983,-15.99,1
23:59,310620484.0,348.5911950921983,-7.99,1
23:59,310620484.0,329.6011950921983,-18.99,6
23:59,952921898.0,-370.90457770801873,-15.99,1
23:59,952921898.0,-376.89457770801874,-5.99,1
23:59,952921898.0,-389.8845777080187,-12.99,1
23:59,786141370.0,143.7947999999992,-15.99,1
23:59,786141370.0,135.8047999999992,-7.99,1
23:59,786141370.0,122.8147999999992,-12.99,1
23:59,786141370.0,116.8247999999992,-5.99,1
23:59,786141370.0,109.8247999999992,-7.0,1
23:59,786141370.0,90.83479999999922,-18.99,6
23:59,868033067.0,-2425.445786451082,-12.99,1
23:59,868033067.0,-2438.4357864510816,-12.99,1
23:59,868033067.0,-2454.4257864510814,-15.99,1
23:59,868033067.0,-2462.415786451081,-7.99,7
23:59,570410059.0,2472.5226467763105,-18.99,6
23:59,570410059.0,2459.5326467763107,-12.99,1
23:59,570410059.0,2446.542646776311,-12.99,1
23:59,570410059.0,2431.552646776311,-14.99,1
23:59,641376155.0,383.3425121014511,-15.99,1
23:59,641376155.0,364.3525121014511,-18.99,6
23:59,641376155.0,264.3525121014511,-100.0,6
23:59,299871610.0,-85.96184694123325,-18.99,6
23:59,299871610.0,-101.95184694123324,-15.99,1
23:59,299871610.0,-116.94184694123324,-14.99,1
23:59,299871610.0,-123.94184694123324,-7.0,1
23:59,299871610.0,-138.93184694123323,-14.99,1
23:59,299871610.0,-153.92184694123324,-14.99,1
23:59,679911053.0,3503.5954874448007,-18.99,6
23:59,679911053.0,3497.605487444801,-5.99,1
23:59,679911053.0,3481.615487444801,-15.99,1
23:59,679911053.0,3473.625487444802,-7.99,7
23:59,695607232.0,-108.59050538944004,-15.99,1
23:59,695607232.0,-116.58050538944003,-7.99,7
23:59,695607232.0,-122.57050538944004,-5.99,1
23:59,695607232.0,-129.57050538944003,-7.0,1
23:59,695607232.0,-136.57050538944003,-7.0,1
23:59,768271776.0,-320.3200967665796,-18.99,6
23:59,768271776.0,-336.3100967665796,-15.99,1
23:59,768271776.0,-344.3000967665796,-7.99,7
23:59,291128777.0,-2729.4664405263684,-12.99,1
23:59,291128777.0,-2748.456440526368,-18.99,6
23:59,227104649.0,4086.053034316177,-7.99,1
23:59,227104649.0,4071.0630343161774,-14.99,1
23:59,227104649.0,4064.0630343161774,-7.0,1
23:59,227104649.0,4045.0730343161777,-18.99,6
23:59,202320275.0,-571.4499000000005,-15.99,1
23:59,202320275.0,-579.4399000000005,-7.99,7
23:59,202320275.0,-594.4299000000005,-14.99,1
23:59,202320275.0,-601.4299000000005,-7.0,1
23:59,202320275.0,-620.4199000000006,-18.99,6
23:59,621181115.0,38.385750429228864,-18.99,6
23:59,621181115.0,22.395750429228865,-15.99,1
23:59,621181115.0,14.405750429228862,-7.99,7
23:59,162162212.0,980.494543327309,-15.99,1
23:59,162162212.0,972.504543327309,-7.99,7
23:59,162162212.0,953.514543327309,-18.99,6
23:59,162162212.0,938.524543327309,-14.99,1
23:59,626989363.0,1212.9310633173752,-18.99,6
23:59,626989363.0,1196.9410633173752,-15.99,1
23:59,626989363.0,1188.9510633173752,-7.99,7
23:59,626989363.0,1181.9510633173752,-7.0,1
23:59,626989363.0,1174.9510633173752,-7.0,1
23:59,626989363.0,1167.9510633173752,-7.0,1
23:59,786927378.0,-1499.3702796373163,-7.99,1
23:59,786927378.0,-1515.3602796373164,-15.99,1
23:59,786927378.0,-1534.3502796373164,-18.99,6
23:59,786927378.0,-1634.3502796373164,-100.0,6
23:59,124125096.0,511.5313943878021,-18.99,6
23:59,124125096.0,495.541394387802,-15.99,1
23:59,124125096.0,487.551394387802,-7.99,1
23:59,124125096.0,472.561394387802,-14.99,1
23:59,124125096.0,457.571394387802,-14.99,1
23:59,925037906.0,1794.8338000000017,-7.99,7
23:59,925037906.0,1778.8438000000017,-15.99,1
23:59,833499132.0,2871.5181500000017,-15.99,1
23:59,833499132.0,2863.528150000002,-7.99,7
23:59,833499132.0,2848.538150000002,-14.99,1
23:59,350921975.0,108.90132107387424,-12.99,1
23:59,350921975.0,95.91132107387423,-12.99,1
23:59,350921975.0,79.92132107387424,-15.99,1
23:59,350921975.0,60.93132107387424,-18.99,6
23:59,350921975.0,-39.06867892612576,-100.0,6
23:59,494977194.0,1321.8050705975782,-7.99,1
23:59,494977194.0,1313.815070597578,-7.99,7
23:59,494977194.0,1300.825070597578,-12.99,1
23:59,494977194.0,1293.825070597578,-7.0,1
23:59,494977194.0,1286.825070597578,-7.0,1
23:59,494977194.0,1267.835070597578,-18.99,6
23:59,541639148.0,4800.636273251512,-18.99,6
23:59,541639148.0,4787.646273251512,-12.99,1
23:59,541639148.0,4771.656273251512,-15.99,1
23:59,700138124.0,5886.485633830919,-18.99,6
23:59,700138124.0,5870.495633830919,-15.99,1
23:59,700138124.0,5862.50563383092,-7.99,7
23:59,941285623.0,1719.6563990667703,-12.99,1
23:59,941285623.0,1706.6663990667705,-12.99,1
23:59,941285623.0,1687.6763990667705,-18.99,6
23:59,941285623.0,1679.6863990667705,-7.99,1
23:59,941285623.0,1671.6963990667705,-7.99,7
23:59,373163757.0,11828.509273794212,-15.99,1
23:59,373163757.0,11820.519273794212,-7.99,1
23:59,218795010.0,-453.36505000000056,-7.99,7
23:59,218795010.0,-460.36505000000056,-7.0,1
23:59,218795010.0,-467.36505000000056,-7.0,1
23:59,534908754.0,-919.6355500000002,-18.99,6
23:59,534908754.0,-935.6255500000002,-15.99,1
23:59,347110339.0,-140.69679250314812,-5.99,1
23:59,347110339.0,-146.68679250314813,-5.99,1
23:59,347110339.0,-152.67679250314814,-5.99,1
23:59,347110339.0,-158.66679250314814,-5.99,1
23:59,347110339.0,-166.65679250314815,-7.99,1
23:59,347110339.0,-185.64679250314816,-18.99,6
23:59,722358036.0,765.127940627083,-18.99,6
23:59,722358036.0,749.137940627083,-15.99,1
23:59,722358036.0,741.147940627083,-7.99,7
23:59,245198540.0,490.69139880177954,-7.99,7
23:59,245198540.0,390.69139880177954,-100.0,6
23:59,834581602.0,833.9836499999992,-7.0,1
23:59,834581602.0,814.9936499999992,-18.99,6
23:59,834581602.0,799.0036499999992,-15.99,1
23:59,834581602.0,791.0136499999992,-7.99,1
23:59,834581602.0,691.0136499999992,-100.0,6
23:59,743630833.0,542.7093132847012,-15.99,1
23:59,743630833.0,523.7193132847012,-18.99,6
23:59,743630833.0,510.7293132847012,-12.99,1
23:59,743630833.0,503.7293132847012,-7.0,1
23:59,743630833.0,497.7393132847012,-5.99,1
23:59,310171581.0,-2188.1837043409196,-15.99,1
23:59,310171581.0,-2207.1737043409194,-18.99,6
23:59,547010927.0,25544.76955551212,-7.0,1
23:59,547010927.0,25529.77955551212,-14.99,1
23:59,547010927.0,25523.78955551212,-5.99,1
23:59,547010927.0,25516.78955551212,-7.0,1
23:59,547010927.0,25500.799555512116,-15.99,1
23:59,547010927.0,25492.80955551211,-7.99,7
23:59,547010927.0,25473.819555512113,-18.99,6
23:59,873693307.0,11286.52621457702,-18.99,6
23:59,902798190.0,-389.7936344310266,-15.99,1
23:59,836110591.0,7848.292629936911,-15.99,1
23:59,836110591.0,7748.292629936911,-100.0,6
23:59,738958551.0,10272.999826751862,-7.99,7
23:59,738958551.0,10265.999826751862,-7.0,1
23:59,738958551.0,10247.009826751862,-18.99,6
23:59,587225252.0,6639.492939936504,-18.99,6
23:59,655730067.0,-128.93955000000045,-18.99,6
23:59,655730067.0,-136.92955000000046,-7.99,1
23:59,655730067.0,-144.91955000000047,-7.99,7
23:59,610645022.0,-308.53116264491837,-15.99,1
23:59,610645022.0,-315.53116264491837,-7.0,1
23:59,610645022.0,-334.5211626449184,-18.99,6
23:59,234952520.0,465.4013999999988,-15.99,1
23:59,282837512.0,15277.18803676936,-7.99,1
23:59,282837512.0,15269.19803676936,-7.99,7
23:59,282837512.0,15250.208036769362,-18.99,6
23:59,282837512.0,15150.208036769362,-100.0,6
23:59,698955014.0,1433.5331802031967,-7.99,1
23:59,698955014.0,1414.5431802031967,-18.99,6
23:59,698955014.0,1401.5531802031967,-12.99,1
23:59,698955014.0,1388.563180203197,-12.99,1
23:59,698955014.0,1373.573180203197,-14.99,1
23:59,698955014.0,1366.573180203197,-7.0,1
23:59,955035930.0,2585.8534791714774,-15.99,1
23:59,955035930.0,2485.8534791714774,-100.0,6
23:59,214765415.0,-204.25604885013536,-7.99,1
23:59,214765415.0,-220.24604885013537,-15.99,1
23:59,399144202.0,2610.356751057389,-7.99,1
23:59,399144202.0,2591.366751057389,-18.99,6
23:59,399144202.0,2491.366751057389,-100.0,6
23:59,399144202.0,2476.37675105739,-14.99,1
23:59,399144202.0,2461.3867510573896,-14.99,1
23:59,455052690.0,252.49373994862765,-7.99,1
23:59,455052690.0,237.50373994862764,-14.99,1
23:59,455052690.0,215.51373994862763,-7.0,1
23:59,455052690.0,196.5237399486276,-18.99,6
23:59,189335192.0,-838.8090017578604,-18.99,6
23:59,189335192.0,-854.7990017578604,-15.99,1
23:59,189335192.0,-954.7990017578604,-100.0,6
23:59,189335192.0,-960.7890017578604,-5.99,1
23:59,189335192.0,-967.7890017578604,-7.0,1
23:59,189335192.0,-982.7790017578604,-14.99,1
23:59,376271050.0,1703.2728069057437,-7.99,1
23:59,684284526.0,-3152.846366745757,-15.99,1
23:59,684284526.0,-3160.836366745757,-7.99,1
23:59,684284526.0,-3166.826366745757,-5.99,1
23:59,684284526.0,-3181.816366745757,-14.99,1
23:59,684284526.0,-3200.8063667457563,-18.99,6
23:59,684284526.0,-3300.8063667457563,-100.0,6
23:59,829914501.0,1681.9728065709742,-15.99,1
23:59,979892433.0,-1291.399800000001,-18.99,6
23:59,967989787.0,-430.3120673592728,-100.0,6
23:59,147508204.0,-111.18528221811344,-15.99,1
23:59,147508204.0,-119.17528221811344,-7.99,1
23:59,820686957.0,-762.2723163111959,-18.99,6
23:59,820686957.0,-770.262316311196,-7.99,1
23:59,820686957.0,-778.252316311196,-7.99,7
23:59,191992682.0,-2747.291460292063,-15.99,1
23:59,191992682.0,-2766.281460292063,-18.99,6
23:59,858560423.0,13077.543909769358,-7.0,1
23:59,858560423.0,13070.543909769358,-7.0,1
23:59,858560423.0,13051.553909769358,-18.99,6
23:59,858560423.0,13035.563909769358,-15.99,1
23:59,858560423.0,12935.563909769358,-100.0,6
23:59,691843653.0,-3129.2458999999935,-15.99,1
23:59,691843653.0,-3137.2358999999933,-7.99,7
23:59,691843653.0,-3156.225899999993,-18.99,6
23:59,691843653.0,-3163.225899999993,-7.0,1
23:59,691843653.0,-3170.225899999993,-7.0,1
23:59,691843653.0,-3183.215899999993,-12.99,1
23:59,828532554.0,737.2268765071483,-12.99,1
23:59,828532554.0,731.2368765071483,-5.99,1
23:59,828532554.0,712.2468765071483,-18.99,6
23:59,828532554.0,696.2568765071483,-15.99,1
23:59,857455726.0,-284.98831412431576,-7.99,7
23:59,857455726.0,-292.9783141243158,-7.99,1
23:59,627917561.0,4361.195050000005,-14.99,1
23:59,627917561.0,4355.205050000005,-5.99,1
23:59,627917561.0,4342.215050000005,-12.99,1
23:59,627917561.0,4326.2250500000055,-15.99,1
23:59,627917561.0,4318.235050000006,-7.99,7
23:59,627917561.0,4299.245050000006,-18.99,6
23:59,851649498.0,11599.727052227274,-14.99,1
23:59,851649498.0,11586.737052227274,-12.99,1
23:59,851649498.0,11570.747052227274,-15.99,1
23:59,851649498.0,11562.757052227274,-7.99,7
23:59,851649498.0,11543.767052227277,-18.99,6
23:59,799453072.0,-101.5708500000012,-18.99,6
23:59,799453072.0,-117.56085000000118,-15.99,1
23:59,799453072.0,-217.5608500000012,-100.0,6
23:59,799453072.0,-230.5508500000012,-12.99,1
23:59,799453072.0,-237.5508500000012,-7.0,1
23:59,799453072.0,-252.5408500000012,-14.99,1
23:59,799453072.0,-267.5308500000012,-14.99,1
23:59,472995101.0,2739.350834242803,-15.99,1
23:59,472995101.0,2731.3608342428033,-7.99,1
23:59,472995101.0,2724.3608342428033,-7.0,1
23:59,472995101.0,2709.3708342428035,-14.99,1
23:59,913801979.0,503.9397799144938,-7.99,1
23:59,913801979.0,484.9497799144938,-18.99,6
23:59,913801979.0,384.9497799144938,-100.0,6
23:59,165045150.0,1219.0160614028557,-7.99,7
23:59,165045150.0,1204.0260614028557,-14.99,1
23:59,744398361.0,-292.01900000000035,-15.99,1
23:59,744398361.0,-300.00900000000036,-7.99,1
23:59,744398361.0,-318.99900000000036,-18.99,6
23:59,764450279.0,22500.31157061562,-15.99,1
23:59,764450279.0,22481.32157061562,-18.99,6
23:59,335698481.0,-2325.580496694939,-15.99,1
23:59,335698481.0,-2344.570496694939,-18.99,6
23:59,335698481.0,-2444.570496694939,-100.0,6
23:59,720221651.0,-2444.218866598434,-7.99,1
23:59,720221651.0,-2460.208866598434,-15.99,1
23:59,642924505.0,722.9546701835261,-5.99,1
23:59,642924505.0,707.9646701835261,-14.99,1
23:59,467207141.0,1090.5908670482638,-7.99,1
23:59,467207141.0,1071.6108670482638,-12.99,1
23:59,467207141.0,1058.6208670482638,-12.99,1
23:59,467207141.0,1052.6308670482638,-5.99,1
23:59,467207141.0,1033.6408670482638,-18.99,6
23:59,308505160.0,14335.279117773049,-14.99,1
23:59,308505160.0,14322.289117773047,-12.99,1
23:59,308505160.0,14307.299117773047,-14.99,1
23:59,308505160.0,14292.309117773048,-14.99,1
23:59,618138606.0,1828.389702870066,-15.99,1
23:59,618138606.0,1815.399702870066,-12.99,1
23:59,618138606.0,1796.409702870066,-18.99,6
23:59,618138606.0,1696.409702870066,-100.0,6
23:59,578131296.0,947.3877194440438,-7.0,1
23:59,578131296.0,932.3977194440438,-14.99,1
23:59,578131296.0,916.4077194440438,-15.99,1
23:59,578131296.0,908.4177194440438,-7.99,1
23:59,578131296.0,889.4277194440438,-18.99,6
23:59,240643705.0,1036.663617373981,-14.99,1
23:59,240643705.0,1029.663617373981,-7.0,1
23:59,240643705.0,1014.673617373981,-14.99,1
23:59,240643705.0,998.683617373981,-15.99,1
23:59,240643705.0,990.6936173739808,-7.99,7
23:59,240643705.0,971.7036173739808,-18.99,6
23:59,240643705.0,871.7036173739809,-100.0,6
23:59,613427466.0,7332.439455264375,-7.99,1
23:59,613427466.0,7316.449455264376,-15.99,1
23:59,613427466.0,7297.459455264376,-18.99,6
23:59,613427466.0,7290.459455264376,-7.0,1
23:59,613427466.0,7284.469455264376,-5.99,1
23:59,613427466.0,7278.479455264376,-5.99,1
23:59,993238248.0,-397.25748739288395,-15.99,1
23:59,993238248.0,-405.2474873928839,-7.99,1
23:59,993238248.0,-505.2474873928839,-100.0,6
23:59,257633312.0,-203.10165000000092,-15.99,1
23:59,257633312.0,-211.09165000000093,-7.99,1
23:59,257633312.0,-230.08165000000093,-18.99,6
23:59,257633312.0,-245.07165000000097,-14.99,1
23:59,257633312.0,-260.06165000000095,-14.99,1
23:59,257633312.0,-267.06165000000095,-7.0,1
23:59,257633312.0,-273.05165000000096,-5.99,1
23:59,366550080.0,28213.603800416076,-7.99,7
23:59,366550080.0,28197.613800416075,-15.99,1
23:59,361955473.0,260.1770452440844,-18.99,6
23:59,361955473.0,245.1870452440844,-14.99,1
23:59,361955473.0,232.1970452440844,-12.99,1
23:59,671824917.0,-865.6132000000003,-7.99,1
23:59,671824917.0,-884.6032000000004,-18.99,6
23:59,671824917.0,-984.6032000000004,-100.0,6
23:59,671824917.0,-997.5932000000004,-12.99,1
23:59,828750680.0,2251.28234521368,-7.99,1
23:59,828750680.0,2243.29234521368,-7.99,7
23:59,828750680.0,2224.3023452136804,-18.99,6
23:59,828750680.0,2124.3023452136804,-100.0,6
23:59,162370388.0,-2359.3728999999994,-15.99,1
23:59,162370388.0,-2367.362899999999,-7.99,7
23:59,162370388.0,-2386.352899999999,-18.99,6
23:59,203466392.0,4084.949014911599,-7.99,1
23:59,203466392.0,4077.949014911599,-7.0,1
23:59,812692024.0,4323.336706663929,-100.0,6
23:59,812692024.0,4307.34670666393,-15.99,1
23:59,812692024.0,4299.35670666393,-7.99,1
23:59,812692024.0,4280.36670666393,-18.99,6
23:59,812692024.0,4267.37670666393,-12.99,1
23:59,812692024.0,4261.38670666393,-5.99,1
23:59,581618317.0,-4933.544201873206,-7.99,1
23:59,581618317.0,-4941.534201873205,-7.99,7
23:59,581618317.0,-4956.524201873205,-14.99,1
23:59,581618317.0,-4962.514201873205,-5.99,1
23:59,581618317.0,-4981.504201873205,-18.99,6
23:59,581618317.0,-5081.504201873205,-100.0,6
23:59,252760664.0,7678.080289540872,-15.99,1
23:59,252760664.0,7670.090289540873,-7.99,7
23:59,252760664.0,7651.100289540873,-18.99,6
23:59,252760664.0,7644.100289540873,-7.0,1
23:59,252760664.0,7637.100289540873,-7.0,1
23:59,252760664.0,7537.100289540873,-100.0,6
23:59,349107386.0,-3494.735973194561,-14.99,1
23:59,349107386.0,-3510.725973194561,-15.99,1
23:59,349107386.0,-3518.715973194561,-7.99,1
23:59,317161035.0,-3657.952599999997,-15.99,1
23:59,317161035.0,-3676.942599999996,-18.99,6
23:59,621652856.0,1525.38996961054,-18.99,6
23:59,284905540.0,9143.98071628352,-100.0,6
23:59,284905540.0,9124.99071628352,-18.99,6
23:59,284905540.0,9109.00071628352,-15.99,1
23:59,284905540.0,9101.01071628352,-7.99,7
23:59,284161641.0,738.9923110405757,-15.99,1
23:59,284161641.0,720.0023110405757,-18.99,6
23:59,818552503.0,820.986999999999,-100.0,6
23:59,818552503.0,812.9969999999989,-7.99,1
23:59,818552503.0,805.0069999999989,-7.99,7
23:59,151916463.0,126.14255559916889,-18.99,6
23:59,151916463.0,119.14255559916889,-7.0,1
23:59,151916463.0,112.14255559916889,-7.0,1
23:59,435984758.0,4920.323095660437,-18.99,6
23:59,435984758.0,4914.333095660437,-5.99,1
23:59,435984758.0,4893.353095660437,-14.99,1
23:59,435984758.0,4885.3630956604375,-7.99,1
23:59,127809299.0,1168.0151394027737,-14.99,1
23:59,127809299.0,1155.0251394027734,-12.99,1
23:59,127809299.0,1148.0251394027734,-7.0,1
23:59,127809299.0,1132.0351394027734,-15.99,1
23:59,127809299.0,1113.0451394027734,-18.99,6
23:59,948558249.0,10149.653631737076,-18.99,6
23:59,948558249.0,10141.663631737076,-7.99,7
23:59,948558249.0,10125.673631737076,-15.99,1
23:59,948558249.0,10118.673631737076,-7.0,1
23:59,948558249.0,10111.673631737076,-7.0,1
23:59,194023154.0,-2531.807171784734,-15.99,1
23:59,194023154.0,-2539.7971717847336,-7.99,1
23:59,194023154.0,-2545.7871717847333,-5.99,1
23:59,194023154.0,-2551.777171784733,-5.99,1
23:59,194023154.0,-2558.777171784733,-7.0,1
23:59,919185264.0,4447.7676312396925,-18.99,6
23:59,919185264.0,4440.7676312396925,-7.0,1
23:59,919185264.0,4434.777631239693,-5.99,1
23:59,919185264.0,4418.787631239693,-15.99,1
23:59,919185264.0,4410.797631239693,-7.99,7
23:59,973388795.0,1067.5036761636215,-15.99,1
23:59,973388795.0,1059.5136761636215,-7.99,1
23:59,973388795.0,1040.5236761636215,-18.99,6
23:59,973388795.0,1025.5336761636215,-14.99,1
23:59,409370545.0,1166.1682755455208,-7.0,1
23:59,409370545.0,1160.1782755455208,-5.99,1
23:59,409370545.0,1145.1882755455208,-14.99,1
23:59,409370545.0,1138.1882755455208,-7.0,1
23:59,709608057.0,3419.2697336606852,-15.99,1
23:59,709608057.0,3411.2797336606855,-7.99,1
23:59,709608057.0,3405.2897336606857,-5.99,1
23:59,709608057.0,3399.299733660686,-5.99,1
23:59,709608057.0,3386.309733660686,-12.99,1
23:59,709608057.0,3367.3197336606863,-18.99,6
23:59,697140785.0,186.1226167361032,-15.99,1
23:59,697140785.0,178.1326167361032,-7.99,7
23:59,697140785.0,159.14261673610318,-18.99,6
23:59,697140785.0,59.14261673610318,-100.0,6
23:59,697140785.0,53.15261673610318,-5.99,1
23:59,697140785.0,46.15261673610318,-7.0,1
23:59,624500124.0,3925.7731023768074,-7.99,7
23:59,624500124.0,3912.783102376808,-12.99,1
23:59,624500124.0,3906.793102376808,-5.99,1
23:59,624500124.0,3887.803102376808,-18.99,6
23:59,815993333.0,6944.458337166158,-15.99,1
23:59,815993333.0,6925.468337166159,-18.99,6
23:59,815385232.0,11512.662019340862,-7.0,1
23:59,815385232.0,11506.672019340862,-5.99,1
23:59,815385232.0,11487.682019340862,-18.99,6
23:59,277562576.0,718.1950181051029,-14.99,1
23:59,277562576.0,699.2050181051029,-18.99,6
23:59,277562576.0,691.2150181051029,-7.99,1
23:59,277562576.0,683.2250181051029,-7.99,7
23:59,478651121.0,-210.9052704015303,-15.99,1
23:59,478651121.0,-218.8952704015303,-7.99,7
23:59,478651121.0,-237.8852704015303,-18.99,6
23:59,960208650.0,18758.47055244046,-7.0,1
23:59,960208650.0,18751.47055244046,-7.0,1
23:59,960208650.0,18735.48055244046,-15.99,1
23:59,960208650.0,18727.490552440457,-7.99,7
23:59,960208650.0,18708.500552440455,-18.99,6
23:59,718058208.0,2734.657411281471,-14.99,1
23:59,718058208.0,2728.6674112814712,-5.99,1
23:59,718058208.0,2722.677411281471,-5.99,1
23:59,718058208.0,2706.6874112814717,-15.99,1
23:59,718058208.0,2698.697411281472,-7.99,7
23:59,718058208.0,2679.707411281472,-18.99,6
23:59,534204159.0,6428.393624115159,-18.99,6
23:59,534204159.0,6420.403624115159,-7.99,7
23:59,788740658.0,3094.7203729050566,-14.99,1
23:59,788740658.0,3068.740372905057,-12.99,1
23:59,788740658.0,3055.7503729050572,-12.99,1
23:59,285220959.0,12654.998155841264,-15.99,1
23:59,285220959.0,12641.018155841264,-5.99,1
23:59,285220959.0,12626.028155841264,-14.99,1
23:59,285220959.0,12613.038155841265,-12.99,1
23:59,387957305.0,-2693.3311059800785,-15.99,1
23:59,387957305.0,-2701.3211059800783,-7.99,7
23:59,387957305.0,-2720.311105980078,-18.99,6
23:59,280098744.0,985.7703778716656,-100.0,6
23:59,971010829.0,569.6850564442452,-18.99,6
23:59,737645298.0,-2717.5391999999983,-15.99,1
23:59,737645298.0,-2732.529199999998,-14.99,1
23:59,737645298.0,-2832.529199999998,-100.0,6
23:59,737645298.0,-2851.519199999998,-18.99,6
23:59,655450953.0,-2853.94737845553,-15.99,1
23:59,655450953.0,-2872.937378455529,-18.99,6
23:59,858989281.0,28971.26100205841,-15.99,1
23:59,494156986.0,-219.6527543276652,-15.99,1
23:59,494156986.0,-227.6427543276652,-7.99,1
23:59,494156986.0,-327.6427543276652,-100.0,6
23:59,494156986.0,-340.6327543276652,-12.99,1
23:59,494156986.0,-353.62275432766523,-12.99,1
23:59,494156986.0,-366.6127543276653,-12.99,1
23:59,494156986.0,-385.60275432766525,-18.99,6
23:59,252964502.0,-805.5413724913005,-15.99,1
23:59,987229118.0,1949.7084611877249,-15.99,1
23:59,987229118.0,1930.7184611877249,-18.99,6
23:59,987229118.0,1917.7284611877249,-12.99,1
23:59,987229118.0,1911.7384611877249,-5.99,1
23:59,987229118.0,1898.7484611877248,-12.99,1
23:59,909669130.0,785.2178847367666,-15.99,1
23:59,909669130.0,777.2278847367666,-7.99,7
23:59,909669130.0,770.2278847367666,-7.0,1
23:59,961077907.0,-40.832550000000005,-15.99,1
23:59,961077907.0,-59.82255000000001,-18.99,6
23:59,961077907.0,-74.81255,-14.99,1
23:59,961077907.0,-174.81255,-100.0,6
23:59,832564361.0,17668.795167228865,-18.99,6
23:59,832564361.0,17652.805167228864,-15.99,1
23:59,832564361.0,17645.805167228864,-7.0,1
23:59,832564361.0,17630.815167228862,-14.99,1
23:59,832564361.0,17623.815167228862,-7.0,1
23:59,832564361.0,17617.82516722886,-5.99,1
23:59,832564361.0,17517.82516722886,-100.0,6
23:59,783650950.0,-550.5676434110117,-14.99,1
23:59,783650950.0,-557.5676434110117,-7.0,1
23:59,783650950.0,-572.5576434110117,-14.99,1
23:59,783650950.0,-588.5476434110117,-15.99,1
23:59,783650950.0,-596.5376434110117,-7.99,1
23:59,783650950.0,-615.5276434110117,-18.99,6
23:59,896821055.0,235.66175926708252,-14.99,1
23:59,896821055.0,228.66175926708252,-7.0,1
23:59,896821055.0,221.66175926708252,-7.0,1
23:59,896821055.0,213.6717592670825,-7.99,1
23:59,308068836.0,1535.358522568192,-15.99,1
23:59,308068836.0,1527.368522568192,-7.99,1
23:59,228136274.0,1821.6904999999997,-7.99,7
23:59,228136274.0,1813.7004999999997,-7.99,1
23:59,228136274.0,1713.7004999999997,-100.0,6
23:59,609939116.0,8473.777164867906,-5.99,1
23:59,609939116.0,8467.787164867907,-5.99,1
23:59,609939116.0,8452.797164867907,-14.99,1
23:59,609939116.0,8444.807164867907,-7.99,1
23:59,609939116.0,8425.817164867907,-18.99,6
23:59,873701090.0,1220.9033101543107,-5.99,1
23:59,873701090.0,1214.9133101543107,-5.99,1
23:59,873701090.0,1198.923310154311,-15.99,1
23:59,873701090.0,1190.933310154311,-7.99,1
23:59,873701090.0,1171.943310154311,-18.99,6
23:59,662610817.0,-1106.076831324928,-18.99,6
23:59,662610817.0,-1122.066831324928,-15.99,1
23:59,824916823.0,9867.710871788897,-5.99,1
23:59,824916823.0,9852.720871788895,-14.99,1
23:59,824916823.0,9837.730871788895,-14.99,1
23:59,824916823.0,9831.740871788896,-5.99,1
23:59,824916823.0,9823.750871788898,-7.99,1
23:59,824916823.0,9804.760871788898,-18.99,6
23:59,867987292.0,3061.0882258263746,-12.99,1
23:59,867987292.0,3042.098225826375,-18.99,6
23:59,867987292.0,3026.108225826375,-15.99,1
23:59,152488934.0,2314.6387073137307,-15.99,1
23:59,152488934.0,2306.648707313731,-7.99,7
23:59,152488934.0,2206.648707313731,-100.0,6
23:59,760704118.0,1754.590312717489,-7.99,1
23:59,760704118.0,1746.600312717489,-7.99,7
23:59,962295212.0,-2938.995149999997,-15.99,1
23:59,962295212.0,-2946.9851499999963,-7.99,1
23:59,962295212.0,-2959.975149999996,-12.99,1
23:59,939972497.0,2055.881958600011,-15.99,1
23:59,939972497.0,2040.8919586000109,-14.99,1
23:59,939972497.0,2033.8919586000109,-7.0,1
23:59,939972497.0,1933.8919586000109,-100.0,6
23:59,939972497.0,1914.9019586000109,-18.99,6
23:59,274818272.0,841.7351785671315,-18.99,6
23:59,274818272.0,825.7451785671315,-15.99,1
23:59,274818272.0,812.7551785671315,-12.99,1
23:59,274818272.0,806.7651785671314,-5.99,1
23:59,274818272.0,800.7751785671314,-5.99,1
23:59,274818272.0,785.7851785671314,-14.99,1
23:59,274818272.0,685.7851785671314,-100.0,6
23:59,724997545.0,-162.8883080022183,-15.99,1
23:59,724997545.0,-170.87830800221832,-7.99,1
23:59,724997545.0,-176.86830800221833,-5.99,1
23:59,724997545.0,-191.8583080022183,-14.99,1
23:59,724997545.0,-204.84830800221835,-12.99,1
23:59,916270283.0,2792.3642499999996,-18.99,6
23:59,916270283.0,2784.37425,-7.99,7
23:59,916270283.0,2771.38425,-12.99,1
23:59,119993184.0,-2046.1344029108625,-18.99,6
23:59,119993184.0,-2054.1244029108625,-7.99,1
23:59,119993184.0,-2060.1144029108623,-5.99,1
23:59,119993184.0,-2075.104402910862,-14.99,1
23:59,119993184.0,-2082.104402910862,-7.0,1
23:59,119993184.0,-2089.104402910862,-7.0,1
23:59,612304466.0,-2123.9032500000003,-14.99,1
23:59,612304466.0,-2129.89325,-5.99,1
23:59,612304466.0,-2135.88325,-5.99,1
23:59,612304466.0,-2154.8732499999996,-18.99,6
23:59,612304466.0,-2162.8632499999994,-7.99,1
23:59,612304466.0,-2178.853249999999,-15.99,1
23:59,909676212.0,1274.7594045320272,-7.99,7
23:59,909676212.0,1255.7694045320272,-18.99,6
23:59,909676212.0,1155.7694045320272,-100.0,6
23:59,909676212.0,1140.7794045320272,-14.99,1
23:59,909676212.0,1127.7894045320272,-12.99,1
23:59,909676212.0,1114.7994045320272,-12.99,1
23:59,909676212.0,1101.8094045320272,-12.99,1
23:59,409971170.0,3621.1832989943423,-18.99,6
23:59,409971170.0,3608.1932989943425,-12.99,1
23:59,409971170.0,3595.2032989943427,-12.99,1
23:59,409971170.0,3589.213298994343,-5.99,1
23:59,409971170.0,3573.223298994343,-15.99,1
23:59,409971170.0,3565.2332989943434,-7.99,7
23:59,741903302.0,2778.986865014125,-15.99,1
23:59,741903302.0,2759.9968650141254,-18.99,6
23:59,741903302.0,2745.0068650141257,-14.99,1
23:59,741903302.0,2739.016865014126,-5.99,1
23:59,741903302.0,2733.026865014126,-5.99,1
23:59,758885184.0,1438.9471822743446,-15.99,1
23:59,758885184.0,1419.9571822743446,-18.99,6
23:59,101531259.0,185.32469999999967,-7.99,1
23:59,101531259.0,85.32469999999967,-100.0,6
23:59,652048867.0,769.435299999999,-5.99,1
23:59,652048867.0,761.445299999999,-7.99,7
23:59,652048867.0,661.445299999999,-100.0,6
23:59,652048867.0,642.4552999999989,-18.99,6
23:59,940569402.0,6805.184671678789,-15.99,1
23:59,940569402.0,6797.194671678789,-7.99,7
23:59,489964679.0,21619.09103909183,-15.99,1
23:59,489964679.0,21600.101039091827,-18.99,6
23:59,188263947.0,704.4617500000006,-18.99,6
23:59,656317661.0,64.48164154140274,-15.99,1
23:59,760753808.0,136.08469999999943,-18.99,6
23:59,492850697.0,8.641086665863677,-12.99,1
23:59,492850697.0,0.6510866658636765,-7.99,7
23:59,492850697.0,-99.34891333413633,-100.0,6
23:59,143383029.0,87.90333065233864,-15.99,1
23:59,143383029.0,79.91333065233864,-7.99,7
23:59,479366718.0,2470.7614476324006,-7.99,7
23:59,479366718.0,2370.7614476324006,-100.0,6
23:59,479366718.0,2351.771447632401,-18.99,6
23:59,427909748.0,2300.5732000000135,-18.99,6
23:59,427909748.0,2292.5832000000137,-7.99,1
23:59,427909748.0,2284.593200000014,-7.99,7
23:59,427909748.0,2277.593200000014,-7.0,1
23:59,427909748.0,2270.593200000014,-7.0,1
23:59,427909748.0,2257.603200000014,-12.99,1
23:59,427909748.0,2251.6132000000143,-5.99,1
23:59,690941877.0,-58.84503848250811,-15.99,1
23:59,690941877.0,-66.83503848250811,-7.99,1
23:59,690941877.0,-81.8250384825081,-14.99,1
23:59,618514666.0,22651.844041064312,-15.99,1
23:59,618514666.0,22643.85404106431,-7.99,1
23:59,618514666.0,22628.86404106431,-14.99,1
23:59,618514666.0,22613.874041064308,-14.99,1
23:59,618514666.0,22598.884041064302,-14.99,1
23:59,618514666.0,22591.884041064302,-7.0,1
23:59,618514666.0,22572.894041064304,-18.99,6
23:59,668329719.0,9640.021970977376,-7.0,1
23:59,668329719.0,9634.031970977376,-5.99,1
23:59,668329719.0,9621.041970977376,-12.99,1
23:59,668329719.0,9614.041970977376,-7.0,1
23:59,668329719.0,9606.051970977376,-7.99,7
23:59,724537117.0,-1231.5585500000004,-15.99,1
23:59,724537117.0,-1250.5485500000004,-18.99,6
23:59,724537117.0,-1265.5385500000004,-14.99,1
23:59,354894456.0,70.47999999999958,-5.99,1
23:59,354894456.0,54.489999999999576,-15.99,1
23:59,354894456.0,35.499999999999574,-18.99,6
23:59,382862215.0,-33.141000000000155,-15.99,1
23:59,382862215.0,-52.13100000000016,-18.99,6
23:59,382862215.0,-152.13100000000014,-100.0,6
23:59,365608668.0,660.2492520241888,-15.99,1
23:59,365608668.0,641.2592520241888,-18.99,6
23:59,365608668.0,541.2592520241888,-100.0,6
23:59,365608668.0,535.2692520241887,-5.99,1
23:59,345514953.0,-876.2653000000007,-15.99,1
23:59,797184978.0,-363.27991342698056,-15.99,1
23:59,797184978.0,-369.26991342698057,-5.99,1
23:59,797184978.0,-382.2599134269806,-12.99,1
23:59,797184978.0,-388.2499134269806,-5.99,1
23:59,920031185.0,-748.7690705162921,-18.99,6
23:59,920031185.0,-754.7590705162921,-5.99,1
23:59,920031185.0,-760.7490705162921,-5.99,1
23:59,920031185.0,-775.7390705162921,-14.99,1
23:59,421475159.0,-192.1347373255874,-7.99,7
23:59,421475159.0,-211.1247373255874,-18.99,6
23:59,421475159.0,-226.1147373255874,-14.99,1
23:59,421475159.0,-232.10473732558745,-5.99,1
23:59,421475159.0,-247.09473732558743,-14.99,1
23:59,421475159.0,-253.08473732558744,-5.99,1
23:59,604334058.0,729.8564999999994,-15.99,1
23:59,604334058.0,721.8664999999994,-7.99,7
23:59,145387690.0,6091.051957375697,-15.99,1
23:59,145387690.0,6076.061957375698,-14.99,1
23:59,145387690.0,6070.071957375698,-5.99,1
23:59,145387690.0,6063.071957375698,-7.0,1
23:59,145387690.0,5963.071957375698,-100.0,6
23:59,519644021.0,3903.175563850927,-15.99,1
23:59,519644021.0,3888.1855638509273,-14.99,1
23:59,519644021.0,3869.195563850928,-18.99,6
23:59,519644021.0,3769.195563850928,-100.0,6
23:59,237493332.0,16047.317430347126,-7.99,1
23:59,237493332.0,16028.327430347126,-18.99,6
23:59,237493332.0,16015.337430347126,-12.99,1
23:59,237493332.0,16002.347430347128,-12.99,1
23:59,237493332.0,15987.357430347129,-14.99,1
23:59,237493332.0,15974.367430347129,-12.99,1
23:59,237493332.0,15874.367430347129,-100.0,6
23:59,757115616.0,2299.620000000004,-18.99,6
23:59,433837402.0,-7.345868464188099,-15.99,1
23:59,433837402.0,-15.3358684641881,-7.99,1
23:59,433837402.0,-34.3258684641881,-18.99,6
23:59,441142605.0,2925.716442275728,-7.99,1
23:59,441142605.0,2918.716442275728,-7.0,1
23:59,441142605.0,2911.716442275728,-7.0,1
23:59,441142605.0,2892.726442275728,-18.99,6
23:59,628470485.0,1225.1970299001232,-18.99,6
23:59,628470485.0,1217.2070299001232,-7.99,1
23:59,628470485.0,1117.2070299001232,-100.0,6
23:59,628470485.0,1104.2170299001232,-12.99,1
23:59,518746136.0,458.5827717630835,-7.99,1
23:59,518746136.0,450.5927717630835,-7.99,7
23:59,518746136.0,435.60277176308347,-14.99,1
23:59,518746136.0,429.61277176308346,-5.99,1
23:59,518746136.0,423.62277176308345,-5.99,1
23:59,518746136.0,410.63277176308344,-12.99,1
23:59,556631012.0,1016.1380730856782,-7.0,1
23:59,556631012.0,1003.1480730856782,-12.99,1
23:59,556631012.0,996.1480730856782,-7.0,1
23:59,556631012.0,989.1480730856782,-7.0,1
23:59,556631012.0,973.1580730856782,-15.99,1
23:59,556631012.0,965.1680730856782,-7.99,7
23:59,556631012.0,946.1780730856782,-18.99,6
23:59,556631012.0,846.1780730856782,-100.0,6
23:59,519649533.0,277.02181637066224,-7.0,1
23:59,519649533.0,264.0318163706622,-12.99,1
23:59,519649533.0,249.04181637066225,-14.99,1
23:59,519649533.0,236.0518163706622,-12.99,1
23:59,519649533.0,217.0618163706622,-18.99,6
23:59,519649533.0,201.0718163706622,-15.99,1
23:59,519649533.0,193.08181637066215,-7.99,1
23:59,613729471.0,10892.153371309963,-15.99,1
23:59,613729471.0,10792.153371309963,-100.0,6
23:59,653667523.0,3877.972899570015,-15.99,1
23:59,653667523.0,3869.982899570015,-7.99,1
23:59,653667523.0,3856.992899570016,-12.99,1
23:59,653667523.0,3842.002899570016,-14.99,1
23:59,653667523.0,3835.002899570016,-7.0,1
23:59,734161378.0,-2715.1601694342125,-7.99,1
23:59,734161378.0,-2728.1501694342123,-12.99,1
23:59,734161378.0,-2743.140169434212,-14.99,1
23:59,734161378.0,-2762.130169434212,-18.99,6
23:59,252419513.0,-2179.818685813416,-15.99,1
23:59,252419513.0,-2187.8086858134157,-7.99,7
23:59,252419513.0,-2206.798685813415,-18.99,6
23:59,194745206.0,660.3283720912432,-15.99,1
23:59,194745206.0,653.3283720912432,-7.0,1
23:59,194745206.0,634.3383720912432,-18.99,6
23:59,977899503.0,500.25689358085265,-15.99,1
23:59,977899503.0,485.26689358085264,-14.99,1
23:59,977899503.0,470.27689358085263,-14.99,1
23:59,977899503.0,451.2868935808526,-18.99,6
23:59,806358207.0,13998.039482859393,-15.99,1
23:59,806358207.0,13979.049482859393,-18.99,6
23:59,887853850.0,11445.214615192666,-7.99,1
23:59,887853850.0,11430.224615192668,-14.99,1
23:59,373875019.0,17948.88951500658,-7.0,1
23:59,373875019.0,17929.89951500658,-18.99,6
23:59,373875019.0,17913.909515006577,-15.99,1
23:59,373875019.0,17905.919515006575,-7.99,1
23:59,856147482.0,-426.5029485986247,-15.99,1
23:59,856147482.0,-441.4929485986247,-14.99,1
23:59,856147482.0,-448.4929485986247,-7.0,1
23:59,856147482.0,-463.4829485986247,-14.99,1
23:59,856147482.0,-482.4729485986247,-18.99,6
23:59,435313070.0,2989.0413330332203,-100.0,6
23:59,435313070.0,2973.0513330332205,-15.99,1
23:59,491392945.0,6044.101500000008,-7.0,1
23:59,491392945.0,6031.111500000008,-12.99,1
23:59,491392945.0,6018.121500000008,-12.99,1
23:59,491392945.0,6005.131500000009,-12.99,1
23:59,491392945.0,5997.141500000009,-7.99,1
23:59,491392945.0,5989.151500000009,-7.99,7
23:59,491392945.0,5970.161500000009,-18.99,6
23:59,766941757.0,4147.410671121908,-15.99,1
23:59,766941757.0,4128.4206711219085,-18.99,6
23:59,766941757.0,4028.420671121909,-100.0,6
23:59,986267641.0,9064.968177602224,-15.99,1
23:59,986267641.0,9056.978177602225,-7.99,7
23:59,986267641.0,9037.988177602225,-18.99,6
23:59,776108637.0,1542.6646536574956,-18.99,6
23:59,776108637.0,1534.6746536574956,-7.99,1
23:59,776108637.0,1518.6846536574956,-15.99,1
23:59,776108637.0,1503.6946536574956,-14.99,1
23:59,776108637.0,1403.6946536574956,-100.0,6
23:59,532525712.0,-766.1218000000003,-15.99,1
23:59,532525712.0,-774.1118000000004,-7.99,7
23:59,532525712.0,-781.1118000000004,-7.0,1
23:59,145553416.0,-2643.915649999999,-7.0,1
23:59,145553416.0,-2659.905649999999,-15.99,1
23:59,145553416.0,-2678.8956499999986,-18.99,6
23:59,598586358.0,-3448.832449999996,-18.99,6
23:59,598586358.0,-3464.8224499999956,-15.99,1
23:59,598586358.0,-3472.8124499999954,-7.99,1
23:59,637649383.0,1154.0984499999984,-15.99,1
23:59,637649383.0,1135.1084499999984,-18.99,6
23:59,637649383.0,1122.1184499999983,-12.99,1
23:59,637649383.0,1115.1184499999983,-7.0,1
23:59,637649383.0,1102.1284499999983,-12.99,1
23:59,637649383.0,1002.1284499999985,-100.0,6
23:59,709142813.0,1149.5195499999993,-15.99,1
23:59,709142813.0,1141.5295499999993,-7.99,7
23:59,709142813.0,1134.5295499999993,-7.0,1
23:59,709142813.0,1127.5295499999993,-7.0,1
23:59,711045550.0,2701.943350000003,-7.99,1
23:59,711045550.0,2682.9533500000034,-18.99,6
23:59,337771621.0,-2807.272649999999,-5.99,1
23:59,337771621.0,-2814.272649999999,-7.0,1
23:59,337771621.0,-2848.2526499999985,-18.99,6
23:59,337771621.0,-2864.2426499999983,-15.99,1
23:59,337771621.0,-2872.232649999998,-7.99,1
23:59,337771621.0,-2972.232649999998,-100.0,6
23:59,492215823.0,3749.998573815444,-15.99,1
23:59,492215823.0,3731.008573815445,-18.99,6
23:59,912705941.0,19700.82040351887,-14.99,1
23:59,912705941.0,19693.82040351887,-7.0,1
23:59,912705941.0,19678.830403518867,-14.99,1
23:59,912705941.0,19670.840403518865,-7.99,1
23:59,660789920.0,-2470.5083473823724,-18.99,6
23:59,660789920.0,-2485.498347382372,-14.99,1
23:59,920830317.0,-134.86397936251865,-15.99,1
23:59,920830317.0,-142.85397936251866,-7.99,7
23:59,920830317.0,-161.84397936251867,-18.99,6
23:59,998405607.0,-342.9414999999981,-7.0,1
23:59,998405607.0,-349.9414999999981,-7.0,1
23:59,998405607.0,-365.9314999999981,-15.99,1
23:59,998405607.0,-384.9214999999981,-18.99,6
23:59,998405607.0,-484.9214999999981,-100.0,6
23:59,598793068.0,1168.6588499999982,-7.99,7
23:59,598793068.0,1160.6688499999982,-7.99,1
23:59,598793068.0,1147.6788499999982,-12.99,1
23:59,598793068.0,1141.6888499999982,-5.99,1
23:59,598793068.0,1122.6988499999982,-18.99,6
23:59,833899961.0,1528.4277442498694,-12.99,1
23:59,833899961.0,1513.4377442498694,-14.99,1
23:59,833899961.0,1506.4377442498694,-7.0,1
23:59,833899961.0,1491.4477442498694,-14.99,1
23:59,744211756.0,-4204.838249999993,-14.99,1
23:59,744211756.0,-4223.828249999993,-18.99,6
23:59,744211756.0,-4323.828249999993,-100.0,6
23:59,744211756.0,-4339.818249999993,-15.99,1
23:59,744211756.0,-4347.808249999993,-7.99,7
23:59,380228542.0,450.6717418155656,-15.99,1
23:59,380228542.0,442.6817418155656,-7.99,1
23:59,380228542.0,423.6917418155656,-18.99,6
23:59,957821152.0,-1395.4229535715497,-15.99,1
23:59,957821152.0,-1403.4129535715497,-7.99,7
23:59,957821152.0,-1422.4029535715497,-18.99,6
23:59,957821152.0,-1522.4029535715497,-100.0,6
23:59,964702094.0,1461.433037640289,-14.99,1
23:59,964702094.0,1455.443037640289,-5.99,1
23:59,964702094.0,1448.443037640289,-7.0,1
23:59,964702094.0,1432.453037640289,-15.99,1
23:59,964702094.0,1413.463037640289,-18.99,6
23:59,749378808.0,4895.240434499769,-15.99,1
23:59,749378808.0,4887.25043449977,-7.99,1
23:59,749378808.0,4868.26043449977,-18.99,6
23:59,749378808.0,4855.27043449977,-12.99,1
23:59,749378808.0,4849.28043449977,-5.99,1
23:59,749378808.0,4843.2904344997705,-5.99,1
23:59,749378808.0,4828.300434499771,-14.99,1
23:59,773633520.0,1035.1698109385115,-12.99,1
23:59,773633520.0,1028.1698109385115,-7.0,1
23:59,773633520.0,1015.1798109385117,-12.99,1
23:59,773633520.0,996.1898109385116,-18.99,6
23:59,773633520.0,980.1998109385116,-15.99,1
23:59,720742759.0,1508.7289808830074,-7.99,1
23:59,720742759.0,1502.7389808830071,-5.99,1
23:59,720742759.0,1483.748980883007,-18.99,6
23:59,982949451.0,-3819.941667052509,-15.99,1
23:59,982949451.0,-3827.931667052508,-7.99,1
23:59,982949451.0,-3846.921667052508,-18.99,6
23:59,876890798.0,4117.0921706999325,-18.99,6
23:59,876890798.0,4101.102170699933,-15.99,1
23:59,876890798.0,4093.112170699933,-7.99,1
23:59,876890798.0,4087.122170699933,-5.99,1
23:59,876890798.0,3987.122170699933,-100.0,6
23:59,216286013.0,175.6932566539399,-100.0,6
23:59,216286013.0,159.7032566539399,-15.99,1
23:59,216286013.0,151.71325665393988,-7.99,7
23:59,667367404.0,9889.198441342283,-15.99,1
23:59,667367404.0,9789.198441342283,-100.0,6
23:59,108563213.0,26017.18070262166,-7.0,1
23:59,108563213.0,26011.190702621658,-5.99,1
23:59,108563213.0,25998.200702621656,-12.99,1
23:59,108563213.0,25992.210702621654,-5.99,1
23:59,108563213.0,25984.220702621653,-7.99,7
23:59,108563213.0,25968.23070262165,-15.99,1
23:59,108563213.0,25949.24070262165,-18.99,6
23:59,241459011.0,1387.344013272347,-15.99,1
23:59,241459011.0,1379.354013272347,-7.99,1
23:59,241459011.0,1373.364013272347,-5.99,1
23:59,241459011.0,1273.364013272347,-100.0,6
23:59,184430449.0,2896.463927693265,-14.99,1
23:59,184430449.0,2890.473927693265,-5.99,1
23:59,184430449.0,2874.4839276932653,-15.99,1
23:59,184430449.0,2855.4939276932655,-18.99,6
23:59,137822385.0,3867.984801541066,-5.99,1
23:59,137822385.0,3861.9948015410664,-5.99,1
23:59,137822385.0,3854.0048015410666,-7.99,7
23:59,137822385.0,3835.014801541067,-18.99,6
23:59,213112754.0,7432.800560569875,-7.99,1
23:59,213112754.0,7419.810560569875,-12.99,1
23:59,213112754.0,7400.820560569875,-18.99,6
23:59,835736339.0,2434.8390661464714,-18.99,6
23:59,835736339.0,2428.8490661464716,-5.99,1
23:59,835736339.0,2421.8490661464716,-7.0,1
23:59,835736339.0,2408.859066146472,-12.99,1
23:59,835736339.0,2393.869066146472,-14.99,1
23:59,835736339.0,2385.8790661464723,-7.99,1
23:59,678851253.0,4832.3158235708515,-100.0,6
23:59,678851253.0,4816.325823570852,-15.99,1
23:59,678851253.0,4808.335823570852,-7.99,7
23:59,570269025.0,3947.937072911829,-5.99,1
23:59,570269025.0,3934.9470729118298,-12.99,1
23:59,570269025.0,3927.9470729118298,-7.0,1
23:59,570269025.0,3920.9470729118298,-7.0,1
23:59,570269025.0,3901.9570729118295,-18.99,6
23:59,570269025.0,3885.9670729118297,-15.99,1
23:59,570269025.0,3785.9670729118297,-100.0,6
23:59,412823730.0,667.0702258504897,-15.99,1
23:59,412823730.0,659.0802258504897,-7.99,1
23:59,412823730.0,559.0802258504897,-100.0,6
23:59,235881534.0,14557.099790498232,-15.99,1
23:59,235881534.0,14549.109790498233,-7.99,1
23:59,235881534.0,14543.119790498233,-5.99,1
23:59,235881534.0,14537.129790498231,-5.99,1
23:59,235881534.0,14530.129790498231,-7.0,1
23:59,235881534.0,14515.139790498231,-14.99,1
23:59,235881534.0,14496.149790498232,-18.99,6
23:59,129018172.0,10245.442321236931,-15.99,1
23:59,129018172.0,10238.442321236931,-7.0,1
23:59,129018172.0,10219.452321236931,-18.99,6
23:59,624563756.0,116.27932878355638,-18.99,6
23:59,624563756.0,101.2893287835564,-14.99,1
23:59,624563756.0,88.29932878355639,-12.99,1
23:59,624563756.0,73.3093287835564,-14.99,1
23:59,624563756.0,65.3193287835564,-7.99,1
23:59,624563756.0,57.3293287835564,-7.99,7
23:59,624563756.0,-42.6706712164436,-100.0,6
23:59,703588001.0,16.663049999999437,-12.99,1
23:59,703588001.0,8.673049999999437,-7.99,1
23:59,703588001.0,-10.316950000000562,-18.99,6
23:59,871866387.0,446.7070999999992,-7.0,1
23:59,871866387.0,439.7070999999992,-7.0,1
23:59,871866387.0,424.7170999999992,-14.99,1
23:59,871866387.0,418.7270999999991,-5.99,1
23:59,871866387.0,402.73709999999915,-15.99,1
23:59,871866387.0,394.74709999999914,-7.99,1
23:59,574548998.0,-45.74935000000095,-15.99,1
23:59,574548998.0,-53.739350000000954,-7.99,1
23:59,574548998.0,-72.72935000000095,-18.99,6
23:59,574548998.0,-78.71935000000094,-5.99,1
23:59,769319491.0,435.3669999999993,-5.99,1
23:59,769319491.0,422.37699999999927,-12.99,1
23:59,769319491.0,416.38699999999926,-5.99,1
23:59,769319491.0,409.38699999999926,-7.0,1
23:59,769319491.0,390.39699999999925,-18.99,6
23:59,769319491.0,382.4069999999992,-7.99,1
23:59,769319491.0,374.4169999999992,-7.99,7
23:59,769319491.0,274.41699999999923,-100.0,6
23:59,442079728.0,171.8651192193139,-18.99,6
23:59,999752672.0,1989.7968935333345,-15.99,1
23:59,654329190.0,257.8126009485193,-15.99,1
23:59,383833857.0,27121.07221496069,-14.99,1
23:59,383833857.0,27106.08221496069,-14.99,1
23:59,383833857.0,27093.09221496069,-12.99,1
23:59,383833857.0,27086.09221496069,-7.0,1
23:59,859603181.0,4193.300852925,-12.99,1
23:59,221356538.0,1126.9464999999998,-15.99,1
23:59,221356538.0,1118.9564999999998,-7.99,7
23:59,221356538.0,1018.9564999999998,-100.0,6
23:59,500051919.0,1077.5796966505902,-7.99,7
23:59,500051919.0,1061.5896966505902,-15.99,1
23:59,500051919.0,1042.5996966505902,-18.99,6
23:59,550644516.0,-50.57345000000145,-15.99,1
23:59,550644516.0,-58.56345000000145,-7.99,7
23:59,550644516.0,-77.55345000000145,-18.99,6
23:59,550644516.0,-92.54345000000144,-14.99,1
23:59,550644516.0,-98.53345000000144,-5.99,1
23:59,550644516.0,-105.53345000000144,-7.0,1
23:59,550644516.0,-111.52345000000145,-5.99,1
23:59,503575533.0,8858.483251971304,-18.99,6
23:59,503575533.0,8842.493251971304,-15.99,1
23:59,503575533.0,8829.503251971304,-12.99,1
23:59,503575533.0,8816.513251971304,-12.99,1
23:59,503575533.0,8809.513251971304,-7.0,1
23:59,503575533.0,8709.513251971304,-100.0,6
23:59,786879739.0,-2358.403294120557,-15.99,1
23:59,786879739.0,-2366.3932941205567,-7.99,1
23:59,786879739.0,-2385.3832941205565,-18.99,6
23:59,348460748.0,534.547549999999,-18.99,6
23:59,348460748.0,518.557549999999,-15.99,1
23:59,348460748.0,510.56754999999896,-7.99,1
23:59,901432314.0,4371.478186388769,-14.99,1
23:59,901432314.0,4356.4881863887695,-14.99,1
23:59,901432314.0,4337.49818638877,-18.99,6
23:59,901432314.0,4321.50818638877,-15.99,1
23:59,901432314.0,4313.51818638877,-7.99,7
23:59,520447032.0,9157.542739645662,-15.99,1
23:59,520447032.0,9138.552739645662,-18.99,6
23:59,392270893.0,13692.418791126487,-15.99,1
23:59,392270893.0,13677.428791126487,-14.99,1
23:59,392270893.0,13664.438791126488,-12.99,1
23:59,392270893.0,13649.448791126488,-14.99,1
23:59,392270893.0,13643.458791126488,-5.99,1
23:59,785749304.0,9496.179054393551,-7.99,1
23:59,785749304.0,9480.189054393551,-15.99,1
23:59,785749304.0,9467.199054393554,-12.99,1
23:59,406862520.0,590.9883265374104,-15.99,1
23:59,406862520.0,582.9983265374104,-7.99,1
23:59,406862520.0,564.0083265374104,-18.99,6
23:59,406862520.0,558.0183265374104,-5.99,1
23:59,406862520.0,545.0283265374104,-12.99,1
23:59,406862520.0,538.0283265374104,-7.0,1
23:59,406862520.0,523.0383265374104,-14.99,1
23:59,819515373.0,2816.126136063792,-7.99,1
23:59,819515373.0,2810.136136063792,-5.99,1
23:59,819515373.0,2795.1461360637923,-14.99,1
23:59,819515373.0,2789.1561360637925,-5.99,1
23:59,819515373.0,2783.1661360637927,-5.99,1
23:59,819515373.0,2764.176136063793,-18.99,6
23:59,933745726.0,137.79105642932325,-7.99,1
23:59,933745726.0,129.80105642932324,-7.99,7
23:59,933745726.0,110.81105642932324,-18.99,6
23:59,933745726.0,104.82105642932324,-5.99,1
23:59,933745726.0,98.83105642932324,-5.99,1
23:59,933745726.0,92.84105642932326,-5.99,1
23:59,933745726.0,85.84105642932326,-7.0,1
23:59,429556122.0,4960.165093344285,-15.99,1
23:59,429556122.0,4947.175093344285,-12.99,1
23:59,429556122.0,4847.175093344285,-100.0,6
23:59,429556122.0,4828.185093344286,-18.99,6
23:59,792845450.0,1722.665150000001,-7.99,7
23:59,792845450.0,1716.675150000001,-5.99,1
23:59,792845450.0,1710.685150000001,-5.99,1
23:59,792845450.0,1704.695150000001,-5.99,1
23:59,792845450.0,1689.705150000001,-14.99,1
23:59,792845450.0,1589.705150000001,-100.0,6
23:59,792845450.0,1570.715150000001,-18.99,6
23:59,709935470.0,345.0207376997723,-14.99,1
23:59,709935470.0,332.0307376997723,-12.99,1
23:59,709935470.0,313.0407376997723,-18.99,6
23:59,138351025.0,-714.1007500000003,-14.99,1
23:59,138351025.0,-721.1007500000003,-7.0,1
23:59,138351025.0,-727.0907500000003,-5.99,1
23:59,138351025.0,-743.0807500000003,-15.99,1
23:59,138351025.0,-762.0707500000003,-18.99,6
23:59,187541224.0,2865.0274566485396,-5.99,1
23:59,187541224.0,2859.03745664854,-5.99,1
23:59,187541224.0,2851.04745664854,-7.99,1
23:59,516051449.0,1874.2787746508288,-18.99,6
23:59,516051449.0,1866.2887746508288,-7.99,1
23:59,516051449.0,1850.2987746508288,-15.99,1
23:59,845648250.0,368.9575499999994,-18.99,6
23:59,845648250.0,352.9675499999994,-15.99,1
23:59,660874296.0,3390.5774499608488,-7.99,7
23:59,660874296.0,3371.587449960849,-18.99,6
23:59,660874296.0,3356.597449960849,-14.99,1
23:59,647472692.0,27303.01374687835,-7.99,7
23:59,647472692.0,27287.02374687835,-15.99,1
23:59,647472692.0,27281.033746878347,-5.99,1
23:59,647472692.0,27275.043746878346,-5.99,1
23:59,647472692.0,27256.053746878344,-18.99,6
23:59,450896297.0,14457.838118178668,-15.99,1
23:59,450896297.0,14449.848118178668,-7.99,7
23:59,450896297.0,14434.858118178669,-14.99,1
23:59,357651163.0,-614.2700000000007,-15.99,1
23:59,357651163.0,-622.2600000000007,-7.99,1
23:59,357651163.0,-635.2500000000007,-12.99,1
23:59,357651163.0,-650.2400000000007,-14.99,1
23:59,357651163.0,-656.2300000000007,-5.99,1
23:59,357651163.0,-663.2300000000007,-7.0,1
23:59,357651163.0,-682.2200000000007,-18.99,6
23:59,950234174.0,2808.952452046593,-15.99,1
23:59,950234174.0,2800.962452046593,-7.99,7
23:59,950234174.0,2781.9724520465934,-18.99,6
23:59,383345285.0,-1161.982373588076,-18.99,6
23:59,383345285.0,-1174.9723735880762,-12.99,1
23:59,446720287.0,107.77744081840552,-18.99,6
23:59,433917275.0,8531.03259955712,-18.99,6
23:59,433917275.0,8524.03259955712,-7.0,1
23:59,433917275.0,8511.04259955712,-12.99,1
23:59,433917275.0,8496.05259955712,-14.99,1
23:59,433917275.0,8480.06259955712,-15.99,1
23:59,401293808.0,233.3304999999992,-15.99,1
23:59,401293808.0,225.34049999999917,-7.99,7
23:59,401293808.0,125.34049999999915,-100.0,6
23:59,868014990.0,-3390.223599999996,-7.99,1
23:59,868014990.0,-3406.213599999996,-15.99,1
23:59,868014990.0,-3413.213599999996,-7.0,1
23:59,868014990.0,-3428.2035999999957,-14.99,1
23:59,868014990.0,-3441.1935999999955,-12.99,1
23:59,366477356.0,1141.3788499999998,-15.99,1
23:59,366477356.0,1133.3888499999998,-7.99,1
23:59,366477356.0,1114.3988499999998,-18.99,6
23:59,683319988.0,8339.891684069265,-14.99,1
23:59,683319988.0,8333.901684069266,-5.99,1
23:59,683319988.0,8318.911684069266,-14.99,1
23:59,683319988.0,8299.921684069266,-18.99,6
23:59,683319988.0,8291.931684069266,-7.99,7
23:59,683319988.0,8283.941684069267,-7.99,1
23:59,653640811.0,18494.113984132346,-5.99,1
23:59,653640811.0,18487.113984132346,-7.0,1
23:59,653640811.0,18474.12398413234,-12.99,1
23:59,653640811.0,18467.12398413234,-7.0,1
23:59,653640811.0,18451.13398413234,-15.99,1
23:59,653640811.0,18443.143984132337,-7.99,1
23:59,653640811.0,18424.153984132336,-18.99,6
23:59,196289502.0,17052.59330954302,-15.99,1
23:59,196289502.0,17033.603309543018,-18.99,6
23:59,196289502.0,17020.613309543016,-12.99,1
23:59,196289502.0,17014.623309543014,-5.99,1
23:59,117273481.0,9571.93506533524,-7.99,7
23:59,117273481.0,9563.94506533524,-7.99,1
23:59,750094757.0,-1653.2493000000006,-18.99,6
23:59,750094757.0,-1669.2393000000006,-15.99,1
23:59,750094757.0,-1769.2393000000006,-100.0,6
23:59,472213568.0,-254.05824420605336,-7.99,1
23:59,472213568.0,-270.04824420605337,-15.99,1
23:59,472213568.0,-370.04824420605337,-100.0,6
23:59,108931112.0,15620.934030715973,-15.99,1
23:59,108931112.0,15612.944030715971,-7.99,7
23:59,108931112.0,15599.954030715971,-12.99,1
23:59,108931112.0,15586.964030715972,-12.99,1
23:59,930277104.0,11253.754912356202,-18.99,6
23:59,585625048.0,2633.360232052841,-15.99,1
23:59,585625048.0,2625.3702320528414,-7.99,7
23:59,585625048.0,2606.3802320528416,-18.99,6
23:59,585625048.0,2591.390232052842,-14.99,1
23:59,585625048.0,2576.400232052842,-14.99,1
23:59,585625048.0,2563.4102320528423,-12.99,1
23:59,585625048.0,2548.4202320528425,-14.99,1
23:59,685959099.0,2614.9368660992423,-15.99,1
23:59,685959099.0,2606.9468660992425,-7.99,1
23:59,685959099.0,2587.9568660992427,-18.99,6
23:59,685959099.0,2574.966866099243,-12.99,1
23:59,685959099.0,2561.976866099243,-12.99,1
23:59,683078800.0,2429.879452944871,-15.99,1
23:59,683078800.0,2421.889452944871,-7.99,1
23:59,835829467.0,-2213.7547499999987,-15.99,1
23:59,835829467.0,-2219.7447499999985,-5.99,1
23:59,835829467.0,-2232.7347499999983,-12.99,1
23:59,835829467.0,-2239.7347499999983,-7.0,1
23:59,835829467.0,-2258.724749999998,-18.99,6
23:59,835829467.0,-2358.724749999998,-100.0,6
23:59,462962606.0,1624.2800499999987,-15.99,1
23:59,462962606.0,1611.2900499999987,-12.99,1
23:59,462962606.0,1596.3000499999987,-14.99,1
23:59,462962606.0,1581.310049999999,-14.99,1
23:59,462962606.0,1575.320049999999,-5.99,1
23:59,462962606.0,1556.330049999999,-18.99,6
23:59,462962606.0,1456.330049999999,-100.0,6
23:59,690958123.0,22548.149485522543,-15.99,1
23:59,690958123.0,22540.15948552254,-7.99,1
23:59,690958123.0,22534.16948552254,-5.99,1
23:59,690958123.0,22515.179485522534,-18.99,6
23:59,138969884.0,938.3359499999996,-15.99,1
23:59,138969884.0,925.3459499999994,-12.99,1
23:59,138969884.0,906.3559499999994,-18.99,6
23:59,610450243.0,-533.6995999999998,-7.99,1
23:59,610450243.0,-546.6895999999998,-12.99,1
23:59,610450243.0,-552.6795999999998,-5.99,1
23:59,610450243.0,-565.6695999999998,-12.99,1
23:59,610450243.0,-584.6595999999998,-18.99,6
23:59,669503912.0,6.310550348817239,-12.99,1
23:59,669503912.0,-1.679449651182761,-7.99,1
23:59,669503912.0,-9.66944965118276,-7.99,7
23:59,669503912.0,-28.65944965118276,-18.99,6
23:59,669503912.0,-128.65944965118277,-100.0,6
23:59,461029994.0,8508.587094096782,-18.99,6
23:59,461029994.0,8492.597094096782,-15.99,1
23:59,461029994.0,8484.607094096782,-7.99,7
23:59,641764023.0,-1007.5763037720046,-7.99,1
23:59,891716230.0,681.8640513926164,-15.99,1
23:59,891716230.0,674.8640513926164,-7.0,1
23:59,891716230.0,659.8740513926164,-14.99,1
23:59,891716230.0,644.8840513926164,-14.99,1
23:59,891716230.0,629.8940513926163,-14.99,1
23:59,891716230.0,610.9040513926163,-18.99,6
23:59,643610517.0,-2990.036190729657,-15.99,1
23:59,719586818.0,19597.139538711628,-15.99,1
23:59,719586818.0,19591.149538711627,-5.99,1
23:59,534583529.0,1335.7792880547652,-7.0,1
23:59,534583529.0,1320.7892880547652,-14.99,1
23:59,534583529.0,1314.7992880547652,-5.99,1
23:59,534583529.0,1298.8092880547651,-15.99,1
23:59,534583529.0,1290.8192880547651,-7.99,7
23:59,782058249.0,-1333.5213733101616,-14.99,1
23:59,782058249.0,-1340.5213733101616,-7.0,1
23:59,782058249.0,-1356.5113733101616,-15.99,1
23:59,890830949.0,1195.4181499999977,-7.99,1
23:59,890830949.0,1187.4281499999977,-7.99,7
23:59,890830949.0,1181.4381499999977,-5.99,1
23:59,890830949.0,1174.4381499999977,-7.0,1
23:59,890830949.0,1167.4381499999977,-7.0,1
23:59,890830949.0,1161.4481499999977,-5.99,1
23:59,627723633.0,-2126.0813280037623,-7.99,1
23:59,627723633.0,-2226.0813280037623,-100.0,6
23:59,627723633.0,-2233.0813280037623,-7.0,1
23:59,331048953.0,424.9283679784936,-18.99,6
23:59,331048953.0,409.9383679784936,-14.99,1
23:59,331048953.0,402.9383679784936,-7.0,1
23:59,331048953.0,396.9483679784936,-5.99,1
23:59,331048953.0,389.9483679784936,-7.0,1
23:59,742223719.0,882.1829073048027,-7.0,1
23:59,742223719.0,875.1829073048027,-7.0,1
23:59,742223719.0,868.1829073048027,-7.0,1
23:59,742223719.0,852.1929073048027,-15.99,1
23:59,742223719.0,833.2029073048027,-18.99,6
23:59,605116158.0,2914.186200000002,-15.99,1
23:59,605116158.0,2906.196200000002,-7.99,7
23:59,605116158.0,2891.2062000000024,-14.99,1
23:59,605116158.0,2884.2062000000024,-7.0,1
23:59,605116158.0,2878.2162000000026,-5.99,1
23:59,605116158.0,2871.2162000000026,-7.0,1
23:59,605116158.0,2852.226200000003,-18.99,6
23:59,384497904.0,866.9084499999991,-15.99,1
23:59,384497904.0,853.9184499999991,-12.99,1
23:59,384497904.0,847.9284499999991,-5.99,1
23:59,384497904.0,834.9384499999991,-12.99,1
23:59,384497904.0,827.9384499999991,-7.0,1
23:59,384497904.0,727.9384499999991,-100.0,6
23:59,905860285.0,12262.40249017094,-7.99,1
23:59,804317849.0,-3811.32163302052,-7.99,1
23:59,804317849.0,-3827.3116330205194,-15.99,1
23:59,804317849.0,-3833.301633020519,-5.99,1
23:59,804317849.0,-3848.291633020519,-14.99,1
23:59,804317849.0,-3867.2816330205183,-18.99,6
23:59,987390838.0,-2968.5662412103784,-15.99,1
23:59,987390838.0,-2976.556241210378,-7.99,1
23:59,987390838.0,-2995.546241210378,-18.99,6
23:59,987390838.0,-3010.5362412103777,-14.99,1
23:59,352899149.0,643.4250499999987,-15.99,1
23:59,899742927.0,13982.722261510602,-7.99,7
23:59,899742927.0,13974.732261510602,-7.99,1
23:59,899742927.0,13955.742261510602,-18.99,6
23:59,899742927.0,13940.752261510605,-14.99,1
23:59,899742927.0,13840.752261510605,-100.0,6
23:59,601627384.0,4639.342644516358,-7.99,1
23:59,980500334.0,-179.0044338929041,-7.99,1
23:59,872286364.0,-562.7053458130997,-15.99,1
23:59,872286364.0,-568.6953458130997,-5.99,1
23:59,596171893.0,727.495594825511,-5.99,1
23:59,596171893.0,720.495594825511,-7.0,1
23:59,596171893.0,701.505594825511,-18.99,6
23:59,106601471.0,11429.09461466168,-12.99,1
23:59,943329213.0,1145.2554079471695,-15.99,1
23:59,943329213.0,1137.2654079471697,-7.99,7
23:59,943329213.0,1118.2754079471697,-18.99,6
23:59,637433131.0,367.872599999999,-15.99,1
23:59,637433131.0,359.882599999999,-7.99,7
23:59,637433131.0,340.892599999999,-18.99,6
23:59,637433131.0,325.902599999999,-14.99,1
23:59,637433131.0,225.90259999999896,-100.0,6
23:59,403383649.0,2301.898804861251,-15.99,1
23:59,403383649.0,2288.908804861251,-12.99,1
23:59,403383649.0,2281.908804861251,-7.0,1
23:59,403383649.0,2274.908804861251,-7.0,1
23:59,229205098.0,8470.185393821419,-18.99,6
23:59,229205098.0,8457.19539382142,-12.99,1
23:59,229205098.0,8450.19539382142,-7.0,1
23:59,229205098.0,8437.20539382142,-12.99,1
23:59,229205098.0,8430.20539382142,-7.0,1
23:59,675231808.0,18529.812187330244,-18.99,6
23:59,675231808.0,18521.822187330243,-7.99,7
23:59,246753533.0,814.9888999999985,-15.99,1
23:59,246753533.0,806.9988999999985,-7.99,1
23:59,246753533.0,794.0088999999984,-12.99,1
23:59,246753533.0,787.0088999999984,-7.0,1
23:59,246753533.0,687.0088999999984,-100.0,6
23:59,726913482.0,-619.9299985264763,-15.99,1
23:59,726913482.0,-638.9199985264763,-18.99,6
23:59,726913482.0,-651.9099985264763,-12.99,1
23:59,670427480.0,910.8508000000012,-15.99,1
23:59,670427480.0,902.8608000000012,-7.99,1
23:59,455831435.0,-1600.5196048014946,-15.99,1
23:59,455831435.0,-1608.5096048014946,-7.99,1
23:59,455831435.0,-1627.4996048014946,-18.99,6
23:59,455831435.0,-1633.4896048014946,-5.99,1
23:59,455831435.0,-1640.4896048014946,-7.0,1
23:59,455831435.0,-1653.4796048014946,-12.99,1
23:59,455831435.0,-1753.4796048014946,-100.0,6
23:59,886921642.0,3954.284347401557,-15.99,1
23:59,886921642.0,3947.284347401557,-7.0,1
23:59,886921642.0,3934.2943474015574,-12.99,1
23:59,886921642.0,3915.3043474015576,-18.99,6
23:59,886921642.0,3815.3043474015576,-100.0,6
23:59,605711527.0,35.36351383258365,-18.99,6
23:59,605711527.0,19.373513832583647,-15.99,1
23:59,605711527.0,11.383513832583647,-7.99,1
23:59,605711527.0,5.393513832583647,-5.99,1
23:59,605711527.0,-7.596486167416353,-12.99,1
23:59,191161970.0,-3851.411999999996,-18.99,6
23:59,191161970.0,-3859.401999999995,-7.99,7
23:59,191161970.0,-3867.3919999999953,-7.99,1
23:59,191161970.0,-3873.381999999995,-5.99,1
23:59,191161970.0,-3886.371999999995,-12.99,1
23:59,283027736.0,850.0542439701728,-12.99,1
23:59,283027736.0,834.0642439701728,-15.99,1
23:59,283027736.0,734.0642439701728,-100.0,6
23:59,303843160.0,643.8480000000015,-15.99,1
23:59,303843160.0,624.8580000000015,-18.99,6
23:59,399538448.0,8369.563173652621,-12.99,1
23:59,399538448.0,8350.573173652621,-18.99,6
23:59,399538448.0,8342.583173652622,-7.99,1
23:59,399538448.0,8334.593173652622,-7.99,7
23:59,398429109.0,1545.838550000001,-15.99,1
23:59,398429109.0,1526.848550000001,-18.99,6
23:59,398429109.0,1519.848550000001,-7.0,1
23:59,398429109.0,1512.848550000001,-7.0,1
23:59,398429109.0,1497.858550000001,-14.99,1
23:59,398429109.0,1490.858550000001,-7.0,1
23:59,108812033.0,984.4762499999983,-12.99,1
23:59,108812033.0,978.4862499999984,-5.99,1
23:59,108812033.0,971.4862499999984,-7.0,1
23:59,108812033.0,965.4962499999984,-5.99,1
23:59,108812033.0,949.5062499999984,-15.99,1
23:59,108812033.0,930.5162499999984,-18.99,6
23:59,108812033.0,830.5162499999983,-100.0,6
23:59,588565416.0,7482.193245597264,-14.99,1
23:59,588565416.0,7475.193245597264,-7.0,1
23:59,588565416.0,7375.193245597264,-100.0,6
23:59,588565416.0,7356.203245597264,-18.99,6
23:59,588565416.0,7340.213245597264,-15.99,1
23:59,554771381.0,-1763.5711500000002,-18.99,6
23:59,477216513.0,-384.01219999999944,-18.99,6
23:59,224215364.0,-1764.3675920882788,-7.99,7
23:59,224215364.0,-1783.3575920882788,-18.99,6
23:59,344522228.0,-2890.629488208393,-15.99,1
23:59,226703987.0,3005.7812999999996,-15.99,1
23:59,721393911.0,-514.3365425357166,-15.99,1
23:59,721393911.0,-521.3365425357166,-7.0,1
23:59,721393911.0,-536.3265425357166,-14.99,1
23:59,721393911.0,-542.3165425357166,-5.99,1
23:59,721393911.0,-548.3065425357166,-5.99,1
23:59,721393911.0,-567.2965425357166,-18.99,6
23:59,187111705.0,7727.811347754887,-15.99,1
23:59,250895529.0,1796.3159824692882,-18.99,6
23:59,250895529.0,1780.3259824692882,-15.99,1
23:59,250895529.0,1772.3359824692882,-7.99,1
23:59,250895529.0,1672.3359824692882,-100.0,6
23:59,860360312.0,472.5280588826804,-15.99,1
23:59,860360312.0,453.5380588826804,-18.99,6
23:59,121858569.0,1993.2961500000024,-100.0,6
23:59,121858569.0,1986.2961500000024,-7.0,1
23:59,121858569.0,1971.3061500000024,-14.99,1
23:59,121858569.0,1965.3161500000024,-5.99,1
23:59,104832000.0,-2866.872358905844,-15.99,1
23:59,104832000.0,-2966.872358905844,-100.0,6
23:59,550169791.0,23171.747176500845,-18.99,6
23:59,550169791.0,23165.757176500843,-5.99,1
23:59,709632525.0,-1463.8823500000003,-5.99,1
23:59,709632525.0,-1470.8823500000003,-7.0,1
23:59,709632525.0,-1483.8723500000006,-12.99,1
23:59,709632525.0,-1499.8623500000006,-15.99,1
23:59,709632525.0,-1518.8523500000006,-18.99,6
23:59,358836279.0,712.1110928075858,-14.99,1
23:59,358836279.0,697.1210928075858,-14.99,1
23:59,358836279.0,682.1310928075858,-14.99,1
23:59,358836279.0,663.1410928075858,-18.99,6
23:59,565175333.0,-3877.1510227298263,-12.99,1
23:59,565175333.0,-3884.1510227298263,-7.0,1
23:59,565175333.0,-3890.141022729826,-5.99,1
23:59,565175333.0,-3909.131022729826,-18.99,6
23:59,565175333.0,-3925.1210227298257,-15.99,1
23:59,338022396.0,818.564189375739,-18.99,6
23:59,838415080.0,-3381.7564999999986,-18.99,6
23:59,838415080.0,-3481.7564999999986,-100.0,6
23:59,823208989.0,1927.6514638695312,-5.99,1
23:59,823208989.0,1920.6514638695312,-7.0,1
23:59,823208989.0,1913.6514638695312,-7.0,1
23:59,823208989.0,1897.6614638695312,-15.99,1
23:59,823208989.0,1889.6714638695312,-7.99,1
23:59,823208989.0,1870.6814638695312,-18.99,6
23:59,254853117.0,3623.93040552982,-18.99,6
23:59,254853117.0,3615.940405529821,-7.99,1
23:59,158766229.0,-470.3468858934699,-7.99,1
23:59,158766229.0,-486.3368858934699,-15.99,1
23:59,158766229.0,-499.3268858934699,-12.99,1
23:59,158766229.0,-514.3168858934699,-14.99,1
23:59,158766229.0,-520.3068858934699,-5.99,1
23:59,321372947.0,-231.9742507890994,-18.99,6
23:59,165098840.0,3.2318736376269133,-14.99,1
23:59,165098840.0,-2.758126362373087,-5.99,1
23:59,165098840.0,-15.748126362373087,-12.99,1
23:59,165098840.0,-22.748126362373085,-7.0,1
23:59,165098840.0,-38.73812636237309,-15.99,1
23:59,165098840.0,-57.72812636237309,-18.99,6
23:59,165098840.0,-157.72812636237308,-100.0,6
23:59,886837068.0,1316.7180999999994,-18.99,6
23:59,886837068.0,1300.7280999999994,-15.99,1
23:59,886837068.0,1292.7380999999991,-7.99,7
23:59,886837068.0,1192.7380999999991,-100.0,6
23:59,886837068.0,1185.7380999999991,-7.0,1
23:59,886837068.0,1178.7380999999991,-7.0,1
23:59,973086490.0,11276.59188133701,-7.99,7
23:59,973086490.0,11260.60188133701,-15.99,1
23:59,973086490.0,11241.61188133701,-18.99,6
23:59,973086490.0,11141.61188133701,-100.0,6
23:59,635679314.0,-2906.9683291195183,-7.99,7
23:59,635679314.0,-2914.958329119518,-7.99,1
23:59,635679314.0,-3014.958329119518,-100.0,6
23:59,635679314.0,-3020.948329119518,-5.99,1
23:59,699313649.0,-2242.7983991419055,-18.99,6
23:59,699313649.0,-2249.7983991419055,-7.0,1
23:59,699313649.0,-2262.7883991419053,-12.99,1
23:59,699313649.0,-2277.778399141905,-14.99,1
23:59,699313649.0,-2290.768399141905,-12.99,1
23:59,527842638.0,1333.1105926329835,-12.99,1
23:59,527842638.0,1327.1205926329835,-5.99,1
23:59,527842638.0,1320.1205926329835,-7.0,1
23:59,527842638.0,1304.1305926329835,-15.99,1
23:59,527842638.0,1285.1405926329835,-18.99,6
23:59,527842638.0,1185.1405926329835,-100.0,6
23:59,215832575.0,-1247.5994637442195,-14.99,1
23:59,215832575.0,-1266.5894637442198,-18.99,6
23:59,215832575.0,-1274.5794637442198,-7.99,7
23:59,215832575.0,-1374.5794637442198,-100.0,6
23:59,907987693.0,-2558.5719999999983,-18.99,6
23:59,907987693.0,-2574.561999999998,-15.99,1
23:59,907987693.0,-2582.551999999998,-7.99,7
23:59,496395938.0,13187.157479880634,-15.99,1
23:59,496395938.0,13181.167479880634,-5.99,1
23:59,496395938.0,13168.177479880636,-12.99,1
23:59,496395938.0,13155.187479880637,-12.99,1
23:59,496395938.0,13136.197479880637,-18.99,6
23:59,229502829.0,-3654.783224186247,-15.99,1
23:59,229502829.0,-3662.7732241862473,-7.99,1
23:59,229502829.0,-3681.763224186247,-18.99,6
23:59,681955876.0,-1346.3181000000006,-5.99,1
23:59,681955876.0,-1354.3081000000006,-7.99,1
23:59,558875206.0,3818.8143108989534,-18.99,6
23:59,558875206.0,3802.8243108989536,-15.99,1
23:59,812839908.0,-1645.5123500000002,-7.0,1
23:59,812839908.0,-1658.5023500000002,-12.99,1
23:59,812839908.0,-1664.4923500000002,-5.99,1
23:59,812839908.0,-1680.4823500000002,-15.99,1
23:59,812839908.0,-1688.4723500000002,-7.99,7
23:59,812839908.0,-1707.4623500000002,-18.99,6
23:59,824218857.0,-3683.021160845428,-100.0,6
23:59,824218857.0,-3699.011160845428,-15.99,1
23:59,824218857.0,-3707.001160845428,-7.99,1
23:59,254018059.0,78.55520000000001,-18.99,6
23:59,254018059.0,62.56520000000001,-15.99,1
23:59,254018059.0,54.57520000000001,-7.99,7
23:59,386729293.0,34350.57623741818,-15.99,1
23:59,386729293.0,34250.57623741818,-100.0,6
23:59,639549973.0,8325.004710464145,-12.99,1
23:59,639549973.0,8312.014710464146,-12.99,1
23:59,639549973.0,8306.024710464146,-5.99,1
23:59,639549973.0,8291.034710464146,-14.99,1
23:59,639549973.0,8275.044710464146,-15.99,1
23:59,639549973.0,8256.054710464146,-18.99,6
23:59,933491926.0,4152.182300000003,-12.99,1
23:59,933491926.0,4139.192300000003,-12.99,1
23:59,933491926.0,4126.202300000004,-12.99,1
23:59,933491926.0,4119.202300000004,-7.0,1
23:59,933491926.0,4103.212300000004,-15.99,1
23:59,933491926.0,4084.222300000004,-18.99,6
23:59,933491926.0,3984.222300000004,-100.0,6
23:59,212560376.0,-123.36887422089784,-18.99,6
23:59,212560376.0,-131.35887422089783,-7.99,1
23:59,212560376.0,-139.34887422089784,-7.99,7
23:59,532478725.0,5555.146652309637,-7.99,1
23:59,532478725.0,5547.156652309637,-7.99,7
23:59,407574996.0,2073.2666093809366,-7.99,1
23:59,407574996.0,2065.276609380937,-7.99,7
23:59,407574996.0,1965.2766093809369,-100.0,6
23:59,895750759.0,-179.40013807566578,-15.99,1
23:59,895750759.0,-187.3901380756658,-7.99,7
23:59,895750759.0,-194.3901380756658,-7.0,1
23:59,895750759.0,-200.3801380756658,-5.99,1
23:59,895750759.0,-213.3701380756658,-12.99,1
23:59,895750759.0,-247.35013807566585,-18.99,6
23:59,402438092.0,1251.9547999999988,-5.99,1
23:59,402438092.0,1235.9647999999988,-15.99,1
23:59,402438092.0,1227.9747999999988,-7.99,1
23:59,402438092.0,1208.9847999999988,-18.99,6
23:59,285428103.0,10832.430621063915,-15.99,1
23:59,285428103.0,10824.440621063915,-7.99,1
23:59,285428103.0,10724.440621063915,-100.0,6
23:59,285428103.0,10705.450621063916,-18.99,6
23:59,642015139.0,211.2038374656383,-7.99,1
23:59,642015139.0,203.21383746563828,-7.99,7
23:59,990461108.0,742.7307686206111,-7.99,7
23:59,990461108.0,736.7407686206111,-5.99,1
23:59,990461108.0,721.7507686206111,-14.99,1
23:59,990461108.0,714.7507686206111,-7.0,1
23:59,990461108.0,708.7607686206111,-5.99,1
23:59,990461108.0,689.7707686206111,-18.99,6
23:59,799861885.0,495.5511999999988,-7.99,1
23:59,799861885.0,476.5611999999988,-18.99,6
23:59,113747882.0,13564.203251158267,-12.99,1
23:59,113747882.0,13557.203251158267,-7.0,1
23:59,113747882.0,13549.213251158268,-7.99,1
23:59,113747882.0,13541.223251158268,-7.99,7
23:59,113747882.0,13522.233251158268,-18.99,6
23:59,137913631.0,979.0221999999995,-15.99,1
23:59,137913631.0,960.0321999999996,-18.99,6
23:59,416060965.0,652.8022547005803,-15.99,1
23:59,416060965.0,644.8122547005803,-7.99,7
23:59,395284483.0,1905.6503402113085,-12.99,1
23:59,395284483.0,1892.6603402113085,-12.99,1
23:59,395284483.0,1877.6703402113085,-14.99,1
23:59,395284483.0,1870.6703402113085,-7.0,1
23:59,395284483.0,1862.6803402113085,-7.99,1
23:59,340295966.0,-1422.1844500000004,-15.99,1
23:59,340295966.0,-1429.1844500000004,-7.0,1
23:59,340295966.0,-1442.1744500000004,-12.99,1
23:59,340295966.0,-1542.1744500000004,-100.0,6
23:59,340295966.0,-1561.1644500000004,-18.99,6
23:59,197050303.0,191.22943256349504,-18.99,6
23:59,197050303.0,175.23943256349503,-15.99,1
23:59,678726554.0,-150.91424765161025,-15.99,1
23:59,678726554.0,-158.90424765161026,-7.99,1
23:59,678726554.0,-177.89424765161027,-18.99,6
23:59,850290152.0,-2920.8834999999967,-18.99,6
23:59,850290152.0,-2936.8734999999965,-15.99,1
23:59,850290152.0,-2944.8634999999963,-7.99,7
23:59,850290152.0,-2959.853499999996,-14.99,1
23:59,850290152.0,-3059.853499999996,-100.0,6
23:59,508518911.0,500.9347502790104,-12.99,1
23:59,508518911.0,494.9447502790103,-5.99,1
23:59,508518911.0,481.95475027901034,-12.99,1
23:59,508518911.0,465.96475027901033,-15.99,1
23:59,508518911.0,446.9747502790103,-18.99,6
23:59,508518911.0,346.9747502790103,-100.0,6
23:59,603375739.0,936.2560630232672,-15.99,1
23:59,166019891.0,9013.417483832563,-15.99,1
23:59,166019891.0,8994.427483832565,-18.99,6
23:59,678330503.0,4114.74123022913,-18.99,6
23:59,762785862.0,893.4986999999994,-100.0,6
23:59,679662108.0,18982.163623259115,-15.99,1
23:59,679662108.0,18963.173623259114,-18.99,6
23:59,975200042.0,-3076.377699999997,-7.99,7
23:59,975200042.0,-3082.3676999999966,-5.99,1
23:59,975200042.0,-3101.3576999999964,-18.99,6
23:59,211493028.0,1382.5614499999992,-15.99,1
23:59,211493028.0,1282.5614499999992,-100.0,6
23:59,211493028.0,1276.5714499999992,-5.99,1
23:59,538003940.0,2775.8500000000085,-14.99,1
23:59,538003940.0,2767.8600000000088,-7.99,7
23:59,538003940.0,2751.870000000009,-15.99,1
23:59,538003940.0,2651.870000000009,-100.0,6
23:59,538003940.0,2632.880000000009,-18.99,6
23:59,688328251.0,-831.0941253548272,-18.99,6
23:59,688328251.0,-839.0841253548272,-7.99,1
23:59,688328251.0,-939.0841253548272,-100.0,6
23:59,364396689.0,-413.88825,-18.99,6
23:59,364396689.0,-419.87825,-5.99,1
23:59,364396689.0,-434.86825,-14.99,1
23:59,535804582.0,-1240.2221500000012,-15.99,1
23:59,535804582.0,-1340.2221500000012,-100.0,6
23:59,535804582.0,-1359.2121500000012,-18.99,6
23:59,998390769.0,67.17435094052418,-7.99,1
23:59,998390769.0,51.184350940524176,-15.99,1
23:59,998390769.0,45.194350940524174,-5.99,1
23:59,998390769.0,32.20435094052417,-12.99,1
23:59,998390769.0,19.21435094052417,-12.99,1
23:59,878989510.0,5176.37188614179,-15.99,1
23:59,878989510.0,5157.38188614179,-18.99,6
23:59,878989510.0,5151.391886141791,-5.99,1
23:59,629078930.0,325.92947972560205,-7.0,1
23:59,629078930.0,318.92947972560205,-7.0,1
23:59,629078930.0,312.93947972560204,-5.99,1
23:59,629078930.0,293.94947972560203,-18.99,6
23:59,629078930.0,277.959479725602,-15.99,1
23:59,629078930.0,269.969479725602,-7.99,7
23:59,848118081.0,-2338.952798002096,-15.99,1
23:59,848118081.0,-2346.942798002096,-7.99,7
23:59,848118081.0,-2365.932798002096,-18.99,6
23:59,848118081.0,-2371.9227980020955,-5.99,1
23:59,848118081.0,-2471.9227980020955,-100.0,6
23:59,701070224.0,-784.8065,-5.99,1
23:59,701070224.0,-791.8065,-7.0,1
23:59,701070224.0,-810.7965,-18.99,6
23:59,807714284.0,1621.247060736,-12.99,1
23:59,807714284.0,1602.257060736,-18.99,6
23:59,752362502.0,8268.99031733032,-14.99,1
23:59,752362502.0,8253.00031733032,-15.99,1
23:59,691012931.0,-1613.472250000001,-7.99,1
23:59,691012931.0,-1632.462250000001,-18.99,6
23:59,978410962.0,-2846.5758395489725,-15.99,1
23:59,978410962.0,-2852.565839548972,-5.99,1
23:59,978410962.0,-2871.555839548972,-18.99,6
23:59,315546581.0,30232.304438925785,-15.99,1
23:59,315546581.0,30224.314438925783,-7.99,1
23:59,315546581.0,30205.32443892578,-18.99,6
23:59,978951113.0,-423.68134259041904,-7.99,1
23:59,978951113.0,-431.67134259041904,-7.99,7
23:59,978951113.0,-450.66134259041905,-18.99,6
23:59,504055745.0,578.4984613417669,-7.99,7
23:59,504055745.0,562.5084613417669,-15.99,1
23:59,504055745.0,547.5184613417669,-14.99,1
23:59,504055745.0,447.5184613417669,-100.0,6
23:59,775790822.0,-3129.155919216068,-7.0,1
23:59,775790822.0,-3136.155919216068,-7.0,1
23:59,775790822.0,-3143.155919216068,-7.0,1
23:59,775790822.0,-3150.155919216068,-7.0,1
23:59,775790822.0,-3169.145919216068,-18.99,6
23:59,775790822.0,-3177.1359192160676,-7.99,7
23:59,497772347.0,744.4637999999978,-15.99,1
23:59,497772347.0,725.4737999999978,-18.99,6
23:59,497772347.0,719.4837999999978,-5.99,1
23:59,497772347.0,706.4937999999978,-12.99,1
23:59,497772347.0,606.4937999999978,-100.0,6
23:59,779236304.0,2544.3975954795324,-7.99,1
23:59,779236304.0,2528.4075954795326,-15.99,1
23:59,779236304.0,2515.417595479533,-12.99,1
23:59,779236304.0,2415.417595479533,-100.0,6
23:59,779236304.0,2396.427595479533,-18.99,6
23:59,346874167.0,590.458149999999,-18.99,6
23:59,346874167.0,575.468149999999,-14.99,1
23:59,346874167.0,559.478149999999,-15.99,1
23:59,703478110.0,5839.874731849387,-15.99,1
23:59,675806859.0,8167.739646765971,-15.99,1
23:59,675806859.0,8159.749646765971,-7.99,7
23:59,925659248.0,-582.3608392295712,-18.99,6
23:59,925659248.0,-598.3508392295712,-15.99,1
23:59,925659248.0,-606.3408392295712,-7.99,1
23:59,572333122.0,-3700.685049999997,-15.99,1
23:59,572333122.0,-3715.675049999996,-14.99,1
23:59,572333122.0,-3721.665049999996,-5.99,1
23:59,572333122.0,-3734.655049999996,-12.99,1
23:59,572333122.0,-3741.655049999996,-7.0,1
23:59,572333122.0,-3760.645049999995,-18.99,6
23:59,938992364.0,705.4476437313995,-18.99,6
23:59,938992364.0,605.4476437313995,-100.0,6
23:59,938992364.0,597.4576437313995,-7.99,1
23:59,938992364.0,591.4676437313994,-5.99,1
23:59,938992364.0,585.4776437313994,-5.99,1
23:59,948069469.0,-569.613600000001,-5.99,1
23:59,948069469.0,-584.603600000001,-14.99,1
23:59,948069469.0,-591.603600000001,-7.0,1
23:59,948069469.0,-597.5936000000011,-5.99,1
23:59,948069469.0,-613.5836000000011,-15.99,1
23:59,948069469.0,-621.5736000000011,-7.99,1
23:59,948069469.0,-640.5636000000011,-18.99,6
23:59,659008214.0,-3384.347602290423,-15.99,1
23:59,659008214.0,-3392.337602290422,-7.99,1
23:59,865748375.0,4573.340208924523,-15.99,1
23:59,865748375.0,4565.350208924523,-7.99,1
23:59,865748375.0,4552.360208924523,-12.99,1
23:59,865748375.0,4545.360208924523,-7.0,1
23:59,865748375.0,4539.3702089245235,-5.99,1
23:59,865748375.0,4526.380208924524,-12.99,1
23:59,865748375.0,4507.390208924524,-18.99,6
23:59,105375973.0,30.189652818940555,-18.99,6
23:59,105375973.0,14.199652818940557,-15.99,1
23:59,105375973.0,6.209652818940555,-7.99,7
23:59,857754342.0,1512.569876279814,-18.99,6
23:59,857754342.0,1506.579876279814,-5.99,1
23:59,603721739.0,1841.840899483184,-15.99,1
23:59,603721739.0,1741.840899483184,-100.0,6
23:59,603721739.0,1722.850899483184,-18.99,6
23:59,140893085.0,7205.2030563654625,-18.99,6
23:59,479456865.0,2235.415699583305,-18.99,6
23:59,479456865.0,2229.425699583305,-5.99,1
23:59,479456865.0,2214.435699583305,-14.99,1
23:59,479456865.0,2198.445699583305,-15.99,1
23:59,479456865.0,2190.4556995833054,-7.99,7
23:59,496865819.0,-90.72343184268244,-100.0,6
23:59,496865819.0,-98.71343184268244,-7.99,1
23:59,496865819.0,-106.70343184268242,-7.99,7
23:59,496865819.0,-125.6934318426824,-18.99,6
23:59,466649401.0,1194.3327935520877,-18.99,6
23:59,466649401.0,1178.3427935520876,-15.99,1
23:59,466649401.0,1170.3527935520876,-7.99,7
23:59,466649401.0,1164.3627935520876,-5.99,1
23:59,466649401.0,1064.3627935520876,-100.0,6
23:59,175452235.0,262.7112500000003,-18.99,6
23:59,175452235.0,247.72125000000028,-14.99,1
23:59,175452235.0,240.72125000000028,-7.0,1
23:59,175452235.0,233.72125000000028,-7.0,1
23:59,175452235.0,227.73125000000027,-5.99,1
23:59,310375875.0,2754.0449638516347,-15.99,1
23:59,310375875.0,2741.054963851635,-12.99,1
23:59,310375875.0,2722.064963851635,-18.99,6
23:59,868377987.0,3381.049909635548,-7.0,1
23:59,868377987.0,3368.059909635548,-12.99,1
23:59,868377987.0,3353.0699096355484,-14.99,1
23:59,868377987.0,3334.0799096355486,-18.99,6
23:59,868377987.0,3318.089909635549,-15.99,1
23:59,868377987.0,3310.099909635549,-7.99,7
23:59,133755851.0,-203.9407518617478,-7.99,1
23:59,133755851.0,-219.9307518617478,-15.99,1
23:59,133755851.0,-234.92075186174785,-14.99,1
23:59,133755851.0,-240.91075186174783,-5.99,1
23:59,133755851.0,-246.90075186174784,-5.99,1
23:59,133755851.0,-252.89075186174784,-5.99,1
23:59,261894284.0,-2442.8737999999967,-15.99,1
23:59,261894284.0,-2461.8637999999964,-18.99,6
23:59,261894284.0,-2561.8637999999964,-100.0,6
23:59,261894284.0,-2568.8637999999964,-7.0,1
23:59,647936800.0,2998.323578243151,-15.99,1
23:59,647936800.0,2990.3335782431514,-7.99,7
23:59,647936800.0,2890.3335782431514,-100.0,6
23:59,758160963.0,9459.84850706394,-14.99,1
23:59,758160963.0,9452.84850706394,-7.0,1
23:59,758160963.0,9446.85850706394,-5.99,1
23:59,758160963.0,9440.86850706394,-5.99,1
23:59,758160963.0,9421.87850706394,-18.99,6
23:59,758160963.0,9413.88850706394,-7.99,7
23:59,758160963.0,9397.89850706394,-15.99,1
23:59,758160963.0,9297.89850706394,-100.0,6
23:59,478412511.0,13072.35807019746,-100.0,6
23:59,478412511.0,13056.36807019746,-15.99,1
23:59,478412511.0,13037.37807019746,-18.99,6
23:59,844835978.0,10898.849205781897,-7.99,7
23:59,844835978.0,10885.859205781897,-12.99,1
23:59,844835978.0,10872.869205781895,-12.99,1
23:59,844835978.0,10857.879205781896,-14.99,1
23:59,844835978.0,10844.889205781898,-12.99,1
23:59,374994043.0,-2303.7680500000006,-15.99,1
23:59,374994043.0,-2322.7580500000004,-18.99,6
23:59,147341222.0,-1492.0702753207954,-15.99,1
23:59,147341222.0,-1500.0602753207954,-7.99,1
23:59,147341222.0,-1519.0502753207954,-18.99,6
23:59,147341222.0,-1619.0502753207954,-100.0,6
23:59,147341222.0,-1634.0402753207954,-14.99,1
23:59,147341222.0,-1641.0402753207954,-7.0,1
23:59,147341222.0,-1654.0302753207957,-12.99,1
23:59,147341222.0,-1660.0202753207957,-5.99,1
23:59,448279144.0,1505.5549999999992,-18.99,6
23:59,448279144.0,1489.5649999999991,-15.99,1
23:59,448279144.0,1481.5749999999991,-7.99,7
23:59,448279144.0,1466.5849999999991,-14.99,1
23:59,448279144.0,1459.5849999999991,-7.0,1
23:59,448279144.0,1452.5849999999991,-7.0,1
23:59,448279144.0,1446.5949999999991,-5.99,1
23:59,620227043.0,-1966.860271013424,-15.99,1
23:59,345582855.0,651.1958528205494,-15.99,1
23:59,859264768.0,564.9111337819384,-18.99,6
23:59,859264768.0,556.9211337819384,-7.99,7
23:59,859264768.0,548.9311337819383,-7.99,1
23:59,567499591.0,-1429.8553000000004,-100.0,6
23:59,344843570.0,440.3181824906662,-15.99,1
23:59,296972867.0,-782.2861000000009,-18.99,6
23:59,215311171.0,7214.564255150088,-7.99,1
23:59,215311171.0,7198.574255150088,-15.99,1
23:59,215311171.0,7183.584255150088,-14.99,1
23:59,215311171.0,7176.584255150088,-7.0,1
23:59,215311171.0,7170.594255150088,-5.99,1
23:59,215311171.0,7155.604255150089,-14.99,1
23:59,215311171.0,7136.614255150089,-18.99,6
23:59,215311171.0,7036.614255150089,-100.0,6
23:59,668175891.0,1465.117223158499,-18.99,6
23:59,668175891.0,1365.117223158499,-100.0,6
23:59,668175891.0,1359.127223158499,-5.99,1
23:59,668175891.0,1352.127223158499,-7.0,1
23:59,668175891.0,1337.137223158499,-14.99,1
23:59,668175891.0,1321.147223158499,-15.99,1
23:59,143003091.0,11073.94514316596,-18.99,6
23:59,143003091.0,11066.94514316596,-7.0,1
23:59,143003091.0,11050.95514316596,-15.99,1
23:59,954263768.0,13.388599999999778,-14.99,1
23:59,954263768.0,-1.601400000000222,-14.99,1
23:59,954263768.0,-16.59140000000022,-14.99,1
23:59,954263768.0,-24.581400000000222,-7.99,7
23:59,954263768.0,-40.571400000000224,-15.99,1
23:59,135937041.0,-1050.7028482684118,-15.99,1
23:59,135937041.0,-1058.6928482684118,-7.99,7
23:59,135937041.0,-1073.6828482684118,-14.99,1
23:59,135937041.0,-1086.6728482684118,-12.99,1
23:59,221868392.0,5733.746193864469,-5.99,1
23:59,221868392.0,5720.756193864469,-12.99,1
23:59,221868392.0,5714.76619386447,-5.99,1
23:59,221868392.0,5698.77619386447,-15.99,1
23:59,221868392.0,5679.78619386447,-18.99,6
23:59,975345315.0,37408.037239282436,-18.99,6
23:59,975345315.0,37392.04723928244,-15.99,1
23:59,975345315.0,37377.05723928244,-14.99,1
23:59,975345315.0,37370.05723928244,-7.0,1
23:59,975345315.0,37364.06723928244,-5.99,1
23:59,280200287.0,-1861.120453386949,-15.99,1
23:59,280200287.0,-1869.110453386949,-7.99,1
23:59,583579399.0,2635.0586999999996,-15.99,1
23:59,583579399.0,2627.0687,-7.99,7
23:59,583579399.0,2614.0787,-12.99,1
23:59,583579399.0,2608.0887,-5.99,1
23:59,583579399.0,2589.0987000000005,-18.99,6
23:59,583579399.0,2489.0987000000005,-100.0,6
23:59,611143859.0,2290.3573000000115,-7.0,1
23:59,611143859.0,2275.3673000000117,-14.99,1
23:59,611143859.0,2256.377300000012,-18.99,6
23:59,611143859.0,2240.387300000012,-15.99,1
23:59,611143859.0,2232.3973000000124,-7.99,1
23:59,421881811.0,3929.733343886144,-15.99,1
23:59,421881811.0,3910.743343886144,-18.99,6
23:59,282046994.0,15.98535000000039,-14.99,1
23:59,282046994.0,-0.0046499999996107,-15.99,1
23:59,282046994.0,-18.99464999999961,-18.99,6
23:59,282046994.0,-118.9946499999996,-100.0,6
23:59,521611005.0,119.08536414895345,-7.99,1
23:59,521611005.0,103.09536414895344,-15.99,1
23:59,521611005.0,3.0953641489534505,-100.0,6
23:59,521611005.0,-15.894635851046548,-18.99,6
23:59,388862238.0,1830.821528473194,-18.99,6
23:59,388862238.0,1822.831528473194,-7.99,1
23:59,388862238.0,1814.841528473194,-7.99,7
23:59,388862238.0,1799.851528473194,-14.99,1
23:59,388862238.0,1792.851528473194,-7.0,1
23:59,817294757.0,-2422.4532999999997,-18.99,6
23:59,213930646.0,-1687.9945634725632,-12.99,1
23:59,213930646.0,-1703.9845634725632,-15.99,1
23:59,213930646.0,-1722.9745634725632,-18.99,6
23:59,124102251.0,4095.735931770645,-15.99,1
23:59,124102251.0,4076.7459317706457,-18.99,6
23:59,124102251.0,4069.7459317706457,-7.0,1
23:59,124102251.0,4063.7559317706455,-5.99,1
23:59,124102251.0,4050.7659317706457,-12.99,1
23:59,124102251.0,4037.775931770646,-12.99,1
23:59,349614277.0,1946.4345499999995,-15.99,1
23:59,349614277.0,1931.4445499999997,-14.99,1
23:59,349614277.0,1918.4545499999997,-12.99,1
23:59,349614277.0,1912.4645499999997,-5.99,1
23:59,349614277.0,1893.4745499999997,-18.99,6
23:59,475277431.0,1833.4581369436191,-5.99,1
23:59,475277431.0,1820.4681369436191,-12.99,1
23:59,736310094.0,-583.361024027426,-15.99,1
23:59,736310094.0,-598.351024027426,-14.99,1
23:59,736310094.0,-604.341024027426,-5.99,1
23:59,736310094.0,-611.341024027426,-7.0,1
23:59,264208990.0,1073.4194499999987,-14.99,1
23:59,264208990.0,1060.4294499999987,-12.99,1
23:59,264208990.0,1047.4394499999987,-12.99,1
23:59,264208990.0,1039.4494499999987,-7.99,1
23:59,264208990.0,1023.4594499999988,-15.99,1
23:59,192202372.0,527.6989338887979,-7.0,1
23:59,192202372.0,519.7089338887979,-7.99,7
23:59,192202372.0,500.7189338887979,-18.99,6
23:59,548638376.0,-360.9948132445335,-7.99,1
23:59,548638376.0,-379.9848132445335,-18.99,6
23:59,286484726.0,1231.0828267328864,-18.99,6
23:59,390747457.0,746.3383999999978,-15.99,1
23:59,390747457.0,738.3483999999978,-7.99,7
23:59,390747457.0,719.3583999999978,-18.99,6
23:59,885259672.0,3874.473507820305,-7.99,7
23:59,885259672.0,3855.483507820305,-18.99,6
23:59,348525881.0,1372.3166245949362,-18.99,6
23:59,348525881.0,1359.3266245949362,-12.99,1
23:59,348525881.0,1352.3266245949362,-7.0,1
23:59,348525881.0,1344.3366245949362,-7.99,1
23:59,779620857.0,-128.10134638517593,-15.99,1
23:59,779620857.0,-136.09134638517594,-7.99,1
23:59,779620857.0,-155.08134638517595,-18.99,6
23:59,661295096.0,3814.420513321748,-7.99,1
23:59,661295096.0,3806.430513321749,-7.99,7
23:59,661295096.0,3791.4405133217488,-14.99,1
23:59,661295096.0,3776.450513321749,-14.99,1
23:59,661295096.0,3770.460513321749,-5.99,1
23:59,661295096.0,3751.4705133217494,-18.99,6
23:59,782013626.0,3377.0051993116285,-15.99,1
23:59,782013626.0,3369.0151993116287,-7.99,7
23:59,782013626.0,3269.0151993116287,-100.0,6
23:59,122884111.0,-3460.996083072969,-18.99,6
23:59,122884111.0,-3560.996083072969,-100.0,6
23:59,122884111.0,-3568.986083072969,-7.99,1
23:59,122884111.0,-3584.976083072969,-15.99,1
23:59,136770968.0,-121.50340000000044,-7.0,1
23:59,136770968.0,-137.49340000000046,-15.99,1
23:59,136770968.0,-156.48340000000047,-18.99,6
23:59,903663593.0,1397.334958302563,-5.99,1
23:59,903663593.0,1382.344958302563,-14.99,1
23:59,903663593.0,1367.354958302563,-14.99,1
23:59,903663593.0,1354.364958302563,-12.99,1
23:59,903663593.0,1335.374958302563,-18.99,6
23:59,985188462.0,-269.8732112887753,-15.99,1
23:59,985188462.0,-277.8632112887753,-7.99,1
23:59,985188462.0,-296.8532112887753,-18.99,6
23:59,985188462.0,-303.8532112887753,-7.0,1
23:59,352291960.0,2775.137053303574,-7.99,1
23:59,964913066.0,-2290.469699999999,-7.99,7
23:59,964913066.0,-2306.459699999999,-15.99,1
23:59,964913066.0,-2319.4496999999988,-12.99,1
23:59,964913066.0,-2326.4496999999988,-7.0,1
23:59,964913066.0,-2341.4396999999985,-14.99,1
23:59,964913066.0,-2347.4296999999983,-5.99,1
23:59,964913066.0,-2366.419699999998,-18.99,6
23:59,195895574.0,8054.312970993026,-15.99,1
23:59,195895574.0,8046.322970993027,-7.99,7
23:59,195895574.0,8031.332970993027,-14.99,1
23:59,195895574.0,8025.342970993027,-5.99,1
23:59,195895574.0,8010.352970993027,-14.99,1
23:59,195895574.0,7991.362970993027,-18.99,6
23:59,971129830.0,-1049.750649999999,-7.0,1
23:59,971129830.0,-1064.740649999999,-14.99,1
23:59,971129830.0,-1083.730649999999,-18.99,6
23:59,971129830.0,-1099.720649999999,-15.99,1
23:59,971129830.0,-1107.710649999999,-7.99,7
23:59,615144184.0,1038.682599125519,-100.0,6
23:59,615144184.0,1030.6925991255189,-7.99,7
23:59,615144184.0,1023.6925991255188,-7.0,1
23:59,615144184.0,1008.7025991255188,-14.99,1
23:59,615144184.0,989.7125991255188,-18.99,6
23:59,550832673.0,3560.9020163955083,-18.99,6
23:59,550832673.0,3544.9120163955085,-15.99,1
23:59,550832673.0,3444.9120163955085,-100.0,6
23:59,550832673.0,3438.9220163955088,-5.99,1
23:59,550832673.0,3432.932016395509,-5.99,1
23:59,215404070.0,593.7345891798498,-18.99,6
23:59,215404070.0,577.7445891798498,-15.99,1
23:59,215404070.0,569.7545891798497,-7.99,7
23:59,215404070.0,563.7645891798497,-5.99,1
23:59,215404070.0,557.7745891798497,-5.99,1
23:59,583558311.0,-458.4722152486677,-12.99,1
23:59,583558311.0,-473.4622152486677,-14.99,1
23:59,583558311.0,-486.4522152486677,-12.99,1
23:59,583558311.0,-492.4422152486677,-5.99,1
23:59,583558311.0,-511.4322152486677,-18.99,6
23:59,131388684.0,23986.81801603339,-15.99,1
23:59,131388684.0,23978.82801603339,-7.99,1
23:59,131388684.0,23959.838016033387,-18.99,6
23:59,131388684.0,23844.848016033386,-100.0,6
23:59,596463612.0,-2076.1676047251385,-7.99,1
23:59,596463612.0,-2092.1576047251383,-15.99,1
23:59,596463612.0,-2111.147604725138,-18.99,6
23:59,936917570.0,-2798.9574999999973,-5.99,1
23:59,936917570.0,-2805.9574999999973,-7.0,1
23:59,936917570.0,-2812.9574999999973,-7.0,1
23:59,936917570.0,-2818.947499999997,-5.99,1
23:59,936917570.0,-2837.937499999997,-18.99,6
23:59,936917570.0,-2953.9274999999966,-15.99,1
23:59,936917570.0,-2961.9174999999964,-7.99,1
23:59,994947671.0,1370.4757000000004,-15.99,1
23:59,548907062.0,142.59348876828847,-15.99,1
23:59,548907062.0,123.60348876828849,-18.99,6
23:59,548907062.0,23.60348876828847,-100.0,6
23:59,699139822.0,2392.3183039008923,-15.99,1
23:59,699139822.0,2373.3283039008925,-18.99,6
23:59,449871732.0,11983.210665309867,-15.99,1
23:59,449871732.0,11975.220665309867,-7.99,7
23:59,449871732.0,11962.230665309868,-12.99,1
23:59,449871732.0,11956.240665309868,-5.99,1
23:59,449871732.0,11949.240665309868,-7.0,1
23:59,449871732.0,11936.250665309868,-12.99,1
23:59,449871732.0,11917.260665309868,-18.99,6
23:59,449871732.0,11817.260665309868,-100.0,6
23:59,383625050.0,3453.2141116357416,-15.99,1
23:59,383625050.0,3445.224111635742,-7.99,1
23:59,383625050.0,3426.234111635742,-18.99,6
23:59,822135975.0,12356.60694389752,-15.99,1
23:59,822135975.0,12348.61694389752,-7.99,1
23:59,822135975.0,12329.62694389752,-18.99,6
23:59,822135975.0,12316.636943897522,-12.99,1
23:59,822135975.0,12309.636943897522,-7.0,1
23:59,822135975.0,12303.646943897522,-5.99,1
23:59,639409800.0,37912.22406756825,-7.99,1
23:59,639409800.0,37896.23406756825,-15.99,1
23:59,639409800.0,37883.24406756825,-12.99,1
23:59,639409800.0,37870.254067568254,-12.99,1
23:59,639409800.0,37864.264067568256,-5.99,1
23:59,639409800.0,37858.27406756826,-5.99,1
23:59,639409800.0,37839.28406756826,-18.99,6
23:59,551755686.0,7260.233212897711,-15.99,1
23:59,551755686.0,7245.243212897712,-14.99,1
23:59,551755686.0,7226.253212897712,-18.99,6
23:59,155867488.0,912.2546999999984,-7.99,1
23:59,155867488.0,904.2646999999984,-7.99,7
23:59,155867488.0,885.2746999999983,-18.99,6
23:59,348325817.0,11783.366963952172,-100.0,6
23:59,348325817.0,11764.376963952172,-18.99,6
23:59,348325817.0,11748.386963952173,-15.99,1
23:59,426466211.0,-3296.4957499999996,-18.99,6
23:59,426466211.0,-3312.4857499999994,-15.99,1
23:59,426466211.0,-3412.4857499999994,-100.0,6
23:59,903468956.0,1284.5825999999993,-7.99,7
23:59,487051121.0,1533.4155683486915,-15.99,1
23:59,487051121.0,1525.4255683486915,-7.99,7
23:59,487051121.0,1519.4355683486915,-5.99,1
23:59,487051121.0,1512.4355683486915,-7.0,1
23:59,487051121.0,1505.4355683486915,-7.0,1
23:59,769311479.0,7052.021405832967,-12.99,1
23:59,769311479.0,7036.031405832967,-15.99,1
23:59,769311479.0,7017.041405832967,-18.99,6
23:59,572136270.0,352.5349115880233,-15.99,1
23:59,572136270.0,345.5349115880233,-7.0,1
23:59,572136270.0,330.5449115880233,-14.99,1
23:59,572136270.0,323.5449115880233,-7.0,1
23:59,785210466.0,2676.225619997711,-7.99,1
23:59,785210466.0,2660.235619997711,-15.99,1
23:59,785210466.0,2641.2456199977114,-18.99,6
23:59,785210466.0,2635.2556199977116,-5.99,1
23:59,785210466.0,2628.2556199977116,-7.0,1
23:59,493855007.0,-2666.4391315743924,-12.99,1
23:59,493855007.0,-2679.429131574392,-12.99,1
23:59,493855007.0,-2692.419131574392,-12.99,1
23:59,493855007.0,-2698.4091315743917,-5.99,1
23:59,493855007.0,-2714.3991315743915,-15.99,1
23:59,197865285.0,628.5541617312203,-15.99,1
23:59,197865285.0,620.5641617312203,-7.99,1
23:59,304455868.0,3402.175007684608,-18.99,6
23:59,304455868.0,3394.185007684608,-7.99,1
23:59,304455868.0,3378.1950076846083,-15.99,1
23:59,304455868.0,3371.1950076846083,-7.0,1
23:59,304455868.0,3364.1950076846083,-7.0,1
23:59,429235692.0,-912.5045000000002,-12.99,1
23:59,429235692.0,-928.4945000000002,-15.99,1
23:59,429235692.0,-936.4845000000004,-7.99,1
23:59,559995067.0,2995.8565555904243,-14.99,1
23:59,559995067.0,2980.8665555904245,-14.99,1
23:59,559995067.0,2967.8765555904247,-12.99,1
23:59,165691047.0,598.130899999999,-14.99,1
23:59,165691047.0,592.140899999999,-5.99,1
23:59,165691047.0,584.150899999999,-7.99,1
23:59,165691047.0,568.160899999999,-15.99,1
23:59,340680761.0,-3141.670599999997,-15.99,1
23:59,340680761.0,-3149.660599999997,-7.99,7
23:59,340680761.0,-3168.6505999999968,-18.99,6
23:59,340680761.0,-3175.6505999999968,-7.0,1
23:59,340680761.0,-3182.6505999999968,-7.0,1
23:59,423208402.0,1.8469500000025043,-18.99,6
23:59,423208402.0,-6.143049999997496,-7.99,1
23:59,423208402.0,-22.133049999997496,-15.99,1
23:59,651756497.0,15234.246420283427,-7.99,7
23:59,651756497.0,15218.25642028343,-15.99,1
23:59,651756497.0,15203.26642028343,-14.99,1
23:59,651756497.0,15184.27642028343,-18.99,6
23:59,355602925.0,1755.9930765753274,-7.0,1
23:59,355602925.0,1748.9930765753274,-7.0,1
23:59,355602925.0,1743.0030765753274,-5.99,1
23:59,355602925.0,1727.0130765753274,-15.99,1
23:59,355602925.0,1719.0230765753274,-7.99,1
23:59,355602925.0,1700.0330765753274,-18.99,6
23:59,932820758.0,-2574.779066775554,-7.0,1
23:59,932820758.0,-2581.779066775554,-7.0,1
23:59,932820758.0,-2588.779066775554,-7.0,1
23:59,932820758.0,-2604.7690667755537,-15.99,1
23:59,932820758.0,-2612.7590667755535,-7.99,1
23:59,524425303.0,-296.75900000000115,-18.99,6
23:59,524425303.0,-312.74900000000116,-15.99,1
23:59,524425303.0,-320.73900000000117,-7.99,7
23:59,524425303.0,-420.7390000000012,-100.0,6
23:59,474301748.0,-2736.089005683968,-15.99,1
23:59,474301748.0,-2744.079005683968,-7.99,1
23:59,474301748.0,-2750.0690056839676,-5.99,1
23:59,474301748.0,-2757.0690056839676,-7.0,1
23:59,474301748.0,-2764.0690056839676,-7.0,1
23:59,474301748.0,-2783.0590056839674,-18.99,6
23:59,704517789.0,18908.449983787385,-15.99,1
23:59,704517789.0,18889.459983787383,-18.99,6
23:59,776431321.0,3574.0919447979495,-7.99,7
23:59,776431321.0,3555.1019447979497,-18.99,6
23:59,744968736.0,-1481.8118265694238,-100.0,6
23:59,744968736.0,-1497.8018265694238,-15.99,1
23:59,280990953.0,651.7596999999985,-7.99,1
23:59,280990953.0,644.7596999999985,-7.0,1
23:59,280990953.0,638.7696999999985,-5.99,1
23:59,280990953.0,631.7696999999985,-7.0,1
23:59,280990953.0,618.7796999999985,-12.99,1
23:59,280990953.0,599.7896999999984,-18.99,6
23:59,422955974.0,323.4231349990498,-12.99,1
23:59,422955974.0,315.4331349990498,-7.99,1
23:59,422955974.0,296.4431349990498,-18.99,6
23:59,535744551.0,1261.351965995626,-7.99,1
23:59,535744551.0,1248.361965995626,-12.99,1
23:59,535744551.0,1229.371965995626,-18.99,6
23:59,480557476.0,12832.417256498184,-7.99,1
23:59,480557476.0,12732.417256498184,-100.0,6
23:59,480557476.0,12713.427256498184,-18.99,6
23:59,480557476.0,12698.437256498184,-14.99,1
23:59,480557476.0,12683.447256498184,-14.99,1
23:59,480557476.0,12676.447256498184,-7.0,1
23:59,480557476.0,12669.447256498184,-7.0,1
23:59,130522384.0,-145.6538156208603,-18.99,6
23:59,130522384.0,-161.64381562086032,-15.99,1
23:59,713057426.0,-855.2717500000002,-18.99,6
23:59,713057426.0,-863.2617500000002,-7.99,1
23:59,713057426.0,-963.2617500000002,-100.0,6
23:59,183888402.0,20281.87497328539,-14.99,1
23:59,183888402.0,20274.87497328539,-7.0,1
23:59,183888402.0,20255.88497328539,-18.99,6
23:59,183888402.0,20247.894973285387,-7.99,1
23:59,801500539.0,-3446.013699999999,-14.99,1
23:59,801500539.0,-3452.003699999999,-5.99,1
23:59,801500539.0,-3467.9936999999986,-15.99,1
23:59,801500539.0,-3486.9836999999984,-18.99,6
23:59,715068825.0,786.5244999999998,-15.99,1
23:59,715068825.0,686.5244999999998,-100.0,6
23:59,534097839.0,-4284.406049999998,-15.99,1
23:59,534097839.0,-4292.396049999998,-7.99,7
23:59,534097839.0,-4307.386049999997,-14.99,1
23:59,534097839.0,-4326.376049999997,-18.99,6
23:59,904154012.0,593.9674581204317,-15.99,1
23:59,904154012.0,587.9774581204317,-5.99,1
23:59,904154012.0,581.9874581204317,-5.99,1
23:59,904154012.0,575.9974581204317,-5.99,1
23:59,544961962.0,1312.954323005609,-14.99,1
23:59,544961962.0,1305.954323005609,-7.0,1
23:59,544961962.0,1292.964323005609,-12.99,1
23:59,544961962.0,1273.974323005609,-18.99,6
23:59,391688371.0,1379.6802995685232,-14.99,1
23:59,391688371.0,1366.6902995685232,-12.99,1
23:59,391688371.0,1351.7002995685232,-14.99,1
23:59,391688371.0,1335.7102995685232,-15.99,1
23:59,391688371.0,1327.7202995685232,-7.99,1
23:59,391688371.0,1308.7302995685232,-18.99,6
23:59,586315521.0,13487.45599513684,-14.99,1
23:59,586315521.0,13481.46599513684,-5.99,1
23:59,586315521.0,13473.47599513684,-7.99,1
23:59,586315521.0,13454.485995136842,-18.99,6
23:59,690523499.0,175.2655500000003,-18.99,6
23:59,690523499.0,168.2655500000003,-7.0,1
23:59,690523499.0,152.2755500000003,-15.99,1
23:59,690523499.0,144.28555000000028,-7.99,1
23:59,593191200.0,682.6996499999991,-18.99,6
23:59,593191200.0,676.7096499999991,-5.99,1
23:59,248658670.0,157.2166500000002,-15.99,1
23:59,248658670.0,149.22665000000018,-7.99,7
23:59,248658670.0,130.23665000000017,-18.99,6
23:59,160166876.0,1655.9500405862436,-18.99,6
23:59,160166876.0,1649.9600405862436,-5.99,1
23:59,160166876.0,1643.9700405862436,-5.99,1
23:59,809499628.0,18672.51981868682,-18.99,6
23:59,809499628.0,18656.529818686817,-15.99,1
23:59,809499628.0,18649.529818686817,-7.0,1
23:59,809499628.0,18636.539818686815,-12.99,1
23:59,809499628.0,18630.549818686817,-5.99,1
23:59,809499628.0,18617.559818686812,-12.99,1
23:59,631111289.0,-270.3565000000009,-7.99,1
23:59,631111289.0,-289.3465000000009,-18.99,6
23:59,631111289.0,-389.3465000000009,-100.0,6
23:59,897592348.0,16388.918772581732,-7.0,1
23:59,897592348.0,16369.928772581732,-18.99,6
23:59,897592348.0,16361.938772581732,-7.99,7
23:59,471897866.0,8622.800451551253,-5.99,1
23:59,471897866.0,8615.800451551253,-7.0,1
23:59,471897866.0,8609.810451551253,-5.99,1
23:59,471897866.0,8594.820451551253,-14.99,1
23:59,471897866.0,8586.830451551254,-7.99,7
23:59,471897866.0,8570.840451551254,-15.99,1
23:59,471897866.0,8551.850451551254,-18.99,6
23:59,540159353.0,12219.956098906445,-7.99,7
23:59,540159353.0,12200.966098906443,-18.99,6
23:59,310740977.0,681.7265265073347,-12.99,1
23:59,310740977.0,674.7265265073347,-7.0,1
23:59,310740977.0,661.7365265073347,-12.99,1
23:59,310740977.0,648.7465265073347,-12.99,1
23:59,310740977.0,632.7565265073347,-15.99,1
23:59,310740977.0,624.7665265073347,-7.99,7
23:59,310740977.0,524.7665265073347,-100.0,6
23:59,293609137.0,88.8994925744981,-5.99,1
23:59,293609137.0,81.8994925744981,-7.0,1
23:59,293609137.0,65.9094925744981,-15.99,1
23:59,293609137.0,57.9194925744981,-7.99,7
23:59,293609137.0,38.9294925744981,-18.99,6
23:59,633345190.0,6793.408091301469,-15.99,1
23:59,633345190.0,6785.418091301469,-7.99,7
23:59,633345190.0,6766.428091301469,-18.99,6
23:59,633345190.0,6753.438091301469,-12.99,1
23:59,633345190.0,6746.438091301469,-7.0,1
23:59,633345190.0,6740.4480913014695,-5.99,1
23:59,219399150.0,-926.0525269529268,-7.99,1
23:59,219399150.0,-933.0525269529268,-7.0,1
23:59,219399150.0,-952.0425269529268,-18.99,6
23:59,258201793.0,-394.85230000000024,-14.99,1
23:59,258201793.0,-413.84230000000025,-18.99,6
23:59,910730524.0,8498.366918730646,-15.99,1
23:59,910730524.0,8490.376918730646,-7.99,1
23:59,910730524.0,8471.386918730646,-18.99,6
23:59,651372390.0,-3630.215749999999,-15.99,1
23:59,525524239.0,-278.3776497888064,-15.99,1
23:59,525524239.0,-297.36764978880643,-18.99,6
23:59,392790315.0,-4404.386394372065,-18.99,6
23:59,392790315.0,-4412.376394372065,-7.99,1
23:59,392790315.0,-4428.366394372065,-15.99,1
23:59,392790315.0,-4443.356394372065,-14.99,1
23:59,392790315.0,-4456.346394372064,-12.99,1
23:59,392790315.0,-4471.336394372064,-14.99,1
23:59,392790315.0,-4477.326394372064,-5.99,1
23:59,392790315.0,-4577.326394372064,-100.0,6
23:59,982286721.0,-3442.0355240177296,-7.99,1
23:59,982286721.0,-3457.02552401773,-14.99,1
23:59,982286721.0,-3470.015524017729,-12.99,1
23:59,982286721.0,-3483.005524017729,-12.99,1
23:59,979135922.0,1460.6883005904508,-15.99,1
23:59,979135922.0,1452.6983005904508,-7.99,1
23:59,670102069.0,2398.9840814522413,-7.99,7
23:59,291580432.0,208.5677500000004,-12.99,1
23:59,291580432.0,201.5677500000004,-7.0,1
23:59,146909202.0,4495.040523427897,-15.99,1
23:59,146909202.0,4489.050523427897,-5.99,1
23:59,146909202.0,4470.060523427897,-18.99,6
23:59,287480331.0,9130.15896133595,-15.99,1
23:59,287480331.0,9111.16896133595,-18.99,6
23:59,305778936.0,11474.378387623008,-15.99,1
23:59,305778936.0,11455.388387623008,-18.99,6
23:59,305778936.0,11442.398387623009,-12.99,1
23:59,305778936.0,11342.398387623009,-100.0,6
23:59,890196840.0,-2876.0813166751304,-18.99,6
23:59,890196840.0,-2892.07131667513,-15.99,1
23:59,890196840.0,-2907.06131667513,-14.99,1
23:59,890196840.0,-2914.06131667513,-7.0,1
23:59,890196840.0,-2921.06131667513,-7.0,1
23:59,890196840.0,-3021.06131667513,-100.0,6
23:59,355940285.0,8103.882978189684,-7.99,7
23:59,355940285.0,8095.892978189684,-7.99,1
23:59,945054126.0,476.0581,-18.99,6
23:59,945054126.0,468.0681,-7.99,1
23:59,945054126.0,462.0780999999999,-5.99,1
23:59,945054126.0,449.08809999999994,-12.99,1
23:59,945054126.0,434.09809999999993,-14.99,1
23:59,945054126.0,421.1080999999999,-12.99,1
23:59,512989907.0,-2413.254403975366,-14.99,1
23:59,512989907.0,-2428.244403975366,-14.99,1
23:59,512989907.0,-2435.244403975366,-7.0,1
23:59,512989907.0,-2451.2344039753657,-15.99,1
23:59,173335108.0,2770.864,-7.99,1
23:59,173335108.0,2762.8740000000003,-7.99,7
23:59,173335108.0,2743.8840000000005,-18.99,6
23:59,189757473.0,-2217.1911499999997,-7.99,1
23:59,189757473.0,-2225.181149999999,-7.99,7
23:59,189757473.0,-2231.171149999999,-5.99,1
23:59,189757473.0,-2250.161149999999,-18.99,6
23:59,623156843.0,5263.094806328898,-15.99,1
23:59,623156843.0,5248.104806328898,-14.99,1
23:59,623156843.0,5229.114806328898,-18.99,6
23:59,518466565.0,1799.887599999999,-100.0,6
23:59,380911501.0,-8.172800000000839,-15.99,1
23:59,684988568.0,-212.4761734272015,-15.99,1
23:59,684988568.0,-220.4661734272015,-7.99,7
23:59,684988568.0,-239.45617342720152,-18.99,6
23:59,151278285.0,-1138.7858000000003,-15.99,1
23:59,151278285.0,-1144.7758000000003,-5.99,1
23:59,151278285.0,-1163.7658000000004,-18.99,6
23:59,329840194.0,1930.807890143148,-7.0,1
23:59,329840194.0,1922.817890143148,-7.99,1
23:59,329840194.0,1903.827890143148,-18.99,6
23:59,180616589.0,1292.0945281236177,-7.0,1
23:59,180616589.0,1276.1045281236177,-15.99,1
23:59,180616589.0,1257.1145281236177,-18.99,6
23:59,874431242.0,10246.57615688029,-7.99,7
23:59,874431242.0,10227.58615688029,-18.99,6
23:59,119943495.0,-1315.250062112858,-7.0,1
23:59,119943495.0,-1322.250062112858,-7.0,1
23:59,119943495.0,-1335.240062112858,-12.99,1
23:59,119943495.0,-1343.230062112858,-7.99,1
23:59,119943495.0,-1351.220062112858,-7.99,7
23:59,290751280.0,748.1027466748255,-5.99,1
23:59,290751280.0,733.1127466748255,-14.99,1
23:59,556992209.0,13130.27862447272,-12.99,1
23:59,556992209.0,13123.27862447272,-7.0,1
23:59,556992209.0,13107.28862447272,-15.99,1
23:59,556992209.0,13099.298624472722,-7.99,1
23:59,556992209.0,13080.308624472722,-18.99,6
23:59,969697937.0,-4747.472765670551,-14.99,1
23:59,969697937.0,-4763.462765670551,-15.99,1
23:59,969697937.0,-4771.45276567055,-7.99,1
23:59,969697937.0,-4871.45276567055,-100.0,6
23:59,969697937.0,-4890.44276567055,-18.99,6
23:59,604288474.0,2445.1371172444215,-7.99,1
23:59,604288474.0,2437.1471172444217,-7.99,7
23:59,604288474.0,2418.157117244422,-18.99,6
23:59,838830098.0,473.8131920877844,-15.99,1
23:59,838830098.0,465.8231920877844,-7.99,1
23:59,838830098.0,458.8231920877844,-7.0,1
23:59,838830098.0,439.8331920877844,-18.99,6
23:59,838830098.0,339.83319208778437,-100.0,6
23:59,237684254.0,6681.310099428765,-15.99,1
23:59,237684254.0,6673.320099428765,-7.99,1
23:59,237684254.0,6654.330099428766,-18.99,6
23:59,213096759.0,-1241.8641082144395,-7.99,7
23:59,213096759.0,-1260.8541082144395,-18.99,6
23:59,436430134.0,-495.4239013371817,-7.0,1
23:59,436430134.0,-501.4139013371817,-5.99,1
23:59,436430134.0,-523.4039013371817,-14.99,1
23:59,436430134.0,-539.3939013371817,-15.99,1
23:59,436430134.0,-558.3839013371817,-18.99,6
23:59,448004226.0,2020.5225235099765,-18.99,6
23:59,448004226.0,2004.5325235099765,-15.99,1
23:59,448004226.0,1996.5425235099765,-7.99,1
23:59,986774156.0,1824.3369316257697,-100.0,6
23:59,672913754.0,12354.991994680928,-15.99,1
23:59,672913754.0,12349.001994680928,-5.99,1
23:59,672913754.0,12342.001994680928,-7.0,1
23:59,672913754.0,12329.011994680928,-12.99,1
23:59,630468201.0,-514.4093338897017,-18.99,6
23:59,630468201.0,-530.3993338897017,-15.99,1
23:59,403902116.0,733.3982499999993,-12.99,1
23:59,403902116.0,726.3982499999993,-7.0,1
23:59,403902116.0,718.4082499999993,-7.99,1
23:59,403902116.0,699.4182499999993,-18.99,6
23:59,490790931.0,590.2276499999987,-15.99,1
23:59,490790931.0,582.2376499999987,-7.99,7
23:59,490790931.0,576.2476499999987,-5.99,1
23:59,490790931.0,570.2576499999986,-5.99,1
23:59,490790931.0,551.2676499999986,-18.99,6
23:59,490790931.0,451.26764999999864,-100.0,6
23:59,285115279.0,-3345.1845607892874,-15.99,1
23:59,285115279.0,-3353.174560789287,-7.99,7
23:59,285115279.0,-3368.164560789287,-14.99,1
23:59,575652395.0,3309.3569257837694,-12.99,1
23:59,575652395.0,3302.3569257837694,-7.0,1
23:59,575652395.0,3287.3669257837696,-14.99,1
23:59,575652395.0,3271.37692578377,-15.99,1
23:59,575652395.0,3263.38692578377,-7.99,7
23:59,575652395.0,3244.3969257837703,-18.99,6
23:59,656812046.0,1357.762753732519,-18.99,6
23:59,996042490.0,6891.847733173505,-15.99,1
23:59,996042490.0,6872.857733173505,-18.99,6
23:59,128033695.0,2692.599678342068,-14.99,1
23:59,128033695.0,2686.609678342068,-5.99,1
23:59,128033695.0,2667.6196783420683,-18.99,6
23:59,128033695.0,2651.6296783420685,-15.99,1
23:59,128033695.0,2643.6396783420687,-7.99,1
23:59,631744379.0,-2168.098759491067,-7.99,1
23:59,631744379.0,-2175.098759491067,-7.0,1
23:59,631744379.0,-2190.088759491067,-14.99,1
23:59,631744379.0,-2196.078759491066,-5.99,1
23:59,631744379.0,-2209.0687594910664,-12.99,1
23:59,631744379.0,-2228.058759491066,-18.99,6
23:59,576188756.0,-4140.0689999999995,-15.99,1
23:59,576188756.0,-4153.058999999999,-12.99,1
23:59,576188756.0,-4166.048999999999,-12.99,1
23:59,576188756.0,-4172.038999999999,-5.99,1
23:59,576188756.0,-4185.028999999999,-12.99,1
23:59,482513594.0,6752.295881267248,-7.99,1
23:59,482513594.0,6733.305881267248,-18.99,6
23:59,657528784.0,202.7989000000007,-15.99,1
23:59,657528784.0,194.80890000000073,-7.99,7
23:59,657528784.0,175.81890000000072,-18.99,6
23:59,445240363.0,-998.2810559632736,-15.99,1
23:59,445240363.0,-1017.2710559632736,-18.99,6
23:59,445240363.0,-1117.2710559632735,-100.0,6
23:59,445240363.0,-1130.2610559632735,-12.99,1
23:59,445240363.0,-1137.2610559632735,-7.0,1
23:59,250957494.0,1018.9770999999988,-15.99,1
23:59,250957494.0,1010.9870999999988,-7.99,1
23:59,250957494.0,995.9970999999988,-14.99,1
23:59,250957494.0,988.9970999999988,-7.0,1
23:59,250957494.0,976.0070999999988,-12.99,1
23:59,250957494.0,963.0170999999988,-12.99,1
23:59,250957494.0,944.0270999999988,-18.99,6
23:59,250957494.0,844.0270999999987,-100.0,6
23:59,854895960.0,4212.88517874872,-15.99,1
23:59,854895960.0,4193.89517874872,-18.99,6
23:59,290818242.0,7881.698172644421,-100.0,6
23:59,290818242.0,7865.708172644421,-15.99,1
23:59,290818242.0,7857.718172644421,-7.99,1
23:59,918772878.0,-1904.9545172453204,-100.0,6
23:59,918772878.0,-1923.9445172453204,-18.99,6
23:59,519933553.0,255.5210041507285,-7.99,7
23:59,519933553.0,239.53100415072845,-15.99,1
23:59,519933553.0,220.54100415072844,-18.99,6
23:59,519933553.0,120.54100415072844,-100.0,6
23:59,519933553.0,114.55100415072845,-5.99,1
23:59,519933553.0,99.56100415072844,-14.99,1
23:59,197779140.0,-138.61770000000035,-5.99,1
23:59,197779140.0,-151.60770000000036,-12.99,1
23:59,197779140.0,-164.59770000000037,-12.99,1
23:59,197779140.0,-179.58770000000038,-14.99,1
23:59,197779140.0,-279.5877000000004,-100.0,6
23:59,197779140.0,-298.5777000000004,-18.99,6
23:59,197779140.0,-314.5677000000004,-15.99,1
23:59,190874125.0,249.2830142135673,-15.99,1
23:59,190874125.0,234.2930142135673,-14.99,1
23:59,190874125.0,215.30301421356728,-18.99,6
23:59,340321732.0,2193.6070000000036,-15.99,1
23:59,340321732.0,2185.617000000004,-7.99,7
23:59,340321732.0,2085.617000000004,-100.0,6
23:59,340321732.0,2079.627000000004,-5.99,1
23:59,340321732.0,2072.627000000004,-7.0,1
23:59,705848712.0,28755.59410646868,-15.99,1
23:59,705848712.0,28740.60410646868,-14.99,1
23:59,705848712.0,28733.60410646868,-7.0,1
23:59,705848712.0,28714.61410646868,-18.99,6
23:59,705848712.0,28614.61410646868,-100.0,6
23:59,856957948.0,11043.163154533906,-15.99,1
23:59,856957948.0,11024.173154533906,-18.99,6
23:59,856957948.0,11011.183154533906,-12.99,1
23:59,856957948.0,11005.193154533908,-5.99,1
23:59,486495235.0,2592.1553893887167,-7.99,1
23:59,486495235.0,2576.165389388717,-15.99,1
23:59,486495235.0,2570.175389388717,-5.99,1
23:59,486495235.0,2564.1853893887173,-5.99,1
23:59,486495235.0,2558.1953893887176,-5.99,1
23:59,486495235.0,2545.205389388718,-12.99,1
23:59,486495235.0,2526.215389388718,-18.99,6
23:59,280268430.0,6088.134113114099,-18.99,6
23:59,807098817.0,945.4729499999992,-7.99,7
23:59,807098817.0,937.4829499999992,-7.99,1
23:59,456246119.0,21992.311909738568,-18.99,6
23:59,456246119.0,21984.321909738566,-7.99,7
23:59,456246119.0,21884.321909738566,-100.0,6
23:59,425964226.0,4372.8076500000025,-18.99,6
23:59,425964226.0,4356.817650000003,-15.99,1
23:59,425964226.0,4256.817650000003,-100.0,6
23:59,132400709.0,775.6720851539397,-7.0,1
23:59,132400709.0,769.6820851539397,-5.99,1
23:59,132400709.0,763.6920851539397,-5.99,1
23:59,132400709.0,756.6920851539397,-7.0,1
23:59,132400709.0,740.7020851539397,-15.99,1
23:59,132400709.0,732.7120851539397,-7.99,1
23:59,242218612.0,130.17630000000057,-18.99,6
23:59,242218612.0,122.18630000000056,-7.99,1
23:59,242218612.0,114.19630000000058,-7.99,7
23:59,522188082.0,9042.523465607424,-7.99,1
23:59,522188082.0,9026.533465607425,-15.99,1
23:59,522188082.0,9007.543465607425,-18.99,6
23:59,799286313.0,-888.6459128758615,-18.99,6
23:59,799286313.0,-896.6359128758615,-7.99,1
23:59,799286313.0,-996.6359128758615,-100.0,6
23:59,899692478.0,-1678.8565935240072,-15.99,1
23:59,899692478.0,-1686.8465935240072,-7.99,1
23:59,899692478.0,-1701.8365935240072,-14.99,1
23:59,899692478.0,-1708.8365935240072,-7.0,1
23:59,899692478.0,-1721.8265935240072,-12.99,1
23:59,899692478.0,-1740.8165935240072,-18.99,6
23:59,899692478.0,-1840.8165935240072,-100.0,6
23:59,924045955.0,3041.8335126586644,-18.99,6
23:59,924045955.0,3025.8435126586646,-15.99,1
23:59,924045955.0,3017.853512658665,-7.99,7
23:59,497809732.0,638.1198695525952,-15.99,1
23:59,497809732.0,619.1298695525952,-18.99,6
23:59,703537476.0,1292.283249999999,-7.99,1
23:59,703537476.0,1279.293249999999,-12.99,1
23:59,703537476.0,1273.303249999999,-5.99,1
23:59,703537476.0,1258.313249999999,-14.99,1
23:59,703537476.0,1239.323249999999,-18.99,6
23:59,449387287.0,930.8526938351016,-100.0,6
23:59,449387287.0,914.8626938351016,-15.99,1
23:59,449387287.0,906.8726938351016,-7.99,1
23:59,469561218.0,4.6779999999991535,-15.99,1
23:59,469561218.0,-3.3120000000008467,-7.99,7
23:59,469561218.0,-22.302000000000845,-18.99,6
23:59,518378868.0,-1468.8449000000005,-14.99,1
23:59,518378868.0,-1476.8349000000003,-7.99,7
23:59,518378868.0,-1495.8249000000003,-18.99,6
23:59,537487133.0,-72.47165000000051,-5.99,1
23:59,537487133.0,-87.4616500000005,-14.99,1
23:59,537487133.0,-93.4516500000005,-5.99,1
23:59,537487133.0,-112.4416500000005,-18.99,6
23:59,537487133.0,-128.4316500000005,-15.99,1
23:59,537487133.0,-136.4216500000005,-7.99,1
23:59,537487133.0,-236.4216500000005,-100.0,6
23:59,494156462.0,-1209.9218364817602,-15.99,1
23:59,494156462.0,-1217.9118364817602,-7.99,7
23:59,494156462.0,-1236.9018364817605,-18.99,6
23:59,248625662.0,-338.4369157151475,-18.99,6
23:59,248625662.0,-354.4269157151475,-15.99,1
23:59,248625662.0,-362.4169157151475,-7.99,7
23:59,163470640.0,1383.5750999999998,-15.99,1
23:59,163470640.0,1375.5850999999998,-7.99,7
23:59,163470640.0,1356.5950999999998,-18.99,6
23:59,163470640.0,1341.6050999999998,-14.99,1
23:59,163470640.0,1335.6150999999998,-5.99,1
23:59,163470640.0,1322.6250999999995,-12.99,1
23:59,163470640.0,1315.6250999999995,-7.0,1
23:59,163470640.0,1215.6250999999995,-100.0,6
23:59,300095518.0,1335.9786283414178,-7.0,1
23:59,151968462.0,8356.840119038496,-18.99,6
23:59,151968462.0,8350.850119038496,-5.99,1
23:59,151968462.0,8335.860119038496,-14.99,1
23:59,151968462.0,8320.870119038496,-14.99,1
23:59,151968462.0,8305.880119038497,-14.99,1
23:59,897714622.0,9811.561237939904,-15.99,1
23:59,897714622.0,9796.571237939905,-14.99,1
23:59,696333897.0,798.2124499999989,-12.99,1
23:59,696333897.0,785.2224499999988,-12.99,1
23:59,696333897.0,685.2224499999988,-100.0,6
23:59,696333897.0,677.2324499999988,-7.99,1
23:59,696333897.0,661.2424499999988,-15.99,1
23:59,696333897.0,642.2524499999988,-18.99,6
01:11,572384506.0,9077.44479961452,-37.74,9
01:12,558119802.0,35428.749046330544,-2.13,2
02:31,518474507.0,15496.427859928595,-26.89,9
02:32,822135975.0,12298.205174611054,-5.44,8
02:35,940569402.0,6780.294671678789,-16.9,9
02:38,414805878.0,14231.356788668612,-29.92,9
02:38,853907490.0,8379.54808460215,-14.9,9
02:44,252760664.0,7534.079830688413,-3.02,7
02:50,822250278.0,7262.243592010595,-64.48,7
02:58,653640811.0,18423.64433017085,-0.51,5
03:08,229205098.0,8414.265393821419,-15.94,9
03:09,853907490.0,8363.669838579524,-15.88,5
03:09,324224854.0,4920.925621995357,-38.46,5
03:11,433917275.0,8453.932599557122,-26.13,9
03:20,679662108.0,18960.1972271085,-2.98,2
03:21,769311479.0,6992.312328457114,-24.73,7
03:22,788740658.0,3022.5050831576327,-33.25,4
03:22,256002321.0,7493.680712079819,-19.25,9
03:22,809499628.0,18593.62981868681,-23.93,9
03:26,949032480.0,5184.89685353582,-31.6,9
03:27,815385232.0,11398.564592985727,-73.13,5
03:35,460463595.0,-270.4529454185789,-49.24,9
03:39,229205098.0,8413.53492645379,-0.73,2
03:41,304455868.0,3349.715879897875,-14.48,2
03:42,510101371.0,14557.88106800894,-37.42,9
03:42,601627384.0,4600.202644516357,-39.14,9
03:47,670102069.0,2356.7540814522413,-42.23,9
03:50,885259672.0,3846.177592381018,-9.31,7
03:53,766941757.0,3995.5306711219087,-32.89,9
03:57,264550521.0,11351.424221543251,-14.99,7
04:00,108481285.0,10023.659764100592,-17.73,5
04:04,633345190.0,6709.50809130147,-30.94,9
04:05,705848712.0,28599.24410646868,-15.37,9
04:08,675806859.0,8083.150632459889,-76.6,8
04:10,719586818.0,19584.64619836436,-6.5,4
04:11,461990622.0,10320.375700443366,-10.8,2
04:17,683319988.0,8251.751684069266,-32.19,9
04:19,183888402.0,20205.154973285385,-42.74,9
04:23,403383649.0,2250.430486470919,-24.48,5
04:24,766941757.0,3980.143352984951,-15.39,7
04:24,949032480.0,5164.21470327473,-20.68,8
04:24,113747882.0,13489.073251158268,-33.16,9
04:25,782013626.0,3237.215199311629,-31.8,9
04:27,556992209.0,13039.316013969958,-40.99,2
04:29,196289502.0,17000.633309543013,-13.99,9
04:33,450896297.0,14411.928118178668,-22.93,9
04:35,887853850.0,11403.034615192666,-27.19,9
04:37,890830949.0,1138.2481499999976,-23.2,9
04:38,668329719.0,9599.520639111044,-6.53,7
04:41,534325901.0,7565.916597027032,-15.0,9
04:42,865748375.0,4495.041749041106,-12.35,7
04:45,709608057.0,3331.8897336606865,-35.43,9
04:48,912705941.0,19668.598099548937,-2.24,7
04:49,699139822.0,2370.3267519806886,-3.0,2
04:50,200080192.0,10206.27446088958,-36.27,4
04:51,730002588.0,14450.781612501716,-6.96,7
04:52,287480331.0,9094.643634700527,-16.53,2
04:52,547010927.0,25458.839555512113,-14.98,9
04:52,683319988.0,8226.852511091602,-24.9,8
04:54,749378808.0,4773.020614995357,-55.28,2
04:55,473820682.0,12747.619450417882,-12.79,5
04:55,851181128.0,5574.61574111401,-37.08,9
04:56,108931112.0,15559.944030715971,-27.02,9
04:56,822718326.0,11999.48181847103,-29.45,7
04:57,282837512.0,15104.978036769362,-45.23,9
05:01,308505160.0,14229.995893900876,-62.31,7
05:04,331450202.0,8731.435757111161,-43.19,2
05:04,450896297.0,14362.86792384344,-49.06,7
05:05,581655972.0,43639.53769550305,-12.81,2
05:05,305778936.0,11309.645266266878,-32.75,2
05:05,886921642.0,3748.5025555728703,-66.8,5
05:05,506618547.0,18762.282728447804,-19.35,7
05:06,489964679.0,21556.50103909183,-43.6,9
05:11,987163717.0,6674.208480000005,-46.34,9
05:14,873693307.0,11267.126214577022,-19.4,9
05:15,994214354.0,10818.08919771433,-34.48,9
05:17,187541224.0,2809.89745664854,-41.15,9
05:19,348325817.0,11722.496963952171,-25.89,9
05:21,987656636.0,4802.081647702161,-5.84,2
05:28,897714622.0,9765.970505440182,-30.6,7
05:29,673025413.0,3894.757145644997,-24.27,5
05:29,383833857.0,27027.69196591404,-58.4,7
05:34,108563213.0,25941.705705885204,-7.53,8
05:34,940569402.0,6775.970672226705,-4.32,2
05:42,687135796.0,29733.52460378835,-10.9,9
05:43,520447032.0,9121.60273964566,-16.95,9
05:43,588565416.0,7286.097684918098,-54.12,5
05:43,874431242.0,10219.111263253217,-8.47,8
05:45,873693307.0,11266.68733095086,-0.44,4
05:47,858989281.0,28958.26100205841,-13.0,9
05:49,802697323.0,17619.96299917581,-31.62,9
05:50,348325817.0,11695.603955046152,-26.89,5
05:54,169006407.0,12731.723438103358,-14.33,7
05:59,984783496.0,15166.73597704301,-8.24,9
06:00,256002321.0,7478.649802860035,-15.03,4
06:03,795847804.0,24960.455985089746,-1.24,4
06:07,435984758.0,4813.980198790802,-71.38,2
06:11,633345190.0,6703.924632340376,-5.58,4
06:11,373875019.0,17841.78589245194,-64.13,7
06:12,785749304.0,9390.73832919519,-76.46,7
06:13,899742927.0,13837.06722036993,-3.69,7
06:13,836110591.0,7710.752629936911,-37.54,9
06:18,858989281.0,28939.24720258728,-19.01,7
06:21,706250160.0,13583.340440693202,-4.43,2
06:22,383625050.0,3419.823670042316,-6.41,8
06:27,547010927.0,25454.502056071564,-4.34,7
06:28,705848712.0,28597.222034532333,-2.02,7
06:30,176922958.0,1633.8355471976497,-26.89,9
06:32,496395938.0,13093.701380440503,-42.5,7
06:33,518474507.0,15487.914798425669,-8.51,5
06:34,541639148.0,4749.206273251512,-22.45,9
06:35,975345315.0,37356.390469479426,-7.68,7
06:40,282837512.0,15083.68545142457,-21.29,8
06:42,687135796.0,29718.116774879854,-15.41,2
06:43,480557476.0,12658.497256498184,-10.95,9
06:44,960208650.0,18692.736389604383,-15.76,5
06:45,905860285.0,12249.105371015516,-13.3,8
06:47,290818242.0,7808.043740247795,-49.67,5
06:47,196289502.0,16969.088317329966,-31.54,7
06:47,859603181.0,4192.72263317429,-0.58,7
06:50,482513594.0,6731.639412105149,-1.67,7
06:54,124102251.0,4030.659857500265,-7.12,7
06:55,832564361.0,17433.628402769857,-84.2,2
06:55,718058208.0,2667.8820826768037,-11.83,2
06:56,120634201.0,5650.885329403303,-22.3,9
06:57,851649498.0,11525.70911790131,-18.06,7
06:57,550169791.0,23160.99085123404,-4.77,2
06:58,985188462.0,-342.5432112887753,-38.69,9
07:02,511179916.0,8288.117860449975,-61.97,5
07:05,245690309.0,10595.733577415873,-9.97,8
07:10,930277104.0,11234.697444138268,-19.06,2
07:12,910730524.0,8455.830351491646,-15.56,2
07:14,203466392.0,4073.421935931349,-4.53,5
07:16,322221939.0,4755.701830113822,-15.13,2
07:17,901037631.0,1841.0193230964069,-5.95,9
07:18,973086490.0,11126.71188133701,-14.9,9
07:19,639549973.0,8252.617458663883,-3.44,7
07:23,604288474.0,2400.724775304438,-17.43,5
07:23,187111705.0,7700.865463592099,-26.95,5
07:23,532478725.0,5507.956652309637,-39.2,9
07:25,809499628.0,18571.257362046104,-22.37,7
07:31,624500124.0,3883.300217591751,-4.5,5
07:32,844835978.0,10836.937507961278,-7.95,8
07:34,128033695.0,2628.7903259333875,-14.85,8
07:34,613729471.0,10737.089155983718,-55.06,2
07:36,370521542.0,28500.587624364547,-7.09,5
07:38,842682241.0,6474.56280851182,-29.04,5
07:38,984783496.0,15144.21819901869,-22.52,2
07:40,709608057.0,3318.0151739274747,-13.87,2
07:41,657139925.0,15127.879269915044,-20.64,9
07:47,815993333.0,6911.96836675415,-13.5,2
07:51,609939116.0,8402.839900501742,-22.98,2
07:54,586315521.0,13434.277962613109,-20.21,7
07:59,851181128.0,5517.489488340273,-57.13,5
08:03,467207141.0,1025.7408670482637,-7.9,9
08:04,930271460.0,429.5200475357764,-5.65,9
08:04,235881534.0,14473.598554359358,-22.55,7
08:05,454129843.0,699.8330951665602,-5.65,9
08:05,950234174.0,2738.2546850744297,-43.72,2
08:05,399538448.0,8329.893173652621,-4.7,9
08:06,519935524.0,1421.107349737519,-5.0,9
08:07,285220959.0,12611.963857880675,-1.07,7
08:08,779946617.0,17674.440052659826,-8.63,5
08:08,901432314.0,4306.41818638877,-7.1,9
08:10,395284483.0,1856.9803402113084,-5.7,9
08:10,480557476.0,12607.16919487506,-51.33,2
08:12,336557504.0,2109.29648720102,-5.0,9
08:13,297823329.0,1005.2764499999992,-4.95,9
08:17,838830098.0,333.6331920877844,-6.2,9
08:21,948558249.0,10106.573631737076,-5.1,9
08:22,221868392.0,5665.118927613823,-14.67,5
08:22,280268430.0,6083.745076389159,-4.39,4
08:22,885259672.0,3840.1275923810176,-6.05,9
08:23,527842638.0,1179.8405926329835,-5.3,9
08:25,331450202.0,8702.049757111161,-29.39,5
08:28,189335192.0,-1033.2126017578605,-50.43,5
08:29,704517789.0,18863.299941873054,-26.16,2
08:30,651756497.0,15176.58940076318,-7.69,2
08:31,417850087.0,18633.040285002196,-62.91,5
08:31,987390838.0,-3047.1137412103776,-36.58,5
08:32,654329190.0,220.7654509485193,-37.05,5
08:33,992204045.0,8008.865213307556,-8.5,4
08:33,696758548.0,-3485.1128963201368,-39.11,5
08:33,768271776.0,-407.1226467665796,-62.82,5
08:34,384497904.0,654.2032499999991,-73.74,5
08:35,703537476.0,1161.854249999999,-77.47,5
08:37,833499132.0,2791.142000000002,-57.4,5
08:38,775790822.0,-3215.483419216067,-38.35,5
08:38,990461108.0,620.3846686206111,-69.39,5
08:38,867679563.0,102.30115370171583,-77.98,5
08:39,496865819.0,-143.76093184268242,-18.07,5
08:41,108931112.0,15421.491030715972,-138.45,5
08:43,143003091.0,11029.27481167586,-21.68,7
08:43,494789005.0,3631.54379685031,-57.36,5
08:43,237493332.0,15856.894938391786,-17.47,2
08:48,364357875.0,9100.48765727709,-127.57,5
08:49,262767079.0,-1125.0947000000003,-137.3,5
08:50,873701090.0,1096.1873389788768,-75.76,5
08:52,119993184.0,-2106.564402910862,-17.46,5
08:55,822718326.0,11976.98381847103,-22.5,5
08:56,919185264.0,4361.478493570697,-49.32,8
08:57,322221939.0,4647.7828301138225,-107.92,5
08:57,522188082.0,8961.645158195774,-45.9,8
08:57,392790315.0,-4659.016394372064,-81.69,5
08:58,828750680.0,2008.4526952136805,-115.85,5
08:59,891513205.0,637.769079659069,-128.56,5
08:59,540159353.0,12173.260098906443,-27.71,5
09:01,191992682.0,-2816.651460292063,-50.37,5
09:02,214339619.0,776.2153508683562,-5.05,9
09:04,558875206.0,3798.124310898954,-4.7,9
09:04,857997794.0,1446.395665150887,-58.27,5
09:05,620227043.0,-2056.522771013424,-89.66,5
09:05,535804582.0,-1394.2443500000013,-35.03,5
09:07,540159353.0,12166.360098906443,-6.9,9
09:07,364357875.0,9064.246144550374,-36.24,2
09:08,146686559.0,-539.7744111734779,-32.29,5
09:10,683078800.0,2414.589452944871,-7.3,9
09:11,581655972.0,43592.80569550305,-46.73,5
09:12,627936697.0,-115.10369999999988,-217.85,5
09:13,155317149.0,418.182399999999,-69.98,2
09:13,108931112.0,15413.862530715973,-7.63,4
09:13,683319988.0,8221.852511091602,-5.0,9
09:14,347110339.0,-200.61679250314816,-14.97,4
09:14,441274121.0,13259.83044065768,-6.6,9
09:14,960208650.0,18602.289389604382,-90.45,5
09:15,889916166.0,493.93340141322665,-18.97,4
09:16,283027736.0,684.0742439701728,-49.99,4
09:16,795847804.0,24907.346985089745,-53.11,5
09:17,407574996.0,-71.98339061906314,-67.26,2
09:17,690958123.0,22509.479485522537,-5.7,9
09:17,169006407.0,12725.923438103358,-5.8,9
09:17,979135922.0,1430.6783005904508,-22.02,2
09:17,143606916.0,556.1674540291897,-54.99,2
09:18,581655972.0,43586.70569550305,-6.1,9
09:18,857997794.0,1381.415665150887,-64.98,4
09:18,549414742.0,8371.619070846391,-63.89,2
09:18,519644021.0,3732.142420944862,-37.05,8
09:19,624563756.0,-49.5706712164436,-6.9,9
09:19,895331556.0,-224.8747000000009,-16.35,5
09:19,412823730.0,531.0502258504897,-28.03,2
09:19,355733816.0,5839.474832674864,-4.99,7
09:19,417850087.0,18625.540285002196,-7.5,9
09:19,422955974.0,251.45313499904975,-44.99,2
09:19,497809732.0,548.1498695525952,-70.98,2
09:19,611143859.0,1942.3973000000124,-290.0,9
09:20,331048953.0,369.9583679784936,-19.99,2
09:20,344843570.0,416.33818249066616,-23.98,7
09:21,215404070.0,544.7845891798497,-12.99,2
09:21,996042490.0,6842.867733173505,-29.99,2
09:22,722971557.0,165.42972084307553,-15.0,4
09:22,781554833.0,1445.8480255639663,-77.73,5
09:23,786141370.0,52.84479999999922,-37.99,2
09:23,299652176.0,482.9543832568792,-100.29,2
09:23,165098840.0,-192.72812636237308,-35.0,2
09:23,506618547.0,18756.332728447804,-5.95,9
09:23,117273481.0,9559.64506533524,-4.3,9
09:23,737547541.0,688.9245995677743,-19.99,2
09:23,338022396.0,784.614189375739,-33.95,7
09:23,421881811.0,3899.1230193382385,-11.62,4
09:24,165045150.0,1172.0760614028557,-31.95,1
09:24,618138606.0,1690.609702870066,-5.8,9
09:24,194745206.0,560.1383720912431,-74.2,2
09:24,667367404.0,9783.548441342286,-5.65,9
09:24,654329190.0,180.7854509485193,-39.98,2
09:25,709142813.0,1084.5895499999992,-42.94,7
09:25,280098744.0,965.7803778716656,-19.99,2
09:25,366550080.0,28188.02149223907,-9.59,2
09:25,992204045.0,8004.515213307555,-4.35,9
09:26,324046160.0,-240.28433321307105,-2.99,4
09:26,461029994.0,8462.627094096782,-21.98,4
09:26,909676212.0,1036.8294045320272,-64.98,2
09:26,621652856.0,1489.39996961054,-35.99,7
09:27,147508204.0,-130.15528221811343,-10.98,7
09:27,497809732.0,526.1498695525952,-22.0,2
09:28,872286364.0,-697.2331958130998,-128.54,5
09:28,346874167.0,412.488149999999,-146.99,2
09:28,300095518.0,1278.9786283414178,-57.0,2
09:28,641376155.0,192.22251210145112,-72.13,2
09:29,734161378.0,-2776.597669434212,-14.47,5
09:29,250895529.0,1580.3359824692882,-92.0,2
09:29,967989787.0,689.7079326407272,-69.98,2
09:30,480557476.0,12495.88319487506,-111.29,2
09:31,572384506.0,9011.67945455294,-65.77,2
09:31,143606916.0,396.18745402918967,-159.98,2
09:31,679662108.0,18909.1472271085,-51.05,2
09:31,849096144.0,2097.900020751343,-61.48,4
09:32,299652176.0,452.8843832568792,-30.07,2
09:32,293609137.0,235.94949257449812,-42.98,2
09:32,737547541.0,682.9345995677743,-5.99,2
09:33,711140907.0,1155.5284999999992,-11.98,4
09:33,996042490.0,6810.887733173506,-31.98,4
09:33,407574996.0,-120.09339061906314,-48.11,1
09:34,277562576.0,623.2550181051029,-59.97,4
09:34,168414279.0,206.34728427492132,-5.99,2
09:35,352291960.0,2751.157053303574,-23.98,1
09:35,469330905.0,1.782068029215523,-84.98,2
09:36,195895574.0,7983.693939494524,-7.67,2
09:36,680773155.0,874.2503833310916,-25.0,2
09:37,663479159.0,5002.613541827712,-36.96,7
09:37,909669130.0,757.7178847367666,-12.51,4
09:38,913127700.0,1927.728238011116,-83.55,5
09:38,280130290.0,66.06024999999948,-133.98,2
09:38,856461967.0,5.612353529492552,-99.98,1
09:39,402438092.0,1098.3822999999988,-110.6,2
09:39,358836279.0,643.1610928075858,-19.98,4
09:41,637433131.0,201.90259999999896,-24.0,4
09:41,261793952.0,803.3532602038149,-35.03,2
09:41,737547541.0,637.9545995677743,-44.98,2
09:41,347110339.0,-266.58679250314816,-65.97,4
09:41,280098744.0,952.3003778716655,-13.48,4
09:42,849096144.0,2068.940020751343,-28.96,7
09:42,324046160.0,-291.26433321307104,-50.98,2
09:42,414454079.0,1498.0478500000015,-5.07,4
09:42,621652856.0,1369.29996961054,-120.1,2
09:43,821971408.0,1393.2371102355432,-18.97,7
09:43,449387287.0,685.7006938351014,-221.17,2
09:44,293609137.0,200.9594925744981,-34.99,2
09:44,709142813.0,974.6095499999992,-109.98,2
09:44,535744551.0,1079.381965995626,-149.99,2
09:45,913801979.0,347.0846799144938,-37.87,5
09:45,556631012.0,765.1980730856782,-80.98,2
09:46,504055745.0,409.56846134176686,-37.95,7
09:46,412823730.0,502.51171585048974,-28.54,4
09:46,786141370.0,24.844799999999218,-28.0,2
09:46,514362267.0,726.6798191070602,-28.48,4
09:48,541639148.0,4712.4628590793145,-36.74,4
09:48,588565416.0,7258.147684918098,-27.95,1
09:48,773633520.0,920.2198109385116,-59.98,4
09:48,793781222.0,2083.808878947406,-4.99,1
09:50,722971557.0,37.439720843075534,-127.99,2
09:50,767447966.0,5653.631062706571,-13.96,7
09:51,673025413.0,3808.951145644997,-85.81,5
09:51,518466565.0,1586.9175999999993,-212.97,2
09:51,147508204.0,-155.15528221811343,-25.0,2
09:51,117308635.0,1408.162101478339,-97.31,5
09:52,760704118.0,1694.620312717489,-51.98,2
09:52,179173981.0,5618.766843018323,-46.29,4
09:53,283027736.0,649.0742439701728,-35.0,2
09:53,168414279.0,195.36728427492133,-10.98,1
09:54,194745206.0,497.9783720912432,-62.16,2
09:55,556631012.0,733.2080730856782,-31.99,2
09:57,967989787.0,589.7179326407272,-99.99,2
09:57,598793068.0,1012.2188499999982,-110.48,2
09:57,630691258.0,404.1765448748413,-5.99,2
09:58,475277431.0,1798.488136943619,-21.98,4
09:58,402438092.0,988.1472999999988,-110.24,2
09:58,324046160.0,-319.26433321307104,-28.0,2
09:58,293609137.0,182.97949257449812,-17.98,4
09:59,480557476.0,12308.983194875062,-186.9,2
09:59,601627384.0,4572.472644516358,-27.73,1
09:59,145387690.0,5951.735751299882,-11.34,7
09:59,524425303.0,-520.2390000000012,-99.5,2
10:00,938992364.0,512.4276437313995,-73.05,2
10:01,143383029.0,17.943330652338645,-61.97,2
10:01,348525881.0,1286.3566245949362,-57.98,2
10:01,192202372.0,399.2389338887979,-101.48,4
10:01,160166876.0,1607.9900405862436,-35.98,2
10:02,641376155.0,167.1725121014511,-25.05,2
10:03,358836279.0,578.1710928075858,-64.99,2
10:03,283027736.0,599.0742439701728,-50.0,2
10:03,903953091.0,4546.827038995666,-15.97,7
10:03,154246234.0,202.53489210210412,-45.97,2
10:03,535744551.0,1061.401965995626,-17.98,4
10:05,152616936.0,1118.7570078630647,-44.95,7
10:05,575652395.0,3242.5287370538736,-1.87,2
10:06,331048953.0,339.0083679784936,-30.95,7
10:07,781554833.0,1340.8680255639665,-104.98,2
10:07,137913631.0,880.0621999999996,-79.97,2
10:07,538003940.0,2588.920000000009,-43.96,4
10:08,344843570.0,381.3081824906661,-35.03,2
10:08,722971557.0,20.459720843075537,-16.98,4
10:09,933745726.0,7.113556429323268,-78.73,5
10:10,160166876.0,1458.0100405862436,-149.98,2
10:10,261793952.0,660.2432602038149,-143.11,2
10:11,660561861.0,740.30478743765,-22.0,2
10:11,250895529.0,1567.3459824692882,-12.99,2
10:12,283027736.0,508.0942439701728,-90.98,2
10:12,264550521.0,11264.834221543251,-86.59,2
10:12,299652176.0,446.8743832568792,-6.01,2
10:12,679662108.0,18825.8612271085,-83.29,2
10:12,930277104.0,11214.107444138268,-20.59,2
10:12,556631012.0,712.2380730856781,-20.97,1
10:13,903953091.0,4541.327038995666,-5.5,9
10:13,165098840.0,-299.7081263623731,-106.98,6
10:13,134461671.0,6654.921497495748,-9.58,5
10:14,346874167.0,384.488149999999,-28.0,2
10:15,867679563.0,83.32115370171583,-18.98,2
10:16,978951113.0,-470.65134259041906,-19.99,2
10:16,519649533.0,88.58181637066218,-104.5,7
10:19,554792076.0,29938.184412192462,-0.49,7
10:20,497809732.0,504.1698695525952,-21.98,4
10:23,779376323.0,4084.4232458196566,-84.0,2
10:23,480557476.0,12144.511194875062,-164.47,2
10:23,524425303.0,-674.7390000000012,-154.5,2
10:24,427909748.0,2184.6432000000145,-66.97,4
10:24,261793952.0,655.2532602038149,-4.99,1
10:25,979135922.0,1350.6183005904509,-80.06,2
10:25,762896656.0,267.1624981518587,-128.12,2
10:26,338022396.0,735.644189375739,-48.97,2
10:27,828750680.0,1936.48269521368,-71.97,4
10:27,773633520.0,894.2498109385115,-25.97,7
10:29,938992364.0,473.8691237313995,-38.56,4
10:29,155867488.0,790.0746999999983,-95.2,2
10:31,143383029.0,-77.53666934766136,-95.48,2
10:32,300095518.0,1246.9886283414178,-31.99,2
10:32,555804115.0,-1154.4235475587034,-42.36,2
10:34,709151315.0,376.2692183741599,-6.99,1
10:35,284161641.0,175.0323110405757,-24.97,4
10:38,258201793.0,-476.23480000000023,-62.39,5
10:38,448004226.0,1960.602523509976,-35.94,7
10:38,615144184.0,877.7425991255188,-111.97,2
10:39,572384506.0,8988.944014552939,-22.74,4
10:40,524425303.0,-796.7390000000012,-122.0,2
10:40,250895529.0,1476.3659824692882,-90.98,2
10:42,155867488.0,631.2026999999983,-158.87,2
10:42,490790931.0,413.27764999999863,-37.99,2
10:44,300095518.0,1182.0186283414178,-64.97,2
10:45,261793952.0,617.2332602038149,-38.02,2
10:45,520447032.0,9097.812261837564,-23.79,7
10:45,967989787.0,567.7179326407272,-22.0,2
10:47,685959099.0,2476.0068660992433,-85.97,4
10:47,519649533.0,-100.41818362933782,-189.0,4
10:48,556631012.0,667.2480730856781,-44.99,2
10:49,130522384.0,-221.64381562086032,-60.0,2
10:53,386277162.0,374.3299999999995,-12.98,7
10:54,299652176.0,351.61438325687925,-95.26,2
10:55,143383029.0,-135.01666934766138,-57.48,2
10:58,779376323.0,3934.9232458196566,-149.5,2
10:59,427909748.0,2141.7132000000147,-42.93,7
10:59,424927189.0,44.65083274410519,-77.98,2
11:01,490790931.0,360.3076499999986,-52.97,2
11:01,555804115.0,-1235.401047558703,-80.98,2
11:02,283027736.0,479.1342439701728,-28.96,1
11:02,598793068.0,900.2588499999981,-111.96,2
11:03,299652176.0,291.4543832568793,-60.16,2
11:05,324046160.0,-380.24433321307106,-60.98,2
11:06,331048953.0,314.0083679784936,-25.0,2
11:08,155867488.0,465.3306999999984,-165.87,2
11:09,147508204.0,-187.14528221811344,-31.99,2
11:11,857997794.0,1301.425665150887,-79.99,2
11:13,555804115.0,-1350.8860475587032,-115.48,2
11:14,143383029.0,-225.01666934766135,-90.0,2
11:15,237684254.0,6607.389512246085,-46.94,7
11:16,895331556.0,-269.8247000000009,-44.95,7
11:16,849096144.0,2023.960020751343,-44.98,6
11:17,347110339.0,-314.57679250314817,-47.99,2
11:19,130522384.0,-277.62381562086034,-55.98,2
11:19,556631012.0,648.7680730856781,-18.48,4
11:20,480557476.0,12045.12519487506,-99.39,2
11:20,324046160.0,-400.23433321307107,-19.99,4
11:22,293609137.0,152.98949257449812,-29.99,2
11:23,679662108.0,18585.0892271085,-240.77,2
11:24,709151315.0,351.2692183741599,-25.0,2
11:28,402438092.0,909.7947999999988,-78.35,2
11:30,570410059.0,2396.552646776311,-35.0,2
11:33,299652176.0,271.40438325687927,-20.05,2
11:34,978951113.0,-500.6413425904191,-29.99,4
11:35,259015404.0,1873.4421271347585,-33.69,4
11:36,950234174.0,2708.0246850744297,-30.23,2
11:39,641376155.0,127.1125121014511,-40.06,2
11:40,857997794.0,1279.425665150887,-22.0,2
11:42,250895529.0,1426.435982469288,-49.93,1
11:42,709151315.0,288.29921837415986,-62.97,2
11:44,155867488.0,388.3306999999984,-77.0,2
11:45,402438092.0,856.1922999999989,-53.6,2
11:47,679662108.0,18378.6032271085,-206.49,2
11:49,641376155.0,67.0025121014511,-60.11,2
11:51,155867488.0,238.5586999999984,-149.77,2
11:54,793781222.0,2013.828878947406,-69.98,2
11:54,534204159.0,6407.530491584736,-12.87,7
11:55,807098817.0,907.4829499999992,-30.0,4
11:57,660561861.0,692.33478743765,-47.97,2
11:58,347110339.0,-344.5667925031482,-29.99,2
11:58,857997794.0,1244.485665150887,-34.94,1
12:01,719742742.0,-498.4000077779633,-29.74,9
12:07,213096759.0,-1279.7541082144396,-18.9,9
12:08,155867488.0,122.4006999999984,-116.16,2
12:09,347110339.0,-413.5567925031482,-68.99,2
12:09,938992364.0,413.8291237313995,-60.04,2
12:09,299652176.0,252.36438325687928,-19.04,2
12:11,293609137.0,76.01949257449812,-76.97,4
12:12,711140907.0,1133.5684999999992,-21.96,7
12:13,143383029.0,-317.5166693476614,-92.5,2
12:13,779376323.0,3852.9232458196566,-82.0,2
12:13,879091637.0,574.377523737977,-22.37,2
12:18,792845450.0,1538.865150000001,-31.85,9
12:30,679662108.0,18224.617227108494,-153.99,2
12:30,456246119.0,21881.821909738566,-2.5,4
12:31,402438092.0,822.8322999999989,-33.36,2
12:33,358836279.0,568.1810928075857,-9.99,2
12:34,585625048.0,2516.4302320528427,-31.99,2
12:34,749378808.0,4743.290614995358,-29.73,9
12:35,685959099.0,2434.0268660992433,-41.98,2
12:36,519649533.0,-200.41818362933785,-100.0,4
12:36,331048953.0,279.0083679784936,-35.0,2
12:37,137913631.0,835.0721999999996,-44.99,2
12:44,348325817.0,11600.089235046153,-95.51,4
12:46,402438092.0,708.0972999999989,-114.73,2
12:51,299652176.0,170.14438325687928,-82.22,2
12:52,688712152.0,7115.322017176151,-145.6,2
12:52,454356905.0,2318.2450492553553,-1.3,7
12:55,155867488.0,59.41469999999842,-62.99,2
12:55,598793068.0,808.2788499999981,-91.98,2
12:56,779376323.0,3735.9232458196566,-117.0,2
12:59,564214408.0,-31.609915274274,-20.62,5
13:00,642015139.0,183.80383746563828,-19.41,5
13:00,977899503.0,291.13689358085264,-160.15,2
13:02,548907062.0,-84.37651123171153,-107.98,2
13:03,585625048.0,2511.1302320528425,-5.3,9
13:04,402438092.0,617.3697999999989,-90.73,2
13:05,348325817.0,11594.989235046152,-5.1,9
13:05,143383029.0,-442.5066693476614,-124.99,2
13:05,344843570.0,286.22818249066614,-95.08,2
13:07,773633520.0,839.2598109385115,-54.99,2
13:07,793781222.0,1919.858878947406,-93.97,2
13:07,688712152.0,7108.822017176151,-6.5,9
13:08,130522384.0,-377.6138156208603,-99.99,2
13:08,277562576.0,616.3550181051029,-6.9,9
13:09,596171893.0,675.535594825511,-25.97,1
13:09,630691258.0,399.1765448748413,-5.0,9
13:10,519649533.0,-319.4181836293378,-119.0,4
13:10,849096144.0,2019.6600207513432,-4.3,9
13:12,660561861.0,664.83478743765,-27.5,4
13:14,938992364.0,353.84912373139946,-59.98,1
13:15,358836279.0,545.2110928075857,-22.97,1
13:16,548907062.0,-91.36651123171151,-6.99,4
13:16,155867488.0,-21.771300000001578,-81.19,2
13:17,412823730.0,440.4717158504897,-62.04,2
13:17,593191200.0,532.0322499999991,-144.68,5
13:17,261793952.0,575.2132602038149,-42.02,2
13:18,322221939.0,4642.082830113823,-5.7,9
13:18,970298834.0,3051.8130445564148,-0.01,2
13:19,854895960.0,4091.77917874872,-102.12,5
13:20,918772878.0,-1938.4720172453203,-14.53,5
13:22,187111705.0,7695.065463592099,-5.8,9
13:24,812692024.0,4256.28670666393,-5.1,9
13:25,407574996.0,-125.89339061906314,-5.8,9
13:25,412823730.0,420.4617158504897,-20.01,2
13:25,685959099.0,2409.0768660992435,-24.95,4
13:30,779376323.0,3591.9232458196566,-144.0,2
13:30,621652856.0,1362.79996961054,-6.5,9
13:30,807098817.0,826.5029499999991,-80.98,2
13:36,578131296.0,883.4477194440437,-5.98,4
13:41,143383029.0,-651.4966693476614,-208.99,2
13:44,660561861.0,532.85478743765,-131.98,2
13:44,647472692.0,27194.513746878343,-61.54,7
13:45,331048953.0,264.03836797849357,-14.97,4
13:45,497772347.0,594.5137999999978,-11.98,7
13:47,519649533.0,-490.4181836293378,-171.0,7
13:49,556631012.0,618.7980730856781,-29.97,2
13:53,641376155.0,43.98251210145111,-23.02,1
13:54,783650950.0,-737.3906434110116,-121.86,5
14:02,280130290.0,27.570249999999483,-38.49,2
14:04,136770968.0,-222.8770000000005,-66.39,5
14:06,412823730.0,320.39171585048973,-100.07,2
14:09,615144184.0,797.7625991255188,-50.0,2
14:11,165098840.0,-412.6881263623731,-112.98,2
14:15,143383029.0,-724.4866693476614,-72.99,2
14:17,807098817.0,776.5129499999991,-49.99,4
14:17,615144184.0,727.7825991255188,-69.98,2
14:18,737537711.0,-485.37446639846434,-30.26,5
14:23,578131296.0,835.4577194440437,-47.99,2
14:28,449387287.0,579.3566938351014,-106.34,5
14:33,194745206.0,458.3513720912431,-39.63,5
14:34,578131296.0,833.9577194440437,-1.5,4
14:37,168414279.0,65.38728427492134,-129.98,2
14:38,280130290.0,-138.4097500000005,-165.98,2
14:40,347110339.0,-435.52679250314816,-21.97,1
14:41,709151315.0,266.29921837415986,-22.0,2
14:53,283027736.0,405.1542439701728,-73.98,2
14:53,807098817.0,751.5129499999991,-25.0,2
14:57,168414279.0,49.40728427492134,-15.98,4
15:01,358836279.0,425.3610928075857,-119.85,4
15:03,449387287.0,426.7706938351014,-152.59,2
15:03,508518911.0,341.9847502790103,-4.99,7
15:04,578131296.0,823.9677194440437,-9.99,2
15:05,283027736.0,373.1642439701728,-31.99,2
15:09,412823730.0,238.33171585048973,-82.06,2
15:11,904154012.0,554.0274581204317,-21.97,7
15:15,165098840.0,-512.6781263623731,-99.99,6
15:16,373875019.0,17724.80589245194,-116.98,2
15:19,168414279.0,-2.582715725078664,-51.99,2
15:21,283027736.0,338.17424397017277,-34.99,2
15:23,709151315.0,169.31921837415985,-96.98,2
15:25,679911053.0,3434.8883075183862,-38.74,2
15:25,720742759.0,1449.7989808830073,-33.95,1
15:27,867987292.0,3003.580042547226,-22.53,7
15:28,711140907.0,1111.5684999999992,-22.0,2
15:29,347110339.0,-523.5167925031482,-87.99,2
15:29,155867488.0,-73.55730000000158,-51.79,2
15:34,449387287.0,220.99869383510136,-205.77,2
15:41,143383029.0,-802.9666693476614,-78.48,2
15:42,414454079.0,1495.0078500000018,-3.04,4
15:47,448279144.0,1406.614999999999,-39.98,2
15:52,660561861.0,517.37478743765,-15.48,4
15:54,941285623.0,1655.7163990667705,-15.98,4
15:54,155317149.0,396.182399999999,-22.0,2
15:57,155867488.0,-158.94330000000156,-85.39,2
15:57,744968736.0,-1530.826826569424,-33.02,5
15:59,425730826.0,2652.50690938872,-59.98,2
16:05,143383029.0,-906.9666693476614,-104.0,2
16:09,274818272.0,655.7951785671314,-29.99,2
16:12,329840194.0,1781.347890143148,-122.48,2
16:13,155867488.0,-322.74330000000157,-163.8,2
16:13,283027736.0,278.19424397017275,-59.98,2
16:19,274818272.0,611.7951785671314,-44.0,2
16:20,587225252.0,6600.372939936504,-39.12,9
16:22,776108637.0,1358.2485536574954,-45.45,5
16:23,532478725.0,5491.141897931429,-16.81,2
16:24,170233640.0,-421.8812600501027,-46.97,4
16:25,310375875.0,2659.0854256574585,-62.98,4
16:27,409971170.0,3555.0032989943434,-10.23,7
16:31,256045540.0,-3638.3163999999992,-27.28,5
16:33,899692478.0,-1878.9210935240071,-38.1,5
16:35,155867488.0,-529.2293000000016,-206.49,2
16:36,380228542.0,275.7117418155656,-147.98,2
16:38,329840194.0,1761.297890143148,-20.05,7
16:39,860360312.0,366.5580588826804,-86.98,2
16:41,653667523.0,3774.144899570016,-60.86,5
16:41,551755686.0,7189.283212897712,-36.97,4
16:43,283027736.0,178.20424397017274,-99.99,2
16:44,679662108.0,18167.931227108496,-56.69,2
16:44,170233640.0,-447.7763600501027,-25.9,5
16:44,628470485.0,1004.2370299001232,-99.98,4
16:46,762700245.0,1084.1477000000025,-34.99,2
16:48,673818591.0,1791.1221753758407,-28.95,1
16:53,679662108.0,18052.431227108496,-115.5,2
16:54,603721739.0,1702.8808994831838,-19.97,7
16:55,183186021.0,-1261.6400499999988,-36.86,5
16:56,303843160.0,586.9080000000015,-37.95,1
16:58,492215823.0,3718.4992938154446,-12.51,4
16:59,610450243.0,-608.6445999999999,-23.98,2
17:00,776108637.0,1303.2685536574954,-54.98,2
17:03,241459011.0,1228.384013272347,-44.98,2
17:04,108481285.0,9935.333764100593,-88.33,5
17:04,964702094.0,1313.473037640289,-99.99,2
17:04,546296727.0,-45.44227269738154,-103.98,2
17:06,297823329.0,874.4642999999992,-130.81,5
17:06,143383029.0,-992.4566693476614,-85.49,2
17:06,679662108.0,17766.845227108497,-285.59,2
17:08,303843160.0,560.9280000000015,-25.98,4
17:09,838830098.0,283.6331920877844,-50.0,2
17:09,955035930.0,2467.9134791714773,-17.94,9
17:11,624500124.0,3766.778217591751,-116.52,5
17:15,690523499.0,127.30555000000028,-16.98,4
17:17,752362502.0,8252.839412912075,-0.16,2
17:19,771125520.0,1146.7347999999993,-31.95,7
17:20,886921642.0,3716.93255557287,-31.57,5
17:21,971010829.0,527.7350564442452,-41.95,7
17:22,678330503.0,3791.3412302291304,-323.4,5
17:22,280268430.0,6069.26507638916,-14.48,4
17:23,409971170.0,3533.264589749405,-21.74,7
17:23,559995067.0,2842.5905555904246,-125.29,2
17:23,519935524.0,1411.097349737519,-10.01,2
17:23,678330503.0,3775.200422698488,-16.14,5
17:24,822135975.0,12296.175174611051,-2.03,4
17:24,844835978.0,10809.97750796128,-26.96,7
17:25,836110591.0,7501.480629936911,-209.27,2
17:26,435984758.0,4804.422118790802,-9.56,4
17:26,656317661.0,57.491641541402736,-6.99,1
17:26,706250160.0,13276.740440693202,-306.6,2
17:27,999752672.0,1950.8268935333344,-38.97,2
17:27,366477356.0,971.4288499999998,-142.97,2
17:27,141521177.0,8421.733900000016,-71.99,2
17:28,758885184.0,1394.9571822743446,-25.0,2
17:28,690523499.0,60.315550000000286,-66.99,2
17:29,414805878.0,14126.666788668612,-104.69,2
17:29,361201224.0,4099.987886533854,-142.55,2
17:31,291580432.0,165.5677500000004,-36.0,4
17:33,626989363.0,1155.9710633173752,-11.98,7
17:34,143383029.0,-1181.436669347661,-188.98,2
17:35,641764023.0,-1035.9713037720046,-28.39,5
17:36,846550094.0,1881.864771501413,-1.99,4
17:37,857754342.0,1456.589876279814,-49.99,4
17:38,957821152.0,-1578.6154535715498,-56.21,5
17:38,679662108.0,17617.087227108495,-149.76,2
17:38,857754342.0,1434.089876279814,-22.5,9
17:38,308068836.0,1517.368522568192,-10.0,2
17:39,698076160.0,7074.179710241275,-70.14,5
17:39,660874296.0,3332.2524499608494,-24.34,2
17:40,752362502.0,8235.779412912076,-17.06,7
17:41,424397946.0,1244.5097836054,-81.98,2
17:41,519935524.0,1397.560329737519,-13.54,4
17:41,143383029.0,-1294.9266693476611,-113.49,2
17:41,990461108.0,610.3946686206111,-9.99,7
17:42,220183538.0,936.7839999999994,-4.99,7
17:42,639409800.0,37830.46266875074,-8.82,5
17:44,466649401.0,905.6804935520876,-158.68,5
17:46,833499132.0,2758.1920000000023,-32.95,7
17:46,679662108.0,17498.129227108497,-118.96,2
17:46,245690309.0,10544.801577415872,-50.93,5
17:46,344219145.0,8834.762330975842,-224.69,2
17:47,349614277.0,1886.4845499999997,-6.99,7
17:47,699997811.0,977.546650000004,-41.99,2
17:47,653640811.0,18391.624330170845,-32.02,2
17:48,388862238.0,1744.476528473194,-48.38,2
17:49,769311479.0,6959.002328457113,-33.31,1
17:49,887853850.0,11368.13356502038,-34.9,7
17:50,454129843.0,616.1428451665602,-83.69,5
17:50,578131296.0,798.0077194440437,-25.96,1
17:50,534325901.0,7564.601275948503,-1.32,2
17:50,859264768.0,542.9411337819383,-5.99,4
17:51,130154096.0,1350.555001705878,-35.95,7
17:51,836110591.0,7287.994629936911,-213.49,2
17:53,660874296.0,3209.2674499608493,-122.98,2
17:53,198051483.0,-916.7469104088568,-21.42,5
17:54,303843160.0,525.9280000000015,-35.0,2
17:55,316793091.0,1027.154260054951,-31.99,2
17:56,642924505.0,674.014670183526,-33.95,1
17:59,616924659.0,263.4145798230852,-112.98,2
18:00,399538448.0,8267.903173652621,-61.99,2
18:02,344219145.0,8697.618330975842,-137.14,2
18:03,897592348.0,16218.382772581732,-143.56,5
18:06,270374623.0,11261.721823069163,-12.25,9
18:06,559995067.0,2616.4905555904247,-226.1,2
18:07,310375875.0,2611.3154256574585,-47.77,9
18:09,939972497.0,1788.1795586000108,-126.72,5
18:10,280130290.0,-217.8997500000005,-79.49,2
18:11,487051121.0,1386.4355683486915,-119.0,2
18:12,336171116.0,-457.8147000000006,-88.92,5
18:14,131388684.0,23794.798016033383,-50.05,5
18:14,124125096.0,396.556744387802,-46.02,5
18:19,678851253.0,4759.349823570852,-48.99,2
18:21,559995067.0,2474.4325555904247,-142.06,2
18:21,679662108.0,17422.543227108497,-75.59,2
18:22,868377987.0,3221.023159635549,-89.08,5
18:25,450896297.0,14361.30273384344,-1.57,7
18:26,151968462.0,8280.883773293162,-20.07,7
18:26,280130290.0,-282.3997500000005,-64.5,2
18:27,452974357.0,-3718.218949999994,-23.46,5
18:27,851649498.0,11402.85911790131,-122.85,5
18:29,824916823.0,9772.280871788898,-32.48,9
18:30,901432314.0,4276.36018638877,-30.06,5
18:30,806358207.0,13925.726022859391,-53.32,7
18:31,994214354.0,10805.3835995328,-12.71,7
18:33,678330503.0,3752.220422698488,-22.98,9
18:34,613427466.0,7144.730455264376,-133.75,5
18:36,995615876.0,2218.4944896983884,-60.83,5
18:37,270374623.0,11247.559891743023,-14.16,5
18:38,587225252.0,6587.030230669705,-13.34,2
18:38,982286721.0,-3515.990524017729,-32.98,5
18:40,448279144.0,1384.634999999999,-21.98,7
18:42,679662108.0,17329.485227108496,-93.06,2
18:43,912584712.0,1358.284619544733,-111.59,5
18:44,986267641.0,9028.61665093811,-9.37,2
18:44,521611005.0,-55.87463585104655,-39.98,4
18:45,173317688.0,-2396.448734884284,-42.96,5
18:46,834383043.0,5631.774657761605,-32.98,2
18:49,344522228.0,-2896.2394882083927,-5.61,5
18:53,785749304.0,9383.34832919519,-7.39,9
18:56,786141370.0,-28.860600000000787,-53.71,5
18:56,678851253.0,4681.649823570852,-77.7,2
19:01,399144202.0,2449.597708638708,-11.79,7
19:07,399144202.0,2415.397708638708,-34.2,9
19:08,108931112.0,15391.202824527378,-22.66,2
19:08,656317661.0,-165.70895845859727,-223.2,5
19:08,670102069.0,2337.1550023379027,-19.6,2
19:09,535744551.0,957.981165995626,-103.42,5
19:09,414805878.0,14123.321168435486,-3.35,2
19:11,503575533.0,8577.339251971305,-132.17,5
19:16,512989907.0,-2481.076903975366,-29.84,5
19:16,213112754.0,7318.248560569875,-82.57,5
19:16,623156843.0,5182.108738297076,-47.01,8
19:16,713910252.0,337.22587572854115,-111.62,5
19:18,932820758.0,-2677.6790667755536,-64.92,5
19:19,137822385.0,3796.591101541067,-38.42,5
19:23,315546581.0,30194.722847642548,-10.6,5
19:23,424397946.0,1189.7417836054,-54.77,5
19:30,873701090.0,945.1133389788768,-151.07,5
19:30,678851253.0,4573.849823570852,-107.8,2
19:31,890567652.0,289.8133496796006,-126.74,5
19:32,920031185.0,767.3236794837078,-60.95,5
19:34,433917275.0,8435.627692976701,-18.3,2
19:36,540159353.0,12157.50305415327,-8.86,2
19:40,701070224.0,-1042.75515,-231.96,5
19:46,954263768.0,-56.917100000000225,-16.35,5
19:50,316793091.0,904.182460054951,-122.97,5
19:51,291580432.0,129.07920000000038,-36.49,5
20:03,678851253.0,4509.477823570852,-64.37,2
20:04,680773155.0,839.5639833310915,-34.69,5
20:13,511179916.0,8180.114860449975,-108.0,5
20:20,601627384.0,4562.328288585635,-10.14,7
20:21,195895574.0,7956.043939494524,-27.65,9
20:24,143383029.0,-1542.6059193476613,-247.68,5
20:31,166019891.0,8973.021483832565,-21.41,5
20:32,221868392.0,5630.978927613823,-34.14,9
20:41,391559884.0,14.42404999999934,-310.76,5
20:41,486495235.0,2519.848664202182,-6.37,2
20:43,586041848.0,59.61169999999889,-89.38,5
20:44,806358207.0,13892.22830183904,-33.5,2
20:47,248658670.0,103.21415000000016,-27.02,5
20:47,152488934.0,2136.684057313731,-69.96,5
20:50,893134725.0,1267.1438376616677,-24.9,9
20:51,441274121.0,13257.370621017417,-2.46,7
20:56,858989281.0,28776.93120258728,-162.32,5
21:00,504055745.0,374.5894613417669,-34.98,5
21:10,454356905.0,2279.4550492553553,-38.79,9
21:22,930277104.0,11180.927444138268,-33.18,9
21:48,146909202.0,4440.789635562483,-29.27,7
21:49,489964679.0,21543.018928952763,-13.48,7
00:38,370521542.0,28491.37124554691,-9.22,7
01:56,987656636.0,4792.490205516076,-9.59,7
01:58,575652395.0,3198.540633988293,-43.99,8
02:11,970298834.0,3050.2206156598204,-1.59,8
02:31,547010927.0,25442.318108024934,-12.18,5
02:34,679662108.0,17319.746789439152,-9.74,4
02:35,844835978.0,10787.527507961278,-22.45,9
02:36,399144202.0,2391.557708638708,-23.84,9
02:37,779946617.0,17635.80769629465,-38.63,7
02:42,287480331.0,9052.453634700529,-42.19,9
02:44,994214354.0,10785.2035995328,-20.18,9
02:52,822718326.0,11966.033818471027,-10.95,9
02:53,853907490.0,8335.853751414788,-27.82,2
02:56,836110591.0,7252.364629936911,-35.63,9
03:00,887853850.0,11340.88356502038,-27.25,9
03:05,522188082.0,8900.499274563274,-61.15,2
03:09,806358207.0,13883.254099406244,-8.97,2
03:13,287480331.0,9024.216476134789,-28.24,2
03:23,858989281.0,28759.98120258728,-16.95,9
03:27,836110591.0,7226.045136852543,-26.32,7
03:35,256002321.0,7457.249802860036,-21.4,9
03:40,549414742.0,8335.17907084639,-36.44,9
03:40,151968462.0,8242.383609528872,-38.5,4
03:40,887853850.0,11325.324474531986,-15.56,7
03:42,851181128.0,5487.059488340273,-30.43,9
03:48,421881811.0,3872.7258890005346,-26.4,7
03:55,480557476.0,12041.845271388842,-3.28,8
03:55,183888402.0,20164.814973285385,-40.34,9
04:01,500043411.0,14653.92705325737,-38.8,5
04:02,719586818.0,19576.32113880127,-8.33,7
04:02,449871732.0,11815.547586548471,-1.71,2
04:11,987229118.0,1878.823836364856,-19.92,2
04:13,639409800.0,37819.532742371644,-10.93,2
04:15,490790931.0,320.8176499999986,-39.49,9
04:16,252760664.0,7512.744974387018,-21.33,2
04:17,912705941.0,19635.86669464642,-32.73,7
04:18,187541224.0,2774.21745664854,-35.68,9
04:27,859603181.0,4177.746311861926,-14.98,7
04:29,108931112.0,15347.472824527378,-43.73,9
04:29,270374623.0,11246.396611813896,-1.16,8
04:33,409971170.0,3490.697013658843,-42.57,7
04:36,348325817.0,11565.939235046151,-29.05,9
04:37,994214354.0,10766.784567252109,-18.42,7
04:42,940569402.0,6754.270672226705,-21.7,9
04:43,392270893.0,13635.615165806104,-7.84,7
04:45,899742927.0,13805.154836229493,-31.91,7
04:45,120634201.0,5630.945329403304,-19.94,9
04:46,554792076.0,29937.826389785903,-0.36,7
04:48,749378808.0,4740.558115109184,-2.73,7
04:49,441274121.0,13248.620621017417,-8.75,9
04:52,113747882.0,13440.193251158267,-48.88,9
04:55,657139925.0,15114.629269915044,-13.25,9
05:03,897714622.0,9741.980569431142,-23.99,4
05:04,873693307.0,11244.03733095086,-22.65,9
05:06,108481285.0,9925.797246901077,-9.54,4
05:07,609939116.0,8342.504291336449,-60.34,5
05:10,858989281.0,28743.46572396476,-16.52,7
05:12,802697323.0,17588.512999175808,-31.45,9
05:13,651756497.0,15147.74940076318,-28.84,9
05:14,984783496.0,15131.129938888247,-13.09,7
05:18,950234174.0,2674.842369963383,-33.18,5
05:29,706250160.0,13239.168094709456,-37.57,2
05:31,769311479.0,6935.570430781227,-23.43,2
05:32,851649498.0,11400.83709841493,-2.02,2
05:34,282837512.0,15045.51545142457,-38.17,9
05:35,873693307.0,11226.660074647449,-17.38,5
05:37,146909202.0,4426.632985724662,-14.16,7
05:37,633345190.0,6668.934632340376,-34.99,9
05:39,930277104.0,11155.137444138269,-25.79,9
05:42,245690309.0,10532.351577415871,-12.45,9
05:43,134461671.0,6627.292621250166,-27.63,7
05:43,822135975.0,12295.396688718203,-0.78,7
05:44,324224854.0,4892.762711841247,-28.16,8
05:45,874431242.0,10194.421263253214,-24.69,9
05:46,287230540.0,1594.9522932932662,-24.5,9
05:46,285873880.0,13124.0727344085,-19.82,8
05:49,705848712.0,28584.282034532334,-12.94,9
05:49,364357875.0,9063.0061113853,-1.24,2
05:51,670102069.0,2311.435002337903,-25.72,9
05:53,766941757.0,3951.4133529849514,-28.73,9
05:55,651756497.0,15073.993057561978,-73.76,7
05:57,832564361.0,17385.456641584868,-48.17,2
06:00,216285378.0,25362.997384634906,-31.63,9
06:04,534204159.0,6366.852243270784,-40.68,5
06:04,237493332.0,15841.9486370817,-14.95,5
06:07,604288474.0,2321.846654217042,-78.88,7
06:09,450896297.0,14328.47273384344,-32.83,9
06:12,699139822.0,2356.5787337595434,-13.75,7
06:14,315078351.0,8502.585937467298,-65.48,7
06:16,433917275.0,8416.0376929767,-19.59,9
06:20,624500124.0,3764.6841897787303,-2.09,2
06:22,572384506.0,8983.039186310867,-5.9,2
06:24,842682241.0,6466.199284390896,-8.36,4
06:25,290818242.0,7787.430335577895,-20.61,2
06:25,128033695.0,2595.271067891601,-33.52,7
06:29,435984758.0,4797.392727459423,-7.03,7
06:31,494789005.0,3555.912793302319,-75.63,2
06:31,795847804.0,24875.515025940236,-31.83,5
06:32,581655972.0,43585.100162614435,-1.61,7
06:37,383833857.0,27002.58712291351,-25.1,7
06:38,532478725.0,5471.425487528939,-19.72,7
06:39,454356905.0,2268.576610331798,-10.88,2
06:39,399144202.0,2357.1827387325543,-34.37,7
06:39,718058208.0,2648.6993062397064,-19.18,2
06:42,633345190.0,6645.453042146297,-23.48,2
06:43,169006407.0,12718.181195374696,-7.74,5
06:43,473820682.0,12711.950534998392,-35.67,7
06:43,259015404.0,1837.9521271347585,-35.49,9
06:44,943329213.0,1042.499991612945,-75.78,2
06:45,940569402.0,6725.300704694349,-28.97,2
06:46,601627384.0,4523.098288585636,-39.23,9
06:47,670102069.0,2287.6246052956612,-23.81,5
06:48,550169791.0,23123.692593127584,-37.3,2
06:50,987163717.0,6639.538480000005,-34.67,9
06:50,285220959.0,12585.801730607218,-26.16,8
06:52,985188462.0,-376.0832112887753,-33.54,9
06:52,414805878.0,14083.821168435486,-39.5,9
06:53,905860285.0,12235.88168701622,-13.22,2
06:53,108563213.0,25927.873230068697,-13.83,2
06:53,245690309.0,10521.309358542978,-11.04,2
06:54,433917275.0,8404.558470063834,-11.48,8
06:55,704517789.0,18859.871862221597,-3.43,5
06:55,221868392.0,5609.243872258018,-21.74,2
06:57,587225252.0,6550.600230669705,-36.43,9
07:00,441274121.0,13244.1866613973,-4.43,8
07:00,949032480.0,5131.89470327473,-32.32,9
07:01,417850087.0,18600.37792603175,-25.16,2
07:01,809499628.0,18504.313143459553,-66.94,5
07:02,145387690.0,5931.345751299882,-20.39,9
07:02,785749304.0,9336.03675581121,-47.31,7
07:03,930277104.0,11135.614359057308,-19.52,2
07:04,366550080.0,28114.219076064237,-73.8,7
07:05,779236304.0,2366.247595479533,-30.18,9
07:05,489964679.0,21514.598928952764,-28.42,9
07:08,623156843.0,5146.9883454598985,-35.12,5
07:12,678330503.0,3747.520422698488,-4.7,9
07:13,510101371.0,14534.21106800894,-23.67,9
07:13,776108637.0,1297.5685536574954,-5.7,9
07:14,973086490.0,11109.88385137674,-16.83,4
07:18,822250278.0,7239.480407518833,-22.76,2
07:18,667367404.0,9773.05073642842,-10.5,5
07:26,237684254.0,6536.219373978303,-71.17,2
07:28,482513594.0,6707.165219925837,-24.47,5
07:29,506618547.0,18751.82769633768,-4.51,7
07:30,383625050.0,3414.2750988152416,-5.55,5
07:31,187111705.0,7694.577440751495,-0.49,2
07:32,461990622.0,10306.943254631413,-13.43,5
07:34,199016328.0,4731.9538318827645,-19.8,7
07:35,558119802.0,35424.550189581285,-4.2,2
07:36,489964679.0,21489.201751374236,-25.4,2
07:41,846550094.0,1875.768165171468,-6.1,7
07:42,683319988.0,8184.102511091602,-37.75,9
07:43,361201224.0,4080.863098787924,-19.12,2
07:43,124102251.0,4002.276598682017,-28.38,7
07:47,655368335.0,5219.022092150994,-11.89,8
07:47,264550521.0,11263.156987457376,-1.68,2
07:51,496395938.0,13080.853737566047,-12.85,5
07:55,653640811.0,18376.187279208458,-15.44,5
07:57,310375875.0,2580.8654256574587,-30.45,9
08:02,885259672.0,3834.7775923810177,-5.35,9
08:02,678851253.0,4449.689026328273,-59.79,2
08:03,454129843.0,610.2428451665602,-5.9,9
08:04,305778936.0,11292.615266266876,-17.03,9
08:04,213112754.0,7272.758420728159,-45.49,8
08:06,709608057.0,3280.3251739274747,-37.69,9
08:06,399538448.0,8262.253173652622,-5.65,9
08:07,647472692.0,27152.586351580005,-41.93,8
08:11,380228542.0,269.5617418155656,-6.15,9
08:11,395284483.0,1851.2803402113084,-5.7,9
08:11,949032480.0,5092.425661869267,-39.47,8
08:13,331450202.0,8678.557345729705,-23.49,5
08:14,762700245.0,1077.3477000000023,-6.8,9
08:14,586315521.0,13427.859256323987,-6.42,7
08:15,297823329.0,868.3142999999992,-6.15,9
08:15,336557504.0,2104.29648720102,-5.0,9
08:17,613729471.0,10704.411102685368,-32.68,2
08:19,519644021.0,3672.4015586855776,-59.74,7
08:19,567499591.0,-1479.8899000000004,-50.03,5
08:24,668329719.0,9585.558863624674,-13.96,5
08:24,518474507.0,15484.515499865283,-3.4,7
08:24,633345190.0,6640.403042146297,-5.05,9
08:25,531186970.0,5452.38688373582,-14.97,5
08:26,170637730.0,3135.883626255588,-13.79,8
08:28,744398361.0,-414.2970000000004,-95.3,5
08:29,905860285.0,12155.30468701622,-80.58,5
08:29,518466565.0,1546.8579999999993,-40.06,5
08:30,547010927.0,25415.138108024938,-27.18,9
08:32,598793068.0,679.6013499999981,-128.68,5
08:32,256002321.0,7426.48363341298,-30.77,5
08:33,910730524.0,8453.370625174111,-2.46,5
08:35,417850087.0,18526.89892603175,-73.48,5
08:37,762859681.0,193.6075999999988,-55.25,5
08:37,986267641.0,9016.053979670123,-12.56,7
08:37,314980178.0,4334.892850000006,-53.51,5
08:37,762785862.0,792.6514499999994,-100.85,5
08:38,224524792.0,-2288.413182430848,-33.4,5
08:40,820686957.0,-892.825166311196,-114.57,5
08:40,245198540.0,380.4063988017795,-10.29,5
08:41,348525881.0,1187.791624594936,-98.56,5
08:43,355733816.0,5808.196175148083,-31.28,4
08:43,229205098.0,8359.249977913112,-54.28,5
08:43,194023154.0,-2592.9321717847333,-34.16,5
08:45,473820682.0,12613.152534998391,-98.8,5
08:46,832564361.0,17371.05064158487,-14.41,5
08:48,151968462.0,8192.676609528871,-49.71,5
08:49,355602925.0,1671.1255265753275,-28.91,5
08:50,969697937.0,-4937.41526567055,-46.97,5
08:50,196289502.0,16902.074582936984,-67.01,7
08:51,685959099.0,2344.8798660992434,-64.2,5
08:54,472995101.0,2662.9471842428034,-46.42,5
08:56,270374623.0,11151.532611813896,-94.86,5
08:59,700138124.0,5797.16763383092,-65.34,5
08:59,986267641.0,8999.295979670123,-16.76,5
09:00,903953091.0,4456.991038995666,-84.34,5
09:02,117273481.0,9554.39506533524,-5.25,9
09:03,618138606.0,1684.809702870066,-5.8,9
09:03,383833857.0,26995.48712291351,-7.1,9
09:06,624563756.0,-56.8706712164436,-7.3,9
09:06,613729471.0,10699.411102685368,-5.0,9
09:06,771125520.0,1094.7051999999992,-52.03,5
09:08,851649498.0,11395.43709841493,-5.4,9
09:10,586315521.0,13421.259256323989,-6.6,9
09:11,683319988.0,8178.752511091601,-5.35,9
09:12,540159353.0,12152.15305415327,-5.35,9
09:16,762896656.0,155.8624981518587,-111.3,2
09:17,280098744.0,822.1703778716657,-130.13,2
09:19,282046994.0,-250.3706499999996,-131.38,5
09:20,214339619.0,771.5153508683561,-4.7,9
09:21,506618547.0,18746.67769633768,-5.15,9
09:21,641376155.0,15.922512101451108,-28.06,2
09:22,950234174.0,2592.1823699633833,-82.66,2
09:23,581655972.0,43578.200162614434,-6.9,9
09:26,873701090.0,933.0933389788768,-12.02,1
09:26,711140907.0,1098.5784999999992,-12.99,2
09:26,370521542.0,28435.98124554691,-55.39,2
09:26,578131296.0,760.0177194440437,-37.99,2
09:27,300095518.0,1059.0286283414175,-122.99,2
09:27,535744551.0,945.001165995626,-12.98,7
09:27,570269025.0,3689.22007291183,-96.75,5
09:28,441142605.0,2842.736442275728,-49.99,4
09:28,641376155.0,-54.217487898548896,-70.14,2
09:29,480198977.0,12989.879720897708,-51.98,4
09:29,639549973.0,8152.227458663882,-100.39,2
09:29,762896656.0,3.9624981518587106,-151.9,2
09:30,673025413.0,3768.013296479624,-35.95,1
09:31,700138124.0,5795.125199200155,-2.04,7
09:31,331684336.0,-1459.0263699513214,-30.21,5
09:32,834383043.0,5614.794657761606,-16.98,4
09:33,322221939.0,4466.396830113823,-175.69,2
09:34,264550521.0,11144.156987457376,-119.0,2
09:35,279149837.0,2235.4260499999987,-36.96,7
09:37,815993333.0,6826.730441502344,-85.24,5
09:37,856957948.0,10933.709154533906,-71.48,5
09:38,555804115.0,-1371.5760475587033,-20.69,5
09:39,625658193.0,139.76935975621683,-52.07,4
09:39,282837512.0,15040.530652778743,-4.98,2
09:40,348525881.0,1180.801624594936,-6.99,7
09:41,176922958.0,1572.9455471976496,-60.89,2
09:42,873701090.0,930.77766401957,-2.32,5
09:43,160166876.0,1305.3850405862436,-152.62,2
09:43,280098744.0,725.5703778716656,-96.6,2
09:44,986774156.0,1804.3669316257697,-19.97,7
09:47,299652176.0,121.84438325687928,-48.3,2
09:47,903663593.0,1310.374958302563,-25.0,2
09:47,221356538.0,986.0064999999996,-32.95,7
09:48,264550521.0,10878.156987457376,-266.0,2
09:48,655368335.0,5197.002092150993,-22.02,2
09:48,300095518.0,962.5386283414176,-96.49,2
09:49,535744551.0,910.001165995626,-35.0,2
09:50,654329190.0,146.83545094851928,-33.95,1
09:50,987656636.0,4764.300205516076,-28.19,2
09:52,520447032.0,9069.292261837563,-28.52,4
09:53,903468956.0,1208.9853999999991,-75.6,5
09:56,980500334.0,-226.9844338929041,-47.98,2
09:56,279149837.0,2136.3900499999986,-99.04,5
09:57,821971408.0,1357.4251102355431,-35.81,5
09:58,280098744.0,662.6003778716656,-62.97,4
09:59,762896656.0,-110.13750184814128,-114.1,2
09:59,299652176.0,10.544383256879286,-111.3,2
09:59,711140907.0,1052.3742999999993,-46.2,5
10:00,322221939.0,4407.638830113823,-58.76,2
10:01,570323670.0,3639.9732934962512,-73.06,2
10:04,635679314.0,-3029.0258291195178,-8.08,5
10:04,546296727.0,-79.19227269738154,-33.75,2
10:04,283027736.0,100.21424397017276,-77.99,2
10:06,264550521.0,10766.856987457377,-111.3,2
10:08,903953091.0,4321.205038995666,-135.79,2
10:09,916270283.0,2686.40425,-84.98,2
10:10,956717493.0,1502.2093722249324,-28.0,2
10:11,828750680.0,1930.49269521368,-5.99,2
10:14,639549973.0,8143.222110772392,-9.01,7
10:15,300095518.0,903.0386283414176,-59.5,2
10:16,283027736.0,80.22424397017275,-19.99,2
10:17,344843570.0,171.10318249066614,-115.12,2
10:18,909669130.0,624.0598847367667,-133.66,2
10:18,352291960.0,2716.157053303574,-35.0,2
10:19,137822385.0,3791.341101541067,-5.25,9
10:19,856461967.0,-77.73664647050744,-83.35,5
10:22,264550521.0,10561.056987457378,-205.8,2
10:25,680773155.0,817.5639833310915,-22.0,2
10:26,769319491.0,267.4269999999992,-6.99,1
10:27,348325817.0,11513.549235046154,-52.39,2
10:30,280098744.0,429.5563778716656,-233.04,2
10:30,762896656.0,-308.93750184814127,-198.8,2
10:31,299652176.0,-214.1556167431207,-224.7,2
10:38,903953091.0,4228.819038995665,-92.39,2
10:38,793781222.0,1906.8688789474056,-12.99,2
10:39,300095518.0,749.0586283414177,-153.98,2
10:40,546296727.0,-131.17227269738154,-51.98,4
10:42,896821055.0,56.67175926708251,-157.0,7
10:43,299652176.0,-361.15561674312073,-147.0,2
10:45,807098817.0,721.5229499999991,-29.99,2
10:45,414454079.0,1483.8278500000015,-11.18,4
10:46,225210798.0,1164.2877737592082,-55.54,5
10:47,240643705.0,814.7336173739809,-56.97,4
10:51,849096144.0,2013.6700207513431,-5.99,2
10:51,352291960.0,2500.557053303574,-215.6,2
10:53,687135796.0,29707.180586045753,-10.94,5
10:54,504055745.0,342.59946134176687,-31.99,6
10:55,680773155.0,767.5739833310915,-49.99,2
10:55,637433131.0,188.91259999999895,-12.99,2
10:56,903468956.0,1183.9853999999991,-25.0,2
10:58,280098744.0,366.5563778716656,-63.0,2
11:03,352291960.0,2473.2570533035737,-27.3,2
11:04,299652176.0,-563.4556167431207,-202.3,2
11:06,300095518.0,600.5686283414177,-148.49,2
11:10,154246234.0,189.55489210210413,-12.98,7
11:11,299652176.0,-748.9556167431207,-185.5,2
11:14,680773155.0,757.5839833310915,-9.99,2
11:15,414454079.0,1330.5558500000018,-153.27,2
11:17,322221939.0,4256.480830113823,-151.16,2
11:18,896821055.0,-28.328240732917493,-85.0,7
11:22,909669130.0,367.88788473676664,-256.17,2
11:22,179173981.0,5566.86989853393,-51.9,7
11:22,344843570.0,21.853182490666143,-149.25,2
11:23,280098744.0,239.88437787166563,-126.67,2
11:23,504055745.0,312.60946134176686,-29.99,4
11:27,145387690.0,5914.354234773201,-16.99,8
11:29,154246234.0,114.56489210210414,-74.99,2
11:30,903468956.0,1154.4853999999991,-29.5,2
11:32,722971557.0,-47.520279156924474,-67.98,2
11:32,322221939.0,4200.508830113823,-55.97,2
11:32,355733816.0,5802.206175148083,-5.99,7
11:36,919185264.0,4341.498493570697,-19.98,7
11:38,889916166.0,321.44340141322664,-172.49,2
11:40,300095518.0,491.5886283414177,-108.98,2
11:40,299652176.0,-1038.7556167431208,-289.8,2
11:40,668175891.0,1299.657223158499,-21.49,4
11:41,154246234.0,75.59489210210414,-38.97,2
11:41,324046160.0,-564.2343332130711,-164.0,2
11:44,722971557.0,-70.50027915692448,-22.98,2
11:45,454356905.0,2248.2654103317977,-20.31,4
11:45,680773155.0,738.6139833310915,-18.97,1
11:45,179173981.0,5532.479898533929,-34.39,9
11:46,866941383.0,2690.556950000007,-31.97,4
11:46,896821055.0,-202.8282407329175,-174.5,4
11:47,909669130.0,230.71588473676664,-137.17,2
11:48,344843570.0,-34.39681750933386,-56.25,2
11:48,776431321.0,3540.732433149659,-14.37,5
11:48,160166876.0,1266.0175405862435,-39.37,2
11:49,280990953.0,524.7896999999984,-75.0,4
11:49,225210798.0,1134.2977737592082,-29.99,4
11:52,660561861.0,482.38478743764995,-34.99,2
11:52,680773155.0,705.6139833310915,-33.0,4
11:53,264550521.0,10325.856987457377,-235.2,2
11:54,549414742.0,8333.751925365164,-1.43,2
11:57,828750680.0,1784.0226952136802,-146.47,2
12:01,903468956.0,1054.4853999999991,-100.0,2
12:01,572136270.0,303.57491158802327,-19.97,1
12:07,280098744.0,90.11237787166569,-149.77,2
12:08,618514666.0,22542.904041064303,-29.99,4
12:08,160166876.0,1155.0325405862436,-110.99,2
12:09,896821055.0,-272.8082407329175,-69.98,2
12:12,264550521.0,10117.256987457376,-208.6,2
12:13,945054126.0,355.95809999999994,-65.15,5
12:13,680773155.0,572.6439833310915,-132.97,2
12:18,889916166.0,300.9634014132266,-20.48,2
12:22,762896656.0,-329.93750184814127,-21.0,2
12:22,280990953.0,350.28969999999845,-174.5,7
12:23,903468956.0,1029.4853999999991,-25.0,2
12:25,828750680.0,1679.5326952136802,-104.49,2
12:26,541639148.0,4665.569502554945,-46.89,4
12:27,300095518.0,413.10862834141767,-78.48,2
12:29,264550521.0,9905.156987457376,-212.1,2
12:30,299652176.0,-1140.2556167431208,-101.5,2
12:31,836655156.0,-3166.6914552191547,-18.43,5
12:32,277562576.0,566.7733383738674,-49.58,2
12:32,909669130.0,187.34388473676665,-43.37,2
12:34,280098744.0,21.512377871665677,-68.6,2
12:35,625658193.0,59.71935975621683,-80.05,2
12:35,706361191.0,592.5740984940779,-54.98,2
12:36,192202372.0,384.68473498059944,-14.55,7
12:43,162370388.0,-2424.137899999999,-37.79,5
12:43,711045550.0,2539.9833500000036,-142.97,2
12:46,534908754.0,-996.6127000000002,-60.99,5
12:47,762896656.0,-412.5375018481412,-82.6,2
12:47,308505160.0,14226.874642621371,-3.12,2
12:50,300095518.0,370.62862834141765,-42.48,2
12:52,299652176.0,-1342.5556167431207,-202.3,2
12:52,570269025.0,3662.27007291183,-26.95,1
12:53,896821055.0,-312.8082407329175,-40.0,2
12:56,344843570.0,-63.10681750933386,-28.71,5
12:57,138969884.0,840.4012499999994,-65.95,5
12:57,300095518.0,193.62862834141765,-177.0,2
12:57,766692943.0,-2010.67175,-28.39,5
12:58,816685391.0,-682.9247037084264,-80.27,5
12:59,585625048.0,2505.3302320528423,-5.8,9
13:01,722971557.0,-77.40027915692448,-6.9,9
13:02,280098744.0,-149.9596221283343,-171.47,2
13:02,160166876.0,1117.9150405862435,-37.12,2
13:04,630691258.0,302.1865448748413,-96.99,2
13:04,455052690.0,67.75173994862763,-128.77,5
13:04,909669130.0,53.671884736766685,-133.67,2
13:06,719742742.0,-517.3675077779633,-18.97,5
13:07,264550521.0,9758.156987457376,-147.0,2
13:08,407574996.0,-132.69339061906314,-6.8,9
13:09,762896656.0,-586.1375018481413,-173.6,2
13:09,630468201.0,-659.5356838897017,-129.14,5
13:13,925659248.0,-692.2255892295711,-85.88,5
13:15,277562576.0,561.8233383738674,-4.95,9
13:16,280098744.0,-261.9316221283343,-111.97,2
13:17,941285623.0,1650.7263990667705,-4.99,1
13:17,340321732.0,2067.627000000004,-5.0,9
13:17,187111705.0,7689.227440751494,-5.35,9
13:20,762896656.0,-784.2375018481413,-198.1,2
13:20,143383029.0,-1580.0459193476613,-37.44,9
13:20,264550521.0,9506.856987457377,-251.3,2
13:23,160166876.0,1012.1650405862435,-105.75,2
13:24,761272540.0,246.5252499999988,-61.98,5
13:24,344843570.0,-177.8568175093339,-114.75,2
13:25,709151315.0,94.01321837415986,-75.31,5
13:27,569687509.0,-2254.7703999999994,-51.18,5
13:29,548907062.0,-101.35651123171152,-9.99,4
13:29,300095518.0,64.14862834141763,-129.48,2
13:31,202320275.0,-774.0548500000006,-153.63,5
13:39,280098744.0,-543.3176221283343,-281.39,2
13:41,762896656.0,-791.2375018481413,-7.0,2
13:42,625658193.0,-0.3406402437831701,-60.06,4
13:43,160166876.0,922.5400405862435,-89.62,2
13:54,414454079.0,1218.5698500000017,-111.99,2
13:57,618514666.0,22454.7180410643,-88.19,5
13:59,344843570.0,-301.23181750933384,-123.38,2
14:02,903953091.0,4112.647038995666,-116.17,2
14:05,429235692.0,-1015.6245000000002,-79.14,5
14:09,762896656.0,-946.6375018481413,-155.4,2
14:09,280990953.0,300.28969999999845,-50.0,2
14:13,688328251.0,-998.0363753548272,-58.95,5
14:17,896821055.0,-416.3082407329175,-103.5,7
14:20,414454079.0,1000.9118500000016,-217.66,2
14:22,660561861.0,428.0787874376499,-54.31,5
14:22,160166876.0,834.4375405862436,-88.1,2
14:25,280990953.0,135.78969999999845,-164.5,2
14:29,300095518.0,10.65862834141764,-53.49,2
14:31,909669130.0,-92.6281152632333,-146.3,2
14:32,687135796.0,29694.150586045755,-13.03,9
14:35,896821055.0,-565.3082407329175,-149.0,4
14:36,546296727.0,-246.67227269738152,-115.5,2
14:37,160166876.0,686.3200405862435,-148.12,2
14:38,299652176.0,-1530.855616743121,-188.3,2
14:39,280098744.0,-646.9036221283343,-103.59,2
14:46,762896656.0,-1196.5375018481411,-249.9,2
14:47,809499628.0,18495.82314345955,-8.49,9
14:50,903953091.0,4070.677038995666,-41.97,4
14:51,807098817.0,591.5429499999991,-129.98,2
14:53,300095518.0,-87.32137165858235,-97.98,2
14:55,909669130.0,-243.10011526323328,-150.47,2
14:56,299652176.0,-1670.1556167431206,-139.3,2
14:57,903953091.0,4027.7478830548,-42.93,7
15:00,854895960.0,4047.79917874872,-43.98,2
15:05,441142605.0,2833.736442275728,-9.0,4
15:07,160166876.0,601.2025405862435,-85.12,2
15:12,344843570.0,-390.48181750933384,-89.25,2
15:18,299652176.0,-1986.5556167431205,-316.4,2
15:20,346874167.0,236.439199999999,-148.05,5
15:28,660561861.0,421.8528316336894,-6.23,2
15:29,896821055.0,-625.3082407329175,-60.0,4
15:30,280990953.0,-28.210300000001553,-164.0,4
15:33,409971170.0,3468.116263658843,-22.58,4
15:33,344843570.0,-528.4818175093338,-138.0,2
15:36,726913482.0,-794.2332985264763,-142.32,5
15:38,274818272.0,584.8151785671314,-26.98,4
15:39,160166876.0,474.85004058624344,-126.35,2
15:41,828750680.0,1573.0526952136802,-106.48,2
15:43,299652176.0,-2235.7556167431203,-249.2,2
15:46,625658193.0,-156.03464024378314,-155.69,5
16:01,280990953.0,-254.71030000000155,-226.5,4
16:04,299652176.0,-2613.0556167431205,-377.3,2
16:04,414454079.0,879.1398500000016,-121.77,2
16:09,388862238.0,1736.976528473194,-7.5,4
16:17,467207141.0,858.7608670482637,-166.98,2
16:19,901432314.0,4273.662642908,-2.7,5
16:22,376271050.0,1681.2928069057436,-21.98,4
16:24,547010927.0,25404.748108024934,-10.39,7
16:29,532478725.0,5455.475487528939,-15.95,1
16:29,300095518.0,-156.31137165858237,-68.99,2
16:30,456221621.0,299.522967302628,-98.47,5
16:30,280098744.0,-714.7896221283343,-67.89,2
16:31,527842638.0,1176.3505926329835,-3.49,4
16:32,792845450.0,1522.885150000001,-15.98,1
16:33,344843570.0,-638.7318175093338,-110.25,2
16:33,903953091.0,3954.9478830548,-72.8,2
16:35,736310094.0,-674.4096240274259,-63.07,5
16:37,642924505.0,669.024670183526,-4.99,4
16:39,521611005.0,-77.87463585104655,-22.0,2
16:41,414454079.0,774.8678500000017,-104.27,2
16:45,151278285.0,-1231.2766000000004,-67.51,5
16:49,280098744.0,-842.8476221283343,-128.06,2
16:52,241459011.0,1215.404013272347,-12.98,1
16:56,860360312.0,258.2694588826804,-108.29,5
16:57,300095518.0,-260.30137165858235,-103.99,2
16:58,117308635.0,1391.1121014783391,-17.05,7
16:59,344843570.0,-750.4818175093338,-111.75,2
16:59,274818272.0,515.8151785671314,-69.0,4
17:00,421881811.0,3864.4678490005344,-8.26,4
17:04,280098744.0,-1035.3476221283345,-192.5,2
17:05,228136274.0,1580.7004999999997,-133.0,2
17:05,610645022.0,-419.4017626449184,-84.88,5
17:07,160166876.0,359.35004058624344,-115.5,2
17:08,698076160.0,7072.679710241275,-1.5,4
17:12,196289502.0,16885.734582936984,-16.34,9
17:12,587225252.0,6530.170230669704,-20.43,2
17:13,851181128.0,5427.3676908211055,-59.69,5
17:13,131388684.0,23792.939527137052,-1.86,5
17:15,880546403.0,-1410.3995000000018,-67.02,5
17:16,299652176.0,-2745.3556167431207,-132.3,2
17:17,583579399.0,2449.1187000000004,-39.98,2
17:17,395284483.0,1725.2803402113084,-126.0,2
17:18,519935524.0,1357.510329737519,-40.05,2
17:19,448279144.0,1349.684999999999,-34.95,1
17:21,117273481.0,9536.42506533524,-17.97,7
17:24,108931112.0,15340.931124527378,-6.54,4
17:24,807098817.0,571.5529499999991,-19.99,2
17:25,705848712.0,28578.579784701655,-5.7,8
17:25,197865285.0,507.5841617312203,-112.98,2
17:26,984783496.0,15094.596428888248,-36.53,4
17:26,858989281.0,28722.46572396476,-21.0,1
17:26,675806859.0,8075.782648698933,-7.37,5
17:28,200080192.0,10201.234460889578,-5.04,7
17:29,835736339.0,2314.8990661464723,-70.98,1
17:30,450896297.0,14314.7673066567,-13.71,2
17:31,241459011.0,1197.4340132723469,-17.97,4
17:31,274818272.0,458.8251785671314,-56.99,7
17:32,221868392.0,5570.053872258019,-39.19,9
17:33,395284483.0,1545.4363402113083,-179.84,2
17:33,651756497.0,15055.753057561978,-18.24,7
17:34,213112754.0,7251.568420728159,-21.19,9
17:34,698955014.0,1315.1620302031968,-51.41,5
17:34,500843551.0,1322.9398999999996,-41.95,7
17:35,303843160.0,341.5634000000015,-184.36,5
17:36,496674181.0,-2076.1446223307225,-33.5,5
17:36,758160963.0,9249.923185882344,-47.98,7
17:37,361955473.0,147.21704524408435,-84.98,2
17:38,390747457.0,705.0083999999978,-14.35,9
17:38,160166876.0,334.98254058624343,-24.37,2
17:38,815385232.0,11371.294592985729,-27.27,7
17:40,366477356.0,817.9288499999998,-153.5,2
17:40,730002588.0,14447.448525958398,-3.33,5
17:42,299652176.0,-2939.955616743121,-194.6,2
17:43,834581602.0,652.3636499999992,-38.65,9
17:44,429556122.0,4820.120251606174,-8.06,8
17:44,405945930.0,5942.386275568806,-35.98,2
17:45,909669130.0,-360.6441152632333,-117.54,2
17:47,147474476.0,3818.18910283296,-35.98,2
17:48,642924505.0,639.044670183526,-29.98,2
17:49,344843570.0,-903.1068175093338,-152.62,2
17:49,310375875.0,2545.4316246032163,-35.43,5
17:49,151916463.0,14.198555599168898,-97.94,5
17:50,113747882.0,13304.39325115827,-135.8,2
17:50,316793091.0,838.202460054951,-65.98,2
17:52,574548998.0,-206.70935000000097,-127.99,2
17:53,618514666.0,22452.618811468972,-2.1,2
17:53,824916823.0,9760.940871788898,-11.34,4
17:53,373875019.0,17667.330248673505,-57.48,2
17:54,395284483.0,1330.5643402113085,-214.87,2
17:55,859603181.0,4166.756311861926,-10.99,1
17:55,690958123.0,22377.494485522537,-131.98,5
17:55,647472692.0,27044.688351580004,-107.9,5
17:58,467207141.0,815.7808670482636,-42.98,2
17:58,556992209.0,12941.274013969958,-98.04,5
18:00,909669130.0,-475.4301152632333,-114.79,2
18:00,629078930.0,247.999479725602,-21.97,7
18:00,703478110.0,5832.884731849387,-6.99,7
18:02,160166876.0,274.2475405862434,-60.73,2
18:04,228136274.0,1475.0564999999997,-105.64,2
18:05,842682241.0,6438.279284390896,-27.92,9
18:06,366477356.0,700.4288499999998,-117.5,2
18:06,550169791.0,23076.800593127584,-25.5,9
18:06,971010829.0,494.76505644424515,-32.97,7
18:07,146909202.0,4385.332985724662,-41.3,2
18:07,600185455.0,86.75000224748148,-18.45,9
18:11,237493332.0,15824.7086370817,-17.24,9
18:11,299652176.0,-3072.955616743121,-133.0,2
18:13,361955473.0,99.71704524408436,-47.5,2
18:14,344843570.0,-938.7318175093338,-35.62,2
18:17,511179916.0,8127.19913209197,-52.92,7
18:20,532478725.0,5432.4954875289395,-22.98,9
18:21,414454079.0,741.5778500000017,-33.29,9
18:21,859603181.0,4079.7743118619264,-86.98,5
18:22,762896656.0,-1231.5375018481411,-35.0,2
18:22,534325901.0,7552.651275948503,-11.95,9
18:22,383833857.0,26982.54712291351,-12.94,9
18:28,844835978.0,10767.53750796128,-19.99,7
18:29,678330503.0,3744.4462892014535,-3.07,7
18:29,867987292.0,3001.1147072991193,-2.47,5
18:30,471897866.0,8542.347891671656,-9.5,4
18:31,160166876.0,206.3800405862434,-67.87,2
18:34,874431242.0,10156.00130935729,-38.42,7
18:34,792845450.0,1458.915150000001,-63.97,7
18:38,785749304.0,9322.79675581121,-13.24,9
18:38,954263768.0,-80.56450000000022,-23.65,5
18:39,361955473.0,-49.282954755915625,-149.0,2
18:41,246753533.0,679.0687999999984,-7.94,5
18:42,146909202.0,4323.060985724662,-62.27,2
18:43,806358207.0,13880.154099406243,-3.1,7
18:43,366477356.0,615.9288499999998,-84.5,2
18:43,374994043.0,-2343.7130500000003,-20.96,5
18:44,315546581.0,30178.767432135108,-15.96,2
18:44,128030172.0,-509.5015774498499,-32.46,5
18:47,235881534.0,14460.506394359358,-13.09,7
18:48,930271460.0,374.13884753577634,-55.38,5
18:49,550644516.0,-247.40290000000147,-135.88,5
18:49,948558249.0,10090.865631737075,-15.71,5
18:50,510101371.0,14520.79106800894,-13.42,7
18:51,639409800.0,37785.38674237165,-34.15,5
18:52,494404688.0,-2704.8907653362076,-36.05,5
18:52,414805878.0,14057.541468435487,-26.28,7
18:53,414805878.0,14037.156047219967,-20.39,7
18:53,293191074.0,781.5381499999991,-19.34,9
18:53,713057426.0,-1004.0817500000004,-40.82,9
18:56,624563756.0,-115.3241712164436,-58.45,5
18:56,252964502.0,-834.4489224913006,-28.91,5
18:56,587202562.0,653.6777994170685,-103.68,5
18:57,252701364.0,-3862.368672677914,-30.12,5
18:58,572136270.0,255.32251158802327,-48.25,5
18:59,753525749.0,-2377.158399999999,-39.37,5
19:00,720221651.0,-2502.088866598434,-41.88,5
19:00,762896656.0,-1252.5375018481411,-21.0,2
19:01,683319988.0,8176.26791040616,-2.48,5
19:03,471897866.0,8511.841891671656,-30.51,5
19:06,556992209.0,12923.344021115508,-17.93,7
19:08,146909202.0,4246.060985724662,-77.0,2
19:09,214339619.0,673.4145508683561,-98.1,5
19:11,824916823.0,9758.97970229978,-1.96,2
19:13,124102251.0,3930.680598682017,-71.6,5
19:17,647936800.0,2833.6601144420833,-56.67,7
19:17,824916823.0,9729.53970229978,-29.44,9
19:18,461029994.0,8391.269094096782,-71.36,5
19:19,233981231.0,2664.406881960624,-70.01,5
19:22,518474507.0,15455.325499865285,-29.19,9
19:22,886921642.0,3716.560521880814,-0.37,4
19:27,964702094.0,1252.286387640289,-61.19,5
19:30,762896656.0,-1439.4375018481414,-186.9,2
19:33,984783496.0,15075.346428888248,-19.25,9
19:34,876890798.0,3930.3045706999337,-56.82,5
19:36,503575533.0,8574.077874664672,-3.26,5
19:41,146909202.0,4188.716985724662,-57.34,2
19:42,762896656.0,-1522.0375018481411,-82.6,2
19:45,203466392.0,4036.8030551943048,-36.62,8
19:49,951817450.0,9734.857998099164,-92.02,5
19:49,519935524.0,1318.262829737519,-39.25,5
19:49,627723633.0,-2264.8513280037623,-31.77,5
19:55,146909202.0,4045.230985724662,-143.49,2
19:56,762896656.0,-1592.0375018481411,-70.0,2
19:57,482513594.0,6682.287219925837,-24.88,5
19:59,979135922.0,1340.2833005904508,-10.33,5
20:01,227104649.0,3947.297034316178,-97.78,5
20:05,510101371.0,14450.08406800894,-70.71,5
20:09,616924659.0,231.1945798230852,-32.22,5
20:15,679911053.0,3383.995164943611,-50.89,8
20:16,241459011.0,1184.1606132723468,-13.27,5
20:24,752362502.0,8171.230858579233,-64.55,2
20:34,280268430.0,6060.8523328061365,-8.41,7
20:35,419550103.0,19663.7111699773,-0.79,8
20:43,235881534.0,14416.4548518628,-44.05,2
20:45,170233640.0,-470.3198600501027,-22.54,5
20:51,497772347.0,378.79444999999777,-215.72,5
21:00,116598243.0,2194.0272217774504,-43.24,5
21:25,520447032.0,9059.98881660802,-9.3,5
21:48,305778936.0,11287.978348729564,-4.64,2
01:02,570323670.0,3633.7590355643265,-6.21,7
01:25,679662108.0,17298.6234881366,-21.12,7
01:38,108931112.0,15310.011124527378,-30.92,9
01:39,433837402.0,-60.9558684641881,-26.63,9
01:40,950234174.0,2591.41601312024,-0.77,7
01:44,421881811.0,3849.8281708614513,-14.64,5
01:46,370521542.0,28433.08599520283,-2.9,5
01:50,687135796.0,29685.540608605497,-8.61,2
02:01,779946617.0,17602.1054788111,-33.7,4
02:29,310740977.0,444.5145529589969,-80.25,2
02:35,858989281.0,28704.48572396476,-17.98,9
02:36,348325817.0,11479.809235046154,-33.74,9
02:40,549414742.0,8311.211925365164,-22.54,9
02:50,550169791.0,23034.33835027488,-42.46,5
02:53,518474507.0,15424.995499865285,-30.33,9
02:57,534204159.0,6289.485161361812,-77.37,8
03:05,940569402.0,6701.15070469435,-24.15,9
03:09,450896297.0,14291.237306656698,-23.53,9
03:18,511179916.0,8104.0371484869165,-23.16,2
03:20,256002321.0,7402.333633412981,-24.15,9
03:30,264550521.0,9499.783634948411,-7.07,5
03:33,639549973.0,8132.936820700184,-10.29,7
03:33,518474507.0,15395.551982287749,-29.44,8
03:40,237493332.0,15804.2586370817,-20.45,9
03:43,709608057.0,3241.2451739274748,-39.08,9
03:43,858989281.0,28669.80093362814,-34.68,5
03:45,659415300.0,2112.87023053596,-19.36,2
03:47,480557476.0,12019.58402295333,-22.26,2
03:56,145387690.0,5885.224234773201,-29.13,9
03:57,256002321.0,7392.031297536635,-10.3,7
03:59,298000165.0,27491.690476809872,-19.43,2
04:02,221868392.0,5530.623872258018,-39.43,9
04:03,824916823.0,9658.932458440506,-70.61,7
04:03,553734946.0,240.3862999999983,-15.75,9
04:12,237493332.0,15803.110703801956,-1.15,5
04:13,213112754.0,7251.153917895469,-0.41,7
04:18,270374623.0,11141.582611813896,-9.95,9
04:21,285220959.0,12577.877763416302,-7.92,8
04:26,364357875.0,9014.779327654987,-48.23,5
04:27,229205098.0,8349.281695342126,-9.97,2
04:29,549414742.0,8289.360861909054,-21.85,4
04:34,287480331.0,8995.976476134789,-28.24,9
04:35,117308635.0,1389.7440072910497,-1.37,4
04:37,738958551.0,10096.884547323143,-50.13,7
04:39,547010927.0,25378.123417821123,-26.62,7
04:40,124102251.0,3914.603668885234,-16.08,5
04:43,252760664.0,7502.668460647972,-10.08,7
04:46,506618547.0,15485.632226391415,-21.05,2
04:49,851181128.0,5401.677690821106,-25.69,9
04:51,749378808.0,4704.458115109183,-36.1,9
04:53,802697323.0,17545.082999175807,-43.43,9
04:55,572384506.0,8954.349186310867,-28.69,9
04:57,678851253.0,4375.203431475898,-74.49,5
04:58,885259672.0,3825.3329419798074,-9.44,8
05:00,769311479.0,6905.388737445648,-30.18,2
05:02,683319988.0,8099.263901693566,-77.0,7
05:05,383833857.0,26933.62946399356,-48.92,2
05:05,287480331.0,8962.688529529016,-33.29,7
05:10,559995067.0,2444.9793137949846,-29.45,7
05:25,128033695.0,2594.723778804683,-0.55,5
05:26,196289502.0,16864.394582936984,-21.34,9
05:26,454356905.0,2225.153225233368,-23.11,2
05:27,766941757.0,3914.583352984951,-36.83,9
05:29,832564361.0,17353.72249470138,-17.33,7
05:31,647936800.0,2800.070114442083,-33.59,9
05:32,842682241.0,6432.6345358154185,-5.64,2
05:33,417850087.0,18458.91253493181,-67.99,7
05:33,221868392.0,5500.309789666887,-30.31,8
05:34,705848712.0,28564.979784701656,-13.6,9
05:40,216285378.0,25328.287384634907,-34.71,9
05:40,290818242.0,7783.846139188372,-3.58,7
05:43,409971170.0,3448.9253494146774,-19.19,5
05:46,558119802.0,35423.07982147815,-1.47,5
05:47,237684254.0,6499.492033072651,-36.73,2
05:49,588565416.0,7234.680022474989,-23.47,5
05:49,633345190.0,6611.403042146297,-29.0,9
05:49,450896297.0,14287.07991684918,-4.16,2
05:49,510101371.0,14419.09406800894,-30.99,9
05:49,873701090.0,914.5141595783014,-16.26,7
05:49,973086490.0,11098.64385137674,-11.24,9
05:51,520447032.0,9035.62881660802,-24.36,9
05:52,146909202.0,4034.098870411704,-11.13,7
05:52,657139925.0,15096.639269915044,-17.99,9
05:54,853907490.0,8322.853751414788,-13.0,9
05:55,461990622.0,10296.699967301942,-10.24,4
05:55,624500124.0,3744.7655178724726,-19.92,2
06:00,282837512.0,14988.988231821775,-51.54,7
06:01,836110591.0,7191.055136852543,-34.99,9
06:01,108481285.0,9918.727276987414,-7.07,2
06:02,815385232.0,11311.4047061411,-59.89,8
06:04,601627384.0,4494.4682885856355,-28.63,9
06:05,910730524.0,8451.3333121844,-2.04,7
06:08,749378808.0,4630.94493704745,-73.51,7
06:10,187111705.0,7677.521432678834,-11.71,8
06:13,143003091.0,10970.117087062052,-59.16,7
06:14,949032480.0,5069.925661869267,-22.5,9
06:16,985188462.0,-416.2632112887753,-40.18,9
06:18,851649498.0,11378.93996577225,-16.5,8
06:19,308505160.0,14212.635090399575,-14.24,8
06:22,673025413.0,3713.511047869795,-54.5,7
06:23,331684336.0,-1505.1763699513217,-46.15,9
06:23,986267641.0,8977.676548437636,-21.62,2
06:33,471897866.0,8501.456172534998,-10.39,7
06:34,322221939.0,4197.545050763868,-2.96,5
06:34,899742927.0,13758.852503186978,-46.3,7
06:36,853907490.0,8288.969998268622,-33.88,7
06:37,496395938.0,13073.688919688348,-7.16,5
06:39,489964679.0,21444.46175137423,-44.74,9
06:40,366550080.0,28095.248991956913,-18.97,8
06:41,897714622.0,9729.62762648463,-12.35,7
06:42,992204045.0,7981.5683907628845,-22.95,7
06:43,187541224.0,2735.58745664854,-38.63,9
06:44,933491926.0,3970.122300000004,-14.1,9
06:45,949032480.0,5066.602402448338,-3.32,7
06:51,809499628.0,18485.44314345955,-10.38,9
06:52,948558249.0,10046.157517352623,-44.71,7
06:54,930277104.0,11121.69477993321,-13.92,5
06:55,120634201.0,5611.055329403303,-19.89,9
06:56,670102069.0,2261.744605295661,-25.88,9
06:57,984783496.0,15059.106428888248,-16.24,9
06:58,183888402.0,20117.014973285382,-47.8,9
06:58,704517789.0,18838.45443683875,-21.42,7
07:00,108931112.0,15304.435851188286,-5.58,7
07:00,675806859.0,8014.939561129633,-60.84,8
07:00,435984758.0,4781.368575618949,-16.02,5
07:01,441274121.0,13232.703485547196,-11.48,2
07:03,399144202.0,2342.402738732554,-14.78,9
07:03,758160963.0,9205.208683586656,-44.71,5
07:05,730002588.0,14422.687836464123,-24.76,5
07:06,310375875.0,2519.151624603216,-26.28,9
07:07,519644021.0,3619.408833816467,-52.99,5
07:08,532478725.0,5394.55548752894,-37.94,9
07:11,776108637.0,1292.1685536574953,-5.4,9
07:13,987163717.0,6601.608480000004,-37.93,9
07:15,575652395.0,3182.8817809963452,-15.66,8
07:16,815993333.0,6781.886608517283,-44.84,5
07:16,151968462.0,8153.567542096987,-39.11,5
07:17,270374623.0,11136.110845817926,-5.47,5
07:19,433917275.0,8400.527296233411,-4.03,7
07:24,973086490.0,11062.651405401932,-35.99,2
07:26,788740658.0,2983.8206082351467,-38.68,5
07:29,873693307.0,11224.438664946689,-2.22,5
07:31,482513594.0,6616.2182591771725,-66.07,2
07:33,534325901.0,7543.779499463872,-8.87,2
07:33,613729471.0,10690.13904234982,-9.27,5
07:34,905860285.0,12149.931087400131,-5.37,8
07:34,912705941.0,19556.70598199424,-79.16,2
07:40,414805878.0,14006.51604721997,-30.64,9
07:43,623156843.0,5102.473247425491,-44.52,5
07:45,719586818.0,19516.906035823176,-59.42,5
07:48,383625050.0,3393.463215314341,-20.81,7
07:48,586315521.0,13414.452115675787,-6.81,2
07:51,324224854.0,4862.838576891716,-29.92,7
07:53,836110591.0,7190.976221780246,-0.08,5
07:57,581655972.0,43560.768018740506,-17.43,5
07:59,399538448.0,8254.753173652622,-7.5,9
08:02,454129843.0,604.5428451665601,-5.7,9
08:07,699139822.0,2322.315651224382,-34.26,5
08:08,951817450.0,9698.903050991745,-35.95,7
08:12,235881534.0,14392.446685625891,-24.01,5
08:12,706250160.0,13229.97496212901,-9.19,7
08:18,519935524.0,1312.862829737519,-5.4,9
08:18,541639148.0,4656.430992735591,-9.14,7
08:19,668329719.0,9532.955437135011,-52.6,2
08:19,395284483.0,1324.5143402113083,-6.05,9
08:21,215426302.0,292.7244040256919,-19.28,5
08:22,667367404.0,9762.871550124635,-10.18,2
08:23,408057540.0,5203.76707280612,-6.0,9
08:26,853907490.0,8252.639998268622,-36.33,5
08:28,195895574.0,7937.164939494524,-18.88,5
08:29,722358036.0,706.654390627083,-34.49,5
08:29,540159353.0,12138.18105415327,-13.97,5
08:30,248142083.0,-8.753565297483235,-111.47,5
08:31,885259672.0,3819.282941979807,-6.05,9
08:34,324046160.0,-671.0067332130711,-106.77,5
08:35,141521177.0,8312.953900000015,-108.78,5
08:36,179173981.0,5528.635006736486,-3.84,2
08:36,822250278.0,7217.0214816873295,-22.46,5
08:36,506618547.0,15434.224226391418,-51.41,5
08:39,603375739.0,825.4390630232672,-110.82,5
08:40,785749304.0,9316.678782289497,-6.12,2
08:43,322720763.0,6945.090530649673,-106.41,5
08:44,241459011.0,1179.4606132723468,-4.7,9
08:46,618138606.0,1546.675902870066,-138.13,5
08:47,366477356.0,447.5907499999998,-168.34,5
08:48,108563213.0,25904.80288461655,-23.07,4
08:48,700138124.0,5790.292617556472,-4.83,2
08:50,874431242.0,10121.269758810582,-34.73,2
08:53,493855007.0,-2745.1791315743917,-30.78,5
08:54,984783496.0,15054.768236893346,-4.34,5
08:54,822135975.0,12279.476269666651,-15.92,4
08:54,832564361.0,17338.33649470138,-15.39,5
08:55,956717493.0,1447.9852722249325,-54.22,5
08:56,187111705.0,7580.319432678833,-97.2,5
08:57,240643705.0,688.7693173739809,-125.96,5
08:59,611143859.0,1775.8347500000125,-166.56,5
09:01,117273481.0,9530.42506533524,-6.0,9
09:04,987656636.0,4754.028057255231,-10.27,7
09:04,290818242.0,7776.746139188372,-7.1,9
09:09,473820682.0,12591.277085678685,-21.88,5
09:10,683078800.0,2408.989452944871,-5.6,9
09:11,661295096.0,3736.927543800848,-14.54,2
09:11,643610517.0,-3030.6936907296567,-40.66,5
09:13,169006407.0,12712.481195374694,-5.7,9
09:14,147341222.0,-1760.2490753207956,-100.23,5
09:14,386277162.0,342.83999999999946,-31.49,4
09:14,425964226.0,4251.117650000003,-5.7,9
09:15,214339619.0,667.314550868356,-6.1,9
09:15,613729471.0,10683.63904234982,-6.5,9
09:15,558875206.0,3793.124310898954,-5.0,9
09:16,340680761.0,-3204.678099999997,-22.03,5
09:16,793781222.0,1898.8888789474056,-7.98,4
09:18,851649498.0,11374.58996577225,-4.35,9
09:18,762859681.0,3421.637599999999,-11.97,4
09:19,506618547.0,15428.574226391418,-5.65,9
09:20,690958123.0,22369.894485522535,-7.6,9
09:22,414454079.0,735.4778500000017,-6.1,4
09:22,596171893.0,669.545594825511,-5.99,1
09:23,578131296.0,725.0177194440437,-35.0,2
09:23,540159353.0,12132.381054153271,-5.8,9
09:23,520447032.0,8968.664781186464,-66.96,8
09:24,818552503.0,627.850999999999,-177.16,5
09:24,764450279.0,22480.464818719924,-0.86,5
09:25,819515373.0,2733.186136063793,-30.99,2
09:26,767447966.0,5544.284062706572,-109.35,5
09:32,853907490.0,8218.639998268622,-34.0,2
09:34,284905540.0,9050.17071628352,-50.84,6
09:36,503575533.0,8536.057874664672,-38.02,2
09:38,865748375.0,4493.553305696334,-1.49,7
09:39,518746136.0,259.89027176308343,-150.74,2
09:42,316793091.0,762.2324600549509,-75.97,4
09:42,673025413.0,3487.411047869795,-226.1,7
09:43,706361191.0,464.7943484940779,-127.78,5
09:45,762859681.0,3391.6475999999993,-29.99,2
09:46,703588001.0,-82.30695000000055,-71.99,2
09:47,145387690.0,5873.494029317612,-11.73,8
09:48,311467864.0,-707.587300000001,-71.96,5
09:49,270374623.0,11080.990845817923,-55.12,2
09:49,261793952.0,550.2232602038149,-24.99,7
09:52,709151315.0,58.06321837415986,-35.95,1
09:53,856957948.0,10913.719154533906,-19.99,4
09:54,475277431.0,1758.5381369436193,-39.95,7
09:55,355733816.0,5778.246175148083,-23.96,7
09:56,398429109.0,1464.888550000001,-25.97,7
09:56,950234174.0,2585.36601312024,-6.05,4
09:58,246753533.0,597.0987999999984,-81.97,4
09:58,138351025.0,-873.3319000000004,-111.26,5
10:00,280098744.0,-1084.256622128334,-48.91,5
10:00,585133606.0,5559.5044181394705,-118.97,2
10:01,609939116.0,8341.403716045574,-1.1,5
10:05,270374623.0,11053.450845817924,-27.54,4
10:08,762859681.0,3360.6875999999993,-30.96,1
10:09,308897841.0,1366.9222999999988,-125.24,2
10:13,895331556.0,-284.4414000000009,-14.62,5
10:19,518746136.0,217.92027176308343,-41.97,2
10:22,812692024.0,4204.8067066639305,-51.48,4
10:23,162162212.0,780.720043327309,-157.8,5
10:23,391688371.0,1246.6902995685232,-62.04,2
10:24,718058208.0,2642.6993062397064,-6.0,7
10:27,556631012.0,605.8080730856781,-12.99,2
10:30,849096144.0,1963.0810207513432,-50.59,5
10:31,987656636.0,4735.928057255231,-18.1,7
10:32,548907062.0,-116.72851123171152,-15.37,2
10:33,534204159.0,6256.485481361812,-33.0,4
10:34,570323670.0,3610.7690355643263,-22.99,1
10:34,575652395.0,3164.835760996345,-18.05,4
10:37,456246119.0,21877.544858632897,-4.28,5
10:38,503575533.0,8511.037874664671,-25.02,2
10:39,518746136.0,144.44277176308344,-73.48,2
10:43,310740977.0,377.5245529589969,-66.99,2
10:45,270374623.0,10991.150845817923,-62.3,2
10:49,264550521.0,9345.723634948414,-154.06,2
10:52,154246234.0,33.60489210210414,-41.99,2
10:52,743630833.0,405.8695632847012,-91.87,5
11:05,673025413.0,3264.1110478697947,-223.3,7
11:18,518746136.0,97.57527176308344,-46.87,2
11:18,270374623.0,10907.850845817926,-83.3,2
11:20,549414742.0,8270.706461909054,-18.65,4
11:24,588565416.0,7077.7470224749895,-156.93,5
11:25,348525881.0,1161.831624594936,-18.97,7
11:26,117308635.0,1279.1440072910495,-110.6,7
11:33,642015139.0,149.84383746563827,-33.96,1
11:33,518746136.0,-44.90972823691658,-142.49,2
11:36,822250278.0,7130.73488168733,-86.29,4
11:42,673025413.0,3079.3110478697945,-184.8,7
11:45,604288474.0,2320.6852658936837,-1.16,2
11:51,647472692.0,27022.58146865668,-22.11,7
11:53,518746136.0,-130.7772282369166,-85.87,2
11:54,757115616.0,2261.670000000004,-37.95,7
11:55,923322792.0,-437.5868317536377,-25.0,2
11:55,117308635.0,1033.4720072910495,-245.67,4
11:58,556631012.0,504.8380730856781,-100.97,2
11:59,473820682.0,12505.867085678685,-85.41,2
12:04,518746136.0,-139.7622282369166,-8.98,2
12:09,941285623.0,1601.2503990667706,-49.48,5
12:13,673025413.0,2954.0110478697943,-125.3,4
12:27,117308635.0,957.1720072910496,-76.3,4
12:27,879091637.0,538.0375237379769,-36.34,9
12:28,518746136.0,-249.98222823691657,-110.22,2
12:28,556631012.0,420.8380730856781,-84.0,2
12:28,348460748.0,476.81754999999896,-33.75,2
12:32,843174694.0,-5263.810999999998,-15.96,5
12:38,673025413.0,2680.3110478697945,-273.7,4
12:40,298007503.0,2268.965103625634,-34.64,9
12:42,598586358.0,-3504.199949999995,-31.39,5
12:47,348460748.0,416.81754999999896,-60.0,2
12:50,117308635.0,815.0860072910496,-142.09,7
12:52,419084831.0,-239.7680755261032,-107.41,5
12:58,270374623.0,10779.050845817928,-128.8,2
13:00,585625048.0,2498.530232052842,-6.8,9
13:02,414454079.0,693.8878500000017,-41.59,9
13:02,548907062.0,-380.6005112317115,-263.87,2
13:04,480557476.0,12013.53402295333,-6.05,9
13:06,767447966.0,5539.184062706571,-5.1,9
13:06,915666111.0,-4532.7395747720375,-46.99,5
13:07,849096144.0,1956.5810207513432,-6.5,9
13:07,407574996.0,-137.84339061906314,-5.15,9
13:08,348460748.0,377.44254999999896,-39.38,2
13:09,688712152.0,7102.022017176151,-6.8,9
13:12,612304466.0,-2203.8807499999994,-25.03,5
13:13,270374623.0,10548.050845817928,-231.0,2
13:14,187111705.0,7574.669432678834,-5.65,9
13:14,630691258.0,296.4865448748413,-5.7,9
13:15,678851253.0,4344.333431475898,-30.87,9
13:15,277562576.0,555.8733383738673,-5.95,9
13:15,910730524.0,8443.8333121844,-7.5,9
13:20,475277431.0,1660.5381369436193,-98.0,2
13:21,718058208.0,2600.6618555057585,-42.04,7
13:23,340321732.0,2062.327000000004,-5.3,9
13:25,322221939.0,4191.745050763868,-5.8,9
13:28,556631012.0,292.8580730856781,-127.98,2
13:41,298007503.0,2189.8051036256343,-79.16,2
13:41,518746136.0,-280.7247282369166,-30.74,2
13:46,695607232.0,-235.41750538944,-98.85,5
13:48,673025413.0,2477.3110478697945,-203.0,4
13:50,518746136.0,-372.2097282369166,-91.48,2
13:52,475277431.0,1467.3381369436192,-193.2,2
13:53,349107386.0,-3589.223473194561,-70.51,5
14:00,556631012.0,109.8780730856781,-182.98,2
14:09,773633520.0,794.2598109385115,-45.0,2
14:14,518746136.0,-443.8197282369166,-71.61,2
14:19,673025413.0,2375.8110478697945,-101.5,7
14:23,773633520.0,739.2598109385115,-55.0,2
14:37,469330905.0,-7.111442587251517,-8.89,7
14:39,250895529.0,1340.172182469288,-86.26,5
14:42,681955876.0,-1408.5331000000006,-54.22,5
14:46,117308635.0,689.0860072910496,-126.0,7
14:48,773633520.0,647.7598109385115,-91.5,2
14:50,518746136.0,-557.8047282369166,-113.98,2
14:56,673025413.0,2237.2110478697946,-138.6,7
14:58,348460748.0,258.56754999999896,-118.88,2
15:08,270374623.0,10457.750845817927,-90.3,2
15:09,518746136.0,-632.8047282369166,-75.0,2
15:17,348460748.0,213.56754999999896,-45.0,2
15:19,773633520.0,568.7598109385115,-79.0,2
15:20,679911053.0,3378.2937848673055,-5.7,2
15:30,773633520.0,479.25981093851146,-89.5,2
15:33,673025413.0,2076.9110478697944,-160.3,4
15:34,270374623.0,10317.750845817927,-140.0,2
15:46,348460748.0,151.69254999999896,-61.88,2
16:02,409370545.0,1066.6412755455208,-71.55,5
16:02,108481285.0,9881.737276987416,-36.99,7
16:02,348460748.0,48.56754999999896,-103.12,2
16:02,504055745.0,258.10946134176686,-54.5,2
16:02,518746136.0,-743.4072282369166,-110.6,2
16:03,773633520.0,376.75981093851146,-102.5,2
16:03,678330503.0,3691.717409999903,-52.73,5
16:05,673025413.0,1826.3110478697945,-250.6,4
16:07,548907062.0,-415.55051123171154,-34.95,1
16:09,679911053.0,3343.3137848673055,-34.98,4
16:17,587225252.0,6500.290230669704,-29.88,9
16:19,348460748.0,-22.30745000000104,-70.88,2
16:21,653667523.0,3748.204899570016,-25.94,9
16:22,624500124.0,3726.3955178724727,-18.37,7
16:23,126929801.0,1759.5021063404756,-22.0,2
16:23,286484726.0,1128.0928267328864,-102.99,2
16:26,504055745.0,218.6094613417669,-39.5,2
16:35,901432314.0,4245.422642908,-28.24,1
16:36,388862238.0,1696.9965284731938,-39.98,4
16:38,773633520.0,351.75981093851146,-25.0,2
16:39,296972867.0,-830.7912000000009,-48.51,5
16:40,518746136.0,-861.1422282369166,-117.73,2
16:40,329840194.0,1700.077890143148,-61.22,2
16:42,970298834.0,3027.5624670811476,-22.66,4
16:43,642924505.0,627.044670183526,-12.0,4
16:44,370757362.0,1538.281589812676,-50.98,2
16:46,504055745.0,114.60946134176686,-104.0,2
16:47,982949451.0,-3883.994167052508,-37.07,5
16:48,551755686.0,7187.347485725705,-1.94,8
16:50,104832000.0,-2993.624858905844,-26.75,5
16:50,624500124.0,3632.422617872473,-93.97,4
16:56,345582855.0,638.5874528205494,-12.61,5
17:00,518746136.0,-980.3772282369166,-119.23,2
17:04,504055745.0,25.10946134176686,-89.5,2
17:04,587225252.0,6498.552314291163,-1.74,5
17:05,198630866.0,-373.9976235612686,-48.2,5
17:07,817294757.0,-2478.1107999999995,-55.66,5
17:09,807714284.0,1552.2889607359998,-49.97,5
17:09,773633520.0,291.75981093851146,-60.0,2
17:13,296770890.0,3116.487010379083,-30.18,9
17:15,471897866.0,8464.956172534998,-36.5,4
17:16,348460748.0,-104.80745000000104,-82.5,2
17:17,500043411.0,14604.836071478092,-49.09,8
17:17,200080192.0,10192.267519092564,-8.97,2
17:18,660874296.0,3201.7774499608495,-7.49,4
17:18,261894284.0,-2584.1412999999966,-15.28,5
17:19,518474507.0,15311.551982287749,-84.0,2
17:19,705848712.0,28524.044562350897,-40.94,8
17:19,670102069.0,2257.201850329287,-4.54,2
17:20,834581602.0,630.3836499999992,-21.98,4
17:21,901432314.0,4204.648942908,-40.77,4
17:21,245690309.0,10498.32866283525,-22.98,2
17:23,773633520.0,252.25981093851144,-39.5,2
17:24,419550103.0,19650.7211699773,-12.99,7
17:25,824916823.0,9454.532458440506,-204.4,2
17:26,556992209.0,12914.344021115508,-9.0,7
17:27,521611005.0,-115.86463585104656,-37.99,2
17:27,331450202.0,8632.105345729706,-46.45,5
17:28,532478725.0,5392.149404475447,-2.41,2
17:30,237493332.0,15620.960703801957,-182.15,2
17:30,361201224.0,4064.823098787924,-16.04,7
17:31,117308635.0,493.7860072910496,-195.3,2
17:32,235881534.0,14307.126685625894,-85.32,2
17:33,349614277.0,1830.5145499999996,-55.97,2
17:33,344219145.0,8617.638330975842,-79.98,2
17:33,169006407.0,12691.361195374691,-21.12,7
17:33,683078800.0,2383.029452944871,-25.96,7
17:34,836110591.0,7156.476221780246,-34.5,7
17:34,833899961.0,1458.017744249869,-33.43,9
17:34,656317661.0,-195.66895845859727,-29.96,7
17:35,534325901.0,7528.789499463872,-14.99,9
17:35,951817450.0,9633.923050991743,-64.98,7
17:36,859264768.0,482.94113378193833,-60.0,2
17:37,773633520.0,200.25981093851144,-52.0,2
17:38,854513972.0,2163.9455500000004,-23.96,7
17:39,166019891.0,8941.549483832565,-31.47,5
17:40,673025413.0,1658.3110478697945,-168.0,7
17:40,587202562.0,503.6877994170685,-149.99,2
17:41,741269136.0,2777.9059500000017,-19.97,7
17:42,518474507.0,15133.751982287748,-177.8,2
17:43,949032480.0,4894.430402448338,-172.17,2
17:45,656389634.0,371.32065957801456,-23.97,1
17:45,586315521.0,13394.622115675787,-19.83,2
17:46,736340277.0,9633.185340984614,-34.4,5
17:46,496395938.0,13023.176919688349,-50.51,5
17:48,994214354.0,10763.74548129336,-3.04,5
17:49,348460748.0,-145.68245000000104,-40.88,2
17:49,670427480.0,746.8908000000013,-155.97,2
17:50,329840194.0,1674.897570143148,-25.18,4
17:51,270374623.0,10233.750845817927,-84.0,2
17:56,885259672.0,3799.272941979807,-20.01,2
17:58,383625050.0,3280.8612153143413,-112.6,5
17:58,564744955.0,78.74735858884188,-70.66,5
17:59,897592348.0,16118.392772581732,-99.99,2
17:59,117308635.0,264.8860072910496,-228.9,2
18:01,556631012.0,-15.906676914321906,-125.78,5
18:02,824916823.0,9308.232458440509,-146.3,2
18:03,348460748.0,-216.93245000000104,-71.25,2
18:03,703478110.0,5797.0377318493875,-35.85,5
18:04,603721739.0,1570.118899483184,-132.76,5
18:05,673025413.0,1487.5110478697943,-170.8,4
18:08,376271050.0,1674.4791885480563,-6.81,7
18:10,282102606.0,393.54611242282647,-106.27,5
18:11,687135796.0,29671.340608605493,-14.2,9
18:14,773633520.0,89.25981093851146,-111.0,2
18:14,548907062.0,-526.1085112317115,-110.56,2
18:14,949032480.0,4635.4724024483385,-258.96,2
18:15,675806859.0,8000.959561129634,-13.98,9
18:15,475117511.0,8752.98474675902,-105.52,5
18:19,138609932.0,2657.9850032945856,-17.5,7
18:20,256002321.0,7356.345297536635,-35.69,5
18:20,668329719.0,9443.369437135014,-89.59,2
18:26,605116158.0,2844.246200000003,-7.98,7
18:26,992204045.0,7922.7823907628845,-58.79,2
18:32,196289502.0,16829.054540828187,-35.34,2
18:32,941285623.0,1546.2803990667703,-54.97,7
18:33,475117511.0,8745.994746759021,-6.99,7
18:36,348460748.0,-235.68245000000104,-18.75,2
18:38,604334058.0,626.0399999999994,-95.83,5
18:38,491392945.0,5933.943500000009,-36.22,5
18:40,815385232.0,11239.5147061411,-71.89,5
18:43,286484726.0,1078.2377767328865,-49.86,5
18:44,113747882.0,13276.20325115827,-28.19,9
18:45,124125096.0,263.031394387802,-133.53,5
18:45,752362502.0,8156.166554653203,-15.06,8
18:45,169006407.0,12662.859669801945,-28.5,5
18:47,999752672.0,1836.6330935333344,-114.19,5
18:48,558119802.0,35402.96182147815,-20.12,5
18:49,548907062.0,-674.4945112317115,-148.39,2
18:49,532525712.0,-806.0618000000004,-24.95,9
18:49,321372947.0,-286.95645078909945,-54.98,5
18:50,214339619.0,635.824550868356,-31.49,7
18:50,604334058.0,606.0499999999994,-19.99,7
18:51,929044080.0,-88.15860849437175,-31.64,5
18:53,500843551.0,1290.9598999999996,-31.98,7
18:54,340295966.0,-1604.9644500000004,-43.8,5
18:56,587202562.0,391.8277994170685,-111.86,4
18:56,736340277.0,9615.627155671542,-17.56,8
18:57,585596026.0,3283.51985090199,-7.96,7
18:57,195895574.0,7925.153656023279,-12.01,7
18:58,994214354.0,10736.66548129336,-27.08,9
19:01,354894456.0,1.4899999999995686,-34.01,9
19:01,305778936.0,11257.238348729565,-30.74,9
19:01,575652395.0,2885.325760996345,-279.51,5
19:01,940569402.0,6690.087334883299,-11.06,2
19:02,282837512.0,14956.008231821776,-32.98,9
19:05,361201224.0,3996.371783079846,-68.45,8
19:07,143061865.0,7854.671278381066,-10.62,4
19:08,683319988.0,8063.173901693566,-36.09,9
19:09,158414827.0,-1454.7500000000018,-6.9,5
19:16,441274121.0,13199.145485547197,-33.56,5
19:17,252760664.0,7436.378460647972,-66.29,5
19:21,678726554.0,-302.4662476516103,-124.57,5
19:21,151916463.0,-19.0214444008311,-33.22,9
19:31,383833857.0,26912.689463993564,-20.94,9
19:37,975345315.0,37316.08446947943,-40.31,5
19:38,361201224.0,3867.305783079846,-129.07,5
19:46,106601471.0,11379.721164376546,-33.38,7
19:51,414805878.0,13983.470157169751,-23.05,7
19:56,547010927.0,25358.123417821123,-20.0,9
19:56,901432314.0,4190.942942908,-13.71,5
20:02,180616589.0,1246.9085281236178,-10.21,5
20:04,131388684.0,23748.572350714865,-44.37,2
20:05,773633520.0,-36.285539061488535,-125.55,5
20:07,203466392.0,3996.8273063983793,-39.98,7
20:08,713641917.0,1507.155352873777,-5.7,5
20:12,639409800.0,37784.815058650216,-0.57,7
20:18,887853850.0,11290.894474531986,-34.43,9
20:19,815993333.0,6675.710608517283,-106.18,5
20:24,806358207.0,13877.424294993054,-2.73,7
20:24,229205098.0,8248.971695342127,-100.31,5
20:31,647936800.0,2798.2453137472953,-1.82,2
20:36,699997811.0,954.624100000004,-22.92,5
20:38,550832673.0,3351.424016395509,-81.51,5
20:47,902798190.0,-481.47963443102657,-91.69,5
20:54,143061865.0,7813.581278381066,-41.09,5
20:58,668329719.0,9335.485437135014,-107.88,5
21:02,651756497.0,15047.672976888864,-8.08,5
21:06,179173981.0,5492.535006736485,-36.1,9
21:21,331450202.0,8626.661953178573,-5.44,8
21:27,310375875.0,2487.3511438581454,-31.8,8
21:34,901432314.0,4180.896035968885,-10.05,5
21:53,170637730.0,3116.567745217624,-19.32,7
22:38,903663593.0,1306.429380043554,-3.95,2
00:12,678851253.0,4343.935695055984,-0.4,2
01:04,270374623.0,10215.703345354124,-18.05,2
01:26,134461671.0,6578.8605705805985,-48.43,7
02:04,520447032.0,8963.865397925832,-4.8,7
02:18,549414742.0,8245.765912606053,-24.94,2
02:21,203466392.0,3980.587306398379,-16.24,9
02:39,169006407.0,12659.44811906604,-3.41,8
02:46,450896297.0,14254.22991684918,-32.85,9
02:57,549414742.0,8213.215912606054,-32.55,9
03:01,613729471.0,10680.395370473936,-3.24,7
03:01,600185455.0,63.37000224748148,-23.38,9
03:05,699139822.0,2322.169343897246,-0.15,7
03:12,851649498.0,11307.555849243898,-67.03,8
03:16,183888402.0,20086.514973285382,-30.5,9
03:17,885259672.0,3787.709833776946,-11.56,4
03:20,285220959.0,12543.927793302772,-33.95,7
03:22,985188462.0,-449.05321128877534,-32.79,9
03:28,461990622.0,10291.25004162336,-5.45,5
03:29,873693307.0,11202.738664946688,-21.7,9
03:30,721393911.0,-602.6365425357167,-35.34,9
03:32,441274121.0,13150.185095656105,-48.96,4
03:35,128033695.0,2563.881675287405,-30.84,8
03:44,586315521.0,13350.552684591516,-44.07,4
03:45,510101371.0,14377.34406800894,-41.75,9
03:46,480557476.0,12008.14900188542,-5.39,7
03:48,874431242.0,10097.357466349138,-23.91,2
03:50,245690309.0,10464.81469741504,-33.51,5
03:50,670102069.0,2222.411850329287,-34.79,9
03:52,809499628.0,18465.99314345955,-19.45,9
03:55,601627384.0,4462.738288585636,-31.73,9
03:58,987163717.0,6578.628480000005,-22.98,9
03:59,639549973.0,8131.2209810897475,-1.72,5
04:01,256002321.0,7347.305297536635,-9.04,9
04:03,417850087.0,18441.64273262688,-17.27,8
04:04,213112754.0,7232.953917895469,-18.2,9
04:07,225210798.0,1112.7177737592085,-21.58,9
04:08,639409800.0,37742.92724541641,-41.89,5
04:08,806358207.0,13861.975683380788,-15.45,7
04:11,433917275.0,8376.137296233412,-24.39,9
04:13,310375875.0,2462.4611438581455,-24.89,9
04:15,668329719.0,9300.398095988685,-35.09,2
04:20,802697323.0,17508.64299917581,-36.44,9
04:22,414805878.0,13948.870157169751,-34.6,9
04:25,519644021.0,3611.035032378142,-8.37,5
04:31,858989281.0,28651.00093362814,-18.8,9
04:35,348325817.0,11441.869235046152,-37.94,9
04:35,213112754.0,7197.501308694782,-35.45,7
04:38,322720763.0,6930.739963193858,-14.35,7
04:38,683319988.0,8028.773901693567,-34.4,9
04:42,779946617.0,17578.053895686022,-24.05,5
04:44,581655972.0,43556.86051379709,-3.91,2
04:49,986267641.0,8972.549620120777,-5.13,5
04:49,532478725.0,5356.5794044754475,-35.57,9
04:50,113747882.0,13219.163874083852,-57.04,2
04:51,679911053.0,3340.393676783416,-2.92,8
04:51,558119802.0,35315.40625391146,-87.56,7
04:51,556992209.0,12895.04865280786,-19.3,2
04:53,964702094.0,1221.934304305138,-30.35,5
04:57,315546581.0,30169.46669423829,-9.3,2
04:58,522188082.0,8899.198942540614,-1.3,7
04:58,550169791.0,23016.6907064366,-17.65,5
05:01,873693307.0,11160.71254292451,-42.03,7
05:01,984783496.0,15036.438236893346,-18.33,9
05:02,383625050.0,3264.521215314341,-16.34,9
05:06,534204159.0,6250.986464580399,-5.5,7
05:07,108931112.0,15277.755851188283,-26.68,9
05:09,718058208.0,2576.512907777619,-24.15,4
05:13,709608057.0,3205.4251739274746,-35.82,9
05:17,489964679.0,21408.921751374233,-35.54,9
05:17,738958551.0,10025.151043405043,-71.73,7
05:21,973388795.0,1006.0936761636216,-19.44,9
05:31,785749304.0,9297.97079481416,-18.71,8
05:31,687135796.0,29655.400608605494,-15.94,9
05:33,383625050.0,3248.560317177237,-15.96,2
05:33,518474507.0,15099.521982287748,-34.23,9
05:35,179173981.0,5468.194914892663,-24.34,5
05:37,198946608.0,4869.303813976653,-22.21,5
05:38,310375875.0,2448.7043064740974,-13.76,7
05:39,585625048.0,2498.181974999357,-0.35,2
05:39,315078351.0,8466.092583854665,-36.49,5
05:40,973086490.0,11023.636470753365,-39.01,5
05:41,722358036.0,675.234390627083,-31.42,9
05:42,305778936.0,11235.308348729564,-21.93,9
05:44,151968462.0,8117.715350220954,-35.85,5
05:45,719586818.0,19514.578169084405,-2.33,8
05:45,647936800.0,2764.153653402812,-34.09,2
05:46,815993333.0,6657.615330491724,-18.1,5
05:47,822250278.0,7107.894211204435,-22.84,7
05:47,473820682.0,12494.99527403444,-10.87,2
05:49,769311479.0,6864.564833635515,-40.82,7
05:49,679662108.0,17291.704008680776,-6.92,8
05:50,196289502.0,16814.074540828187,-14.98,9
05:50,912705941.0,19540.153286686535,-16.55,2
05:52,414805878.0,13942.409289492496,-6.46,2
05:52,221868392.0,5479.319789666887,-20.99,9
05:52,108563213.0,25896.303852284334,-8.5,7
05:52,467207141.0,785.5008670482637,-30.28,9
05:53,366550080.0,28080.01188543129,-15.24,4
05:53,994214354.0,10702.82548129336,-33.84,9
05:54,832564361.0,17316.383422921826,-21.95,2
05:54,308505160.0,14208.402565168542,-4.23,5
05:55,433917275.0,8368.064128921062,-8.07,5
05:55,657139925.0,15079.839269915044,-16.8,9
05:55,252760664.0,7410.273230962094,-26.11,5
05:56,541639148.0,4650.311059556643,-6.12,5
05:59,126929801.0,1745.6997015783834,-13.8,5
06:02,687135796.0,29651.80673062742,-3.59,2
06:06,287480331.0,8933.988529529015,-28.7,9
06:06,766941757.0,3880.2833529849513,-34.3,9
06:08,705848712.0,28513.254562350896,-10.79,9
06:08,237493332.0,15610.72115595962,-10.24,5
06:11,145387690.0,5848.936275981992,-3.32,7
06:13,425964226.0,4240.790053979412,-10.33,8
06:14,706250160.0,13221.944443035394,-8.03,8
06:19,200080192.0,10172.510612964114,-19.76,2
06:20,851181128.0,5378.754487608613,-22.92,8
06:21,683319988.0,8021.450540457565,-7.32,8
06:22,450896297.0,14233.448550265855,-20.78,7
06:25,749378808.0,4599.744937047451,-31.2,9
06:30,532478725.0,5350.548679060552,-6.03,2
06:31,730002588.0,14413.498460046816,-9.19,5
06:35,324224854.0,4843.719345617809,-19.12,7
06:37,187541224.0,2700.74745664854,-34.84,9
06:38,547010927.0,25322.22341782112,-35.9,9
06:40,836110591.0,7126.656221780247,-29.82,9
06:42,203466392.0,3919.503205981304,-61.08,7
06:43,572384506.0,8919.179186310866,-35.17,9
06:44,187111705.0,7561.027888394047,-13.64,2
06:44,305778936.0,11179.297261537864,-56.01,2
06:48,143003091.0,10969.776387819176,-0.34,8
06:50,196289502.0,16752.372417289775,-61.7,2
06:52,984783496.0,15005.455194253957,-30.98,7
06:53,511179916.0,8102.975983707457,-1.06,5
06:56,950234174.0,2584.690323886288,-0.68,5
06:56,749378808.0,4597.282949716422,-2.46,5
07:01,124102251.0,3912.7308170897286,-1.87,7
07:05,264550521.0,9331.793250938468,-13.93,2
07:07,496395938.0,13003.805942484869,-19.37,2
07:08,653640811.0,18323.633762610316,-52.55,8
07:08,588565416.0,7074.14933364675,-3.6,7
07:09,873701090.0,878.7101628808681,-35.8,5
07:10,235881534.0,14300.961627120105,-6.17,7
07:13,940569402.0,6676.5973348832995,-13.49,9
07:15,506618547.0,15409.94698066405,-18.63,2
07:17,994214354.0,10701.12208513074,-1.7,5
07:17,673025413.0,1436.071814084738,-51.44,8
07:19,344219145.0,8615.910653372655,-1.73,2
07:20,146909202.0,3979.85210276932,-54.25,5
07:21,216285378.0,25300.827384634908,-27.46,9
07:22,853907490.0,8197.435277760156,-21.2,2
07:22,795847804.0,24828.535918782076,-46.98,7
07:22,842682241.0,6422.627230190828,-10.01,2
07:23,322221939.0,4141.250861916044,-50.49,5
07:31,815385232.0,11228.742078002348,-10.77,2
07:33,690958123.0,22333.181464824895,-36.71,2
07:36,575652395.0,2811.6094709512136,-73.72,7
07:43,221868392.0,5444.172152166025,-35.15,5
07:45,633345190.0,6585.953042146297,-25.45,9
07:49,651756497.0,15044.474066343872,-3.2,5
07:50,399144202.0,2326.2388859156576,-16.16,7
07:53,960208650.0,18523.48203131446,-65.1,5
07:54,229205098.0,8236.190495556159,-12.78,8
07:59,865748375.0,4482.570498138156,-10.98,7
07:59,897714622.0,9726.763749883385,-2.86,5
08:02,399538448.0,8247.953173652622,-6.8,9
08:04,259015404.0,1759.5421271347582,-41.99,9
08:05,108481285.0,9827.521933891692,-54.22,2
08:05,519935524.0,1307.162829737519,-5.7,9
08:07,905860285.0,12077.93678229014,-71.99,7
08:09,527842638.0,1100.8248426329835,-6.0,9
08:09,836110591.0,7124.540410907949,-2.12,7
08:11,752362502.0,8146.002665081272,-10.16,5
08:12,435984758.0,4757.521808625624,-23.85,2
08:14,704517789.0,18804.9305440479,-33.52,8
08:16,930277104.0,11086.32477993321,-35.37,9
08:19,700138124.0,5786.762993357077,-3.53,5
08:21,246753533.0,576.3640999999984,-20.73,5
08:23,992204045.0,7922.563452356216,-0.22,2
08:24,554792076.0,29928.729168532336,-9.1,7
08:27,832564361.0,17242.239422921826,-74.14,5
08:28,901432314.0,4175.396035968885,-5.5,9
08:29,762700245.0,1072.6477000000025,-4.7,9
08:31,345582855.0,623.9707528205494,-14.62,5
08:35,259015404.0,1742.7066783121115,-16.84,2
08:38,540159353.0,12105.403054153272,-26.98,5
08:39,290818242.0,7707.1319562325325,-69.61,2
08:45,776431321.0,3514.189702593939,-26.54,7
08:46,370521542.0,28413.67345979585,-19.41,5
08:47,204855464.0,-766.9394386396161,-168.1,5
08:50,835829467.0,-969.292249999998,-10.57,5
08:50,642924505.0,496.950720183526,-130.09,5
08:50,120634201.0,5594.705329403303,-16.35,9
08:51,499244466.0,-368.5888312834225,-71.16,5
08:53,165691047.0,500.0515999999989,-68.11,5
08:55,609939116.0,8224.370716045574,-117.03,5
08:56,609939116.0,8169.60545516476,-54.77,7
08:57,768271776.0,-446.5637967665796,-39.44,5
08:57,930277104.0,11064.37293196951,-21.95,2
08:59,868014990.0,-3484.1310999999955,-42.94,5
08:59,241459011.0,1123.1085132723467,-56.35,5
09:02,290751280.0,375.1135466748256,-128.0,5
09:02,540159353.0,12076.700082728112,-28.7,5
09:03,691012931.0,-1673.809750000001,-41.35,5
09:05,613729471.0,10613.468370473936,-66.93,5
09:06,478986718.0,-962.2211000000012,-50.01,5
09:07,195895574.0,7900.523656023279,-24.63,9
09:09,131388684.0,23724.845796261743,-23.73,2
09:10,678330503.0,3673.488245349617,-18.23,7
09:11,315546581.0,30149.43669423829,-20.03,4
09:11,950234174.0,2443.087323886288,-141.6,5
09:11,455831435.0,-1793.7996048014943,-40.32,5
09:12,834581602.0,570.9725499999992,-59.41,5
09:12,885259672.0,3737.6298037769466,-50.08,4
09:14,475277431.0,1449.3381369436192,-18.0,4
09:14,604288474.0,2245.253265893684,-75.43,5
09:15,822135975.0,12260.568197448998,-18.91,7
09:15,188263947.0,179.5017500000006,-24.96,7
09:16,627622066.0,3934.5549547156625,-32.96,7
09:17,558119802.0,35233.54095391146,-81.87,7
09:17,166019891.0,8930.363483832565,-11.19,5
09:17,534325901.0,7453.931469463872,-74.86,4
09:18,583579399.0,2429.1287000000007,-19.99,2
09:18,868377987.0,3210.043159635549,-10.98,7
09:18,215404070.0,432.8145891798497,-111.97,2
09:18,124102251.0,3900.720817089728,-12.01,4
09:18,496395938.0,12992.795942484869,-11.01,7
09:19,516051449.0,1799.3287746508286,-50.97,4
09:19,698076160.0,6974.042710241275,-98.64,5
09:20,647472692.0,26984.53626757727,-38.05,5
09:21,308897841.0,1341.7320999999988,-25.19,5
09:22,373163757.0,11808.509273794212,-12.01,4
09:22,766941757.0,3857.3991571058314,-22.88,5
09:23,324224854.0,4783.019345617809,-60.7,2
09:23,442070890.0,1399.1424124443708,-53.99,2
09:24,933491926.0,3965.132300000004,-4.99,7
09:25,105375973.0,-29.88034718105945,-36.09,2
09:25,241459011.0,1074.7335132723467,-48.38,7
09:25,259015404.0,1731.2566783121115,-11.45,7
09:25,905860285.0,12034.26678229014,-43.67,2
09:27,220183538.0,911.7839999999994,-25.0,2
09:29,659008214.0,-3401.3301022904225,-8.99,5
09:29,859264768.0,439.9511337819383,-42.99,2
09:30,264208990.0,1008.4694499999988,-14.99,4
09:31,730002588.0,14389.118460046817,-24.38,7
09:31,237493332.0,15494.05115595962,-116.67,2
09:33,143061865.0,7797.070231114411,-16.51,7
09:34,851649498.0,10944.955849243895,-362.6,2
09:34,711045550.0,2474.3373500000034,-65.65,5
09:34,365608668.0,387.7057520241888,-147.56,5
09:35,656389634.0,321.33065957801455,-49.99,1
09:35,409370545.0,1061.6212755455208,-5.02,7
09:35,154246234.0,-109.89510789789584,-143.5,2
09:35,920031185.0,689.6986794837078,-77.62,2
09:37,604288474.0,2222.746385893684,-22.51,4
09:39,331048953.0,139.40336797849358,-124.64,5
09:39,819515373.0,2701.2361360637933,-31.95,7
09:40,124102251.0,3825.660817089728,-75.06,2
09:40,449871732.0,8363.567586548472,-11.98,1
09:40,993663752.0,379.3894424103965,-147.98,2
09:41,581655972.0,43492.628513797084,-64.23,5
09:41,824916823.0,9269.327191281078,-38.91,2
09:42,221868392.0,5427.642152166025,-16.53,1
09:42,743630833.0,388.8895632847012,-16.98,4
09:45,626989363.0,1090.9810633173752,-64.99,2
09:45,365608668.0,363.73575202418874,-23.97,4
09:46,241459011.0,902.9835132723468,-171.75,4
09:46,639549973.0,8027.620981089747,-103.6,2
09:47,859264768.0,346.4811337819383,-93.47,2
09:48,298000165.0,27485.70047680987,-5.99,4
09:48,705848712.0,28410.274562350896,-102.98,2
09:49,909676212.0,1023.8494045320272,-12.98,7
09:49,108931112.0,15195.890551188286,-81.87,4
09:49,585596026.0,3190.5298509019904,-92.99,2
09:51,867987292.0,2919.8867072991193,-81.23,5
09:51,769311479.0,6725.064833635515,-139.5,2
09:51,904154012.0,542.0474581204317,-11.98,7
09:54,815385232.0,11215.602078002348,-13.14,7
09:54,652048867.0,636.4652999999989,-5.99,1
09:54,802697323.0,17442.513999175808,-66.13,4
09:55,776108637.0,1185.5690536574953,-106.6,5
09:55,680773155.0,497.65398333109147,-74.99,2
09:56,449871732.0,8309.577586548472,-53.99,2
09:56,517934629.0,635.6676787084264,-64.99,2
09:57,183888402.0,19934.864973285385,-151.65,2
09:57,920031185.0,660.8311794837078,-28.87,2
09:59,623156843.0,5081.50324742549,-20.97,1
09:59,656389634.0,83.37065957801454,-87.97,2
09:59,886837068.0,1154.768099999999,-23.97,4
09:59,450896297.0,14192.588550265857,-40.86,7
10:00,865748375.0,4363.500498138156,-119.07,5
10:01,454129843.0,588.5728451665601,-15.97,7
10:02,385685918.0,343.5099408415522,-50.0,2
10:02,581655972.0,43479.64851379708,-12.98,7
10:02,819515373.0,2674.2561360637933,-26.98,4
10:03,414454079.0,691.8678500000017,-2.02,4
10:04,405945930.0,5921.426275568806,-20.96,1
10:05,822718326.0,11955.827818471029,-10.21,5
10:05,585625048.0,2366.201974999357,-131.98,2
10:05,859264768.0,245.0111337819383,-101.47,2
10:06,336557504.0,1882.29648720102,-222.0,7
10:06,338022396.0,522.144189375739,-213.5,2
10:07,446720287.0,6.807440818405524,-100.97,2
10:08,933491926.0,3883.152300000004,-81.98,6
10:08,785210466.0,2608.265619997712,-19.99,2
10:09,851649498.0,10794.455849243895,-150.5,2
10:10,254853117.0,3534.461952564331,-81.48,5
10:11,639549973.0,8000.320981089747,-27.3,2
10:12,151968462.0,8089.635350220954,-28.08,2
10:13,987163717.0,6270.628480000005,-308.0,2
10:14,993663752.0,275.93944241039645,-103.45,2
10:14,516051449.0,1774.3587746508283,-24.97,7
10:14,380228542.0,112.5617418155656,-157.0,2
10:16,920031185.0,606.8411794837078,-53.99,2
10:16,757115616.0,2111.680000000004,-149.99,2
10:17,531186970.0,5411.396883735821,-40.99,2
10:18,587202562.0,339.85779941706846,-51.97,4
10:19,137822385.0,3783.541101541067,-7.8,9
10:19,454129843.0,518.6028451665601,-69.97,2
10:20,200080192.0,10110.714612964111,-61.8,5
10:21,322221939.0,4084.930861916044,-56.32,2
10:22,596171893.0,636.595594825511,-32.95,7
10:23,558875206.0,3787.134310898954,-5.99,1
10:23,700138124.0,5751.452993357077,-35.31,2
10:25,446720287.0,-82.17255918159448,-88.98,2
10:26,240643705.0,572.2693173739809,-116.5,2
10:27,168414279.0,-22.572715725078663,-19.99,2
10:28,338022396.0,483.16418937573894,-38.98,2
10:28,298000165.0,27461.567204430343,-24.13,2
10:29,113747882.0,13206.253874083854,-12.91,4
10:31,380228542.0,-32.4382581844344,-145.0,2
10:33,992204045.0,7916.563452356216,-6.0,2
10:35,920031185.0,576.8811794837078,-29.96,1
10:36,433917275.0,8361.874128921061,-6.19,4
10:37,680773155.0,441.0624833310914,-56.59,5
10:38,838830098.0,179.65379208778438,-103.98,5
10:38,154246234.0,-496.29510789789583,-386.4,2
10:42,500043411.0,14535.092551478092,-69.74,4
10:42,624563756.0,-135.3141712164436,-19.99,2
10:42,769319491.0,201.45699999999923,-65.97,2
10:43,491392945.0,5783.96350000001,-149.98,2
10:43,851649498.0,10637.655849243898,-156.8,2
10:44,518474507.0,15030.937604134322,-68.58,8
10:45,795847804.0,24817.345918782077,-11.19,4
10:46,703588001.0,-113.26695000000056,-30.96,7
10:48,757115616.0,2005.690000000004,-105.99,2
10:49,639549973.0,7853.320981089747,-147.0,2
10:51,338022396.0,375.20418937573896,-107.96,2
10:52,471897866.0,8433.975181448599,-30.98,7
10:52,923322792.0,-551.2118317536376,-113.62,2
10:52,126929801.0,1697.759701578383,-47.94,7
10:55,656389634.0,44.00315957801454,-39.37,7
10:56,851649498.0,10403.8558492439,-233.8,2
10:57,446720287.0,-186.15255918159448,-103.98,2
10:57,975345315.0,37303.07952395255,-13.0,4
10:58,993663752.0,144.44944241039644,-131.49,2
10:58,264208990.0,952.4894499999988,-55.98,2
11:01,990461108.0,576.4446686206111,-33.95,1
11:01,987163717.0,6172.628480000005,-98.0,4
11:02,895331556.0,-298.8054000000009,-14.36,5
11:02,627917561.0,4239.245050000006,-60.0,2
11:03,380228542.0,-106.9382581844344,-74.5,2
11:03,154246234.0,-779.0951078978958,-282.8,2
11:03,910730524.0,8389.994694218129,-53.84,5
11:04,923322792.0,-580.8368317536376,-29.62,2
11:05,637649383.0,977.1584499999984,-24.97,1
11:05,364357875.0,8975.741312463866,-39.04,2
11:07,757115616.0,1876.190000000004,-129.5,2
11:07,373163757.0,11803.519273794212,-4.99,7
11:08,365608668.0,315.74575202418873,-47.99,6
11:10,742223719.0,827.2129073048027,-5.99,4
11:11,653640811.0,18287.64376261031,-35.99,1
11:15,446720287.0,-324.6225591815945,-138.47,2
11:15,656389634.0,-29.85684042198546,-73.86,4
11:15,500051919.0,1025.6296966505902,-16.97,7
11:17,992204045.0,7842.349452356216,-74.21,5
11:18,519644021.0,3547.7250323781427,-63.31,2
11:22,851649498.0,10207.8558492439,-196.0,2
11:23,338022396.0,255.70418937573896,-119.5,2
11:24,386729293.0,34218.1439482526,-32.43,2
11:24,449871732.0,8268.305586548471,-41.27,2
11:26,776431321.0,3485.219702593939,-28.97,4
11:29,478412511.0,13030.38807019746,-6.99,1
11:29,832564361.0,17143.559422921826,-98.68,6
11:29,887853850.0,11289.53892445375,-1.36,7
11:30,758160963.0,9197.504078206108,-7.7,7
11:31,364357875.0,8893.851312463867,-81.89,2
11:32,987163717.0,5957.0284800000045,-215.6,4
11:32,196289502.0,16743.192417289774,-9.18,4
11:33,365608668.0,274.79575202418874,-40.95,7
11:34,383625050.0,3205.020317177237,-43.54,2
11:34,656389634.0,-87.58434042198546,-57.73,2
11:35,314980178.0,4274.892850000006,-60.0,2
11:37,380228542.0,-323.4382581844344,-216.5,2
11:37,446720287.0,-442.0925591815945,-117.47,2
11:37,967989787.0,467.6154326407273,-100.1,2
11:38,923322792.0,-659.5868317536376,-78.75,2
11:38,489964679.0,21394.171751374233,-14.75,1
11:41,757115616.0,1780.210000000004,-95.98,2
11:42,987163717.0,5684.728480000004,-272.3,4
11:43,338022396.0,193.23418937573896,-62.47,2
11:44,508518911.0,191.9947502790103,-149.99,2
11:47,859264768.0,66.52113378193829,-178.49,2
11:47,642924505.0,472.9807201835261,-23.97,4
11:52,703478110.0,5785.057731849388,-11.98,7
11:53,492215823.0,3691.9392938154447,-26.56,1
11:55,446720287.0,-609.0825591815944,-166.99,2
11:56,287480331.0,8882.895823595703,-51.09,7
11:56,489964679.0,21386.396401374233,-7.78,4
11:57,987163717.0,5559.428480000004,-125.3,4
11:58,757115616.0,1747.720000000004,-32.49,2
11:59,134847904.0,5434.942044386297,-16.98,4
12:02,923322792.0,-740.2118317536376,-80.62,2
12:03,699139822.0,2284.339343897246,-37.83,9
12:03,449871732.0,8172.419586548471,-95.89,2
12:04,822718326.0,11937.85781847103,-17.97,7
12:05,736310094.0,-685.3096240274259,-10.9,9
12:10,992204045.0,7809.339452356216,-33.01,2
12:11,897592348.0,16070.983417878098,-47.41,5
12:13,240643705.0,398.2693173739809,-174.0,2
12:14,971010829.0,456.78505644424513,-37.98,2
12:14,859264768.0,-42.448866218061696,-108.97,2
12:16,920031185.0,509.8911794837078,-66.99,2
12:17,446720287.0,-782.0725591815944,-172.99,2
12:18,572384506.0,8674.879186310867,-244.3,2
12:22,338022396.0,165.25418937573895,-27.98,2
12:22,711140907.0,918.3942999999992,-133.98,2
12:22,891716230.0,452.5808513926163,-158.32,5
12:23,688712152.0,7084.3904951875475,-17.63,2
12:26,973086490.0,11008.436470753364,-15.2,9
12:29,337771621.0,-3005.122649999998,-32.89,9
12:29,987163717.0,5219.928480000004,-339.5,7
12:30,757115616.0,1666.740000000004,-80.98,2
12:30,897592348.0,16050.9934178781,-19.99,2
12:31,923322792.0,-803.5868317536376,-63.38,2
12:36,835736339.0,2220.273066146472,-94.63,5
12:36,655368335.0,5169.975092150993,-27.03,4
12:38,993663752.0,118.55944241039644,-25.89,9
12:39,711140907.0,862.4042999999992,-55.99,2
12:39,331450202.0,8621.26362773874,-5.4,5
12:40,656812046.0,1332.6927537325191,-25.07,2
12:41,413557825.0,624.1023499999994,-18.97,7
12:41,303843160.0,265.57340000000147,-75.99,2
12:42,598793068.0,670.6113499999981,-8.99,4
12:46,631111289.0,-404.1315000000009,-14.79,5
12:47,358846516.0,1082.3622225272177,-75.99,2
12:50,757115616.0,1571.750000000004,-94.99,2
12:50,294474095.0,-2518.216286499238,-61.75,5
12:50,344219145.0,8566.532653372655,-49.38,5
12:50,446720287.0,-956.0625591815945,-173.99,2
12:51,338022396.0,62.264189375738965,-102.99,2
12:52,180719578.0,-4485.497749999995,-29.69,5
12:52,534325901.0,7434.041469463872,-19.89,9
12:52,336557504.0,1812.79648720102,-69.5,7
12:53,987163717.0,5088.328480000004,-131.6,7
12:53,624500124.0,3628.5598479020823,-3.86,2
12:54,471897866.0,8389.7631814486,-44.21,5
12:54,572384506.0,8543.279186310867,-131.6,2
12:55,609939116.0,8150.495455164761,-19.11,2
12:55,822135975.0,12254.458197448996,-6.11,4
12:55,224215364.0,-1799.6775920882787,-16.32,5
12:56,971129830.0,-1121.1206499999992,-13.41,5
12:59,117273481.0,9509.44506533524,-20.98,4
12:59,874506295.0,-1424.569256245572,-14.23,5
13:00,246753533.0,476.3740999999984,-99.99,2
13:00,338022396.0,13.274189375738963,-48.99,2
13:01,887853850.0,11261.338924453748,-28.2,9
13:01,541639148.0,4612.227769556644,-38.08,4
13:03,383625050.0,3192.880317177237,-12.14,2
13:03,585625048.0,2361.001974999357,-5.2,9
13:05,711140907.0,789.9342999999992,-72.47,2
13:06,387957305.0,-2741.5061059800782,-21.2,5
13:08,923322792.0,-874.8368317536376,-71.25,2
13:10,480557476.0,12002.79900188542,-5.35,9
13:12,832564361.0,17133.579422921826,-9.98,9
13:12,644751433.0,-1507.8481584655383,-25.18,5
13:14,277562576.0,550.1733383738673,-5.7,9
13:14,940569402.0,6663.345682594914,-13.25,8
13:18,564214408.0,-39.975615274274006,-8.37,5
13:18,752362502.0,8122.302665081272,-23.7,9
13:21,893134725.0,1210.9247376616677,-56.22,5
13:23,812692024.0,4197.00670666393,-7.8,9
13:24,322221939.0,4079.530861916044,-5.4,9
13:25,987656636.0,4735.10121659509,-0.83,5
13:27,282837512.0,14940.778046307338,-15.23,7
13:30,923322792.0,-938.5868317536376,-63.75,2
13:31,824916823.0,9243.557191281076,-25.77,2
13:32,338022396.0,-83.70581062426103,-96.98,2
13:32,637649383.0,859.1142999999984,-118.04,5
13:37,987163717.0,4907.728480000003,-180.6,7
13:38,605116158.0,2819.162400000003,-25.08,5
13:39,587202562.0,309.9077994170685,-29.95,7
13:40,130154096.0,1335.565001705878,-14.99,4
13:41,572384506.0,8470.479186310868,-72.8,2
13:42,858989281.0,28637.61968026507,-13.38,2
13:43,402438092.0,517.627299999999,-99.74,2
13:45,508518911.0,168.0347502790103,-23.96,7
13:47,237684254.0,6496.080722483111,-3.41,5
13:48,698955014.0,1313.1720302031968,-1.99,4
13:51,657139925.0,15041.809411276075,-38.03,2
13:54,656389634.0,-145.67934042198544,-58.09,7
13:54,572384506.0,8261.179186310868,-209.3,2
13:56,154246234.0,-1057.6951078978957,-278.6,2
13:57,987163717.0,4673.928480000003,-233.8,7
13:57,508518911.0,151.0547502790103,-16.98,4
13:57,336557504.0,1760.2964872010198,-52.5,7
13:57,421881811.0,3804.420777075302,-45.41,2
13:58,587202562.0,246.92779941706848,-62.98,2
14:00,923322792.0,-985.0868317536376,-46.5,2
14:02,821971408.0,1333.9331102355434,-23.49,5
14:03,992204045.0,7769.349452356216,-39.99,7
14:06,920031185.0,391.0161794837078,-118.88,2
14:08,402438092.0,403.64229999999895,-113.99,2
14:11,126929801.0,1617.8337015783834,-79.93,5
14:12,500843551.0,1254.9798999999996,-35.98,2
14:14,245690309.0,10404.11069741504,-60.7,5
14:16,718058208.0,2549.492907777619,-27.02,4
14:17,448279144.0,1135.3421999999991,-214.34,5
14:18,920031185.0,365.1486794837078,-25.87,2
14:19,987163717.0,4528.328480000003,-145.6,4
14:25,659415300.0,1966.9758805359595,-145.89,5
14:28,656389634.0,-198.17934042198544,-52.5,4
14:28,101531259.0,12.008449999999655,-73.32,5
14:30,851649498.0,9955.8558492439,-252.0,2
14:31,572384506.0,8037.179186310868,-224.0,2
14:32,993663752.0,-50.44055758960356,-169.0,2
14:32,154246234.0,-1175.2951078978956,-117.6,2
14:32,757115616.0,1488.260000000004,-83.49,2
14:33,336557504.0,1673.2964872010198,-87.0,4
14:40,338022396.0,-127.68581062426104,-43.98,2
14:44,920031185.0,284.1561794837078,-80.99,2
14:50,851649498.0,9824.255849243898,-131.6,2
14:50,510101371.0,14306.753572773958,-70.59,7
14:58,656389634.0,-217.29684042198545,-19.12,2
15:03,380228542.0,-502.4382581844344,-179.0,2
15:06,941285623.0,1525.3103990667703,-20.97,7
15:08,336557504.0,1533.7964872010198,-139.5,7
15:11,338022396.0,-257.15581062426105,-129.47,2
15:12,656389634.0,-253.28184042198544,-35.98,2
15:13,446720287.0,-1073.5625591815945,-117.5,2
15:17,448004226.0,1940.612523509976,-19.99,4
15:18,698076160.0,6933.384155919802,-40.66,8
15:19,828750680.0,1503.0726952136802,-69.98,2
15:20,336557504.0,1479.2964872010198,-54.5,4
15:20,851649498.0,9691.255849243898,-133.0,2
15:23,518466565.0,1488.2448999999992,-58.61,5
15:25,903953091.0,3923.4578830548,-31.49,4
15:28,380228542.0,-624.9382581844344,-122.5,2
15:34,757115616.0,1368.2900000000038,-119.97,2
15:36,867987292.0,2884.893481432749,-34.99,8
15:38,229205098.0,8211.650495556158,-24.54,7
15:38,656389634.0,-305.39934042198547,-52.12,2
15:41,446720287.0,-1169.5425591815945,-95.98,2
15:41,380228542.0,-714.4382581844344,-89.5,2
15:46,757115616.0,1212.8200000000038,-155.47,2
15:53,538003940.0,2558.9300000000094,-29.99,4
15:54,851649498.0,9434.3558492439,-256.9,2
15:54,611143859.0,1765.8247500000125,-10.01,2
15:54,993663752.0,-168.91055758960357,-118.47,2
15:55,548907062.0,-823.4412112317115,-148.95,5
15:58,828750680.0,1475.11269521368,-27.96,7
16:01,446720287.0,-1510.5425591815945,-341.0,2
16:03,380228542.0,-899.4382581844344,-185.0,2
16:09,738958551.0,9987.261043405044,-37.89,9
16:12,106601471.0,11374.970403046776,-4.75,8
16:15,380228542.0,-956.9382581844344,-57.5,2
16:16,604288474.0,2208.757473547491,-13.99,7
16:21,241459011.0,843.7335132723467,-59.25,2
16:22,757115616.0,1135.8300000000038,-76.99,2
16:27,446720287.0,-1690.5225591815945,-179.98,2
16:29,859603181.0,4047.7543118619265,-32.02,2
16:29,752362502.0,8106.252665081272,-16.05,7
16:30,380228542.0,-1090.4382581844343,-133.5,2
16:31,241459011.0,825.3585132723467,-18.38,2
16:34,198946608.0,4839.223813976653,-30.08,2
16:35,291580432.0,104.12920000000038,-24.95,4
16:37,338022396.0,-415.625810624261,-158.47,2
16:39,666952234.0,-109.80990187551316,-50.07,5
16:45,757115616.0,982.3300000000038,-153.5,2
16:47,489964679.0,21384.833482666912,-1.56,2
16:48,807098817.0,553.5829499999991,-17.97,4
16:49,912584712.0,1340.314619544733,-17.97,1
16:55,886921642.0,3709.048440238568,-7.51,2
16:57,521611005.0,-157.84463585104655,-41.98,2
16:58,851649498.0,9178.8558492439,-255.5,2
17:00,446720287.0,-1789.5225591815945,-99.0,2
17:04,392270893.0,13587.777165806105,-47.84,5
17:05,478651121.0,-377.31582040153035,-139.43,5
17:06,675806859.0,7951.812433182879,-49.15,7
17:07,237684254.0,6436.050722483111,-60.03,1
17:13,338022396.0,-482.59581062426105,-66.97,2
17:20,241459011.0,693.3585132723467,-132.0,7
17:20,518474507.0,14984.977604134325,-45.96,1
17:21,474951915.0,-2625.033595234011,-25.84,5
17:23,587225252.0,6462.162314291163,-36.39,9
17:26,446720287.0,-1855.0125591815945,-65.49,2
17:27,851649498.0,8938.755849243898,-240.1,2
17:27,333054026.0,831.3598940231901,-43.16,7
17:31,399144202.0,2295.3388859156576,-30.9,9
17:35,452974357.0,-3730.0614499999942,-11.84,5
17:38,757115616.0,949.3400000000038,-32.99,2
17:44,108481285.0,9697.411933891692,-130.11,2
17:44,899742927.0,13752.622982210762,-6.23,8
17:48,446720287.0,-1982.9725591815943,-127.96,2
17:56,993663752.0,-197.39055758960356,-28.48,2
17:59,757115616.0,801.3400000000038,-148.0,2
18:00,550832673.0,3335.444016395509,-15.98,4
18:03,766812921.0,135.17944999999918,-75.0,2
18:14,383833857.0,26882.682848003413,-30.01,8
18:25,137913631.0,683.2726499999997,-151.8,5
18:28,336557504.0,1248.7964872010198,-103.5,4
18:30,993663752.0,-293.87055758960355,-96.48,2
18:31,996042490.0,6779.547272669815,-31.34,2
18:55,621181115.0,-101.45124957077114,-115.86,5
18:59,383833857.0,26832.492848003418,-50.19,5
19:13,256002321.0,7340.87579905523,-6.43,7
19:37,785749304.0,9285.03079481416,-12.94,9
19:45,670102069.0,2191.795690645023,-30.62,2
19:47,406772240.0,-1345.3822000000005,-39.44,5
19:55,951817450.0,9613.373347310384,-20.55,8
20:07,180616589.0,1196.6905281236177,-50.22,5
20:10,522188082.0,8746.885942540614,-152.31,5
20:14,331450202.0,8605.413627738739,-15.85,9
20:32,709608057.0,3204.2093954721167,-1.22,2
20:34,550169791.0,22920.468706436597,-96.22,5
20:35,892354433.0,-753.6799606343386,-66.03,5
20:37,195895574.0,7876.52344121112,-24.0,5
20:41,430910686.0,756.4429000000003,-149.77,5
21:11,779236304.0,2330.1075954795333,-36.14,9
00:10,853907490.0,8186.049955734138,-11.39,4
00:11,633345190.0,6549.703042146297,-36.25,9
00:13,873693307.0,11151.23717392278,-9.48,5
00:15,586315521.0,13348.807800512855,-1.74,7
00:17,166019891.0,8926.153241257232,-4.21,7
00:26,575652395.0,2781.3765987184374,-30.23,7
00:26,719586818.0,19508.570729616706,-6.01,5
00:31,324224854.0,4733.398817185299,-49.62,7
00:32,873693307.0,11144.24717392278,-6.99,9
00:33,887853850.0,11241.148924453748,-20.19,9
00:44,572384506.0,8004.499186310868,-32.68,9
00:50,986267641.0,8954.478586169631,-18.07,7
00:54,433917275.0,8361.673704869048,-0.2,7
00:55,802697323.0,17412.633999175807,-29.88,9
00:55,874431242.0,10075.667466349138,-21.69,9
00:56,414454079.0,646.1678500000016,-45.7,9
00:57,704517789.0,18758.46928534508,-46.46,5
01:00,601627384.0,4425.268288585636,-37.47,9
01:02,113747882.0,13198.44250127314,-7.81,2
01:06,586315521.0,13318.367800512857,-30.44,9
01:09,851181128.0,5353.583338068363,-25.17,7
01:12,815385232.0,11207.80634178576,-7.8,2
01:15,623156843.0,5065.615763261028,-15.89,2
01:17,885259672.0,3667.363045701568,-70.27,2
01:18,730002588.0,14388.89921370856,-0.22,2
01:23,824916823.0,9215.327191281078,-28.23,9
01:24,409971170.0,3393.072658181936,-55.85,7
01:24,858989281.0,28592.616074824367,-45.0,2
01:34,905860285.0,12006.214797392546,-28.05,2
01:40,795847804.0,24789.12673992026,-28.22,2
01:41,435984758.0,4694.9144825456515,-62.61,2
01:46,534204159.0,6220.924616024079,-30.06,2
01:49,270374623.0,10202.736757384637,-12.97,2
01:51,237493332.0,15480.11115595962,-13.94,9
01:55,286484726.0,1077.3031320337757,-0.93,5
01:58,417850087.0,18438.16772235376,-3.48,5
01:58,113747882.0,13166.71250127314,-31.73,9
01:59,832564361.0,17099.240283837473,-34.34,8
02:01,866941383.0,2652.416950000007,-38.14,9
02:06,851181128.0,5335.333338068363,-18.25,9
02:06,987163717.0,4497.298480000003,-31.03,9
02:10,482513594.0,6555.872207013297,-9.18,5
02:10,441274121.0,13134.245095656104,-15.94,9
02:16,705848712.0,28378.290955986835,-31.98,8
02:17,624500124.0,3564.914319931194,-63.65,2
02:25,290818242.0,7693.948856212889,-13.18,7
02:27,987229118.0,1869.0185366002504,-9.81,5
02:28,891716230.0,444.92913561892567,-7.65,7
02:38,887853850.0,11230.41517920076,-10.73,5
02:39,489964679.0,21341.803482666914,-43.03,9
02:41,441274121.0,13133.497980899709,-0.75,2
02:41,510101371.0,14268.813572773955,-37.94,9
02:43,670102069.0,2141.455690645023,-50.34,9
02:45,683319988.0,7987.850540457564,-33.6,9
02:46,940569402.0,6626.5096293659635,-36.84,5
02:52,383833857.0,26829.064985147077,-3.43,7
02:54,727417797.0,6233.1253484788695,-56.39,7
02:55,506618547.0,15398.559924972747,-11.39,4
02:56,541639148.0,4592.773777106331,-19.45,4
02:59,145387690.0,5831.299051830574,-17.64,8
03:02,386729293.0,34204.11167224324,-14.03,2
03:02,779946617.0,17546.913895686022,-31.14,9
03:06,985188462.0,-476.75321128877533,-27.7,9
03:10,588565416.0,7069.7991015136795,-4.35,7
03:15,779236304.0,2293.1675954795332,-36.94,9
03:17,822135975.0,12213.587618975818,-40.87,7
03:17,806358207.0,13832.112905998352,-29.86,2
03:19,496395938.0,12956.838219217085,-35.96,7
03:19,874431242.0,10074.586849838624,-1.08,2
03:27,143061865.0,7760.116939314938,-36.95,5
03:30,683319988.0,7957.35835255399,-30.49,2
03:32,213112754.0,7178.611308694782,-18.89,9
03:40,473820682.0,12488.525935810418,-6.47,7
03:43,414805878.0,13908.929289492497,-33.48,9
03:46,235881534.0,14275.974062021658,-24.99,8
03:46,679662108.0,17214.410179677103,-77.29,7
03:47,667367404.0,9733.119611430344,-29.75,5
03:48,824916823.0,9201.066145329942,-14.26,2
03:51,752362502.0,8093.586542828968,-12.67,2
03:53,364357875.0,8870.551549472037,-23.3,2
03:53,678851253.0,4334.195897434961,-9.74,7
03:55,549414742.0,8202.412492153593,-10.8,5
03:56,270374623.0,10189.046757384634,-13.69,9
03:59,785749304.0,9278.04079481416,-6.99,9
04:06,264550521.0,9282.829147097802,-48.96,2
04:08,108481285.0,9686.256061197106,-11.16,2
04:11,585133606.0,5557.33745939284,-2.17,4
04:11,213112754.0,7153.664498242133,-24.95,5
04:20,383625050.0,3188.460041415413,-4.42,8
04:25,534325901.0,7410.670513151525,-23.37,2
04:26,196289502.0,16710.45865107217,-32.73,7
04:28,282837512.0,14902.03718948933,-38.74,7
04:32,196289502.0,16693.82865107217,-16.63,9
04:34,987656636.0,4731.626718509037,-3.47,7
04:35,229205098.0,8185.458628784393,-26.19,7
04:35,769311479.0,6709.534136169757,-15.53,5
04:35,779946617.0,17517.993555588997,-28.92,8
04:36,865748375.0,4353.26197636277,-10.24,5
04:37,549414742.0,8167.632492153593,-34.78,9
04:39,558119802.0,35206.60095391146,-26.94,9
04:47,700138124.0,5750.284156390776,-1.17,5
04:48,910730524.0,8380.764133289233,-9.23,7
04:49,604288474.0,2207.5792537939137,-1.18,7
04:50,785749304.0,9275.513523106183,-2.53,7
04:54,647936800.0,2724.656441957035,-39.5,7
04:54,187541224.0,2663.10745664854,-37.64,9
04:54,461990622.0,10268.084114298888,-23.17,5
04:56,766941757.0,3819.5191571058313,-37.88,9
04:56,151968462.0,8038.486464654571,-51.15,2
04:56,842682241.0,6353.181599899588,-69.45,4
04:58,547010927.0,25289.27341782112,-32.95,9
04:59,973086490.0,10998.056470753363,-10.38,9
05:00,897714622.0,9719.515857448325,-7.25,8
05:01,216285378.0,25263.087384634902,-37.74,9
05:03,718058208.0,2542.2191775137258,-7.27,7
05:03,169006407.0,12649.333599865497,-10.11,7
05:04,128033695.0,2528.8516752874048,-35.03,9
05:07,187111705.0,7527.105984271817,-33.92,7
05:11,836110591.0,7122.605118073938,-1.94,7
05:13,851649498.0,8921.667772591316,-17.09,7
05:16,183888402.0,19894.734973285384,-40.13,9
05:21,657139925.0,15019.319411276076,-22.49,9
05:21,519644021.0,3507.768254584826,-39.96,7
05:25,815993333.0,6641.367022742121,-16.25,2
05:27,587225252.0,6457.245686680301,-4.92,7
05:30,287480331.0,8881.669211381666,-1.23,2
05:31,348325817.0,11416.369235046152,-25.5,9
05:35,128033695.0,2500.8213085019233,-28.03,7
05:36,518474507.0,14955.047604134325,-29.93,9
05:51,709608057.0,3171.6893954721168,-32.52,9
05:55,237493332.0,15470.05459793164,-10.06,7
05:57,675806859.0,7908.52992643292,-43.28,2
05:57,687135796.0,29638.82673062742,-12.98,9
06:08,522188082.0,8718.377199621442,-28.51,7
06:09,108563213.0,25875.97419517134,-20.33,5
06:09,949032480.0,4615.532402448339,-19.94,9
06:10,454356905.0,2179.463225233368,-45.69,9
06:19,203466392.0,3910.1743605389993,-9.33,5
06:21,912705941.0,19532.795186365172,-7.36,5
06:22,280268430.0,6031.404985753484,-29.45,5
06:23,639549973.0,7837.726108930256,-15.59,8
06:24,399144202.0,2251.9088859156577,-43.43,9
06:26,520447032.0,8911.010855368351,-52.85,2
06:26,200080192.0,10041.319649535184,-69.39,2
06:27,256002321.0,7321.9257990552305,-18.95,9
06:35,709608057.0,3150.273638558324,-21.42,2
06:36,822250278.0,7091.314207855906,-16.58,8
06:38,670102069.0,2123.846380373488,-17.61,7
06:38,259015404.0,1690.7266783121115,-40.53,9
06:40,120634201.0,5576.215329403303,-18.49,9
06:43,994214354.0,10672.55208513074,-28.57,9
06:48,124102251.0,3805.9506164897584,-19.71,8
06:50,668329719.0,9294.706682101692,-5.69,7
06:52,609939116.0,8134.051958852751,-16.44,2
06:53,511179916.0,8089.3584373282865,-13.62,8
06:54,859603181.0,4012.0043118619265,-35.75,9
06:54,370521542.0,28400.433459795848,-13.24,9
06:54,108931112.0,15166.100551188283,-29.79,9
06:55,510101371.0,14217.487263145696,-51.33,8
06:57,873701090.0,855.3148565786039,-23.4,5
06:57,414805878.0,13886.245725075738,-22.68,7
06:58,310375875.0,2423.1143064740972,-25.59,9
07:00,930277104.0,11038.808681636949,-0.92,8
07:00,127809299.0,1110.3705657577852,-2.67,2
07:05,305778936.0,11152.757261537865,-26.54,9
07:06,950234174.0,2402.730434821153,-40.36,7
07:07,809499628.0,18458.753143459548,-7.24,9
07:08,146909202.0,3975.2253004315216,-4.63,7
07:08,315546581.0,30137.669852527342,-11.77,4
07:11,678330503.0,3641.391108134033,-32.1,5
07:11,960208650.0,18480.393710985183,-43.09,7
07:16,245690309.0,10372.401617618469,-31.71,7
07:16,547010927.0,25275.08148950553,-14.19,5
07:20,195895574.0,7852.32344121112,-24.2,9
07:22,687135796.0,29622.491923611095,-16.33,7
07:27,308505160.0,14168.421837987296,-39.98,5
07:30,399144202.0,2238.947185379695,-12.96,2
07:31,749378808.0,4590.171200093473,-7.11,7
07:32,943329213.0,1038.4246193497577,-4.08,4
07:40,305778936.0,11127.163823715568,-25.59,7
07:40,170637730.0,3078.798369171737,-37.77,8
07:40,340321732.0,2035.587000000004,-26.74,9
07:41,558119802.0,35201.69314798577,-4.91,7
07:44,256002321.0,7318.5648376526415,-3.36,2
07:50,661295096.0,3711.880924172199,-25.05,7
07:52,679911053.0,3267.293843269971,-73.1,2
07:55,550169791.0,22875.43090005307,-45.04,7
07:58,613729471.0,10591.525524741965,-21.94,7
08:02,532478725.0,5340.515214004058,-10.03,5
08:02,738958551.0,9977.659000765696,-9.6,5
08:06,699139822.0,2269.1068023677294,-15.23,8
08:08,179173981.0,5466.2044184211245,-1.99,7
08:09,809499628.0,18446.53714455047,-12.22,7
08:15,581655972.0,43476.61029640742,-3.04,4
08:16,285220959.0,12531.096261928244,-12.83,7
08:18,986267641.0,8926.79858616963,-27.68,9
08:32,651756497.0,15032.938941732707,-11.54,8
08:38,633345190.0,6545.167929573647,-4.54,7
08:41,471897866.0,8319.436460909215,-70.33,7
08:43,984783496.0,14997.215194253957,-8.24,9
08:50,570323670.0,3585.051220686365,-25.72,5
08:51,949032480.0,4555.838120120479,-59.69,5
08:56,391688371.0,1238.1993911585,-8.49,7
08:56,348325817.0,11400.57473094357,-15.79,7
09:14,427909748.0,2089.743200000015,-51.97,4
09:17,417850087.0,18367.62668235376,-70.54,4
09:18,943329213.0,1004.3346193497576,-34.09,7
09:19,999752672.0,1830.6430935333344,-5.99,7
09:19,170637730.0,3021.134449171737,-57.66,4
09:19,660874296.0,3180.8074499608497,-20.97,7
09:20,225210798.0,1110.7277737592085,-1.99,4
09:21,200080192.0,10011.029649535183,-30.29,7
09:23,706250160.0,13212.994632091024,-8.95,5
09:25,859603181.0,3957.3439475680752,-54.66,2
09:25,143003091.0,10962.786387819177,-6.99,4
09:25,282837512.0,14895.64291948933,-6.39,4
09:26,386729293.0,34156.121672243244,-47.99,6
09:26,673025413.0,1430.9567296202345,-5.12,4
09:26,887853850.0,11215.73517920076,-14.68,7
09:27,472995101.0,2551.9671842428033,-110.98,2
09:28,134461671.0,6558.830570580599,-20.03,6
09:29,403383649.0,2211.440486470919,-38.99,1
09:30,633345190.0,6527.1075595736465,-18.06,4
09:31,310375875.0,2410.164691160321,-12.95,5
09:33,936813994.0,1282.4784608327882,-150.98,2
09:34,897592348.0,16020.0334178781,-30.96,7
09:40,639409800.0,37733.80484541641,-9.12,4
09:43,435984758.0,4684.864442545651,-10.05,4
09:44,973086490.0,10953.089700654613,-44.97,5
09:46,647936800.0,2684.586441957035,-40.07,7
09:46,654329190.0,48.60795094851929,-98.23,2
09:49,246753533.0,456.3840999999984,-19.99,4
09:49,833499132.0,2584.5670000000023,-173.62,2
09:52,152616936.0,982.2710078630648,-136.49,2
09:52,245690309.0,10355.141617618468,-17.26,7
09:52,284905540.0,8824.070716283519,-226.1,2
09:52,737547541.0,543.4825995677743,-94.47,2
09:55,386729293.0,33922.34967224325,-233.77,2
09:56,936813994.0,1148.9884608327882,-133.49,2
09:56,349614277.0,1824.5245499999996,-5.99,1
09:57,986774156.0,1778.4069316257694,-25.96,7
09:58,660561861.0,290.2528316336894,-131.6,2
10:00,601627384.0,4419.108288585636,-6.16,1
10:00,782013626.0,3150.225199311629,-86.99,6
10:02,627622066.0,3875.5362221696296,-59.02,2
10:03,183888402.0,19874.374218226752,-20.36,7
10:03,472995101.0,2400.9771842428036,-150.99,2
10:04,858989281.0,28448.43007482437,-144.19,2
10:06,690958123.0,22308.802924198066,-24.38,7
10:06,297823329.0,843.3442999999992,-24.97,1
10:09,131388684.0,23662.545796261744,-62.3,7
10:09,713910252.0,252.22587572854115,-85.0,2
10:10,639409800.0,37707.68903654843,-26.12,2
10:11,737547541.0,510.5965995677743,-32.89,2
10:13,287230540.0,1572.992293293266,-21.96,1
10:16,472995101.0,2380.987184242804,-19.99,4
10:17,604870380.0,-1882.0965529005532,-15.44,5
10:17,654329190.0,-61.627049051480725,-110.24,2
10:21,386729293.0,33809.67767224325,-112.67,2
10:23,795847804.0,24766.726739920257,-22.4,2
10:23,146686559.0,-579.222211173478,-39.45,5
10:24,152616936.0,814.3270078630648,-167.94,2
10:25,936813994.0,999.9984608327882,-148.99,2
10:25,660561861.0,171.9528316336894,-118.3,2
10:25,158414827.0,-1462.0000000000018,-7.25,5
10:25,215311171.0,7023.624255150089,-12.99,2
10:26,857455726.0,-398.9583141243158,-105.98,2
10:26,419550103.0,19597.6711699773,-53.05,2
10:27,914806976.0,1145.8532501854866,-74.99,2
10:28,857997794.0,1208.505665150887,-35.98,4
10:29,191161970.0,-3973.647999999994,-87.28,5
10:29,581655972.0,43406.63029640742,-69.98,2
10:29,762859681.0,3348.7475999999992,-11.94,4
10:29,147508204.0,-292.12528221811345,-104.98,2
10:30,916270283.0,2660.43425,-25.97,1
10:31,345582855.0,587.9410528205493,-36.03,5
10:31,220183538.0,906.7939999999994,-4.99,4
10:32,675398089.0,-722.9294407746511,-139.93,5
10:32,510101371.0,14201.397263145696,-16.09,4
10:32,131388684.0,23440.645796261742,-221.9,4
10:33,111137699.0,-160.6338999999994,-114.43,5
10:35,601627384.0,4381.938917147947,-37.17,7
10:35,534097839.0,-4352.161049999997,-25.79,5
10:36,895331556.0,-376.7954000000009,-77.99,2
10:37,366550080.0,28011.593885431288,-68.42,5
10:38,844835978.0,10747.25150796128,-20.29,5
10:38,290751280.0,262.13354667482554,-112.98,2
10:39,660561861.0,70.45283163368941,-101.5,2
10:40,920031185.0,134.18617948370778,-149.97,2
10:40,713910252.0,213.22587572854115,-39.0,2
10:41,858989281.0,28342.744074824364,-105.69,2
10:41,737547541.0,460.2105995677743,-50.39,2
10:41,668692488.0,2807.95562857381,-5.99,4
10:42,903663593.0,1183.054380043554,-123.38,2
10:43,949032480.0,4502.498120120479,-53.34,2
10:44,322221939.0,4029.6306076645938,-49.9,5
10:46,586315521.0,13237.917800512856,-80.45,2
10:46,291128777.0,-2794.6714405263683,-46.21,5
10:46,414454079.0,630.9578500000016,-15.21,4
10:47,402438092.0,309.90389999999894,-93.74,5
10:47,970298834.0,2940.706467081148,-86.86,5
10:47,277562576.0,525.1877839436273,-24.99,7
10:48,910730524.0,8291.556133289232,-89.21,5
10:48,719742742.0,-526.2100077779633,-8.84,5
10:49,679911053.0,3249.3038432699714,-17.99,1
10:49,690958123.0,22279.81292419806,-28.99,7
10:52,903663593.0,1015.054380043554,-168.0,2
10:52,494156986.0,-469.6587543276653,-84.06,5
10:53,660561861.0,-93.34716836631056,-163.8,2
10:54,668175891.0,1293.667223158499,-5.99,2
10:55,480557476.0,11999.67351629933,-3.13,7
10:56,713910252.0,193.72587572854115,-19.5,2
10:57,366550080.0,28002.24379860277,-9.35,8
10:57,386729293.0,33711.69167224325,-97.99,2
10:57,832564361.0,17008.940283837474,-90.3,2
10:57,936813994.0,891.4984608327882,-108.5,2
10:57,742223719.0,795.2229073048027,-31.99,2
10:58,413557825.0,370.7572999999994,-253.35,5
10:59,964913066.0,-2414.952199999998,-48.53,5
11:00,165098840.0,-532.7481263623731,-20.07,5
11:00,781554833.0,1302.8780255639665,-37.99,2
11:02,314980178.0,4244.912850000006,-29.98,2
11:03,221868392.0,5399.733519229305,-12.39,4
11:04,250895529.0,1305.182182469288,-34.99,2
11:04,143003091.0,10922.423450475617,-40.36,7
11:05,423208402.0,-42.66159999999749,-20.53,5
11:05,903663593.0,881.1793800435539,-133.88,2
11:06,472995101.0,2227.1327842428036,-153.85,5
11:06,188263947.0,107.5221500000006,-71.98,5
11:06,308068836.0,1308.068522568192,-209.3,2
11:06,737547541.0,418.2245995677743,-41.99,2
11:06,668692488.0,2776.99562857381,-30.96,7
11:07,858989281.0,28208.35807482437,-134.39,2
11:09,758885184.0,1234.9771822743446,-159.98,2
11:09,785210466.0,2587.9166199977117,-20.35,5
11:11,806358207.0,13689.900905998353,-142.21,5
11:13,237684254.0,6396.300412296665,-39.75,5
11:14,147474476.0,3677.860802832959,-140.33,5
11:14,131388684.0,23328.645796261742,-112.0,2
11:15,442070890.0,1366.1824124443708,-32.96,1
11:17,284905540.0,8586.070716283519,-238.0,2
11:19,290818242.0,7658.568856212889,-35.38,2
11:20,737547541.0,261.4385995677743,-156.79,2
11:20,386729293.0,33417.71967224325,-293.97,2
11:22,472995101.0,2103.6527842428036,-123.48,2
11:23,331450202.0,8594.886884854435,-10.53,2
11:25,858989281.0,27971.758074824367,-236.6,2
11:25,828532554.0,576.2868765071482,-119.97,2
11:26,654329190.0,-164.36954905148073,-102.74,2
11:26,766941757.0,3533.219157105831,-286.3,2
11:26,854513972.0,2048.9737000000005,-114.97,5
11:27,806358207.0,13547.800905998352,-142.1,2
11:28,936813994.0,859.4984608327882,-32.0,2
11:29,786141370.0,-106.4395000000008,-77.58,5
11:30,860360312.0,211.2694588826804,-47.0,2
11:31,308068836.0,1002.168522568192,-305.9,2
11:31,833499132.0,2508.0670000000023,-76.5,2
11:32,235881534.0,14262.934062021655,-13.04,2
11:33,866941383.0,2406.416950000007,-246.0,2
11:34,472995101.0,2012.6927842428036,-90.96,2
11:35,823208989.0,1796.7414638695311,-73.94,2
11:36,713910252.0,109.72587572854115,-84.0,2
11:37,166019891.0,8893.553241257232,-32.6,2
11:38,504055745.0,-41.084638658233146,-66.19,5
11:38,886837068.0,1029.7780999999993,-124.99,2
11:39,585625048.0,2299.9759749993573,-61.03,5
11:40,169006407.0,12586.853599865495,-62.48,2
11:43,736340277.0,9568.98715567154,-29.79,7
11:44,766941757.0,3358.219157105831,-175.0,2
11:44,834581602.0,478.9825499999991,-91.99,2
11:44,936813994.0,721.5284608327881,-137.97,2
11:46,173335108.0,2683.8940000000007,-59.99,2
11:47,419550103.0,19593.96887281081,-3.7,7
11:47,849096144.0,1903.8920207513431,-52.69,5
11:47,833499132.0,2324.6920000000023,-183.38,2
11:47,776431321.0,3479.2297025939392,-5.99,1
11:48,170637730.0,3016.114449171737,-5.02,7
11:48,654329190.0,-207.11954905148073,-42.75,2
11:48,136770968.0,-308.40265000000045,-85.53,5
11:48,858989281.0,27959.172074824368,-12.59,2
11:48,586041848.0,35.65169999999889,-23.96,7
11:50,131388684.0,23076.645796261742,-252.0,2
11:50,386729293.0,33213.37567224325,-204.34,2
11:51,500043411.0,14495.202551478093,-39.89,4
11:51,822718326.0,11891.99381847103,-45.86,5
11:51,179173981.0,5448.694418421124,-17.51,7
11:53,737547541.0,179.5525995677743,-81.89,2
11:54,851181128.0,5324.983338068363,-10.35,2
11:54,425730826.0,2633.92190938872,-18.59,5
11:55,540159353.0,11976.710082728112,-99.99,2
11:58,936813994.0,573.5384608327881,-147.99,2
11:59,308068836.0,853.0685225681921,-149.1,2
11:59,409370545.0,1029.4712755455207,-32.15,7
12:00,500843551.0,1234.9898999999996,-19.99,2
12:00,802697323.0,17312.53399917581,-100.1,2
12:01,713910252.0,47.725875728541155,-62.0,2
12:02,994214354.0,10637.907605130742,-34.64,4
12:03,131388684.0,22902.345796261743,-174.3,2
12:03,766941757.0,3193.719157105831,-164.5,2
12:04,409971170.0,3382.832658181936,-10.24,1
12:06,618138606.0,1471.685902870066,-74.99,2
12:07,558875206.0,3739.862539399781,-47.27,7
12:10,737547541.0,124.25259956777433,-55.3,2
12:11,472995101.0,1977.2127842428035,-35.48,2
12:11,189335192.0,-1122.8878517578603,-89.68,5
12:11,849096144.0,1893.9020207513431,-9.99,2
12:11,661295096.0,3692.910924172199,-18.97,1
12:12,386729293.0,33067.77567224325,-145.6,2
12:12,802697323.0,17211.03399917581,-101.5,2
12:14,799453072.0,-405.3454500000011,-137.81,5
12:14,879091637.0,339.9375237379769,-198.1,2
12:14,654329190.0,-296.3620490514807,-89.24,2
12:15,836110591.0,7086.615118073938,-35.99,9
12:16,858989281.0,27904.57207482437,-54.6,2
12:16,853907490.0,8167.859955734139,-18.19,9
12:18,999752672.0,1795.7930935333345,-34.85,9
12:20,838830098.0,136.43379208778438,-43.22,9
12:21,482513594.0,6547.066207013298,-8.81,5
12:21,454356905.0,2158.5427319904093,-20.92,7
12:24,386729293.0,32915.90367224325,-151.87,2
12:27,867987292.0,2844.8734814327486,-40.02,2
12:27,570410059.0,2366.5626467763113,-29.99,2
12:27,534204159.0,6164.994616024079,-55.93,4
12:30,713910252.0,-21.274124271458845,-69.0,2
12:30,936813994.0,423.5784608327881,-149.96,2
12:31,909676212.0,992.3694045320271,-31.48,4
12:32,408057540.0,5200.318753408385,-3.45,5
12:32,472995101.0,1880.7327842428035,-96.48,2
12:34,766941757.0,3123.719157105831,-70.0,2
12:37,245198540.0,363.9713988017795,-16.43,5
12:39,149684419.0,1221.413299999998,-30.95,1
12:42,812692024.0,4191.016706663931,-5.99,9
12:43,858989281.0,27847.91407482437,-56.66,2
12:44,843174694.0,-5284.863499999998,-21.05,5
12:44,500043411.0,14472.284551478093,-22.92,5
12:47,266777719.0,1758.7789337802396,-48.18,2
12:47,179173981.0,5408.394418421124,-40.3,9
12:47,743630833.0,347.9495632847012,-40.94,7
12:48,799286313.0,-1060.4160628758616,-63.78,5
12:48,879091637.0,245.4375237379769,-94.5,2
12:48,280098744.0,-1134.1946221283342,-49.94,5
12:49,903663593.0,752.5543800435539,-128.62,2
12:49,936917570.0,-2990.702499999996,-28.79,5
12:50,713910252.0,-81.27412427145885,-60.0,2
12:50,986774156.0,1755.4269316257694,-22.98,2
12:51,131388684.0,22773.545796261744,-128.8,2
12:51,409971170.0,3318.332658181936,-64.5,4
12:52,654329190.0,-340.9795490514807,-44.62,2
12:53,588565416.0,6971.81910151368,-97.98,2
12:56,948069469.0,-689.614000000001,-49.05,5
12:59,832564361.0,16809.440283837474,-199.5,2
12:59,828750680.0,1375.12269521368,-99.99,2
13:02,833499132.0,2245.9420000000023,-78.75,2
13:02,585625048.0,2293.925974999357,-6.05,9
13:02,151968462.0,7993.241134654571,-45.25,4
13:03,936813994.0,334.5884608327881,-88.99,2
13:05,472995101.0,1780.2527842428035,-100.48,2
13:05,215426302.0,277.3384040256919,-15.39,5
13:08,480557476.0,11993.52351629933,-6.15,9
13:09,170637730.0,2973.5824491717367,-42.53,5
13:10,152616936.0,675.0830078630647,-139.24,2
13:10,583579399.0,2279.1487000000006,-149.98,2
13:11,482513594.0,6532.866207013298,-14.2,9
13:12,386729293.0,32708.03167224325,-207.87,2
13:13,758160963.0,9137.949609783696,-59.55,5
13:14,824916823.0,9158.82614532994,-31.95,2
13:14,896821055.0,-791.7976407329176,-166.49,5
13:14,131388684.0,22545.345796261743,-228.2,2
13:15,433917275.0,8345.558724869048,-16.11,4
13:15,322221939.0,4023.9306076645935,-5.7,9
13:18,993663752.0,-402.4584075896035,-108.59,5
13:18,903663593.0,704.1793800435539,-48.38,2
13:18,441142605.0,2733.7464422757284,-99.99,2
13:19,713910252.0,-116.27412427145885,-35.0,2
13:20,358846516.0,1043.4822225272176,-38.88,9
13:20,654329190.0,-381.08954905148073,-40.11,2
13:20,277562576.0,519.8377839436273,-5.35,9
13:22,403383649.0,2102.135486470919,-109.3,5
13:23,866941383.0,2191.416950000007,-215.0,2
13:26,184430449.0,2830.4939276932655,-25.0,2
13:28,660789920.0,-2498.4658473823724,-12.97,5
13:29,876890798.0,3907.324570699933,-22.98,2
13:29,152616936.0,633.0970078630647,-41.99,2
13:36,940569402.0,6563.5096293659635,-63.0,2
13:38,936813994.0,171.59846083278808,-162.99,2
13:39,833499132.0,2124.4420000000023,-121.5,2
13:40,240643705.0,364.31931737398094,-33.95,7
13:41,308068836.0,692.7685225681921,-160.3,2
13:41,506618547.0,15348.119924972749,-50.44,2
13:44,152616936.0,591.8110078630648,-41.29,2
13:44,994214354.0,10633.80828545962,-4.1,8
13:45,792845450.0,1368.945150000001,-89.97,4
13:46,131388684.0,22468.345796261743,-77.0,2
13:50,629078930.0,216.009479725602,-31.99,2
13:54,713910252.0,-216.27412427145885,-100.0,2
13:55,308068836.0,532.4685225681922,-160.3,2
13:58,879091637.0,115.9375237379769,-129.5,2
14:01,454356905.0,2128.070891990409,-30.47,4
14:03,358846516.0,1006.5322225272176,-36.95,7
14:03,138609932.0,2648.9850032945856,-9.0,4
14:04,806358207.0,13258.000905998351,-289.8,2
14:04,832564361.0,16620.440283837474,-189.0,2
14:04,758160963.0,9046.501609783696,-91.45,5
14:05,131388684.0,22387.845796261743,-80.5,2
14:05,158766229.0,-602.8200858934699,-82.51,5
14:06,940569402.0,6427.0096293659635,-136.5,2
14:07,500843551.0,1199.0098999999996,-35.98,2
14:08,581618317.0,-5115.1417018732045,-33.64,5
14:10,833499132.0,2068.1920000000023,-56.25,2
14:11,152616936.0,529.5250078630647,-62.29,2
14:12,134847904.0,5346.972044386297,-87.97,2
14:16,456246119.0,21873.564858632897,-3.98,4
14:18,713910252.0,-286.27412427145885,-70.0,2
14:18,358846516.0,959.4701725272176,-47.06,5
14:19,901037631.0,1788.8793230964066,-52.14,2
14:20,737547541.0,64.06659956777432,-60.19,2
14:21,216286013.0,53.20015665393987,-98.51,5
14:22,879091637.0,-92.66247626202308,-208.6,2
14:27,833499132.0,2036.6920000000025,-31.5,2
14:29,119943495.0,-1422.875062112858,-71.66,5
14:29,395654270.0,-2126.8912028122,-25.69,9
14:34,690958123.0,22144.69292419806,-135.12,2
14:36,940569402.0,6260.409629365963,-166.6,2
14:37,264208990.0,813.7770999999987,-138.71,5
14:39,936813994.0,87.30971083278807,-84.29,5
14:40,661295096.0,3612.930924172199,-79.98,2
14:41,303843160.0,225.59340000000148,-39.98,4
14:46,806358207.0,12980.800905998352,-277.2,2
14:47,737547541.0,29.06659956777432,-35.0,2
14:47,386729293.0,32469.33167224325,-238.7,2
14:48,660561861.0,-232.64716836631055,-139.3,2
14:48,152616936.0,292.9390078630647,-236.59,2
14:50,166019891.0,8759.063241257232,-134.49,2
14:51,868377987.0,3175.043159635549,-35.0,2
14:53,879091637.0,-186.46247626202307,-93.8,2
14:54,970298834.0,2928.9091391327424,-11.8,8
14:54,713910252.0,-462.2741242714589,-176.0,2
14:54,240643705.0,314.3293173739809,-49.99,2
15:01,668175891.0,1268.667223158499,-25.0,2
15:01,166019891.0,8699.900101257232,-59.16,4
15:03,940569402.0,6117.609629365963,-142.8,2
15:04,806358207.0,12795.300905998352,-185.5,2
15:04,992204045.0,7763.754545268935,-5.59,2
15:04,866941383.0,2160.4669500000073,-30.95,7
15:05,386729293.0,32337.75967224325,-131.57,2
15:07,832564361.0,16433.540283837472,-186.9,2
15:08,713910252.0,-487.2741242714589,-25.0,2
15:12,737547541.0,-62.60540043222568,-91.67,2
15:22,858989281.0,27834.97407482437,-12.94,9
15:23,308068836.0,223.76852256819217,-308.7,2
15:23,713910252.0,-534.7741242714588,-47.5,2
15:24,117273481.0,9469.674038341049,-39.77,2
15:25,134847904.0,5232.538844386297,-114.43,5
15:25,660561861.0,-330.64716836631055,-98.0,2
15:27,832564361.0,16133.940283837472,-299.6,2
15:27,586315521.0,13232.707800512855,-5.21,7
15:28,806358207.0,12490.100905998352,-305.2,2
15:32,390747457.0,618.9307999999978,-86.08,5
15:34,361201224.0,3830.2057830798462,-37.1,7
15:38,654329190.0,-398.70704905148074,-17.62,2
15:39,472995101.0,1553.7727842428037,-37.49,2
15:40,920031185.0,77.19617948370777,-56.99,2
15:41,487051121.0,1351.734810104039,-34.7,7
15:41,155317149.0,321.230249999999,-74.95,5
15:42,806358207.0,12205.200905998352,-284.9,2
15:44,737547541.0,-187.20540043222567,-124.6,2
15:45,574548998.0,-286.03055000000097,-79.32,5
15:50,215311171.0,6978.063915918114,-45.56,5
15:52,941285623.0,1519.3203990667705,-5.99,2
15:56,421881811.0,3792.997272904669,-11.42,5
15:56,833499132.0,1900.1920000000025,-136.5,2
15:56,660561861.0,-365.64716836631055,-35.0,2
15:59,386729293.0,32211.07367224325,-126.69,2
16:03,642015139.0,115.89383746563828,-33.95,1
16:06,737547541.0,-310.3914004322256,-123.19,2
16:09,654329190.0,-499.5670490514807,-100.86,2
16:12,903663593.0,608.5543800435539,-95.62,2
16:16,660561861.0,-392.94716836631056,-27.3,2
16:17,456246119.0,21773.574858632895,-99.99,2
16:17,713910252.0,-559.7741242714588,-25.0,2
16:26,925037906.0,1682.0938000000017,-96.75,7
16:31,587225252.0,6415.095686680302,-42.15,9
16:32,472995101.0,1442.2827842428037,-111.49,2
16:34,903663593.0,504.6793800435539,-103.88,2
16:35,386729293.0,31970.98767224325,-240.09,2
16:35,298007503.0,2172.5751036256343,-17.23,7
16:39,713910252.0,-702.7741242714588,-143.0,2
16:39,475117511.0,8661.004746759021,-84.99,6
16:40,806358207.0,12095.300905998352,-109.9,2
16:40,472995101.0,1355.2827842428037,-87.0,2
16:41,152616936.0,211.7530078630647,-81.19,2
16:41,903663593.0,459.6793800435539,-45.0,2
16:45,940569402.0,5936.309629365963,-62.3,2
16:46,654329190.0,-566.6920490514808,-67.12,2
16:51,653667523.0,3734.224899570016,-13.98,7
16:52,903663593.0,370.4293800435539,-89.25,2
16:52,399538448.0,8222.954049395938,-25.0,4
16:54,365608668.0,186.79501047383255,-88.0,2
16:55,272538745.0,17130.639900000024,-30.95,1
16:58,713910252.0,-864.2741242714588,-161.5,2
17:00,152616936.0,-12.91899213693526,-224.67,2
17:02,450896297.0,14190.655232523512,-1.93,5
17:02,925037906.0,1663.3438000000017,-18.75,4
17:03,308068836.0,15.168522568192174,-208.6,2
17:06,252760664.0,7403.853161794899,-6.42,7
17:09,472995101.0,1290.7827842428037,-64.5,2
17:20,308068836.0,-47.131477431807824,-62.3,2
17:21,245690309.0,10274.641617618468,-80.5,2
17:22,352899149.0,594.4950499999987,-48.93,7
17:24,833499132.0,1827.0670000000025,-73.12,2
17:25,885259672.0,3647.333035701568,-20.03,4
17:27,678851253.0,4273.965897434961,-60.23,6
17:29,903663593.0,282.3043800435539,-88.12,2
17:30,386729293.0,31917.11567224325,-53.87,2
17:36,940569402.0,5724.209629365962,-49.0,2
17:37,713910252.0,-883.7741242714588,-19.5,2
17:48,308068836.0,-269.73147743180783,-222.6,2
17:56,435313070.0,2945.0513330332205,-28.0,6
17:57,940569402.0,5637.409629365962,-86.8,2
17:59,866941383.0,1993.9669500000073,-166.5,2
17:59,833499132.0,1786.1920000000025,-40.88,2
17:59,556992209.0,12744.77853280786,-150.27,4
18:00,806358207.0,11874.800905998352,-220.5,2
18:03,308068836.0,-428.6314774318078,-158.9,2
18:03,854895960.0,4040.707707229198,-7.09,2
18:04,152616936.0,-93.40499213693523,-80.49,2
18:05,532478725.0,5306.1152140040585,-34.4,9
18:07,386729293.0,31784.143672243248,-132.97,2
18:08,355733816.0,5759.306175148084,-18.94,9
18:11,713910252.0,-918.7741242714588,-35.0,2
18:14,383833857.0,26812.414985147076,-16.65,9
18:15,940569402.0,5408.509629365963,-228.9,2
18:16,189335192.0,-1137.2678517578606,-14.38,9
18:16,940569402.0,5395.509629365963,-13.0,9
18:20,925037906.0,1631.8438000000017,-31.5,4
18:24,713910252.0,-988.2741242714588,-69.5,2
18:35,308505160.0,14142.031837987295,-26.39,9
19:09,627936697.0,-148.72369999999987,-33.62,9
19:29,450896297.0,14149.055232523511,-41.6,9
19:32,901432314.0,4164.156035968886,-11.24,9
19:39,736340277.0,9549.172946377235,-19.81,5
19:54,106601471.0,11365.30989887812,-9.66,7
20:14,494977194.0,1240.345070597578,-27.49,9
20:20,392270893.0,13587.315642379908,-0.46,4
20:34,899742927.0,13747.404400778158,-5.22,7
20:36,233981231.0,2659.7762892297583,-4.63,2
20:41,492215823.0,3659.849293815445,-32.09,9
20:52,370521542.0,28384.19477345809,-16.24,8
21:30,259015404.0,1662.1039994801235,-28.62,5
00:13,824916823.0,9139.86614532994,-18.96,9
00:14,315546581.0,30065.60281808946,-72.07,7
00:15,108481285.0,9675.71855374738,-10.54,5
00:15,802697323.0,17172.14399917581,-38.89,9
00:15,987163717.0,4459.118480000003,-38.18,9
00:24,785749304.0,9274.161096382802,-1.35,7
00:25,213112754.0,7129.220471319227,-24.44,2
00:27,815385232.0,11159.50660282405,-48.3,2
00:28,851649498.0,8889.481736968914,-32.19,5
00:33,113747882.0,13143.28250127314,-23.43,9
00:35,651756497.0,15021.7628755983,-11.18,2
00:43,322720763.0,6928.23509870844,-2.5,2
00:45,851181128.0,5324.375066467833,-0.61,2
00:45,519644021.0,3461.4665355864317,-46.3,7
00:46,705848712.0,28360.950955986835,-17.34,9
00:47,657139925.0,14999.329411276076,-19.99,9
00:51,647936800.0,2663.1266938684385,-21.46,5
00:52,795847804.0,24751.220441601406,-15.51,5
00:53,910730524.0,8276.369163978923,-15.19,5
01:00,897714622.0,9712.44439034294,-7.07,2
01:04,237493332.0,15457.008775470706,-13.05,4
01:07,235881534.0,14240.096812161955,-22.84,5
01:11,836110591.0,7048.995118073938,-37.62,9
01:12,858989281.0,27832.322561979883,-2.65,7
01:14,179173981.0,5387.106958749099,-21.29,5
01:20,859603181.0,3902.6236561191504,-54.72,2
01:21,718058208.0,2501.584994531922,-40.63,7
01:22,421881811.0,3780.527246167415,-12.47,4
01:23,264550521.0,9278.183793125423,-4.65,7
01:23,887853850.0,11156.223361016955,-59.51,5
01:25,196289502.0,16671.93865107217,-21.89,9
01:33,912705941.0,19502.24218142499,-30.55,2
01:36,518474507.0,14911.217604134325,-43.83,9
01:38,985188462.0,-510.5332112887753,-33.78,9
01:43,124102251.0,3768.253130531756,-37.7,2
01:50,310620484.0,296.7211950921983,-32.88,9
01:57,887853850.0,11118.843361016956,-37.38,9
02:07,704517789.0,18691.934964287284,-66.53,7
02:15,705848712.0,28337.5386539958,-23.41,5
02:15,679662108.0,17178.480179677103,-35.93,9
02:15,518474507.0,14880.55098055651,-30.67,7
02:16,950234174.0,2399.7220947963506,-3.01,7
02:21,282837512.0,14852.20291948933,-43.44,9
02:23,667367404.0,9729.108793894766,-4.01,5
02:24,586315521.0,13229.46984831212,-3.24,7
02:24,639409800.0,37702.08211827436,-5.61,2
02:33,237684254.0,6362.904811085759,-33.4,4
02:35,120634201.0,5557.365329403303,-18.85,9
02:39,779236304.0,2253.767595479533,-39.4,9
02:39,383625050.0,3185.228953752319,-3.23,7
02:46,522188082.0,8659.171557369107,-59.21,7
02:46,679662108.0,17113.483065905533,-65.0,5
02:49,460463595.0,-308.9429454185789,-38.49,9
02:58,534325901.0,7371.549233618855,-39.12,7
03:06,897592348.0,16017.236863097907,-2.8,2
03:13,471897866.0,8304.606935442262,-14.83,7
03:13,383833857.0,26801.498348163343,-10.92,7
03:13,572384506.0,7975.659186310868,-28.84,9
03:16,145387690.0,5802.909051830574,-28.39,9
03:22,549414742.0,8142.968394161864,-24.66,4
03:25,134461671.0,6519.625532739693,-39.21,5
03:26,187541224.0,2631.8274566485397,-31.28,9
03:28,549414742.0,8107.188394161864,-35.78,9
03:29,308505160.0,14128.694637218212,-13.34,7
03:29,366550080.0,27989.8887860298,-12.36,7
03:33,633345190.0,6492.287559573647,-34.82,9
03:37,506618547.0,15346.319241862891,-1.8,2
03:39,873693307.0,11131.99717392278,-12.25,9
03:40,541639148.0,4559.922994424222,-32.85,7
03:42,709608057.0,3119.173638558324,-31.1,9
03:54,510101371.0,14169.497263145697,-31.9,9
04:04,285220959.0,12473.279051675756,-57.82,4
04:05,348325817.0,11371.29473094357,-29.28,9
04:06,216285378.0,25232.707384634905,-30.38,9
04:07,822250278.0,7059.314207855906,-32.0,9
04:07,417850087.0,18305.04661770143,-62.58,7
04:08,151968462.0,7958.372144942093,-34.87,2
04:08,285873880.0,13059.568353104163,-64.5,7
04:08,673025413.0,1398.5437423123271,-32.41,7
04:11,473820682.0,12444.106794693796,-44.42,5
04:12,949032480.0,4469.0981201204795,-33.4,9
04:14,146909202.0,3973.396869270708,-1.83,5
04:15,558119802.0,35177.393147985764,-24.3,9
04:16,613729471.0,10558.33933544821,-33.19,8
04:17,824916823.0,9105.866093779976,-34.0,4
04:17,183888402.0,19827.54421822675,-46.83,9
04:21,992204045.0,7714.456928345693,-49.3,8
04:25,287480331.0,8860.241228822555,-21.43,8
04:26,987656636.0,4644.224713352584,-87.4,2
04:27,570323670.0,3579.7377847968332,-5.31,2
04:29,675806859.0,7887.0511268803475,-21.48,5
04:30,873693307.0,11120.891409864667,-11.11,5
04:30,762785862.0,771.3114499999994,-21.34,9
04:31,305778936.0,11100.033823715568,-27.13,9
04:33,587225252.0,6379.005686680302,-36.09,9
04:39,554792076.0,29926.668984228105,-2.06,7
04:41,633345190.0,6487.944336593886,-4.34,5
04:43,145387690.0,5787.097049138221,-15.81,2
04:43,482513594.0,6512.729194825483,-20.14,5
04:45,203466392.0,3873.760416608135,-36.41,5
04:46,653640811.0,18272.73597059494,-14.91,4
04:51,331450202.0,8557.140192376377,-37.75,7
04:54,221868392.0,5397.97746960289,-1.76,7
04:58,520447032.0,8878.73085536835,-32.28,9
05:00,450896297.0,14116.315232523511,-32.74,9
05:02,948069469.0,-696.864000000001,-7.25,9
05:05,699139822.0,2251.296318665489,-17.81,7
05:07,930277104.0,11013.08868163695,-25.72,9
05:08,766941757.0,3088.5391571058312,-35.18,9
05:11,901432314.0,4115.092670810097,-49.06,8
05:11,547010927.0,25230.36335365009,-44.72,8
05:12,706250160.0,13210.225509944752,-2.77,8
05:15,290818242.0,7658.327691775163,-0.24,5
05:15,187111705.0,7495.447912701815,-31.66,7
05:16,489964679.0,21309.583482666912,-32.22,9
05:19,441274121.0,13133.30147852229,-0.2,5
05:20,670102069.0,2088.306380373488,-35.54,9
05:23,822135975.0,12186.12082199612,-27.47,2
05:28,532478725.0,5281.525214004058,-24.59,9
05:30,113747882.0,13112.604025682796,-30.68,5
05:33,165691047.0,481.65159999999895,-18.4,9
05:36,166019891.0,8691.483948916157,-8.42,2
05:38,687135796.0,29606.241923611095,-16.25,9
05:42,108931112.0,15126.950551188283,-39.15,9
05:43,769311479.0,6674.232464685772,-35.3,5
05:45,975345315.0,37297.498835628045,-5.58,8
05:47,930277104.0,11013.021751456636,-0.07,5
05:47,647472692.0,26951.64626757727,-32.89,9
05:48,131388684.0,22366.95925145332,-20.89,7
05:49,305778936.0,11040.208845847908,-59.82,2
05:49,143003091.0,10916.54228269762,-5.88,2
05:51,822250278.0,7044.853596656074,-14.46,2
05:52,853907490.0,8153.759955734138,-14.1,9
05:54,433917275.0,8314.158724869048,-31.4,9
06:01,259015404.0,1624.8839994801235,-37.22,9
06:08,540159353.0,11975.37297560692,-1.34,2
06:10,687135796.0,29599.736168467763,-6.51,7
06:13,587225252.0,6357.890680365503,-21.12,5
06:17,960208650.0,18468.19950092421,-12.19,8
06:18,169006407.0,12585.375356302437,-1.48,7
06:19,986267641.0,8873.961639448431,-52.84,7
06:21,815993333.0,6634.885016568277,-6.48,7
06:23,905860285.0,11998.74759991081,-7.47,2
06:26,532478725.0,5266.18083449477,-15.34,4
06:26,510101371.0,14140.905221803729,-28.59,8
06:27,324224854.0,4706.966272996538,-26.43,8
06:30,604288474.0,2190.8357447988265,-16.74,7
06:35,163470640.0,1201.9850999999996,-13.64,9
06:36,836110591.0,7017.681391075717,-31.31,2
06:38,108563213.0,25855.07368857233,-20.9,7
06:39,749378808.0,4568.971200093473,-21.2,9
06:40,730002588.0,14384.074749003848,-4.82,8
06:40,414805878.0,13844.845725075738,-41.4,9
06:40,853907490.0,8131.919784145419,-21.84,5
06:41,575652395.0,2759.891214930603,-21.49,5
06:52,657139925.0,14968.44857611454,-30.88,5
06:53,758160963.0,8993.804743278697,-52.7,7
06:54,128033695.0,2490.742195893075,-10.08,8
06:55,873701090.0,839.0709619701028,-16.24,5
06:58,310375875.0,2404.6320927481365,-5.53,8
06:59,951817450.0,9603.51843528758,-9.85,5
07:01,195895574.0,7842.943896521237,-9.38,7
07:05,282837512.0,14843.009782816738,-9.19,2
07:10,668329719.0,9288.196259594724,-6.51,2
07:10,776108637.0,1180.3190536574953,-5.25,9
07:11,940569402.0,5391.799804415957,-3.71,7
07:11,709608057.0,3089.431000499038,-29.74,7
07:12,842682241.0,6344.981480740413,-8.2,7
07:14,601627384.0,4348.808917147947,-33.13,9
07:15,116598243.0,2188.6272217774504,-5.4,9
07:16,899742927.0,13739.636273376642,-7.77,5
07:16,829914501.0,1676.1728065709742,-5.8,9
07:17,229205098.0,8158.0591586644205,-27.4,2
07:19,749378808.0,4568.165844811352,-0.81,8
07:20,364357875.0,8803.764743364367,-66.79,5
07:22,865748375.0,4282.484555553207,-70.78,2
07:29,550169791.0,22872.108792779032,-3.32,7
07:33,558119802.0,35147.31307090439,-30.08,7
07:35,348325817.0,11360.25106227794,-11.04,2
07:36,322221939.0,4007.023151603048,-16.91,5
07:37,994214354.0,10605.59828545962,-28.21,9
07:42,719586818.0,19500.670181218746,-7.9,2
07:50,414805878.0,13819.201562486878,-25.64,2
07:59,700138124.0,5726.749398862366,-23.53,7
08:03,454129843.0,512.9528451665601,-5.65,9
08:07,146909202.0,3968.096869270708,-5.3,9
08:08,395284483.0,1318.8143402113085,-5.7,9
08:11,949032480.0,4444.68409870184,-24.41,7
08:13,885259672.0,3641.433035701568,-5.9,9
08:15,683319988.0,7931.468352553989,-25.89,9
08:19,874431242.0,10039.340617705822,-35.25,7
08:21,203466392.0,3833.7484166081354,-40.01,5
08:21,478412511.0,13024.03807019746,-6.35,9
08:23,215311171.0,6970.057634310472,-8.01,8
08:25,252964502.0,-895.8550224913006,-61.41,5
08:26,752362502.0,8038.109966994488,-55.48,7
08:27,609939116.0,8132.953785005403,-1.1,7
08:28,678851253.0,4240.3128182142145,-33.65,2
08:29,651372390.0,-3650.1432499999983,-19.93,5
08:29,780463728.0,3610.51687094224,-91.11,5
08:31,480557476.0,11911.288961106298,-82.23,8
08:31,183888402.0,19774.457609767174,-53.09,7
08:32,738958551.0,9967.001269533062,-10.66,7
08:32,213096759.0,-1359.3891082144396,-79.64,5
08:32,166019891.0,8652.563948916157,-38.92,5
08:33,248658670.0,52.31165000000016,-50.9,5
08:34,170637730.0,2900.919709011117,-72.66,5
08:35,905860285.0,11881.31559991081,-117.43,5
08:35,151278285.0,-1377.0113500000004,-145.73,5
08:35,788740658.0,2860.5506082351467,-123.27,5
08:36,837876918.0,-2211.43779146542,-15.8,5
08:36,781554833.0,1151.7767255639665,-151.1,5
08:38,461990622.0,10231.549628390749,-36.53,5
08:40,975200042.0,-3132.5651999999964,-31.21,5
08:43,518746136.0,-1031.3397282369167,-50.96,5
08:43,500843551.0,1125.4741999999997,-73.54,5
08:44,657528784.0,91.29390000000072,-84.52,5
08:45,919185264.0,4334.6374505512495,-6.86,7
08:46,683319988.0,7926.111974916419,-5.36,2
08:46,779946617.0,17494.383154807176,-23.61,7
08:48,554792076.0,29855.772984228104,-70.9,5
08:48,832564361.0,16117.768928737132,-16.17,4
08:48,191992682.0,-2838.836460292063,-22.18,5
08:53,703478110.0,5610.127731849388,-174.93,5
08:53,973086490.0,10883.567743130372,-69.52,8
08:54,228136274.0,1349.7305999999994,-125.33,5
08:54,564214408.0,-90.741715274274,-50.77,5
08:58,197865285.0,-8.51583826877968,-6.1,9
09:01,121858569.0,1879.5911500000025,-85.72,5
09:01,581655972.0,43400.83029640742,-5.8,9
09:03,895331556.0,-396.4528000000009,-19.66,5
09:03,506618547.0,15338.419241862892,-7.9,9
09:04,169006407.0,12580.675356302436,-4.7,9
09:04,117273481.0,9462.174038341049,-7.5,9
09:05,610450243.0,-626.4245999999998,-17.78,5
09:05,690958123.0,22138.892924198062,-5.8,9
09:05,691843653.0,-3196.550899999993,-13.34,5
09:06,524425303.0,-861.7228000000011,-64.98,5
09:07,349614277.0,1733.6123999999995,-90.91,5
09:07,899692478.0,-1957.1849435240072,-78.26,5
09:07,344522228.0,-2923.351988208393,-27.11,5
09:09,135937041.0,-1133.0978482684118,-46.42,5
09:14,540159353.0,11967.87297560692,-7.5,9
09:15,441142605.0,2726.2464422757284,-7.5,4
09:16,683078800.0,2352.631392731244,-5.65,9
09:16,348325817.0,11327.32290227794,-32.93,4
09:16,473820682.0,12413.037434693795,-31.07,4
09:16,421475159.0,-370.60073732558743,-117.52,5
09:17,788740658.0,2830.560608235147,-29.99,7
09:18,722971557.0,-328.70027915692447,-251.3,2
09:19,741903302.0,2680.578315014126,-52.45,5
09:19,924045955.0,2987.8135026586647,-30.04,4
09:19,912584712.0,1256.314619544733,-84.0,7
09:20,586315521.0,13224.11984831212,-5.35,9
09:20,522188082.0,8578.067777369108,-81.1,4
09:20,417850087.0,18299.996617701432,-5.05,9
09:21,933491926.0,3873.162300000005,-9.99,7
09:21,670102069.0,2076.631760842237,-11.67,5
09:21,618138606.0,1464.185902870066,-7.5,9
09:22,865748375.0,4227.4445555532075,-55.04,2
09:22,973388795.0,941.0436761636216,-65.05,2
09:22,973086490.0,10724.007743130373,-159.56,2
09:22,441274121.0,13125.80147852229,-7.5,9
09:23,558875206.0,3734.46253939978,-5.4,9
09:23,290818242.0,7651.827691775163,-6.5,9
09:24,258201793.0,-498.23480000000023,-22.0,2
09:24,667367404.0,9724.008793894764,-5.1,9
09:25,519644021.0,3443.3765355864316,-18.09,4
09:25,272538745.0,17115.649900000022,-14.99,4
09:25,214339619.0,629.724550868356,-6.1,9
09:27,886921642.0,3669.764440238568,-39.28,5
09:29,469561218.0,-114.35130000000086,-92.05,5
09:29,757115616.0,781.3700000000038,-19.97,7
09:30,815993333.0,6607.815016568277,-27.07,1
09:30,722971557.0,-494.6002791569245,-165.9,2
09:31,475277431.0,1214.1381369436192,-235.2,5
09:32,613427466.0,7137.740455264377,-6.99,4
09:32,427909748.0,2057.753200000015,-31.99,2
09:33,497809732.0,479.1698695525952,-25.0,2
09:33,399144202.0,2219.026340546804,-19.92,7
09:34,767447966.0,5473.064062706571,-66.12,2
09:34,430910686.0,592.9429000000003,-163.5,2
09:35,128033695.0,2454.917395893075,-35.82,4
09:38,556992209.0,12712.667704130294,-32.11,7
09:41,235310449.0,252.53418483031,-100.95,5
09:43,767447966.0,5437.994062706572,-35.07,2
09:43,912584712.0,1117.014619544733,-139.3,4
09:44,448004226.0,1845.642523509976,-94.97,2
09:44,547010927.0,25203.06335365009,-27.3,2
09:44,137822385.0,3717.551101541067,-65.99,2
09:44,414454079.0,572.0478500000016,-58.91,2
09:46,924045955.0,2945.7085026586647,-42.11,5
09:48,955035930.0,2352.9434791714775,-114.97,4
09:49,358836279.0,315.8954428075857,-109.47,5
09:49,383833857.0,26794.298348163346,-7.2,1
09:50,684284526.0,-3343.4513667457563,-42.64,5
09:51,298007503.0,2052.889103625634,-119.69,2
09:52,659415300.0,1896.9858805359595,-69.99,2
09:52,137822385.0,3651.5611015410673,-65.99,2
09:53,903663593.0,250.35438004355393,-31.95,7
09:53,519644021.0,3433.3365355864316,-10.04,2
09:54,170233640.0,-528.9130100501027,-58.59,5
09:54,165045150.0,1037.0960614028556,-134.98,2
09:57,925037906.0,1591.8638000000014,-39.98,2
09:58,194745206.0,357.65637209124316,-100.69,5
10:03,444428189.0,2629.204200000002,-32.95,7
10:04,760753808.0,33.840949999999424,-102.24,5
10:04,180616589.0,1179.7105281236177,-16.98,7
10:07,192202372.0,314.7147349805995,-69.97,2
10:09,639549973.0,7757.426108930255,-80.3,2
10:10,430910686.0,545.4429000000003,-47.5,2
10:11,762859681.0,3319.767599999999,-28.98,7
10:12,165045150.0,940.3460614028556,-96.75,2
10:13,844206657.0,-142.31734485343026,-96.86,5
10:14,547010927.0,25084.76335365009,-118.3,2
10:15,229502829.0,-3806.131524186247,-124.37,5
10:17,422955974.0,171.46313499904977,-79.99,2
10:17,298007503.0,2014.403103625634,-38.49,2
10:19,266777719.0,1746.7489337802397,-12.03,1
10:22,246753533.0,448.4840999999984,-7.9,9
10:22,639549973.0,7753.5447623262835,-3.88,2
10:22,252760664.0,7368.733669741109,-35.12,4
10:24,986774156.0,1725.4369316257694,-29.99,2
10:24,575652395.0,2717.757114930603,-42.13,4
10:24,769319491.0,161.7519999999992,-39.7,5
10:24,556992209.0,12696.667704130294,-16.0,4
10:25,903953091.0,3915.6578830548,-7.8,9
10:29,108931112.0,15048.292935034451,-78.66,7
10:30,162162212.0,629.720043327309,-151.0,2
10:35,761272540.0,173.62794999999878,-72.9,5
10:35,547010927.0,24925.163353650092,-159.6,2
10:39,769319491.0,145.7819999999992,-15.97,7
10:40,556992209.0,12620.617704130294,-76.05,2
10:44,661295096.0,3557.742924172199,-55.19,5
10:49,298000165.0,27448.57720443034,-12.99,2
10:51,405416860.0,2637.0933568809046,-12.98,1
10:51,259015404.0,1581.0933730810675,-43.79,2
10:52,912584712.0,869.914619544733,-247.1,4
10:54,766812921.0,-26.435500000000843,-161.61,5
10:54,977899503.0,202.01289358085265,-89.12,5
10:55,479456865.0,2179.4556995833054,-11.0,4
11:03,264550521.0,9249.023793125423,-29.16,7
11:03,162162212.0,493.720043327309,-136.0,2
11:03,310620484.0,261.5311950921983,-35.19,7
11:05,228136274.0,1333.714599999999,-16.02,4
11:07,430910686.0,320.94290000000035,-224.5,2
11:08,598793068.0,646.641349999998,-23.97,4
11:08,298000165.0,27424.622505602347,-23.95,2
11:11,475277431.0,1209.1481369436192,-4.99,4
11:12,857997794.0,1164.5756651508868,-43.93,1
11:15,272538745.0,17050.67990000002,-64.97,2
11:15,430910686.0,101.94290000000036,-219.0,2
11:17,909676212.0,979.3894045320272,-12.98,7
11:18,613729471.0,10447.039335448211,-111.3,2
11:27,254853117.0,3499.481952564331,-34.98,1
11:32,430910686.0,-7.55709999999965,-109.5,2
11:32,572384506.0,7932.166086310868,-43.49,4
11:33,572384506.0,7870.203047528045,-61.96,2
11:38,767447966.0,5430.9800627065715,-7.01,4
11:45,779376323.0,3577.48838398134,-14.43,2
11:47,912584712.0,608.814619544733,-261.1,7
11:48,984783496.0,14995.078974253956,-2.14,4
11:48,613729471.0,10307.039335448211,-140.0,2
11:49,430910686.0,-89.05709999999965,-81.5,2
11:56,441142605.0,2674.2168422757286,-52.03,5
11:57,722971557.0,-696.2002791569245,-201.6,2
11:57,162162212.0,386.220043327309,-107.5,2
12:00,912584712.0,462.514619544733,-146.3,7
12:04,901432314.0,4068.066670810097,-47.03,5
12:04,873701090.0,786.7745419701027,-52.3,4
12:04,414454079.0,531.0678500000016,-40.98,9
12:11,750898750.0,-559.2194653199005,-40.17,9
12:11,621652856.0,1042.04596961054,-320.75,5
12:18,475117511.0,8494.40474675902,-166.6,2
12:19,162162212.0,219.220043327309,-167.0,2
12:20,430910686.0,-180.55709999999965,-91.5,2
12:20,912584712.0,139.81461954473303,-322.7,4
12:27,256002321.0,7258.052494609717,-60.51,5
12:30,198946608.0,4742.371813976653,-96.85,5
12:30,613729471.0,10240.539335448211,-66.5,2
12:33,256002321.0,7245.022494609717,-13.03,9
12:35,722971557.0,-916.0002791569244,-219.8,2
12:45,655730067.0,-194.13620000000049,-49.22,5
12:45,696758548.0,-3508.182896320137,-23.07,5
12:46,613729471.0,9869.539335448211,-371.0,2
12:49,666952234.0,-223.04610187551316,-113.24,5
12:50,679943657.0,3342.0758891801374,-67.72,5
12:52,475117511.0,8293.504746759021,-200.9,2
12:53,355733816.0,5749.316175148084,-9.99,7
12:54,933491926.0,3812.164300000005,-61.0,5
12:57,613729471.0,9806.539335448211,-63.0,2
12:59,215426302.0,218.9304040256919,-58.41,5
13:02,821971408.0,1295.983110235543,-37.95,7
13:03,722358036.0,669.534390627083,-5.7,9
13:03,630691258.0,289.3365448748413,-7.15,9
13:05,290751280.0,254.98354667482553,-7.15,9
13:05,588565416.0,6966.375543518159,-5.44,4
13:09,762700245.0,920.1247000000026,-152.52,5
13:09,572333122.0,-3838.547549999996,-77.9,5
13:10,613729471.0,9562.93933544821,-243.6,2
13:10,899742927.0,13704.546273376642,-35.09,2
13:15,475117511.0,8161.204746759021,-132.3,2
13:16,845648250.0,220.67909999999935,-132.29,5
13:20,815993333.0,6583.3650165682775,-24.45,9
13:21,688712152.0,7078.740495187548,-5.65,9
13:21,993039226.0,-4357.331999999994,-13.12,5
13:22,403383649.0,2088.5663796543063,-13.57,2
13:22,910730524.0,8271.669163978922,-4.7,9
13:22,849096144.0,1886.1020207513432,-7.8,9
13:28,779816907.0,-3031.29858292291,-51.87,5
13:35,256002321.0,7145.772494609717,-99.25,2
13:35,768271776.0,-535.6604967665796,-89.1,5
13:51,890196840.0,-3080.70131667513,-59.64,5
13:55,298000165.0,27284.622505602347,-140.0,4
14:04,909676212.0,931.6905317876132,-47.7,2
14:10,766941757.0,3052.182184867243,-36.36,7
14:17,970298834.0,2908.8791391327422,-20.03,2
14:17,425730826.0,2577.94190938872,-55.98,2
14:28,587225252.0,6308.8406803655025,-49.05,2
14:30,535744551.0,901.011165995626,-8.99,4
14:33,192202372.0,38.879734980599494,-275.83,5
14:34,613729471.0,9294.139335448212,-268.8,2
14:40,520447032.0,8835.913417691661,-42.82,7
14:53,175452235.0,143.73125000000027,-84.0,2
14:54,613427466.0,7121.760455264377,-15.98,7
14:54,613729471.0,9030.239335448212,-263.9,2
14:59,984783496.0,14978.442424860878,-16.64,2
15:02,175452235.0,-22.86874999999972,-166.6,2
15:05,170637730.0,2880.689049011117,-20.23,4
15:07,551755686.0,7174.367485725706,-12.98,4
15:12,659008214.0,-3438.9426022904227,-37.61,5
15:14,448004226.0,1695.5586735099762,-150.08,5
15:19,414454079.0,524.9878500000016,-6.08,4
15:27,175452235.0,-155.86874999999972,-133.0,2
15:31,613729471.0,8783.839335448212,-246.4,2
15:35,170637730.0,2817.0030490111167,-63.69,2
15:40,678330503.0,3637.2164547097505,-4.17,5
15:40,120634201.0,5550.335329403303,-7.03,1
15:40,175452235.0,-405.0687499999997,-249.2,2
15:42,409971170.0,3300.853547259678,-17.48,7
15:46,158414827.0,-1472.1450000000018,-10.14,5
15:49,279149837.0,2118.420049999999,-17.97,7
15:50,175452235.0,-572.3687499999996,-167.3,2
16:04,170637730.0,2546.8310490111166,-270.17,2
16:05,912584712.0,42.51461954473304,-97.3,7
16:11,173335108.0,2668.904000000001,-14.99,4
16:12,973086490.0,10698.507743130373,-25.5,9
16:13,162162212.0,-17.279956672691014,-236.5,2
16:19,386277162.0,327.85999999999945,-14.98,7
16:26,912584712.0,-152.08538045526694,-194.6,7
16:26,170637730.0,2407.5590490111167,-139.27,2
16:26,885259672.0,3630.464022893113,-10.97,5
16:26,233981231.0,2549.8062892297585,-109.97,4
16:29,679911053.0,3221.0638432699716,-28.24,9
16:33,168414279.0,-56.105215725078665,-33.53,5
16:38,879091637.0,-435.81647626202306,-249.35,5
16:38,978951113.0,-749.298142590419,-248.66,5
16:40,162162212.0,-133.779956672691,-116.5,2
16:40,912584712.0,-299.08538045526694,-147.0,4
16:42,183186021.0,-1287.5450499999988,-25.91,5
16:42,175452235.0,-785.8687499999996,-213.5,2
16:42,478412511.0,13009.03807019746,-15.0,4
16:45,613729471.0,8654.339335448212,-129.5,2
16:47,444428189.0,2599.214200000002,-29.99,2
16:55,170637730.0,2332.0290490111165,-75.53,5
16:59,475117511.0,8029.604746759021,-131.6,2
17:00,565175333.0,-3981.273522729826,-56.15,5
17:03,395284483.0,1193.8643402113082,-124.95,5
17:07,639409800.0,37676.11211827436,-25.97,9
17:07,170637730.0,2231.9430490111163,-100.09,2
17:08,613729471.0,8438.739335448212,-215.6,2
17:08,834383043.0,5563.7824497363,-51.01,5
17:10,639420537.0,-1427.20895,-33.11,5
17:13,380228542.0,-1352.9004581844342,-262.46,5
17:13,479366718.0,2339.791447632401,-11.98,4
17:13,175452235.0,-903.4687499999995,-117.6,2
17:13,871200314.0,-448.98547575736166,-150.32,5
17:14,162162212.0,-238.279956672691,-104.5,2
17:15,785749304.0,9250.271096382805,-23.89,9
17:16,652048867.0,557.942099999999,-78.52,5
17:16,475117511.0,7953.30474675902,-76.3,2
17:17,200080192.0,9996.839649535184,-14.19,9
17:19,720742759.0,1159.9454308830072,-289.85,5
17:19,511179916.0,8060.816865735285,-28.54,5
17:19,919185264.0,4322.65745055125,-11.98,1
17:20,303843160.0,200.59340000000148,-25.0,2
17:20,280268430.0,5982.43228942804,-48.97,7
17:21,940569402.0,5374.959804415957,-16.84,9
17:25,184430449.0,2772.5139276932655,-57.98,2
17:29,604334058.0,486.07999999999936,-119.97,4
17:29,874431242.0,10022.551117705822,-16.79,4
17:30,475117511.0,7863.00474675902,-90.3,2
17:31,310375875.0,2318.4690927481365,-86.16,5
17:32,310375875.0,2292.6090927481364,-25.86,9
17:32,435984758.0,4633.0924425456515,-51.77,5
17:33,656317661.0,-215.63895845859727,-19.97,7
17:33,175452235.0,-1112.0687499999997,-208.6,2
17:34,585596026.0,3054.5398509019906,-135.99,2
17:34,221868392.0,5368.99746960289,-28.98,9
17:35,627917561.0,4039.265050000006,-199.98,2
17:35,141521177.0,8302.963900000015,-9.99,2
17:36,930277104.0,10984.131751456636,-28.89,2
17:36,163470640.0,1195.9950999999996,-5.99,4
17:36,954263768.0,-129.20260000000022,-48.64,5
17:37,703478110.0,5596.147731849388,-13.98,7
17:38,192202372.0,-11.100265019400505,-49.98,4
17:38,713910252.0,-1138.8367742714588,-150.56,5
17:38,124102251.0,3733.223130531756,-35.03,2
17:39,858560423.0,12885.57390976936,-49.99,2
17:39,433917275.0,8265.789726575002,-48.37,7
17:40,466649401.0,861.7004935520876,-43.98,2
17:43,131388684.0,22360.687251453317,-6.27,5
17:44,170637730.0,2060.4570490111164,-171.49,2
17:45,956717493.0,1426.0252722249325,-21.96,1
17:46,475117511.0,7648.80474675902,-214.2,2
17:46,672913754.0,12124.667994680927,-204.34,2
17:47,558875206.0,3704.512539399781,-29.95,7
17:49,322720763.0,6851.16509870844,-77.07,2
17:51,308068836.0,-450.8314774318078,-22.2,9
17:51,531186970.0,5376.396883735821,-35.0,2
17:52,558119802.0,34880.613070904394,-266.7,2
17:52,175452235.0,-1347.9687499999995,-235.9,2
17:52,166019891.0,8622.003948916157,-30.56,2
17:53,930271460.0,334.29869753577634,-39.84,5
17:54,858989281.0,27827.08256197988,-5.24,7
17:55,854513972.0,1902.0237000000004,-146.95,2
17:57,994214354.0,10575.236891040058,-30.36,2
18:00,625281433.0,-653.7752073707569,-106.23,5
18:12,596463612.0,-2164.165104725138,-53.02,5
18:15,809499628.0,18426.347144550473,-20.19,9
18:20,581655972.0,43349.46078929952,-51.37,4
18:20,175452235.0,-1452.2687499999995,-104.3,2
18:20,226703987.0,2876.4003,-129.38,5
18:21,475117511.0,7599.80474675902,-49.0,2
18:22,520239952.0,-1480.756176654763,-258.13,5
18:22,534325901.0,7357.909233618855,-13.64,9
18:23,509627909.0,61.80464999999904,-35.64,9
18:24,558119802.0,34656.613070904394,-224.0,2
18:24,651756497.0,15001.502875598298,-20.26,7
18:29,624500124.0,3536.737779931194,-28.18,7
18:32,348460748.0,-267.13245000000103,-31.45,9
18:38,624563756.0,-162.97817121644363,-27.66,5
18:40,122884111.0,-3597.7185830729686,-12.74,5
18:40,788740658.0,2830.444940231025,-0.12,5
18:41,500043411.0,14417.2489468606,-55.04,5
18:48,687135796.0,29584.066168467765,-15.67,7
18:52,329840194.0,1602.132570143148,-72.77,5
18:55,403902116.0,444.9160999999992,-254.5,5
18:56,555804115.0,-1395.3060475587033,-23.73,5
19:00,291580432.0,87.62920000000038,-16.5,4
19:06,815385232.0,11150.55660282405,-8.95,9
19:08,982286721.0,-3556.558024017729,-40.57,5
19:11,605711527.0,-35.90448616741635,-28.31,5
19:14,700138124.0,5675.439398862366,-51.31,5
19:22,785210466.0,2506.2280199977117,-81.69,5
19:23,491392945.0,5682.47750000001,-41.5,5
19:23,213112754.0,7119.230471319227,-9.99,9
19:24,844835978.0,10685.427507961278,-61.82,5
19:24,409370545.0,891.2492755455207,-138.22,5
19:25,117273481.0,9256.080038341048,-206.09,5
19:26,220183538.0,890.3039999999994,-16.49,9
19:32,478412511.0,12704.60107019746,-304.44,5
19:35,435984758.0,4620.659814120553,-12.43,8
19:35,558875206.0,3461.4165393997805,-243.1,5
19:41,871866387.0,334.76409999999913,-59.98,5
19:53,417850087.0,18189.09561770143,-110.9,5
20:00,605116158.0,2808.535700000003,-10.63,5
20:04,482513594.0,6495.523194825483,-17.21,5
20:06,519935524.0,1269.6403297375189,-37.52,5
20:06,270374623.0,10174.306436064822,-14.74,5
20:06,764450279.0,22443.126818719924,-37.34,5
20:07,198630866.0,-434.7852735612686,-60.79,5
20:08,583558311.0,-600.3462152486677,-88.91,5
20:09,660874296.0,3143.5174499608497,-37.29,9
20:12,540159353.0,11907.84097560692,-60.03,5
20:22,419550103.0,19561.47714057855,-32.49,7
20:27,996042490.0,6717.219272669815,-62.33,5
20:27,919185264.0,4189.89545055125,-132.76,5
20:29,127809299.0,1089.8420157577852,-20.53,5
20:29,449871732.0,8069.79258654847,-102.63,5
20:29,698076160.0,6924.553476726233,-8.83,5
20:31,962295212.0,-3053.770149999996,-93.8,5
20:36,874431242.0,10002.321117705822,-20.23,9
20:47,833899961.0,1397.8191457180098,-1.78,2
20:49,245690309.0,10200.402183954688,-74.24,7
20:50,489964679.0,21286.972931940734,-22.61,7
20:56,409971170.0,3276.903547259679,-23.95,9
21:00,197865285.0,-51.966938268779685,-43.45,5
00:14,298000165.0,27258.6649217094,-25.96,2
00:21,671824917.0,-1035.9032000000004,-38.31,9
00:38,973086490.0,10680.577743130372,-17.93,9
00:41,305778936.0,11020.268845847908,-19.94,9
01:12,305778936.0,10954.065824035411,-66.2,5
01:46,480557476.0,11886.47409394666,-24.81,2
01:47,613729471.0,8425.135394980553,-13.6,7
02:25,259015404.0,1540.7633730810678,-40.33,9
02:36,113747882.0,13080.614025682797,-31.99,9
02:37,724997545.0,-238.73830800221833,-33.89,9
02:38,454129843.0,478.4728451665601,-34.48,9
02:41,547010927.0,24898.67335365009,-26.49,9
02:42,489964679.0,21243.28293194074,-43.69,9
02:48,124102251.0,3729.437675095323,-3.79,2
02:54,383625050.0,3179.145387303292,-6.08,2
02:56,853907490.0,8117.669784145419,-14.25,9
02:58,310620484.0,232.6511950921983,-28.88,9
03:02,441274121.0,13116.31147852229,-9.49,9
03:05,256002321.0,7127.572494609717,-18.2,9
03:20,586315521.0,13213.029760145217,-11.09,7
03:25,482513594.0,6492.515975749327,-3.01,8
03:27,259015404.0,1534.8136594208586,-5.95,7
03:28,719586818.0,19496.93756106949,-3.73,5
03:29,421881811.0,3761.766193912851,-18.76,2
03:33,679662108.0,17104.223058696545,-9.26,5
03:35,588565416.0,6938.348836230392,-28.03,5
03:40,949032480.0,4362.248349458774,-82.44,2
03:40,383833857.0,26770.17543259195,-24.12,2
03:49,985188462.0,-541.9132112887753,-31.38,9
03:53,851181128.0,5290.245066467833,-34.13,9
03:55,532478725.0,5240.240834494771,-25.94,9
03:55,657139925.0,14946.19857611454,-22.25,9
03:56,108931112.0,15009.512935034452,-38.78,9
03:57,887853850.0,11091.953361016956,-26.89,9
04:01,633345190.0,6464.404336593886,-23.54,9
04:01,324224854.0,4688.8028961531745,-18.16,2
04:07,518474507.0,14853.900980556513,-26.65,9
04:14,639549973.0,7701.487689833018,-52.06,2
04:16,550169791.0,22834.668112463773,-37.44,7
04:18,519644021.0,3417.5586339806596,-2.73,2
04:23,873693307.0,11103.941409864668,-16.95,9
04:27,853907490.0,8063.547297872545,-54.12,5
04:30,809499628.0,18364.6975090357,-61.65,8
04:30,541639148.0,4523.05282386317,-36.87,2
04:31,473820682.0,12371.460257066075,-41.58,5
04:32,887853850.0,11054.579470626286,-37.37,5
04:33,506618547.0,15296.873873275712,-41.55,7
04:36,414805878.0,13783.171562486878,-36.03,9
04:38,216285378.0,25191.607384634903,-41.1,9
04:41,348325817.0,11288.42290227794,-38.9,9
04:44,169006407.0,12516.45840173873,-64.22,7
04:46,766941757.0,3014.7921848672436,-37.39,9
04:50,601627384.0,4319.138917147947,-29.67,9
04:51,673025413.0,1320.3628301441752,-78.18,8
04:52,441274121.0,13097.091816966436,-19.22,8
04:52,435984758.0,4600.432651162016,-20.23,7
04:54,873693307.0,11075.45363609973,-28.49,8
04:55,196289502.0,16648.44865107217,-23.49,9
04:57,992204045.0,7683.536928345693,-30.92,9
04:57,899742927.0,13681.470259689371,-23.08,7
04:58,824916823.0,9072.976093779977,-32.89,9
05:04,609939116.0,8080.393462185282,-52.56,7
05:04,252760664.0,7338.872058756387,-29.86,5
05:05,785749304.0,9205.731315957097,-44.54,2
05:06,449871732.0,8043.803115645463,-25.99,7
05:08,874431242.0,9956.359774701505,-45.96,2
05:11,285220959.0,12399.886666179123,-73.39,7
05:12,547010927.0,24872.23945483321,-26.43,7
05:13,912705941.0,19497.314521623208,-4.93,8
05:17,822135975.0,12174.37699379605,-11.74,4
05:18,749378808.0,4540.235844811352,-27.93,9
05:25,897714622.0,9706.002985294324,-6.44,8
05:27,235881534.0,14234.097235412908,-6.0,8
05:28,859603181.0,3893.572970442053,-9.05,8
05:29,639409800.0,37664.77183325502,-11.34,7
05:31,940569402.0,5358.059804415957,-16.9,9
05:32,758160963.0,8984.326228214652,-9.48,5
05:32,675806859.0,7871.578064890468,-15.47,7
05:34,779946617.0,17483.766813465365,-10.62,2
05:41,500043411.0,14417.00675569676,-0.24,7
05:42,572384506.0,7837.413047528045,-32.79,9
05:44,730002588.0,14367.505605575898,-16.57,5
05:44,905860285.0,11857.778608782111,-23.54,7
05:48,994214354.0,10552.626891040058,-22.61,9
05:49,237684254.0,6360.1850325703945,-2.72,8
05:49,749378808.0,4515.7484897556615,-24.49,8
05:49,366550080.0,27920.085998668263,-69.8,5
05:50,558119802.0,34627.733070904396,-28.88,9
05:51,510101371.0,14104.465221803728,-36.44,9
05:52,706250160.0,13199.344014819388,-10.88,2
05:54,973086490.0,10680.175405239052,-0.4,2
05:55,245690309.0,10192.703323491573,-7.7,7
05:57,417850087.0,18160.06494894112,-29.03,8
05:59,187111705.0,7494.625420604065,-0.82,7
06:03,310375875.0,2264.7790927481365,-27.83,9
06:03,290818242.0,7595.644272786199,-56.18,8
06:04,699139822.0,2247.0789240058007,-4.22,2
06:05,806358207.0,11798.380240001045,-59.63,7
06:16,705848712.0,28326.6486539958,-10.89,9
06:17,709608057.0,3052.251000499038,-37.18,9
06:18,910730524.0,8251.219163978922,-20.45,9
06:18,522188082.0,8521.731386445857,-56.34,8
06:19,370521542.0,28378.34482362022,-5.85,2
06:21,851181128.0,5270.05257116311,-20.19,5
06:24,534325901.0,7351.909233618855,-6.0,9
06:25,471897866.0,8298.907727473537,-5.7,7
06:26,549414742.0,8081.598394161864,-25.59,9
06:26,895750759.0,-283.5001380756658,-36.15,9
06:27,885259672.0,3614.462910927556,-16.0,2
06:27,641376155.0,-66.20748789854889,-11.99,9
06:36,986267641.0,8871.501952417128,-2.46,7
06:39,187541224.0,2601.83745664854,-29.99,9
06:40,270374623.0,10152.06874508596,-22.24,2
06:44,930277104.0,10976.205023099068,-7.93,7
06:46,200080192.0,9995.920588811005,-0.92,2
06:47,705848712.0,28317.427547724077,-9.22,2
06:53,742223719.0,779.1929073048027,-16.03,9
06:54,108563213.0,25847.52396496558,-7.55,7
06:55,198946608.0,4741.1404048536415,-1.23,2
06:55,709151315.0,35.42321837415986,-22.64,9
06:59,769311479.0,6673.850081832908,-0.38,7
06:59,461990622.0,10205.20048417865,-26.35,5
07:00,170637730.0,2036.3280300194592,-24.13,8
07:00,987163717.0,4420.138480000003,-38.98,9
07:00,802697323.0,17144.11399917581,-28.03,9
07:02,604288474.0,2126.4678177479936,-64.37,2
07:02,655368335.0,5143.798378045256,-26.18,2
07:06,399144202.0,2207.9353340074754,-11.09,5
07:06,120634201.0,5531.445329403303,-18.89,9
07:07,229205098.0,8147.459599088562,-10.6,2
07:07,554792076.0,29828.492196618117,-27.28,7
07:09,776108637.0,1174.4190536574952,-5.9,9
07:12,647936800.0,2625.3782933342713,-37.75,7
07:13,822250278.0,6972.322088164348,-72.53,2
07:16,511179916.0,8057.280327556435,-3.54,7
07:16,113747882.0,12999.829522984051,-80.78,7
07:22,221868392.0,5363.354032030625,-5.64,5
07:22,364357875.0,8773.40187114715,-30.36,2
07:23,461029994.0,8385.25841610095,-6.01,8
07:23,151968462.0,7946.140801229122,-12.23,7
07:24,213112754.0,7117.0267519884555,-2.2,2
07:29,987229118.0,1859.704399859196,-9.31,2
07:33,815993333.0,6580.245621465678,-3.12,7
07:35,280268430.0,5975.638503465595,-6.79,8
07:36,703478110.0,5545.724083055678,-50.42,7
07:37,264550521.0,9240.972070633688,-8.05,2
07:40,331450202.0,8531.260176581533,-25.88,7
07:41,950234174.0,2378.5448260240214,-21.18,5
07:46,802697323.0,17126.866369414176,-17.25,5
07:49,678851253.0,4205.465233781998,-34.85,4
07:49,858989281.0,27785.347675266716,-41.73,2
07:54,134461671.0,6477.787464482521,-41.84,7
08:00,308505160.0,14127.06184585684,-1.63,2
08:02,282837512.0,14807.519782816738,-35.49,9
08:03,203466392.0,3830.2729522321497,-3.48,5
08:04,454129843.0,472.3228451665601,-6.15,9
08:09,832564361.0,16070.81491282004,-46.95,2
08:11,146909202.0,3962.296869270708,-5.8,9
08:11,195895574.0,7805.763896521236,-37.18,9
08:14,873701090.0,705.5745783441566,-81.2,7
08:14,183888402.0,19735.467609767176,-38.99,9
08:16,670102069.0,2033.281760842237,-43.35,9
08:17,940569402.0,5335.941609327987,-22.12,5
08:17,145387690.0,5781.510035385075,-5.59,4
08:22,358846516.0,953.7701725272176,-5.7,9
08:25,667367404.0,9713.189316881204,-10.82,7
08:25,345514953.0,-902.6503000000008,-26.38,5
08:25,423208402.0,-127.1498499999975,-84.49,5
08:27,943829984.0,-331.65619088654296,-36.3,5
08:27,683319988.0,7923.853455341348,-2.26,5
08:30,252701364.0,-3898.3911726779143,-36.02,5
08:31,913127700.0,1855.336338011116,-72.39,5
08:32,969804197.0,-496.6437500000007,-14.45,5
08:33,426474982.0,-3857.38975,-53.89,5
08:35,775790822.0,-3241.5609192160673,-26.08,5
08:36,235881534.0,14142.411235412908,-91.69,5
08:36,290818242.0,7503.874272786198,-91.77,5
08:38,575652395.0,2657.009733168002,-60.75,5
08:39,246753533.0,410.1002999999984,-38.38,5
08:40,737645298.0,-2916.2591999999977,-64.74,5
08:40,795847804.0,24687.979720293923,-63.24,2
08:41,804317849.0,-3904.2116330205185,-36.93,5
08:42,766692943.0,-2047.66175,-36.99,5
08:42,494789005.0,3513.8287933023194,-42.08,5
08:42,531186970.0,5261.673883735821,-114.72,5
08:43,361201224.0,3827.4016157459937,-2.8,4
08:45,799861885.0,424.5515499999988,-52.01,5
08:46,586041848.0,-128.8413000000011,-164.49,5
08:46,737547541.0,-370.4304004322256,-60.04,5
08:46,722358036.0,521.664990627083,-147.87,5
08:47,718058208.0,2492.2814102878947,-9.3,2
08:49,687135796.0,29544.84830898353,-39.22,2
08:50,644751433.0,-1615.4131584655383,-107.56,5
08:51,842682241.0,6322.3965354513675,-22.58,2
08:53,534325901.0,7316.363532942773,-35.55,2
09:00,916270283.0,2613.01625,-47.42,5
09:00,117273481.0,9249.280038341049,-6.8,9
09:01,998390769.0,-51.860849059475825,-71.08,5
09:02,506618547.0,15291.923873275711,-4.95,9
09:03,812012103.0,-991.1843000000003,-126.52,5
09:03,163470640.0,1169.2753999999995,-26.72,5
09:03,886921642.0,3667.385587835999,-2.38,7
09:07,452974357.0,-3768.5064499999944,-38.45,5
09:08,540159353.0,11902.34097560692,-5.5,9
09:09,572136270.0,226.0891115880233,-29.23,5
09:10,214339619.0,623.624550868356,-6.1,9
09:10,683319988.0,7917.753455341348,-6.1,9
09:11,552980092.0,-177.0892808806624,-60.44,5
09:13,570323670.0,3524.547624796833,-55.19,4
09:13,596171893.0,609.6255948255109,-26.97,7
09:15,668175891.0,1216.667223158499,-52.0,4
09:15,889916166.0,220.9834014132266,-79.98,4
09:15,727417797.0,6148.155348478869,-84.97,4
09:16,618138606.0,1459.185902870066,-5.0,9
09:17,999752672.0,1789.5930935333345,-6.2,9
09:17,290818242.0,7498.124272786198,-5.75,9
09:18,690958123.0,22132.292924198064,-6.6,9
09:19,668692488.0,2508.8077785738096,-268.19,5
09:19,508518911.0,117.57475027901032,-33.48,4
09:19,855129444.0,-116.29054543737216,-127.38,5
09:20,586315521.0,13206.179760145216,-6.85,9
09:21,441274121.0,13090.741816966434,-6.35,9
09:21,475117511.0,7594.173679437446,-5.63,7
09:21,417850087.0,18154.36494894112,-5.7,9
09:22,992204045.0,7676.686928345693,-6.85,9
09:23,667367404.0,9707.039316881204,-6.15,9
09:23,138609932.0,2643.6350032945857,-5.35,9
09:26,383833857.0,26747.54543259195,-22.63,1
09:27,719586818.0,19355.16656106949,-141.77,5
09:28,168414279.0,-121.08521572507868,-64.98,4
09:28,792845450.0,1120.445150000001,-248.5,2
09:29,596171893.0,576.6455948255109,-32.98,2
09:32,169689461.0,1117.3931499999992,-172.97,2
09:33,401293808.0,-188.0740000000009,-313.41,5
09:35,116169597.0,1329.8789499999996,-40.97,4
09:35,521611005.0,-237.83463585104653,-79.99,2
09:36,550832673.0,3306.47401639551,-28.97,4
09:38,480557476.0,11860.87409394666,-25.6,2
09:43,668175891.0,1003.1672231584988,-213.5,7
09:43,980500334.0,-327.1094338929041,-100.12,2
09:43,979892433.0,-1397.746600000001,-106.35,5
09:43,246753533.0,330.1202999999984,-79.98,4
09:45,128033695.0,2379.7715972027136,-75.15,2
09:46,738958551.0,9951.796767147873,-15.2,8
09:47,261793952.0,450.13326020381487,-100.09,2
09:49,904154012.0,532.0574581204316,-9.99,7
09:49,187111705.0,7488.575420604065,-6.05,7
09:50,612304466.0,-2223.0432499999993,-19.16,5
09:52,601627384.0,4293.4589171479465,-25.68,7
09:52,391688371.0,1117.8413911585,-120.36,2
09:53,169689461.0,999.4331499999992,-117.96,2
09:55,355733816.0,5736.326175148084,-12.99,2
10:02,456246119.0,21770.574858632895,-3.0,7
10:02,520447032.0,8832.686933865736,-3.23,5
10:04,762896656.0,-1102.6400018481413,-20.6,5
10:08,391688371.0,951.2553911585,-166.59,2
10:09,223207876.0,519.0671000000002,-175.85,2
10:13,980500334.0,-435.4769338929041,-108.37,2
10:13,287480331.0,8854.891228822555,-5.35,9
10:17,298000165.0,27223.6649217094,-35.0,2
10:19,127809299.0,948.8620157577852,-140.98,2
10:21,585625048.0,2268.925974999357,-25.0,2
10:21,348325817.0,11254.43727015192,-33.99,5
10:21,776431321.0,3472.2397025939395,-6.99,7
10:23,895331556.0,-438.6803000000009,-42.23,5
10:23,834383043.0,5563.40968524823,-0.37,8
10:23,308897841.0,1303.0689999999988,-38.66,5
10:24,514362267.0,719.6898191070602,-6.99,4
10:25,910730524.0,8218.169163978922,-33.05,2
10:25,980500334.0,-465.46193389290414,-29.99,2
10:26,456246119.0,21749.929770322393,-20.65,7
10:28,106601471.0,11363.840777610676,-1.47,2
10:30,987656636.0,4611.632771860729,-32.59,8
10:31,527842638.0,1072.8648426329837,-27.96,1
10:32,245198540.0,327.0213988017795,-36.95,7
10:38,480198977.0,12953.899720897709,-35.98,4
10:39,310740977.0,312.54455295899686,-64.98,2
10:58,933491926.0,3806.164300000005,-6.0,2
10:58,310620484.0,182.3111950921983,-50.34,2
11:03,722971557.0,-938.8062791569243,-22.81,5
11:05,766941757.0,3003.665815560732,-11.13,2
11:10,901432314.0,4051.228445583317,-16.84,8
11:14,116169597.0,1113.5579499999997,-216.32,5
11:16,865748375.0,4211.955863871563,-15.49,5
11:21,933491926.0,3786.1743000000047,-19.99,1
11:21,661295096.0,3525.752924172199,-31.99,2
11:32,519935524.0,1183.3903297375189,-86.25,2
11:33,715068825.0,577.0244999999998,-109.5,2
11:43,194745206.0,329.5763720912432,-28.08,2
11:44,769319491.0,76.78199999999921,-69.0,2
11:51,391688371.0,869.3693911585001,-81.89,2
11:52,668175891.0,916.1672231584988,-87.0,4
11:53,715068825.0,468.27449999999976,-108.75,2
11:55,980500334.0,-564.8219338929041,-99.36,2
12:00,169689461.0,828.4631499999991,-170.97,7
12:01,822250278.0,6968.121658164348,-4.2,4
12:04,250895529.0,1125.212182469288,-179.97,2
12:04,737547541.0,-398.3804004322256,-27.95,9
12:07,960208650.0,18454.61177989725,-13.59,2
12:07,715068825.0,393.27449999999976,-75.0,2
12:08,331048953.0,35.873367978493576,-103.53,2
12:10,920830317.0,-184.48397936251865,-22.64,9
12:10,781554833.0,1126.8067255639664,-24.97,9
12:12,527842638.0,1045.8848426329837,-26.98,2
12:13,535744551.0,792.8821659956259,-108.13,5
12:14,414454079.0,515.8778500000016,-9.11,4
12:16,595800644.0,-881.5506500000002,-20.59,9
12:17,403383649.0,1895.3943796543065,-193.17,2
12:21,668175891.0,851.6672231584989,-64.5,7
12:22,572136270.0,207.1191115880233,-18.97,1
12:25,527842638.0,888.9048426329834,-156.98,2
12:26,891513205.0,619.789079659069,-17.98,9
12:32,980500334.0,-595.9169338929041,-31.09,2
12:33,685959099.0,2304.8998660992434,-39.98,4
12:35,179173981.0,5320.293794183544,-66.81,2
12:38,398429109.0,1404.968550000001,-59.92,7
12:39,776431321.0,3452.7940814729095,-19.45,2
12:44,874506295.0,-1461.206756245572,-36.64,5
12:44,403383649.0,1659.5223796543062,-235.87,2
12:45,670102069.0,2021.041760842237,-12.24,7
12:48,214765415.0,-297.7517988501354,-77.51,5
12:48,879091637.0,-473.21647626202304,-37.4,9
12:51,391688371.0,716.0693911585001,-153.3,2
12:54,865748375.0,4206.965863871564,-4.99,1
13:03,930277104.0,10942.555023099068,-33.65,9
13:05,722358036.0,515.164990627083,-6.5,9
13:09,494789005.0,3509.1485043479233,-4.68,2
13:10,399144202.0,2108.0173340074753,-99.92,5
13:11,980500334.0,-658.5344338929041,-62.62,2
13:12,821971408.0,1253.6191102355433,-42.36,5
13:12,989506909.0,-2559.412370759437,-22.54,5
13:13,688712152.0,7073.040495187548,-5.7,9
13:14,652048867.0,529.9920999999989,-27.95,7
13:14,391688371.0,534.7693911585002,-181.3,2
13:14,615144184.0,665.8378491255188,-61.94,5
13:15,715068825.0,301.77449999999976,-91.5,2
13:17,322221939.0,4000.905557204729,-6.12,2
13:21,403765849.0,-2536.2979999999966,-40.39,5
13:21,403383649.0,1427.1363796543062,-232.39,2
13:24,760704118.0,1597.432312717489,-97.19,5
13:25,662610817.0,-1389.306831324928,-236.04,5
13:26,769319491.0,62.80199999999921,-13.98,2
13:29,998405607.0,-536.1089999999981,-51.19,5
13:30,642015139.0,96.17633746563828,-19.72,5
13:30,494789005.0,3505.6003443479235,-3.55,4
13:33,980500334.0,-708.386933892904,-49.85,2
13:33,233981231.0,2450.4622892297584,-99.34,2
13:33,129018172.0,10181.502321236932,-37.95,1
13:35,285873880.0,13029.873371810583,-29.69,4
13:36,779236304.0,2231.3375954795333,-22.43,9
13:38,570323670.0,3490.487624796833,-34.06,2
13:44,715068825.0,245.89949999999976,-55.88,2
13:50,421881811.0,3750.9249739128513,-10.84,4
13:50,769319491.0,-31.69800000000079,-94.5,2
13:55,948558249.0,10043.166963903546,-2.99,8
13:55,600585971.0,287.32424999999955,-69.69,5
14:03,340321732.0,1852.625550000004,-182.96,5
14:08,779620857.0,-301.08134638517595,-146.0,2
14:13,715068825.0,124.77449999999976,-121.12,2
14:17,970298834.0,2893.5240395048563,-15.36,4
14:20,980500334.0,-794.261933892904,-85.88,2
14:20,807098817.0,546.5929499999991,-6.99,4
14:22,403383649.0,1156.2363796543063,-270.9,2
14:26,405416860.0,2524.1165068809046,-112.98,5
14:31,169689461.0,782.4931499999991,-45.97,2
14:36,715068825.0,32.14949999999976,-92.62,2
14:42,980500334.0,-898.114433892904,-103.85,2
14:44,663479159.0,4992.623541827712,-9.99,7
14:45,779620857.0,-375.58134638517595,-74.5,2
14:47,331048953.0,-171.3266320215064,-207.2,2
14:51,980500334.0,-989.989433892904,-91.88,2
14:56,403383649.0,1114.2503796543062,-41.99,2
15:09,556992209.0,12616.31040952584,-4.31,2
15:15,700138124.0,5672.920363960372,-2.52,2
15:19,715068825.0,-55.97550000000024,-88.12,2
15:20,520447032.0,8745.032933865736,-87.65,5
15:21,549414742.0,8054.702039381253,-26.9,5
15:22,331048953.0,-269.2986320215064,-97.97,2
15:22,519935524.0,1118.1403297375189,-65.25,2
15:33,519935524.0,1069.7653297375189,-48.38,2
15:36,715068825.0,-169.97550000000024,-114.0,2
15:38,169689461.0,705.0131499999991,-77.48,7
15:47,980500334.0,-1037.606933892904,-47.62,2
15:55,718058208.0,2485.2714102878945,-7.01,7
15:59,829914501.0,1545.2588065709742,-130.91,5
16:03,980500334.0,-1099.841933892904,-62.23,2
16:10,519935524.0,951.6403297375188,-118.12,2
16:11,211493028.0,1144.6014499999992,-131.97,6
16:14,678330503.0,3613.889321959738,-23.33,8
16:23,679911053.0,3179.0948471689467,-41.97,7
16:24,169689461.0,580.5231499999991,-124.49,7
16:25,527842638.0,813.9248426329834,-74.98,2
16:28,104832000.0,-3020.1523589058443,-26.53,5
16:29,628470485.0,922.2670299001232,-81.97,4
16:30,286484726.0,988.4356320337756,-88.87,2
16:36,409971170.0,3252.0938190263328,-24.81,5
16:44,403383649.0,982.6643796543062,-131.59,2
16:52,766941757.0,2968.875815560732,-34.79,2
16:53,286484726.0,951.3181320337758,-37.12,2
16:53,605116158.0,2807.035700000003,-1.5,4
16:57,169689461.0,521.5231499999991,-59.0,4
17:02,980500334.0,-1131.7019338929038,-31.86,2
17:07,809499628.0,18351.3575090357,-13.34,9
17:09,779620857.0,-517.581346385176,-142.0,2
17:09,836110591.0,6982.461391075717,-35.22,9
17:10,237493332.0,15429.753964530031,-27.25,7
17:13,370757362.0,1511.321589812676,-26.96,7
17:14,527842638.0,661.4348426329834,-152.49,2
17:15,844835978.0,10682.616571187318,-2.81,7
17:17,581655972.0,43344.47078929952,-4.99,7
17:19,117273481.0,9242.290038341049,-6.99,7
17:19,518474507.0,14786.419660306065,-67.48,8
17:19,558119802.0,34621.18622712825,-6.55,2
17:19,704517789.0,18645.69050057426,-46.24,5
17:23,129018172.0,10007.643321236932,-173.86,5
17:23,779620857.0,-655.081346385176,-137.5,2
17:26,873693307.0,10972.86363609973,-102.59,2
17:26,310375875.0,2210.917272748137,-53.86,4
17:26,146909202.0,3956.843057203934,-5.45,7
17:26,348325817.0,11183.06847015192,-71.37,4
17:28,715068825.0,-210.85050000000024,-40.88,2
17:28,980500334.0,-1173.3119338929037,-41.61,2
17:28,414805878.0,13746.461562486878,-36.71,2
17:29,169689461.0,442.03314999999907,-79.49,4
17:31,639409800.0,37649.681833255025,-15.09,4
17:32,511179916.0,7953.680327556434,-103.6,2
17:33,672913754.0,12026.282994680929,-98.39,5
17:35,656812046.0,1260.725753732519,-71.97,5
17:36,618514666.0,22446.62881146897,-5.99,7
17:36,256045540.0,-3668.601399999999,-30.29,5
17:37,551755686.0,7150.397485725705,-23.97,4
17:37,331450202.0,8488.448176581533,-42.81,5
17:38,199016328.0,4717.979653802992,-13.97,2
17:40,184430449.0,2749.5439276932657,-22.97,7
17:41,492215823.0,3627.6692938154447,-32.18,9
17:41,287230540.0,1563.002293293266,-9.99,2
17:42,310375875.0,2160.612264100293,-50.31,8
17:42,141521177.0,8226.691900000014,-76.27,2
17:44,585596026.0,2944.0767009019905,-110.46,5
17:44,653640811.0,18131.804970594934,-140.93,5
17:45,433917275.0,8217.720726575002,-48.07,5
17:45,138609932.0,2622.6350032945857,-21.0,4
17:47,980500334.0,-1309.8044338929035,-136.49,2
17:47,994214354.0,10541.609121537367,-11.02,5
17:49,975345315.0,37276.00883562805,-21.49,4
17:49,858989281.0,27765.157675266717,-20.19,9
17:50,715068825.0,-346.97550000000024,-136.12,2
17:50,511179916.0,7825.580327556434,-128.1,2
17:50,419550103.0,19447.39714057855,-114.08,2
17:51,237493332.0,15366.655964530031,-63.1,5
17:52,117273481.0,9223.32003834105,-18.97,4
17:53,286484726.0,896.2006320337757,-55.12,2
17:53,169689461.0,412.04314999999906,-29.99,7
17:54,880546403.0,-1442.529500000002,-32.13,9
17:54,844835978.0,10665.63657118732,-16.98,4
17:54,667367404.0,9689.335176881204,-17.7,4
17:56,435984758.0,4588.482651162016,-11.95,9
17:57,376271050.0,1641.5091885480565,-32.97,7
17:58,108563213.0,25821.383964965586,-26.14,7
17:59,980500334.0,-1352.1719338929038,-42.37,2
17:59,266777719.0,1646.3589337802396,-100.39,2
18:00,624563756.0,-261.9781712164436,-99.0,4
18:01,519935524.0,864.2653297375189,-87.38,2
18:04,500043411.0,14390.58875569676,-26.42,5
18:04,517934629.0,597.9876787084264,-37.68,9
18:05,975345315.0,37235.324835628046,-40.68,5
18:07,234952520.0,431.1713999999988,-34.23,9
18:08,285428103.0,10605.476621063915,-99.97,5
18:11,668692488.0,2433.8077785738096,-75.0,2
18:13,736340277.0,9493.914946377236,-55.26,5
18:14,190874125.0,190.36301421356728,-24.94,9
18:15,519935524.0,763.7653297375189,-100.5,2
18:16,752362502.0,8032.213296394821,-5.9,2
18:17,169689461.0,286.55314999999905,-125.49,7
18:19,141521177.0,8211.319900000015,-15.37,2
18:21,291580432.0,40.188100000000375,-47.44,5
18:23,520447032.0,8709.932933865735,-35.1,9
18:24,812692024.0,4160.81870666393,-30.2,5
18:26,215311171.0,6930.845925340422,-39.21,2
18:26,842682241.0,6188.143535451368,-134.25,5
18:31,286484726.0,870.7081320337758,-25.49,2
18:34,510101371.0,14070.155221803729,-34.31,7
18:35,785749304.0,9189.211315957094,-16.52,5
18:35,836110591.0,6976.211391075717,-6.25,7
18:35,812692024.0,4158.8287066639305,-1.99,7
18:37,196289502.0,16639.26865107217,-9.18,7
18:37,683319988.0,7898.313455341348,-19.44,9
18:37,851649498.0,8881.626767314796,-7.85,2
18:40,815385232.0,11134.36660282405,-16.19,7
18:42,986267641.0,8836.725952417128,-34.78,5
18:42,108481285.0,9625.615872852435,-50.1,2
18:43,131388684.0,22332.047825696263,-28.64,7
18:43,587202562.0,206.46919941706847,-40.46,5
18:43,284905540.0,8556.190218944732,-29.88,4
18:47,668692488.0,2402.31527857381,-31.49,2
18:47,795847804.0,24669.039720293924,-18.94,9
18:48,287480331.0,8842.099453744462,-12.79,7
18:49,117308635.0,168.85300729104964,-96.03,5
18:50,651756497.0,14990.554542889722,-10.95,5
18:50,169689461.0,155.10314999999906,-131.45,4
18:51,806358207.0,11745.036120001045,-53.34,7
18:51,335698481.0,-2457.537996694939,-12.97,5
18:52,532478725.0,5240.110012177052,-0.13,5
18:54,631111289.0,-419.816500000001,-15.69,5
18:54,719742742.0,-550.2550077779632,-24.05,5
18:55,605116158.0,2780.076600000003,-26.96,5
18:58,333054026.0,734.8858940231901,-96.47,5
18:59,586315521.0,13134.821760145216,-71.36,5
18:59,604870380.0,-1940.2665529005533,-58.17,5
19:00,380911501.0,-62.13755000000084,-53.96,5
19:00,744211756.0,-4379.195749999993,-31.39,5
19:04,807714284.0,1462.3277607359998,-89.96,5
19:04,176922958.0,1544.9655471976496,-27.98,9
19:05,892354433.0,-774.7199606343386,-21.04,9
19:06,851649498.0,8829.336767314795,-52.29,5
19:10,836110591.0,6919.519435629676,-56.69,2
19:18,213930646.0,-1764.5545634725631,-41.58,5
19:22,713641917.0,1496.4173430809649,-10.74,7
19:22,670102069.0,1999.4113729471312,-21.63,5
19:27,736310094.0,-747.2078240274259,-61.9,5
19:34,984783496.0,14958.192424860878,-20.25,9
19:38,370521542.0,28364.70482362022,-13.64,9
19:39,535804582.0,-1536.0489500000012,-141.8,5
19:40,461029994.0,8296.414416100952,-88.84,5
19:46,296972867.0,-861.1019000000009,-30.31,5
19:47,322221939.0,3920.391557204729,-80.51,5
19:50,668329719.0,9281.203826100558,-6.99,5
19:50,641764023.0,-1091.6438037720045,-55.67,5
19:52,550169791.0,22823.968112463772,-10.7,9
19:53,151278285.0,-1405.1513500000003,-28.14,9
19:53,419550103.0,19429.99892785608,-17.4,5
20:00,308068836.0,-579.6244774318078,-128.79,5
20:01,131388684.0,22303.263825696264,-28.78,5
20:10,315546581.0,30002.644818089462,-62.96,5
20:16,742223719.0,729.7967073048027,-49.4,5
20:17,815385232.0,11083.988146682075,-50.38,8
20:17,407574996.0,-386.1263906190632,-248.28,5
20:18,703588001.0,-247.63020000000057,-134.36,5
20:19,754141345.0,-3133.2828351157596,-32.68,5
20:19,642015139.0,60.64633746563827,-35.53,9
20:29,598586358.0,-3523.6849499999953,-19.48,5
20:31,859603181.0,3732.334970442053,-161.24,5
20:33,992204045.0,7661.610682399417,-15.08,7
20:33,149684419.0,1174.770199999998,-46.64,5
20:37,482513594.0,6440.603975749326,-51.91,5
20:42,180616589.0,1175.2831699949168,-4.43,5
20:45,130154096.0,1188.034751705878,-147.53,5
20:46,519649533.0,-511.2981836293378,-20.88,9
20:49,690958123.0,22088.026886106298,-44.27,2
21:06,406772240.0,-1382.8222000000003,-37.44,9
21:06,496395938.0,12919.796339787044,-3.79,5
21:49,736340277.0,9482.809282002952,-11.11,2
00:15,873701090.0,667.0549064760718,-38.52,5
02:33,518474507.0,14744.529660306063,-41.89,9
02:42,766941757.0,2930.195815560732,-38.68,9
03:01,506618547.0,15288.782260741762,-3.14,2
03:06,887853850.0,11026.239470626286,-28.34,9
03:06,633345190.0,6432.454336593886,-31.95,9
03:07,280268430.0,5957.671705820753,-17.97,2
03:07,809499628.0,18337.6075090357,-13.75,9
03:07,237493332.0,15357.255964530032,-9.4,9
03:16,709608057.0,3012.371000499038,-39.88,9
03:17,899742927.0,13624.758342158242,-56.71,2
03:23,550644516.0,-272.59290000000146,-25.19,9
03:24,187111705.0,7483.8755434249315,-4.7,2
03:27,235881534.0,14111.314468249762,-31.1,7
03:30,819515373.0,2652.176136063794,-22.08,9
03:33,699139822.0,2226.1890864725165,-20.89,7
03:34,802697323.0,17090.006369414175,-36.86,9
03:37,633345190.0,6426.044691213473,-6.41,5
03:38,930277104.0,10915.665023099067,-26.89,9
03:40,216285378.0,25155.317384634905,-36.29,9
03:43,532478725.0,5216.754992776604,-23.36,8
03:46,510101371.0,14029.585221803727,-40.57,9
03:46,752362502.0,7985.789848842656,-46.42,2
03:46,736340277.0,9472.109282002952,-10.7,9
03:47,973086490.0,10669.685405239052,-10.49,9
03:50,254853117.0,3495.772942175131,-3.71,7
03:52,547010927.0,24853.04945483321,-19.19,9
03:52,706250160.0,13149.3643042719,-49.98,5
03:54,541639148.0,4490.456201895701,-32.6,8
03:56,331450202.0,8414.561640699627,-73.89,2
04:01,550169791.0,22752.96345513991,-71.0,7
04:01,534204159.0,6137.554616024079,-27.44,9
04:04,433917275.0,8183.580726575002,-34.14,9
04:06,237493332.0,15305.56856736895,-51.69,2
04:06,858989281.0,27756.117675266716,-9.04,9
04:08,828532554.0,551.3803095172897,-24.91,7
04:09,435984758.0,4579.111749866006,-9.37,2
04:11,252760664.0,7318.218462909985,-20.65,7
04:14,832564361.0,16057.81491282004,-13.0,9
04:17,145387690.0,5755.1600353850745,-26.35,9
04:22,183888402.0,19695.637609767175,-39.83,9
04:24,290818242.0,7476.588502630012,-21.54,2
04:27,282837512.0,14770.87978281674,-36.64,9
04:28,143003091.0,10882.40802077992,-34.13,7
04:31,196289502.0,16626.03865107217,-13.23,9
04:34,973086490.0,10656.968857388749,-12.72,2
04:35,806358207.0,11741.457096116816,-3.58,7
04:37,348325817.0,11124.60210686668,-58.47,5
04:38,749378808.0,4482.768489755662,-32.98,9
04:41,679662108.0,17075.63442911579,-28.59,2
04:46,984783496.0,14938.992424860877,-19.2,9
04:48,270374623.0,10147.916150226696,-4.15,5
04:48,441274121.0,13087.338840993254,-3.4,7
04:50,203466392.0,3829.711179776433,-0.56,7
04:51,851181128.0,5242.30257116311,-27.75,9
04:51,842682241.0,6123.37222496521,-64.77,5
04:52,534325901.0,7311.83131236973,-4.53,5
04:54,779236304.0,2204.4075954795335,-26.93,9
04:54,221868392.0,5325.154032030625,-38.2,9
04:54,949032480.0,4332.108349458774,-30.14,9
04:56,417850087.0,18152.3281799077,-2.04,5
04:56,461990622.0,10156.56251587464,-48.64,2
04:58,822250278.0,6927.546791630507,-40.57,2
05:00,581655972.0,43322.47674389967,-21.99,5
05:04,719586818.0,19327.87707589307,-27.29,7
05:04,120634201.0,5519.195329403303,-12.25,9
05:04,213112754.0,7114.212856965676,-2.81,2
05:06,554792076.0,29816.768357892324,-11.72,2
05:07,383833857.0,26743.76953440174,-3.78,5
05:08,822718326.0,11856.03598266141,-35.96,2
05:10,237684254.0,6359.488493508296,-0.7,5
05:15,668329719.0,9264.776450232932,-16.43,7
05:20,809499628.0,18334.67435287218,-2.93,7
05:21,310375875.0,2153.7600649070114,-6.85,5
05:22,851181128.0,5218.829483756815,-23.47,5
05:23,113747882.0,12956.139522984053,-43.69,9
05:25,885259672.0,3585.3754995213726,-29.09,5
05:32,822135975.0,12173.865370206591,-0.51,8
05:32,858989281.0,27704.3238836267,-51.79,5
05:32,613729471.0,8421.486970624654,-3.65,8
05:32,647936800.0,2601.567088194151,-23.81,7
05:34,108481285.0,9610.643467445678,-14.97,2
05:35,832564361.0,16048.74131197442,-9.07,2
05:38,887853850.0,10989.726976718568,-36.51,7
05:40,769311479.0,6633.068177361226,-40.78,5
05:40,930277104.0,10896.113695132985,-19.55,7
05:43,601627384.0,4251.368917147946,-42.09,9
05:45,670102069.0,1964.2113729471312,-35.2,9
05:47,873693307.0,10951.62363609973,-21.24,9
05:50,572384506.0,7801.663047528045,-35.75,9
05:50,987163717.0,4386.348480000003,-33.79,9
05:53,667367404.0,9678.032212458726,-11.3,8
05:53,657139925.0,14925.34857611454,-20.85,9
05:55,450896297.0,14093.415232523514,-22.9,9
06:00,324224854.0,4635.247714867959,-53.56,7
06:02,547010927.0,24839.908497754757,-13.14,5
06:07,128033695.0,2324.1188633946217,-55.65,7
06:07,196289502.0,16593.754545508375,-32.28,7
06:07,108931112.0,14976.932935034452,-32.58,9
06:09,549414742.0,8024.272039381252,-30.43,9
06:10,151968462.0,7943.590207459794,-2.55,7
06:13,901432314.0,3985.757808234492,-65.47,7
06:14,364357875.0,8760.165055653863,-13.24,5
06:16,949032480.0,4306.470812757475,-25.64,5
06:19,496395938.0,12902.113347056187,-17.68,8
06:21,187541224.0,2560.75745664854,-41.08,9
06:22,874431242.0,9948.442649329509,-7.92,8
06:23,609939116.0,8052.759449562014,-27.63,4
06:24,779946617.0,17453.466180543797,-30.3,5
06:30,873693307.0,10925.3552198017,-26.27,5
06:35,698076160.0,6885.827219084593,-38.73,7
06:35,678851253.0,4194.030312986009,-11.43,2
06:35,482513594.0,6403.072891614795,-37.53,2
06:40,994214354.0,10512.959121537368,-28.65,9
06:41,455831435.0,-1827.4996048014943,-33.7,9
06:46,824916823.0,9049.356093779976,-23.62,9
06:52,549414742.0,8004.698470231513,-19.57,2
06:53,912705941.0,19443.536907977206,-53.78,5
06:53,124102251.0,3696.267902769622,-33.17,7
07:01,657139925.0,14904.89134243058,-20.46,5
07:03,170637730.0,1999.1556222184136,-37.17,5
07:06,776108637.0,1169.019053657495,-5.4,9
07:10,370521542.0,28362.566815666574,-2.14,2
07:10,264550521.0,9206.13733203789,-34.83,7
07:10,718058208.0,2463.993162648009,-21.28,4
07:10,179173981.0,5285.353794183545,-34.94,9
07:13,829914501.0,1540.1588065709743,-5.1,9
07:16,901037631.0,1783.0793230964066,-5.8,9
07:17,836110591.0,6888.279435629676,-31.24,9
07:26,366550080.0,27907.60238897904,-12.48,8
07:26,414805878.0,13714.66156248688,-31.8,9
07:26,169006407.0,12511.021956233111,-5.44,7
07:28,421881811.0,3742.411502134264,-8.51,2
07:30,305778936.0,10948.51229639789,-5.55,5
07:35,285220959.0,12365.558017307436,-34.33,5
07:36,586315521.0,13129.874091205616,-4.95,5
07:37,675806859.0,7862.951102682696,-8.63,2
07:38,785749304.0,9186.657139602978,-2.55,7
07:43,519644021.0,3389.254747071184,-28.3,2
07:44,195895574.0,7783.823896521237,-21.94,9
07:45,500043411.0,14312.864277205972,-77.72,2
07:49,910730524.0,8176.709693471259,-41.46,2
07:53,587225252.0,6272.270680365503,-36.57,9
07:53,450896297.0,14076.75187052717,-16.66,4
07:54,383625050.0,3160.0966051614223,-19.05,2
07:58,758160963.0,8983.969073242666,-0.36,8
07:59,473820682.0,12331.131368366088,-40.33,2
07:59,511179916.0,7781.725438581241,-43.85,5
08:01,518474507.0,14742.750772217863,-1.78,2
08:03,527842638.0,656.0348426329834,-5.4,9
08:05,358846516.0,949.4201725272176,-4.35,9
08:05,885259672.0,3580.425499521373,-4.95,9
08:06,399538448.0,8217.954049395938,-5.0,9
08:07,704517789.0,18635.621235264694,-10.07,5
08:08,673025413.0,1311.5253489527352,-8.84,4
08:18,414805878.0,13708.965317755925,-5.7,2
08:19,987656636.0,4602.376755069008,-9.26,5
08:21,623156843.0,5061.874884500228,-3.74,5
08:23,815993333.0,6571.8869688142395,-8.36,4
08:24,195895574.0,7744.116953506564,-39.71,8
08:24,108931112.0,14967.10668654393,-9.83,7
08:25,822135975.0,12131.767370206591,-42.1,5
08:26,429556122.0,4809.166429294684,-10.95,5
08:27,639549973.0,7681.234934334791,-20.25,7
08:28,857997794.0,1093.6376651508867,-70.94,5
08:28,960208650.0,18430.743155974946,-23.87,5
08:30,522188082.0,8520.858505477454,-0.87,8
08:31,954263768.0,-156.1484000000002,-26.95,5
08:31,259015404.0,1518.5290901789926,-16.28,2
08:33,749378808.0,4469.092581676343,-13.68,8
08:33,322221939.0,3891.492821224112,-28.9,2
08:35,961077907.0,-295.62975,-120.82,5
08:36,119993184.0,-2141.866902910862,-35.3,5
08:36,480557476.0,11804.974938466865,-55.9,2
08:37,245690309.0,10172.094421485406,-20.61,2
08:41,979122276.0,-761.4790377056713,-156.26,5
08:41,730002588.0,14350.243167052626,-17.26,7
08:46,142791593.0,-191.17580000000035,-149.84,5
08:46,124102251.0,3637.0899027696223,-59.18,5
08:46,146686559.0,-639.537711173478,-60.32,5
08:47,519933553.0,86.60100415072844,-12.96,5
08:47,890567652.0,228.8461496796006,-60.97,5
08:48,691789577.0,-924.6053,-215.1,5
08:49,795847804.0,24652.95454069007,-16.09,7
08:49,479456865.0,2022.3294995833055,-157.13,5
08:51,308505160.0,14103.132043923406,-23.93,7
08:54,639549973.0,7636.105934334792,-45.13,5
08:55,984783496.0,14919.634041588668,-19.36,7
08:55,441274121.0,12993.888840993252,-93.45,5
08:55,518466565.0,1390.7891499999992,-97.46,5
08:57,336171116.0,-635.1901500000006,-177.38,5
09:00,711045550.0,2384.8983500000036,-89.44,5
09:02,506618547.0,15282.33226074176,-6.45,9
09:03,960208650.0,18318.66615597494,-112.08,5
09:08,214339619.0,616.524550868356,-7.1,9
09:08,117273481.0,9217.620038341049,-5.7,9
09:08,169006407.0,12505.221956233114,-5.8,9
09:11,613729471.0,8415.786970624653,-5.7,9
09:16,890830949.0,1071.0764999999976,-67.17,5
09:16,690958123.0,22082.776886106298,-5.25,9
09:17,999752672.0,1785.2430935333346,-4.35,9
09:17,475277431.0,1201.1581369436192,-7.99,4
09:18,940569402.0,5306.023609327987,-29.92,5
09:18,170637730.0,1983.075622218414,-16.08,7
09:19,355733816.0,5715.356175148084,-20.97,7
09:20,444371478.0,668.6983999999986,-44.05,5
09:20,570269025.0,3595.49007291183,-66.78,5
09:22,540159353.0,11895.84097560692,-6.5,9
09:23,866941383.0,1905.1096500000072,-88.86,5
09:25,187111705.0,7448.575543424931,-35.3,7
09:27,534204159.0,6130.995008365138,-6.56,5
09:30,779376323.0,3571.4983839813403,-5.99,6
09:30,924045955.0,2858.561442658665,-87.15,4
09:31,588565416.0,6936.236910256636,-2.11,7
09:31,282837512.0,14739.839782816738,-31.04,2
09:31,857455726.0,-517.3815141243158,-118.42,5
09:33,348525881.0,1149.851624594936,-11.98,1
09:33,426466211.0,-3444.405749999999,-31.92,5
09:36,819515373.0,2460.686136063793,-191.49,2
09:39,108931112.0,14956.13412654393,-10.97,4
09:40,703537476.0,1081.794249999999,-80.06,2
09:42,176922958.0,1503.4055471976496,-41.56,1
09:42,134461671.0,6467.787464482521,-10.0,7
09:43,279149837.0,2098.450049999999,-19.97,1
09:45,518466565.0,1129.6891499999992,-261.1,2
09:47,706361191.0,444.80434849407794,-19.99,2
09:47,659415300.0,1878.9858805359595,-18.0,4
09:48,215311171.0,6876.380978256548,-54.46,2
09:51,913801979.0,289.4690799144938,-57.62,5
09:55,618514666.0,22443.13881146897,-3.49,4
10:02,370521542.0,28335.21365566658,-27.35,4
10:04,687135796.0,29534.37830898353,-10.47,1
10:14,534583529.0,1230.4638880547652,-60.36,5
10:15,518466565.0,927.3891499999992,-202.3,2
10:16,547010927.0,24780.578497754756,-59.33,2
10:16,421881811.0,3514.925502134264,-227.49,2
10:19,596171893.0,482.17559482551087,-94.47,2
10:20,654329190.0,-643.6192490514808,-76.93,5
10:24,441142605.0,2577.8418422757286,-96.38,2
10:27,223207876.0,414.7671000000002,-104.3,2
10:35,421881811.0,3381.281502134264,-133.64,2
10:36,700138124.0,5645.640805094769,-27.28,7
10:40,223207876.0,304.8671000000002,-109.9,2
10:40,743630833.0,273.4495632847012,-74.5,2
10:40,987656636.0,4563.116755069008,-39.26,7
10:41,655368335.0,5113.7783780452555,-30.02,2
10:42,575652395.0,2655.978909355598,-1.03,7
10:43,441142605.0,2529.4668422757286,-48.38,2
10:47,165691047.0,408.16159999999894,-48.49,2
10:55,668175891.0,784.6772231584989,-66.99,2
10:56,596171893.0,369.19559482551085,-112.98,2
11:04,223207876.0,19.967100000000244,-284.9,2
11:05,941285623.0,1497.3403990667705,-21.98,4
11:06,421881811.0,3229.381502134264,-151.9,2
11:07,165691047.0,375.17159999999893,-32.99,2
11:22,165691047.0,236.17159999999893,-139.0,2
11:23,130522384.0,-468.0838156208604,-90.47,2
11:24,366550080.0,27680.830388979037,-226.77,2
11:32,687135796.0,29518.824598401265,-15.55,7
11:34,538003940.0,2548.9600000000096,-9.97,4
11:35,223207876.0,-241.83289999999977,-261.8,2
11:35,596171893.0,318.19559482551085,-51.0,2
11:44,575652395.0,2640.903819355598,-15.08,4
11:44,127809299.0,873.7303157577852,-75.13,5
11:45,366550080.0,27630.458388979037,-50.37,2
11:49,223207876.0,-491.03289999999976,-249.2,2
11:54,779236304.0,2140.6075954795333,-63.8,2
11:56,596171893.0,212.70559482551084,-105.49,2
11:56,165691047.0,155.68159999999892,-80.49,2
12:03,497809732.0,441.8798695525951,-37.29,9
12:06,223207876.0,-783.6328999999997,-292.6,2
12:09,679943657.0,3336.6758891801373,-5.4,9
12:10,179173981.0,5274.9718201169435,-10.38,5
12:10,448004226.0,1670.5586735099762,-25.0,2
12:10,596171893.0,30.21559482551083,-182.49,2
12:11,454356905.0,2093.500891990409,-34.57,9
12:20,903468956.0,797.5153999999993,-231.97,2
12:28,259015404.0,1483.9490901789927,-34.58,9
12:28,598793068.0,630.661349999998,-15.98,7
12:29,223207876.0,-1038.4328999999998,-254.8,2
12:30,366550080.0,27525.472388979037,-104.99,2
12:31,211493028.0,1104.5614499999992,-40.04,9
12:37,950234174.0,2361.9486335320275,-16.6,7
12:40,672994751.0,233.93629078601,-5.99,7
12:45,493640090.0,-2768.2159499999984,-40.54,5
12:52,300095518.0,-294.77497165858233,-34.47,5
12:52,687135796.0,29503.824598401265,-15.0,9
12:54,366550080.0,27452.672388979037,-72.8,2
12:57,672994751.0,223.94629078600997,-9.99,2
13:00,753525749.0,-2416.683399999999,-39.53,5
13:01,425730826.0,2527.54190938872,-50.4,5
13:02,993039226.0,-4403.261999999994,-45.93,5
13:04,280098744.0,-1247.6156221283345,-113.42,5
13:04,259015404.0,1477.8990901789928,-6.05,9
13:05,348325817.0,11118.70210686668,-5.9,9
13:10,596171893.0,-22.754405174489165,-52.97,2
13:13,407574996.0,-391.82639061906315,-5.7,9
13:13,340321732.0,1844.725550000004,-7.9,9
13:14,824218857.0,-3788.331160845428,-81.33,5
13:16,263882093.0,-1263.3538000000003,-66.21,5
13:18,277562576.0,514.8877839436273,-4.95,9
13:19,322221939.0,3885.792821224112,-5.7,9
13:21,585625048.0,2263.2259749993573,-5.7,9
13:22,854895960.0,3966.8577072291982,-73.85,5
13:24,290751280.0,249.28354667482552,-5.7,9
13:25,366550080.0,27203.51438897904,-249.16,2
13:31,699313649.0,-2335.4908991419047,-44.72,5
13:32,904154012.0,525.0674581204316,-6.99,7
13:44,815993333.0,6546.786968814239,-25.1,2
14:00,979135922.0,1310.2633005904509,-30.02,2
14:02,366550080.0,27085.91438897904,-117.6,2
14:03,105375973.0,-110.10034718105943,-80.22,2
14:05,985188462.0,-571.6432112887753,-29.73,9
14:25,655730067.0,-267.1731500000005,-73.04,5
14:28,706361191.0,300.3463984940779,-144.46,5
14:39,130522384.0,-557.5838156208604,-89.5,2
14:44,941285623.0,1354.4143990667706,-142.93,5
14:48,414454079.0,503.71785000000153,-12.16,4
14:50,668175891.0,769.6872231584989,-14.99,4
14:52,596171893.0,-189.74440517448917,-166.99,2
15:06,130522384.0,-644.0638156208604,-86.48,2
15:11,596171893.0,-310.7444051744892,-121.0,2
15:14,441142605.0,2380.2168422757286,-149.25,2
15:16,678330503.0,3572.6110632496957,-41.28,8
15:20,421881811.0,2979.523502134264,-249.86,2
15:24,807098817.0,514.632949999999,-31.96,4
15:24,901037631.0,1750.8493230964066,-32.23,9
15:28,191992682.0,-2911.346460292063,-72.51,5
15:30,570323670.0,3489.743844298476,-0.74,2
15:33,939972497.0,1766.2095586000107,-21.97,4
15:40,421881811.0,2927.737502134264,-51.79,2
15:40,388862238.0,1637.0265284731938,-59.97,4
15:40,145553416.0,-2725.8531499999985,-46.96,5
15:41,596171893.0,-342.2344051744892,-31.49,2
15:45,321372947.0,-301.9588507890995,-15.0,5
15:52,867987292.0,2733.5734814327484,-111.3,2
15:53,223207876.0,-1128.0328999999997,-89.6,2
15:59,744968736.0,-1550.056826569424,-19.23,5
16:03,596171893.0,-521.2144051744892,-178.98,2
16:06,532478725.0,5184.654992776604,-32.1,9
16:07,399144202.0,2082.317334007475,-25.7,9
16:12,158414827.0,-1481.6850000000018,-9.54,5
16:24,867987292.0,2583.0734814327484,-150.5,2
16:24,738958551.0,9942.058431773756,-9.74,5
16:26,310375875.0,2133.5700649070113,-20.19,9
16:28,223207876.0,-1308.6328999999996,-180.6,2
16:34,345582855.0,542.2422528205493,-45.7,5
16:38,399144202.0,2012.7146669770036,-69.6,2
16:42,779620857.0,-739.549646385176,-84.47,5
16:43,868033067.0,-2513.513286451081,-51.1,5
16:49,709608057.0,2958.8669502705925,-53.5,2
16:50,709151315.0,-135.15978162584014,-170.58,5
16:51,628470485.0,840.3950299001232,-81.87,7
16:52,792845450.0,1113.455150000001,-6.99,1
16:53,303843160.0,-2.4065999999985195,-203.0,7
16:56,198946608.0,4721.090404853641,-20.05,2
16:58,180616589.0,1129.3131699949167,-45.97,4
17:00,108481285.0,9565.199467445678,-45.44,2
17:00,448279144.0,1128.3521999999991,-6.99,4
17:01,280200287.0,-1951.970453386949,-82.86,5
17:03,628470485.0,717.2090299001231,-123.19,7
17:04,399144202.0,1988.8446669770035,-23.87,1
17:07,705848712.0,28302.227547724076,-15.2,9
17:09,303843160.0,-218.0065999999985,-215.6,4
17:10,256002321.0,7108.1324946097175,-19.44,9
17:11,867987292.0,2380.773481432748,-202.3,2
17:11,957821152.0,-1625.7379535715495,-47.12,5
17:11,683319988.0,7862.933455341348,-35.38,9
17:12,867987292.0,2363.9037820475573,-16.87,2
17:12,905860285.0,11814.274408302292,-9.87,2
17:15,844835978.0,10652.48288332993,-13.15,7
17:15,454129843.0,453.3528451665601,-18.97,7
17:18,851649498.0,8799.236767314795,-30.1,7
17:18,331450202.0,8383.881640699627,-30.68,7
17:19,409971170.0,3238.64684044861,-13.45,2
17:19,128033695.0,2303.9288633946217,-20.19,4
17:19,684988568.0,-313.43077342720153,-73.97,5
17:19,399538448.0,8182.954049395938,-35.0,2
17:21,108481285.0,9306.199467445678,-259.0,2
17:23,221868392.0,5315.925738145765,-9.23,5
17:23,486495235.0,2419.8586642021824,-99.99,2
17:23,836110591.0,6867.982425592746,-20.3,7
17:24,656812046.0,1125.3357537325192,-135.39,2
17:26,441274121.0,12841.528840993253,-152.36,2
17:27,897714622.0,9697.296279639875,-8.71,5
17:27,583579399.0,2217.1640500000008,-61.98,5
17:28,901432314.0,3939.193808234492,-46.56,5
17:29,822718326.0,11826.07598266141,-29.96,1
17:29,280268430.0,5880.691705820754,-76.98,2
17:29,355602925.0,1644.1555265753277,-26.97,7
17:31,373163757.0,11793.519273794212,-10.0,7
17:31,893134725.0,1203.9347376616677,-6.99,1
17:32,846550094.0,1812.798165171468,-62.97,4
17:33,223207876.0,-1662.1328999999996,-353.5,2
17:33,698955014.0,361.8683802031967,-90.31,5
17:34,489964679.0,21232.83349745578,-10.45,5
17:34,180616589.0,1113.4331699949166,-15.88,9
17:35,199016328.0,4698.009653802992,-19.97,7
17:35,647472692.0,26928.93774757727,-22.71,4
17:36,516051449.0,1653.6927746508286,-120.67,5
17:37,399538448.0,7888.954049395938,-294.0,2
17:38,532478725.0,5151.624992776604,-33.03,1
17:39,151968462.0,7895.164207459794,-48.43,5
17:39,857754342.0,1404.099876279814,-29.99,2
17:40,627723633.0,-2279.843828003762,-14.99,5
17:41,660789920.0,-2520.1183473823726,-21.65,5
17:41,834581602.0,419.00254999999913,-59.98,4
17:42,886921642.0,3652.445587835999,-14.94,9
17:43,287230540.0,1515.122293293266,-47.88,5
17:43,417850087.0,18084.819219907706,-67.51,4
17:44,531186970.0,5195.173883735821,-66.5,2
17:45,224112146.0,2061.5888,-19.99,2
17:46,280990953.0,1210.3196999999984,-74.97,4
17:46,736340277.0,9333.509282002951,-138.6,2
17:48,108563213.0,25730.763964965583,-90.62,2
17:49,108563213.0,25700.06212362615,-30.7,4
17:49,494789005.0,3503.9625190112088,-1.64,2
17:49,433917275.0,8162.820726575002,-20.76,4
17:49,785749304.0,8929.785139602978,-256.87,2
17:50,769311479.0,6619.918177361226,-13.15,1
17:51,196289502.0,16550.884545508376,-42.87,2
17:53,642015139.0,2.6663374656382715,-57.98,2
17:53,642924505.0,456.4807201835261,-16.5,4
17:54,596171893.0,-568.1844051744893,-46.97,2
17:55,280268430.0,5860.701705820754,-19.99,4
17:57,131388684.0,22269.453825696262,-33.81,1
17:58,868377987.0,3071.063159635549,-103.98,2
17:59,987163717.0,4331.936440000003,-54.41,4
17:59,223207876.0,-1881.2328999999995,-219.1,2
18:00,120634201.0,5498.135329403302,-21.06,7
18:01,867987292.0,2170.0037820475573,-193.9,2
18:03,175452235.0,-1493.4087499999996,-41.14,9
18:03,121858569.0,1843.2011500000024,-36.39,9
18:04,886837068.0,936.4255999999992,-93.35,2
18:05,531186970.0,5115.387883735821,-79.79,2
18:05,690523499.0,397.32555000000025,-2.99,7
18:07,399538448.0,7620.154049395937,-268.8,2
18:08,736340277.0,9087.83728200295,-245.67,2
18:09,380911501.0,-84.15755000000084,-22.02,9
18:10,940569402.0,5292.633609327987,-13.39,9
18:11,213112754.0,7106.972856965676,-7.24,9
18:11,610450243.0,-656.8345999999998,-30.41,5
18:11,785749304.0,8916.835139602978,-12.95,9
18:13,441274121.0,12829.578840993252,-11.95,9
18:16,494404688.0,-2731.3432653362074,-26.45,5
18:19,930271460.0,292.24409753577635,-42.05,5
18:21,223207876.0,-2044.3328999999992,-163.1,2
18:24,486495235.0,2343.8786642021823,-75.98,2
18:25,690523499.0,335.34090000000026,-61.98,5
18:25,433917275.0,8134.654614081965,-28.17,2
18:26,891716230.0,417.94913561892565,-26.98,7
18:27,596171893.0,-621.1644051744893,-52.98,2
18:29,771125520.0,1027.3140999999991,-67.39,5
18:31,398429109.0,1367.482500000001,-37.49,5
18:32,832564361.0,16013.07971197442,-35.66,7
18:35,867987292.0,2026.5037820475573,-143.5,2
18:37,383833857.0,26720.83953440174,-22.93,9
18:38,741269136.0,2696.185950000002,-81.72,5
18:40,287480331.0,8810.909453744462,-31.19,9
18:42,305778936.0,10924.31229639789,-24.2,9
18:43,370521542.0,28242.37965566658,-92.83,5
18:43,956717493.0,1353.3939722249324,-72.63,5
18:44,370521542.0,28230.42965566658,-11.95,9
18:45,220183538.0,879.3139999999994,-10.99,7
18:49,653640811.0,18112.521766865284,-19.28,5
18:51,293609137.0,35.93049257449812,-40.09,5
18:52,486495235.0,2259.8786642021823,-84.0,2
18:53,536924114.0,-798.1754055930962,-90.51,5
18:53,414454079.0,459.4978500000016,-44.22,9
18:55,489964679.0,21202.35349745578,-30.48,9
18:58,994214354.0,10496.828154249795,-16.13,5
18:58,901432314.0,3903.369008234493,-35.82,7
18:59,691843653.0,-3222.6883999999927,-26.14,5
19:01,559995067.0,2404.4703137949846,-40.51,5
19:02,651756497.0,14978.223911651414,-12.33,4
19:06,180719578.0,-4501.697749999995,-16.2,5
19:06,546760202.0,-1938.305527675968,-8.98,5
19:11,482513594.0,6392.172891614795,-10.9,9
19:12,270374623.0,10138.966150226695,-8.95,9
19:12,581655972.0,43253.97474389967,-68.5,5
19:13,256002321.0,7056.460511867248,-51.67,5
19:13,331684336.0,-1535.9788699513217,-30.8,5
19:15,188263947.0,42.944000000000614,-64.58,5
19:15,683319988.0,7817.369667829442,-45.56,7
19:16,224112146.0,1974.8861,-86.7,5
19:16,860360312.0,77.18550888268041,-134.08,5
19:17,969697937.0,-4973.01776567055,-35.6,5
19:18,670102069.0,1941.8125210874016,-22.4,2
19:19,859603181.0,3724.759407657151,-7.58,7
19:20,486495235.0,2234.8786642021823,-25.0,2
19:21,815385232.0,11065.13450668435,-18.85,7
19:22,478986718.0,-1014.5566000000013,-52.34,5
19:24,146909202.0,3936.55591890767,-20.29,7
19:30,113747882.0,12900.108555017638,-56.03,2
19:32,886921642.0,3606.4555878359993,-45.99,5
19:33,344219145.0,8501.082653372654,-65.45,5
19:33,553734946.0,219.4562999999983,-20.93,9
19:35,471897866.0,8234.957156162753,-63.95,5
19:35,534325901.0,7304.84131236973,-6.99,9
19:35,534097839.0,-4365.121049999997,-12.96,5
19:38,690941877.0,-121.6650384825081,-39.84,9
19:38,527842638.0,529.7114426329834,-126.32,5
19:39,587225252.0,6263.839892749228,-8.43,4
19:43,261894284.0,-2611.2012999999965,-27.06,5
19:46,699997811.0,940.6790500000038,-13.95,5
19:47,486495235.0,2225.8886642021826,-8.99,2
19:57,358846516.0,808.5332725272174,-140.89,5
19:59,795847804.0,24620.19454069007,-32.76,5
20:00,624563756.0,-271.2615712164436,-9.28,5
20:05,486495235.0,2042.8886642021823,-183.0,2
20:07,951817450.0,9577.21243528758,-26.31,5
20:07,626989363.0,1065.5410633173751,-25.44,9
20:09,576188756.0,-4202.638999999998,-17.61,5
20:09,245690309.0,10160.208421485406,-11.89,5
20:11,834581602.0,336.68884999999915,-82.31,5
20:14,824916823.0,8999.536867090786,-49.82,5
20:15,874431242.0,9921.612649329509,-26.83,9
20:25,801500539.0,-3554.9486999999986,-67.97,5
20:25,720221651.0,-2537.908866598434,-35.82,5
20:28,992204045.0,7659.94075715372,-1.67,7
20:34,730002588.0,14254.315167052626,-95.93,5
20:44,286484726.0,788.5540320337758,-82.15,5
20:45,500051919.0,996.7420966505902,-28.89,5
20:49,220183538.0,832.4514499999993,-46.86,5
20:50,386729293.0,31770.131490088123,-14.01,4
20:50,414805878.0,13605.141317755924,-103.82,5
20:51,680773155.0,393.36868333109146,-47.69,5
21:00,229205098.0,8129.412613949609,-18.05,7
22:55,322221939.0,3857.902821224112,-27.89,9
01:15,575652395.0,2634.046472565683,-6.86,2
01:17,987656636.0,4505.325844286078,-57.79,5
01:19,421881811.0,2912.805998187099,-14.93,7
01:26,779946617.0,17446.658463425083,-6.81,4
01:30,370521542.0,28219.179974928804,-11.25,5
01:37,687135796.0,29449.23296559198,-54.59,2
02:12,809499628.0,18312.18435287218,-22.49,9
02:22,940569402.0,5272.433609327987,-20.2,9
02:31,558119802.0,34601.736227128255,-19.45,9
02:36,383833857.0,26718.107086273903,-2.73,2
02:42,647472692.0,26925.28040233015,-3.66,8
02:45,282837512.0,14716.20978281674,-23.63,9
02:46,399144202.0,1949.004666977004,-39.84,9
02:46,633345190.0,6389.244691213473,-36.8,9
02:46,259015404.0,1451.1990901789927,-26.7,9
02:53,461990622.0,10094.726942628598,-61.84,2
02:53,705848712.0,28279.327547724075,-22.9,9
02:53,124102251.0,3632.4898890479326,-4.6,5
02:56,795847804.0,24595.35983399702,-24.83,7
02:57,170637730.0,1981.8556409466387,-1.22,7
02:59,639549973.0,7632.321517560509,-3.78,2
03:02,558119802.0,34595.39718654195,-6.34,7
03:03,120634201.0,5480.235329403303,-17.9,9
03:12,256002321.0,7037.570511867248,-18.89,9
03:15,887853850.0,10949.596976718569,-40.13,9
03:25,670102069.0,1899.6225210874015,-42.19,9
03:27,108481285.0,9305.298059053668,-0.9,5
03:31,383625050.0,3135.4596937264855,-24.64,2
03:46,549414742.0,7985.2184702315135,-19.48,9
03:47,308505160.0,14095.506727770671,-7.63,4
03:48,675231808.0,18495.822187330243,-26.0,9
03:50,290818242.0,7458.405215599439,-18.18,2
03:50,940569402.0,5261.208642909845,-11.22,2
03:50,858989281.0,27692.0838836267,-12.24,9
03:50,987163717.0,4294.736440000003,-37.2,9
03:50,970298834.0,2891.4552719342064,-2.07,7
03:52,985188462.0,-609.9832112887754,-38.34,9
03:53,473820682.0,12305.175944210432,-25.96,5
04:03,822250278.0,6912.3238312046615,-15.22,2
04:05,766941757.0,2903.365815560732,-26.83,9
04:06,229205098.0,8127.373132632989,-2.04,5
04:10,324224854.0,4583.786800138159,-51.46,5
04:20,108931112.0,14919.48412654393,-36.65,9
04:27,373163757.0,11759.921343226912,-33.6,2
04:29,113747882.0,12866.918555017635,-33.19,9
04:37,679911053.0,3162.8740179672545,-16.22,2
04:38,867987292.0,2019.2738115873467,-7.23,5
04:38,912705941.0,19420.7716852716,-22.77,8
04:40,698076160.0,6866.0283570379615,-19.8,2
04:43,802697323.0,17052.666369414175,-37.34,9
04:45,853907490.0,8034.160038092522,-8.75,9
04:50,709608057.0,2923.9369502705927,-34.93,9
04:52,657139925.0,14881.70134243058,-23.19,9
04:56,366550080.0,27071.554478097,-14.36,2
04:57,146909202.0,3931.89195311733,-4.66,8
04:58,973086490.0,10649.728857388747,-7.24,9
05:03,554792076.0,29775.70754521453,-41.06,2
05:03,196289502.0,16535.954545508375,-14.93,9
05:06,822135975.0,12091.992288235895,-39.78,2
05:06,179173981.0,5261.094111096829,-13.88,7
05:09,699139822.0,2213.8382624560586,-12.35,5
05:09,441274121.0,12761.248113262063,-68.33,7
05:10,151968462.0,7878.741457611971,-16.42,5
05:12,815993333.0,6536.331186360496,-10.46,7
05:13,541639148.0,4470.095642974833,-20.36,7
05:14,675806859.0,7797.66489877414,-65.29,2
05:15,556992209.0,12611.8855028539,-4.42,5
05:17,836110591.0,6820.822425592746,-47.16,9
05:19,678851253.0,4190.143356729026,-3.89,5
05:22,113747882.0,12815.932523859396,-50.99,7
05:24,143003091.0,10826.722787340144,-55.69,2
05:27,752362502.0,7978.102273757463,-7.69,7
05:27,930277104.0,10857.063695132983,-39.05,9
05:32,853907490.0,8027.94720698776,-6.21,8
05:35,399144202.0,1932.2194437303897,-16.79,7
05:38,494789005.0,3487.6469456986115,-16.32,7
05:38,858989281.0,27643.309542966195,-48.77,2
05:40,994214354.0,10471.188154249798,-25.64,9
05:42,873693307.0,10917.132509474206,-8.22,7
05:43,216285378.0,25124.727384634905,-30.59,9
05:45,450896297.0,14044.05187052717,-32.7,9
05:47,287480331.0,8756.651099700672,-54.26,2
05:50,200080192.0,9947.480121943565,-48.44,5
05:53,572384506.0,7761.873047528045,-39.79,9
05:56,532478725.0,5114.344992776604,-37.28,9
05:57,550169791.0,22723.68359004042,-29.28,7
05:59,984783496.0,14901.304041588668,-18.33,9
06:03,679662108.0,17065.543195809518,-10.09,2
06:03,704517789.0,18620.502751000895,-15.12,2
06:04,960208650.0,18286.869800465865,-31.8,8
06:05,930277104.0,10782.95656064386,-74.11,7
06:06,203466392.0,3811.6815334146017,-18.03,2
06:06,285873880.0,13028.318695255924,-1.55,7
06:13,520447032.0,8672.842933865735,-37.09,9
06:13,865748375.0,2620.1480861727855,-36.82,2
06:15,986267641.0,8804.15536382516,-32.57,5
06:17,719586818.0,19327.666493424,-0.21,2
06:17,769311479.0,6596.63656624869,-23.28,2
06:22,705848712.0,28270.475508024127,-8.85,5
06:26,506618547.0,15270.636282273164,-11.7,2
06:28,949032480.0,4274.600812757475,-31.87,9
06:29,519644021.0,3319.422489297485,-69.83,7
06:32,806358207.0,11736.534027567444,-4.92,8
06:35,348325817.0,11076.96210686668,-41.74,9
06:37,673025413.0,1307.689587154764,-3.84,8
06:39,532478725.0,5106.284312651454,-8.06,4
06:39,776431321.0,3427.8313590185335,-24.96,7
06:41,842682241.0,6071.982020357036,-51.39,8
06:42,496395938.0,12840.045940278258,-62.07,7
06:44,601627384.0,4215.438917147946,-35.93,9
06:44,187541224.0,2520.67745664854,-40.08,9
06:44,213112754.0,7093.359187737695,-13.61,8
06:46,510101371.0,13985.495221803729,-44.09,9
06:50,518474507.0,14703.020772217864,-39.73,9
06:52,549414742.0,7956.304046000154,-28.91,7
06:53,706250160.0,13143.62598731797,-5.74,7
06:53,169006407.0,12460.708652730207,-44.51,2
06:54,683319988.0,7770.398049687488,-46.97,7
06:56,785749304.0,8905.664576133942,-11.17,5
06:58,994214354.0,10436.654112333468,-34.53,7
07:01,417850087.0,18079.55011673987,-5.27,7
07:05,235881534.0,14091.883593865228,-19.43,2
07:06,264550521.0,5578.936180843524,-27.2,5
07:07,651756497.0,14957.603524456505,-20.62,7
07:09,547010927.0,24698.07703081885,-82.5,7
07:11,749378808.0,4436.952581676343,-32.14,9
07:14,587225252.0,6230.099892749228,-33.74,9
07:15,905860285.0,11778.079215377657,-36.2,4
07:15,950234174.0,2335.918153023337,-26.03,7
07:17,322221939.0,3834.561160615084,-23.34,5
07:18,609939116.0,8033.371461559123,-19.39,5
07:19,183888402.0,19666.307609767173,-29.33,9
07:19,851181128.0,5188.434981361692,-30.39,8
07:20,885259672.0,3558.2231858145333,-22.2,2
07:22,315546581.0,30001.24062489859,-1.4,8
07:25,973086490.0,10630.290902173783,-19.44,5
07:29,195895574.0,7739.141992969253,-4.97,8
07:33,668329719.0,9235.498363417026,-29.28,5
07:35,255814263.0,4093.0945976099233,-50.36,2
07:37,282837512.0,14699.59701735269,-16.61,2
07:37,639409800.0,37640.57105969496,-9.11,5
07:38,874431242.0,9908.232649329508,-13.38,9
07:42,758160963.0,8932.150448536942,-51.82,7
07:42,718058208.0,2439.80638962859,-24.19,5
07:43,482513594.0,6383.329525172654,-8.84,5
07:43,949032480.0,4267.486392123141,-7.11,7
07:43,586315521.0,13117.054491350656,-12.82,2
07:45,187111705.0,7393.306215485581,-55.27,2
07:49,237493332.0,15301.05888810061,-4.51,7
07:54,435984758.0,4572.153723072239,-6.96,8
07:56,581655972.0,43247.60297476078,-6.37,7
08:02,358846516.0,803.5332725272174,-5.0,9
08:03,399538448.0,7614.754049395938,-5.4,9
08:06,500043411.0,14277.584872618556,-35.28,2
08:10,623156843.0,5006.1584302173505,-55.72,7
08:11,454129843.0,448.00284516656006,-5.35,9
08:11,467207141.0,778.0008670482637,-7.5,9
08:11,885259672.0,3550.7231858145333,-7.5,9
08:11,395284483.0,1186.5643402113085,-7.3,9
08:12,336557504.0,1243.3964872010197,-5.4,9
08:13,355733816.0,5714.73286752513,-0.62,2
08:13,832564361.0,16002.268535167776,-10.81,8
08:14,613729471.0,8399.595780232941,-16.19,5
08:26,519935524.0,757.5653297375188,-6.2,9
08:27,511179916.0,7765.426283417511,-16.3,5
08:31,298000165.0,27173.712785694956,-49.95,5
08:31,782013626.0,3110.5771993116286,-39.65,5
08:36,897714622.0,9695.116655856878,-2.18,2
08:38,730002588.0,14241.706857277984,-12.61,2
08:39,143606916.0,211.84945402918964,-184.34,5
08:42,215832575.0,-1399.90696374422,-25.33,5
08:42,285115279.0,-3421.171710789287,-53.01,5
08:47,706250160.0,13055.29998731797,-88.33,5
08:51,948069469.0,-734.5030000000011,-37.64,5
08:53,194023154.0,-2640.3696717847333,-47.44,5
08:54,364357875.0,8751.988694450309,-8.18,5
08:55,237684254.0,6346.88314646136,-12.61,2
08:56,441274121.0,12754.898113262065,-6.35,9
08:58,143061865.0,7666.9469393149375,-93.17,5
09:00,886837068.0,930.9255999999992,-5.5,9
09:02,383833857.0,26712.457086273906,-5.65,9
09:03,581655972.0,43242.252974760784,-5.35,9
09:04,506618547.0,15265.036282273164,-5.6,9
09:05,657139925.0,14815.471652956234,-66.23,5
09:05,169006407.0,12452.90865273021,-7.8,9
09:06,480557476.0,11799.961295153573,-5.01,5
09:07,473820682.0,12196.297944210432,-108.88,5
09:09,425964226.0,4233.640053979412,-7.15,9
09:09,406862520.0,297.2043265374104,-225.83,5
09:10,851649498.0,8793.086767314795,-6.15,9
09:14,245198540.0,299.5913988017795,-27.43,5
09:15,314980178.0,4129.538850000006,-115.37,5
09:15,613729471.0,8392.095780232941,-7.5,9
09:16,857997794.0,945.6576651508868,-147.98,2
09:17,624563756.0,-276.9615712164436,-5.7,9
09:17,540159353.0,11890.14097560692,-5.7,9
09:19,663479159.0,4966.653541827712,-25.97,7
09:19,618138606.0,1454.185902870066,-5.0,9
09:19,117273481.0,9212.270038341048,-5.35,9
09:19,262767079.0,-1285.6922000000004,-160.6,5
09:19,690958123.0,22077.126886106296,-5.65,9
09:20,214339619.0,608.624550868356,-7.9,9
09:20,586315521.0,13108.754491350655,-8.3,9
09:22,535744551.0,776.3821659956259,-16.5,4
09:23,760704118.0,1520.432312717489,-77.0,2
09:24,147341222.0,-1896.3679253207956,-136.12,5
09:25,138609932.0,2617.2350032945856,-5.4,9
09:25,910730524.0,8173.141218153913,-3.57,2
09:25,409370545.0,876.1692755455207,-15.08,7
09:26,261793952.0,302.14326020381486,-27.99,7
09:26,370521542.0,28196.609974928804,-22.57,2
09:28,145387690.0,5739.571950934256,-15.59,4
09:29,541639148.0,4447.465642974833,-22.63,7
09:29,749378808.0,4403.893687846972,-33.06,2
09:30,348325817.0,11043.43210686668,-33.53,2
09:30,366550080.0,26858.082478097,-213.47,2
09:32,834383043.0,5497.43968524823,-65.97,4
09:32,779946617.0,17407.84846342508,-38.81,4
09:33,549414742.0,7923.250046000154,-33.05,4
09:34,479456865.0,1841.3294995833055,-181.0,2
09:37,535744551.0,742.4221659956258,-33.96,7
09:37,259015404.0,1440.7790901789926,-10.42,7
09:40,996042490.0,6679.739272669815,-37.48,4
09:40,366550080.0,26781.782478097,-76.3,2
09:44,943329213.0,916.8346193497576,-87.5,2
09:47,598793068.0,625.671349999998,-4.99,4
09:47,116169597.0,1107.5679499999997,-5.99,4
09:47,760704118.0,1481.9463127174888,-38.49,2
09:54,308505160.0,13978.43172777067,-117.07,5
09:54,919185264.0,4186.622230989973,-3.27,5
09:55,225210798.0,1100.7377737592085,-9.99,4
09:56,534583529.0,1129.5888880547652,-100.88,7
10:01,494789005.0,3467.4969456986114,-20.15,2
10:01,760704118.0,1440.6463127174889,-41.3,2
10:05,843537309.0,-745.4557677916318,-41.48,5
10:09,461029994.0,8239.434416100952,-56.98,4
10:12,462962606.0,1393.2100499999988,-63.12,2
10:12,700138124.0,5450.340805094769,-195.3,2
10:13,494789005.0,3374.7769456986116,-92.72,2
10:13,760704118.0,1276.160312717489,-164.49,2
10:15,316793091.0,733.2724600549509,-28.96,1
10:18,779376323.0,3539.65838398134,-31.84,4
10:20,757115616.0,765.3900000000037,-15.98,1
10:20,570410059.0,2346.5826467763113,-19.98,2
10:21,454356905.0,2055.932731990409,-37.57,4
10:21,660561861.0,405.5728316336894,-31.48,4
10:23,143003091.0,10698.732787340145,-127.99,2
10:24,534583529.0,1039.5888880547652,-90.0,4
10:25,282837512.0,14693.79701735269,-5.8,9
10:27,504055745.0,-63.06463865823315,-21.98,4
10:27,366550080.0,26601.210478097,-180.57,2
10:28,760704118.0,1241.160312717489,-35.0,2
10:30,909676212.0,913.7205317876133,-17.97,7
10:30,621652856.0,870.5459696105399,-171.5,2
10:35,480557476.0,11746.425295153573,-53.54,5
10:36,809499628.0,18288.230820511955,-23.95,7
10:37,572136270.0,77.61911158802329,-129.5,2
10:38,403383649.0,975.6643796543062,-7.0,1
10:41,895750759.0,-306.4701380756658,-22.97,7
10:42,462962606.0,1383.2000499999988,-10.01,1
10:44,996042490.0,6671.0037699097775,-8.74,2
10:46,700138124.0,5359.340805094769,-91.0,2
10:48,909676212.0,869.8025317876131,-43.92,5
10:52,405416860.0,2518.126506880905,-5.99,2
10:53,760704118.0,1192.160312717489,-49.0,2
10:54,687135796.0,29423.07296559198,-26.16,7
10:55,856147482.0,-722.8704485986248,-240.4,5
11:08,572136270.0,3.619111588023287,-74.0,2
11:11,621652856.0,717.9459696105399,-152.6,2
11:14,760704118.0,1035.388312717489,-156.77,2
11:17,310740977.0,296.68043592968087,-15.86,2
11:21,700138124.0,5313.840805094769,-45.5,2
11:23,534204159.0,6090.007962881534,-40.99,7
11:27,668175891.0,735.0141231584989,-34.67,5
11:27,298007503.0,1901.759103625634,-112.64,5
11:28,155867488.0,-93.61530000000155,-64.39,5
11:35,621652856.0,467.3459696105399,-250.6,2
11:36,366550080.0,26543.838478097,-57.37,2
11:39,237684254.0,6191.693146461361,-155.19,5
11:40,593378953.0,1644.319650000005,-51.98,2
11:41,903953091.0,3844.3628830548,-71.3,5
11:43,776431321.0,3396.8713590185334,-30.96,1
11:53,700138124.0,5189.9408050947695,-123.9,2
12:00,422955974.0,29.47313499904976,-141.99,7
12:02,504055745.0,-173.05463865823316,-109.99,6
12:04,480557476.0,11731.085295153573,-15.34,7
12:05,441142605.0,2375.226842275729,-4.99,4
12:08,456246119.0,21734.34291063602,-15.59,8
12:10,828750680.0,1313.64269521368,-61.48,4
12:13,621652856.0,289.54596961053994,-177.8,2
12:17,679662108.0,17030.843195809517,-34.7,2
12:18,642015139.0,-31.28366253436173,-33.95,1
12:19,943329213.0,790.8346193497576,-126.0,2
12:23,588565416.0,6935.659450353423,-0.58,7
12:28,572136270.0,-96.13088841197673,-99.75,5
12:32,422955974.0,-109.02686500095024,-138.5,4
12:34,807098817.0,372.132949999999,-142.5,2
12:35,760704118.0,855.5023127174891,-179.89,2
12:37,867679563.0,29.003953701715822,-54.32,5
12:45,108812033.0,640.6919999999983,-122.27,5
12:45,737537711.0,-517.0019663984643,-31.63,5
12:45,660561861.0,369.5728316336894,-36.0,4
12:47,902798190.0,-587.0886344310265,-105.61,5
12:51,419084831.0,-372.7348255261032,-132.97,5
12:52,760704118.0,784.1163127174891,-71.39,2
12:55,179173981.0,5219.434251096829,-41.66,4
12:59,696758548.0,-3528.807896320137,-20.62,5
13:02,248625662.0,-432.7519157151475,-70.34,5
13:03,422955974.0,-249.98686500095025,-140.96,4
13:04,538003940.0,2518.9800000000096,-29.98,6
13:04,366550080.0,26371.652478097,-172.19,2
13:04,621652856.0,-59.054030389460024,-348.6,2
13:05,807098817.0,264.632949999999,-107.5,2
13:06,322221939.0,3828.511160615083,-6.05,9
13:06,687135796.0,29413.122965591974,-9.95,9
13:07,277562576.0,508.0877839436272,-6.8,9
13:07,706301742.0,-3169.0431499999963,-16.47,5
13:08,760704118.0,551.7163127174891,-232.4,2
13:08,722358036.0,509.46499062708295,-5.7,9
13:09,187111705.0,7385.806215485581,-7.5,9
13:09,310620484.0,140.48119509219828,-41.83,9
13:09,407574996.0,-397.52639061906314,-5.7,9
13:11,585625048.0,2256.7759749993575,-6.45,9
13:16,793781222.0,1867.3988789474056,-31.49,4
13:16,673025413.0,1239.271587154764,-68.42,5
13:17,688712152.0,7066.940495187548,-6.1,9
13:19,548907062.0,708.5887887682885,-17.97,4
13:21,910730524.0,8168.441218153913,-4.7,9
13:23,760704118.0,480.3303127174891,-71.39,2
13:25,979135922.0,1220.1313005904508,-90.13,5
13:26,945054126.0,288.53809999999993,-67.42,5
13:32,609939116.0,7795.021461559122,-238.35,5
13:37,366550080.0,26125.266478097,-246.39,2
13:38,572136270.0,-221.1308884119767,-125.0,2
13:42,421881811.0,2888.4059981870987,-24.4,4
13:43,175452235.0,-1589.7567499999996,-96.35,5
13:46,572136270.0,-467.6308884119767,-246.5,2
13:51,605711527.0,-141.61848616741634,-105.71,5
13:57,421881811.0,2840.6359981870987,-47.77,7
13:58,421881811.0,2816.995998187099,-23.64,9
14:13,572136270.0,-571.6308884119767,-104.0,2
14:22,943329213.0,598.3346193497576,-192.5,2
14:57,943329213.0,445.7346193497576,-152.6,2
15:04,508518911.0,17.584750279010322,-99.99,2
15:07,462962606.0,1276.8140499999988,-106.39,2
15:12,163470640.0,1137.2853999999995,-31.99,2
15:19,258201793.0,-570.2348000000002,-72.0,2
15:36,796709231.0,-112.3180221037025,-89.5,2
15:42,786879739.0,-2410.9582941205563,-25.58,5
15:44,192202372.0,-146.0902650194005,-134.99,2
15:45,538003940.0,2507.0000000000095,-11.98,7
15:49,373875019.0,17631.273691396134,-36.06,7
15:51,321372947.0,-347.6576507890995,-45.7,5
15:55,901037631.0,1672.6293230964066,-78.22,2
15:57,287480331.0,8719.261099700672,-37.39,9
15:59,943329213.0,216.13461934975763,-229.6,2
16:06,632065391.0,-296.1461499999995,-46.6,5
16:07,796709231.0,-147.3080221037025,-34.99,2
16:08,903953091.0,3777.3928830548,-66.97,4
16:09,970298834.0,2869.882211934206,-21.57,4
16:18,272538745.0,17017.17990000002,-33.5,9
16:20,899742927.0,13622.82952504988,-1.93,7
16:26,596328017.0,-2574.3178499999976,-110.3,5
16:28,625658193.0,-311.93864024378314,-155.9,5
16:29,587225252.0,6211.75948537289,-18.34,2
16:30,919185264.0,4162.652230989973,-23.97,7
16:30,492215823.0,3554.289453815445,-73.38,4
16:31,527842638.0,372.72144263298344,-156.99,2
16:34,551755686.0,7091.492485725706,-58.9,5
16:34,572136270.0,-708.6308884119767,-137.0,2
16:43,901432314.0,3865.69578290294,-37.67,5
16:44,310375875.0,2124.626744495432,-8.94,5
16:48,886921642.0,3559.4770328471427,-46.98,5
16:48,475117511.0,7573.193679437446,-20.98,4
16:54,297823329.0,796.3642999999992,-46.98,2
16:55,467207141.0,549.5008670482637,-228.5,2
16:58,128033695.0,2287.958863394622,-15.97,9
16:58,409971170.0,3209.721563998921,-28.93,5
17:00,252760664.0,7303.017348198836,-15.2,5
17:03,414454079.0,453.39785000000154,-6.1,4
17:03,572136270.0,-813.1308884119767,-104.5,2
17:04,462962606.0,1112.3560499999987,-164.46,2
17:13,610645022.0,-455.9368626449184,-36.54,5
17:13,310375875.0,2108.746744495432,-15.88,9
17:16,851649498.0,8766.636936721789,-26.45,2
17:17,860360312.0,-136.8144911173196,-214.0,2
17:20,467207141.0,347.5008670482637,-202.0,2
17:21,462962606.0,1018.5700499999988,-93.79,2
17:21,456221621.0,214.04386730262797,-85.48,5
17:22,964702094.0,1166.9643043051378,-54.97,2
17:22,730002588.0,14210.627317277984,-31.08,4
17:24,785749304.0,8896.714576133942,-8.95,9
17:24,520418719.0,756.7629000000036,-15.97,7
17:24,832564361.0,15970.068535167777,-32.2,7
17:26,683319988.0,7728.418049687489,-41.98,9
17:27,982949451.0,-3899.954167052508,-15.96,5
17:28,975345315.0,37208.65483562805,-26.67,5
17:30,121858569.0,1720.2011500000024,-123.0,2
17:30,315546581.0,29994.19254489859,-7.05,4
17:31,833899961.0,1366.8691457180098,-30.95,7
17:32,605116158.0,2771.1066000000033,-8.97,4
17:32,815385232.0,11053.803530759153,-11.33,5
17:33,429556122.0,4777.106429294684,-32.06,1
17:34,572136270.0,-877.6308884119767,-64.5,2
17:34,117273481.0,9202.366720450742,-9.9,8
17:34,672913754.0,11982.332994680928,-43.95,7
17:35,316793091.0,711.2724600549509,-22.0,2
17:38,235881534.0,14066.813593865229,-25.07,7
17:38,581655972.0,43222.27297476078,-19.98,7
17:40,551196328.0,4484.915418629561,-131.73,5
17:41,534325901.0,7288.901312369731,-15.94,9
17:41,653640811.0,18074.501766865284,-38.02,2
17:42,197865285.0,-167.42693826877968,-115.46,2
17:43,971010829.0,317.7950564442451,-138.99,2
17:44,203466392.0,3759.6435334146017,-52.04,5
17:44,943329213.0,-52.66538065024233,-268.8,2
17:45,290818242.0,7424.995215599439,-33.41,6
17:47,166019891.0,8612.497948916158,-9.51,5
17:47,572136270.0,-991.1308884119768,-113.5,2
17:47,433917275.0,8090.416639587273,-44.24,8
17:48,766812921.0,-98.35550000000084,-71.92,4
17:48,795847804.0,24540.34983399702,-55.01,7
17:50,616924659.0,200.3995798230852,-30.8,5
17:51,108563213.0,25643.824123626153,-56.24,5
17:51,467207141.0,300.0008670482637,-47.5,2
17:51,585596026.0,2867.0967009019905,-76.98,2
17:51,824916823.0,8978.817171629435,-20.72,5
17:52,500043411.0,14185.002872618556,-92.58,5
17:53,876890798.0,3862.860970699933,-21.96,7
17:53,604334058.0,436.08999999999935,-49.99,4
17:53,373163757.0,11748.931343226912,-10.99,7
17:57,221868392.0,5313.241842669081,-2.68,5
17:57,736340277.0,9043.256697874702,-44.58,7
17:57,151278285.0,2181.8586499999997,-12.99,2
17:58,520418719.0,513.7629000000036,-243.0,2
18:00,678330503.0,3540.743382396574,-31.87,2
18:01,324224854.0,4551.906800138159,-31.88,9
18:03,197865285.0,-279.4269382687797,-112.0,2
18:07,147474476.0,3472.11280283296,-198.76,2
18:10,535744551.0,708.2321659956258,-34.19,9
18:15,796709231.0,-216.3080221037025,-69.0,2
18:19,624563756.0,-318.9363712164436,-41.97,5
18:22,147474476.0,3211.7548028329597,-260.36,2
18:22,479456865.0,1829.3294995833055,-12.0,7
18:22,108563213.0,25635.699856790245,-8.12,2
18:25,305778936.0,10902.92229639789,-21.39,9
18:25,496395938.0,12809.553940278258,-30.49,5
18:26,556992209.0,12601.8955028539,-9.99,7
18:26,121858569.0,1660.2011500000024,-60.0,2
18:30,131388684.0,22252.30382569626,-17.15,9
18:31,627936697.0,-175.91369999999986,-27.19,9
18:32,344219145.0,8488.064464248659,-13.02,7
18:32,471897866.0,8191.739156162753,-43.22,5
18:33,471897866.0,8143.201993465614,-48.54,5
18:33,241459011.0,629.8111132723467,-63.55,5
18:34,857455726.0,-548.1715141243158,-30.79,9
18:35,534908754.0,-1015.5652000000002,-18.95,5
18:37,822135975.0,12087.922288235895,-4.07,7
18:44,158766229.0,-657.2237358934699,-54.4,5
18:44,449871732.0,8034.323115645463,-9.48,7
18:45,196289502.0,16524.714545508374,-11.24,7
18:47,296972867.0,-935.2228000000008,-74.12,5
18:49,749371623.0,-2671.479153517342,-52.01,5
18:49,690523499.0,321.36090000000024,-13.98,7
18:51,822718326.0,11800.90398266141,-25.17,5
19:00,287480331.0,8697.970939700672,-21.29,7
19:00,836110591.0,6812.909619599622,-7.91,5
19:01,493571342.0,-2603.265880907047,-22.54,5
19:03,738958551.0,9909.108431773757,-32.95,9
19:04,522188082.0,8480.835490295261,-40.02,7
19:04,585133606.0,5348.3034593928405,-209.03,5
19:05,682194230.0,-2391.850849999999,-32.88,5
19:10,873693307.0,10894.232509474206,-22.9,9
19:10,252760664.0,7194.027348198836,-108.99,5
19:10,489964679.0,21177.07349745578,-25.28,9
19:13,564744955.0,-13.448241411158122,-92.2,5
19:13,540159353.0,11857.160864862894,-32.98,8
19:13,166019891.0,8592.797948916157,-19.7,9
19:13,383833857.0,26695.6990862739,-16.76,5
19:23,690958123.0,21927.963886106296,-149.16,5
19:26,699997811.0,842.2058500000038,-98.47,5
19:30,419550103.0,19392.16640872512,-37.83,8
19:32,858560423.0,12882.489253018786,-3.08,2
19:34,553734946.0,135.7061999999983,-83.75,5
19:35,414805878.0,13561.441317755924,-43.7,9
19:36,433917275.0,8061.316639587272,-29.1,9
19:38,518474507.0,14692.382961012005,-10.64,2
19:42,556992209.0,12496.5735028539,-105.32,5
19:48,305778936.0,10886.5444084044,-16.38,2
19:51,198946608.0,4716.257645511003,-4.83,5
19:55,170637730.0,1971.3056409466387,-10.55,9
19:56,245690309.0,10124.690421485406,-35.52,5
19:59,280268430.0,5818.0096848877565,-42.69,2
19:59,450896297.0,14034.46262751292,-9.59,8
20:01,270374623.0,10122.508126280458,-16.46,2
20:05,503575533.0,8471.389874664672,-39.65,5
20:05,472213568.0,-448.13254420605335,-78.08,5
20:08,975345315.0,37190.99442794546,-17.66,2
20:13,350921975.0,-81.92127892612575,-42.85,5
20:18,200080192.0,9893.482121943563,-54.0,5
20:31,912584712.0,-470.25638045526694,-171.17,5
20:34,221868392.0,5286.751842669081,-26.49,9
20:38,583579399.0,2174.1140500000006,-43.05,9
20:38,647936800.0,2573.0956917613194,-28.47,7
20:51,414805878.0,13538.611398017469,-22.83,7
20:52,492215823.0,3234.144453815445,-320.14,5
21:28,675231808.0,18425.654066440376,-70.17,5
00:34,169006407.0,12448.778150953369,-4.13,7
01:11,718058208.0,2424.474199442735,-15.33,7
01:32,541639148.0,4426.586587688163,-20.88,7
01:58,687135796.0,29402.093160915058,-11.03,8
01:59,985188462.0,-649.2532112887753,-39.27,9
02:03,950234174.0,2319.1836848513776,-16.73,4
02:07,639549973.0,7605.930788392071,-26.39,5
02:13,779946617.0,17395.324534700125,-12.52,2
02:21,370521542.0,28193.399663572593,-3.21,7
02:24,547010927.0,24697.95802369165,-0.12,2
02:33,500043411.0,14171.122872618556,-13.88,9
02:38,252760664.0,7183.958509914902,-10.07,7
02:39,414805878.0,13507.181398017468,-31.43,9
02:41,633345190.0,6362.1046912134725,-27.14,9
03:03,912705941.0,19419.57775246385,-1.19,8
03:07,806358207.0,11711.660479903796,-24.87,7
03:07,874431242.0,9880.542649329507,-27.69,9
03:07,897714622.0,9671.212613930567,-23.9,5
03:10,414805878.0,13500.137440360282,-7.04,2
03:10,679662108.0,16960.07153484685,-70.77,7
03:18,670102069.0,1858.711985611104,-40.91,5
03:18,802697323.0,17007.126369414174,-45.54,9
03:18,853907490.0,8025.321982747388,-2.63,5
03:20,987163717.0,4257.906440000003,-36.83,9
03:27,994214354.0,10411.704112333467,-24.95,9
03:29,940569402.0,5249.568642909845,-11.64,9
03:36,237493332.0,15285.608888100607,-15.45,9
03:37,956717493.0,1350.2298504359833,-3.16,8
03:39,256002321.0,7024.220511867247,-13.35,9
03:42,572384506.0,7724.033047528045,-37.84,9
03:45,836110591.0,6785.969619599622,-26.94,9
03:46,500043411.0,14145.93529991768,-25.19,2
03:48,259015404.0,1406.6490901789923,-34.13,9
03:51,987163717.0,4215.344131891316,-42.56,2
03:51,604288474.0,2058.673757147446,-67.79,2
03:52,519644021.0,3301.1478827178516,-18.27,5
03:54,949032480.0,4266.263634656474,-1.22,7
03:56,324224854.0,4497.047927379771,-54.86,7
03:59,897592348.0,15986.363528332937,-30.87,2
04:09,973086490.0,10619.697232643564,-10.59,2
04:10,256002321.0,6978.569909727138,-45.65,7
04:12,554792076.0,29718.06681823076,-57.64,4
04:20,558119802.0,34585.399449055236,-10.0,7
04:22,290818242.0,7414.4783930318,-10.52,4
04:23,581655972.0,43182.67720570716,-39.6,7
04:29,992204045.0,7606.459212502129,-53.48,5
04:29,846550094.0,1798.568165171468,-14.23,9
04:40,520447032.0,8637.962933865736,-34.88,9
04:40,534325901.0,7282.280367656503,-6.62,7
04:42,270374623.0,10114.585620731972,-7.92,2
04:52,151968462.0,7874.5562153551855,-4.19,7
04:53,984783496.0,14884.114041588668,-17.19,9
04:59,480557476.0,11713.145295153572,-17.94,9
05:04,930277104.0,10753.01656064386,-29.94,9
05:05,383625050.0,3127.4610753219913,-8.0,7
05:11,187541224.0,2479.4374566485403,-41.24,9
05:11,678851253.0,4183.783700409301,-6.36,2
05:14,709608057.0,2888.4169502705927,-35.52,9
05:19,203466392.0,3729.436005079935,-30.21,2
05:20,824916823.0,8945.867171629434,-32.95,9
05:21,836110591.0,6781.162179572018,-4.81,7
05:22,315546581.0,29983.659591141914,-10.53,7
05:24,496395938.0,12802.43371670337,-7.12,2
05:24,601627384.0,4179.508917147946,-35.93,9
05:29,910730524.0,8162.31565377272,-6.13,2
05:30,995615876.0,2208.4714315809792,-10.02,5
05:33,905860285.0,11746.079215377657,-32.0,9
05:33,200080192.0,9862.26051826488,-31.22,2
05:33,851649498.0,8696.207642916514,-70.43,5
05:35,788740658.0,2829.9401026670184,-0.5,2
05:36,930277104.0,10704.795003266929,-48.22,8
05:37,216285378.0,25085.837384634902,-38.89,9
05:45,108481285.0,9305.140172017258,-0.16,2
05:46,730002588.0,14148.229842092738,-62.4,4
05:46,673025413.0,1192.865165923188,-46.41,8
05:46,518474507.0,14659.343639084716,-33.04,2
05:47,705848712.0,28254.535508024128,-15.94,9
05:49,885259672.0,3508.8935532411297,-41.83,8
05:51,940569402.0,5234.737525691128,-14.83,2
05:53,183888402.0,19628.167609767173,-38.14,9
05:58,586315521.0,13060.009857828756,-48.74,2
06:01,887853850.0,10920.396976718568,-29.2,9
06:04,284905540.0,8553.551973605945,-2.64,2
06:06,647936800.0,2565.841083755003,-7.25,2
06:06,657139925.0,14797.131652956234,-18.34,9
06:07,785749304.0,8885.734576133942,-10.98,9
06:08,873693307.0,10872.992509474208,-21.24,9
06:08,766941757.0,2868.275815560732,-35.09,9
06:13,675806859.0,7786.026656133653,-11.64,7
06:13,145387690.0,5723.541950934256,-16.03,9
06:15,143061865.0,7609.281358696939,-57.67,7
06:18,120634201.0,5460.495329403303,-19.74,9
06:22,822250278.0,6908.137635987311,-4.19,2
06:25,285220959.0,12364.838773601476,-0.72,2
06:25,706250160.0,13051.152399482266,-4.15,5
06:26,331450202.0,8345.242827139364,-38.64,2
06:28,842682241.0,6033.298644549763,-38.68,5
06:29,383833857.0,26658.074669141115,-37.62,2
06:34,994214354.0,10398.330624771212,-13.37,7
06:37,647472692.0,26891.17870014145,-34.1,7
06:39,873701090.0,641.43909169648,-25.62,7
06:40,237493332.0,15225.09089190307,-60.52,5
06:41,348325817.0,11010.50210686668,-32.93,9
06:41,752362502.0,7924.8507490128,-53.25,5
06:42,858989281.0,27629.809542966195,-13.5,9
06:44,145387690.0,5707.320744499661,-16.22,7
06:45,874431242.0,9814.740196098388,-65.8,7
06:47,699139822.0,2201.461186368007,-12.38,5
06:48,719586818.0,19293.06484771846,-34.6,7
06:49,587225252.0,6157.8792523531,-53.88,2
06:49,780463728.0,3573.216870942239,-37.3,9
06:51,399144202.0,1903.9994437303897,-28.22,9
06:51,146909202.0,3874.1268329412246,-57.77,2
06:51,873693307.0,10851.29456143366,-21.7,2
06:58,609939116.0,7749.1607615060575,-45.86,2
07:02,550169791.0,22691.986696066953,-31.7,7
07:02,282837512.0,14666.27701735269,-27.52,9
07:02,672994751.0,189.12629078600995,-34.82,9
07:03,511179916.0,7762.659662963984,-2.77,7
07:04,865748375.0,2602.657447408488,-17.49,2
07:06,510101371.0,13954.77522180373,-30.72,9
07:08,196289502.0,16512.474545508372,-12.24,9
07:09,364357875.0,8707.385829916755,-44.6,7
07:09,749378808.0,4400.672430994462,-3.22,7
07:10,195895574.0,7738.603224569312,-0.54,7
07:10,822135975.0,12077.048251266677,-10.87,5
07:12,235881534.0,14033.840653810532,-32.97,2
07:13,575652395.0,2597.8443080704574,-36.2,2
07:13,829914501.0,1533.3588065709744,-6.8,9
07:14,305778936.0,10860.5444084044,-26.0,9
07:15,170637730.0,1957.909871038743,-13.4,2
07:16,887853850.0,10855.44356653699,-64.95,5
07:17,532478725.0,5101.473895384353,-4.81,5
07:18,738958551.0,9908.033410157446,-1.08,7
07:20,264550521.0,5576.996227613314,-1.94,8
07:22,795847804.0,24488.701035477832,-51.65,7
07:23,704517789.0,18609.76388601083,-10.74,2
07:24,399144202.0,1872.756847395205,-31.24,2
07:24,549414742.0,7922.870004082187,-0.38,5
07:25,667367404.0,9644.642019174971,-33.39,7
07:29,322221939.0,3822.5808605621473,-5.93,8
07:30,858989281.0,27626.971184638976,-2.84,7
07:31,905860285.0,11677.277383940587,-68.8,5
07:37,287480331.0,8669.940939700671,-28.03,9
07:37,108563213.0,25582.783903618125,-52.92,7
07:38,348325817.0,10995.155607836565,-15.35,7
07:38,520447032.0,8556.094199969191,-81.87,2
07:40,310375875.0,2095.9050436663915,-12.84,8
07:42,489964679.0,21139.33349745578,-37.74,9
07:45,305778936.0,10856.086600531598,-4.46,5
07:49,588565416.0,6924.200590453963,-11.46,5
07:50,461990622.0,10029.843504527851,-64.88,2
07:57,454129843.0,442.40284516656,-5.6,9
08:00,297823329.0,790.3142999999992,-6.05,9
08:04,758160963.0,8920.855125631088,-11.3,7
08:05,885259672.0,3502.7935532411298,-6.1,9
08:06,113747882.0,12804.190290689532,-11.74,7
08:06,213112754.0,7090.9295788602485,-2.43,5
08:07,762700245.0,913.2247000000026,-6.9,9
08:07,395284483.0,1180.9143402113082,-5.65,9
08:09,417850087.0,18047.21693500872,-32.33,8
08:11,358846516.0,797.8832725272174,-5.65,9
08:13,482513594.0,6375.041341287858,-8.29,7
08:17,146909202.0,3869.426832941225,-4.7,9
08:17,399538448.0,7606.954049395938,-7.8,9
08:19,987656636.0,4464.739874457643,-40.59,7
08:21,960208650.0,18259.38743421606,-27.48,2
08:21,734161378.0,-2793.547669434212,-16.95,5
08:25,901432314.0,3858.79578290294,-6.9,9
08:28,435984758.0,4536.612184594255,-35.54,5
08:30,574548998.0,-369.34175000000096,-83.31,5
08:30,943829984.0,-417.454490886543,-85.8,5
08:30,331450202.0,8331.270827139364,-13.97,5
08:32,131388684.0,22232.03182569626,-20.27,5
08:33,214339619.0,536.605050868356,-72.02,5
08:35,849096144.0,1767.788020751343,-118.31,5
08:37,851181128.0,5185.188284327426,-3.25,7
08:39,604288474.0,2013.565757147446,-45.11,5
08:41,623156843.0,4988.060870419534,-18.1,2
08:44,387957305.0,-2760.1586059800784,-18.65,5
08:46,480557476.0,11696.927739787812,-16.22,5
08:47,221356538.0,869.3920999999997,-116.61,5
08:48,954263768.0,-190.55550000000025,-34.41,5
08:48,639409800.0,37626.30983191721,-14.26,5
08:50,903468956.0,744.5015999999994,-53.01,5
08:51,229205098.0,8097.679162671919,-29.69,2
08:54,613729471.0,8391.031539429796,-1.06,7
08:56,783650950.0,-809.9456434110116,-72.55,5
08:58,473820682.0,12184.869957255483,-11.43,7
08:58,425964226.0,4228.040053979412,-5.6,9
08:58,534204159.0,6031.51456524126,-58.49,4
08:58,767447966.0,5336.753062706572,-94.23,5
08:59,355602925.0,1518.5902265753275,-125.57,5
09:04,690958123.0,21921.363886106297,-6.6,9
09:04,667367404.0,9639.242019174972,-5.4,9
09:05,506618547.0,15257.236282273165,-7.8,9
09:06,435984758.0,4435.602184594255,-101.01,5
09:08,187111705.0,7383.047542940088,-2.76,8
09:08,624563756.0,-324.3363712164436,-5.4,9
09:09,613729471.0,8384.681539429796,-6.35,9
09:09,417850087.0,18040.71693500872,-6.5,9
09:09,722971557.0,-1013.9022791569244,-75.1,5
09:11,741903302.0,2675.128315014126,-5.45,9
09:11,851649498.0,8689.707642916514,-6.5,9
09:12,618138606.0,1447.835902870066,-6.35,9
09:14,290818242.0,7409.5283930318,-4.95,9
09:14,621181115.0,-254.14224957077113,-152.69,5
09:16,534204159.0,6023.76502524126,-7.75,4
09:18,479366718.0,2293.311447632401,-46.48,4
09:19,214339619.0,532.305050868356,-4.3,9
09:19,475277431.0,1183.1581369436192,-18.0,4
09:19,131388684.0,22226.98182569626,-5.05,9
09:20,987229118.0,1769.446399859196,-90.26,2
09:20,282837512.0,14596.94701735269,-69.33,2
09:20,985188462.0,238.33678871122467,-22.41,7
09:21,992204045.0,7601.109212502129,-5.35,9
09:21,540159353.0,11851.810864862891,-5.35,9
09:23,117273481.0,9196.716720450742,-5.65,9
09:25,134461671.0,6446.465839712611,-21.32,2
09:26,169006407.0,12443.428150953368,-5.35,9
09:28,683319988.0,7699.088049687489,-29.33,9
09:29,773633520.0,-195.14738906148852,-158.86,5
09:31,441274121.0,12747.998113262063,-6.9,9
09:35,779946617.0,17357.034534700124,-38.29,2
09:35,194745206.0,307.5063720912432,-22.07,2
09:40,346874167.0,82.16584999999901,-154.27,5
09:40,504055745.0,-241.69593865823316,-68.64,5
09:41,904154012.0,508.0874581204316,-16.98,7
09:42,235663459.0,512.9464298120151,-48.19,5
09:45,441142605.0,2343.236842275729,-31.99,2
09:45,987229118.0,1692.4603998591958,-76.99,2
09:47,414454079.0,430.0478500000015,-23.35,2
09:53,598793068.0,427.3483999999981,-198.32,5
09:54,386277162.0,300.8899999999994,-26.97,7
09:56,699139822.0,2147.311186368007,-54.15,2
09:56,903953091.0,3739.4028830548,-37.99,2
09:57,441142605.0,2113.2668422757292,-229.97,2
09:59,985188462.0,205.70678871122468,-32.63,2
10:00,176922958.0,1436.2895471976497,-67.12,5
10:01,766941757.0,2832.7613272545022,-35.51,2
10:04,280990953.0,1062.3396999999984,-147.98,2
10:04,287480331.0,8612.98062315833,-56.96,5
10:04,792845450.0,1091.475150000001,-21.98,4
10:05,254853117.0,3460.7099407437554,-35.06,2
10:15,519644021.0,3207.4038827178515,-93.74,5
10:16,270374623.0,10103.355620731973,-11.23,4
10:16,407574996.0,-459.6863906190631,-62.16,1
10:20,985188462.0,152.13638871122478,-53.57,4
10:21,588565416.0,6756.900590453963,-167.3,2
10:27,259015404.0,1358.32142437753,-48.33,5
10:28,298007503.0,1871.349103625634,-30.41,7
10:34,792845450.0,996.4951500000008,-94.98,2
10:46,250895529.0,1003.616932469288,-121.6,5
10:46,601627384.0,4153.402882522681,-26.11,7
10:56,298000165.0,27095.18678569495,-78.53,5
10:56,570323670.0,3481.336139534806,-8.41,7
11:09,987229118.0,1516.8163998591958,-175.64,2
11:23,280990953.0,1037.3796999999984,-24.96,1
11:27,987229118.0,1434.930399859196,-81.89,2
11:30,414454079.0,418.8678500000015,-11.18,4
11:30,647472692.0,26782.73470014145,-108.44,5
11:33,575652395.0,2574.7351880704573,-23.11,4
11:34,298000165.0,27075.196785694952,-19.99,4
11:40,454356905.0,2052.0159222363072,-3.92,7
11:47,503575533.0,8382.309874664672,-89.08,2
11:48,588565416.0,6441.200590453963,-315.7,2
11:51,421881811.0,2778.3945865255923,-2.07,4
12:04,155317149.0,287.520249999999,-33.71,9
12:07,699139822.0,1966.971186368007,-180.34,4
12:16,812692024.0,4103.44470666393,-55.38,5
12:21,941285623.0,1290.4943990667705,-63.92,7
12:22,588565416.0,6339.700590453963,-101.5,2
12:28,812012103.0,-1029.6743000000004,-38.49,9
12:40,987229118.0,1219.358399859196,-215.57,2
12:45,138969884.0,734.7659999999994,-105.64,5
12:46,430910686.0,-194.00709999999964,-13.45,9
12:48,903953091.0,3707.7228830548006,-31.68,9
12:51,448004226.0,1637.0786735099762,-33.48,4
12:55,548907062.0,687.0987887682885,-21.49,4
12:55,284905540.0,8512.811973605945,-40.74,6
12:56,124377686.0,-2889.4723999999974,-19.18,5
13:05,688712152.0,7060.590495187547,-6.35,9
13:06,163470640.0,1083.1011999999996,-54.18,5
13:06,187111705.0,7377.347542940088,-5.7,9
13:06,548907062.0,654.1187887682885,-32.98,2
13:08,407574996.0,-465.7863906190631,-6.1,9
13:08,490868147.0,-296.23322087869843,-129.8,5
13:14,749378808.0,4393.172430994462,-7.5,9
13:18,340321732.0,1838.225550000004,-6.5,9
13:18,322221939.0,3816.6808605621472,-5.9,9
13:22,277562576.0,503.7877839436272,-4.3,9
13:25,585625048.0,2250.3259749993576,-6.45,9
13:32,903953091.0,3569.1228830548007,-138.6,2
13:36,655450953.0,-2908.8173784555293,-35.88,5
13:49,678726554.0,-434.53524765161023,-132.07,5
13:52,503575533.0,8321.269874664671,-61.04,2
13:54,903953091.0,3477.422883054801,-91.7,2
14:03,857997794.0,933.6776651508868,-11.98,4
14:09,903953091.0,3435.464883054801,-41.96,2
14:20,950234174.0,2183.1236848513777,-136.06,2
14:22,348525881.0,1042.481624594936,-107.37,5
14:30,903953091.0,3404.692883054801,-30.77,2
14:49,762859681.0,3284.787599999999,-34.98,7
14:52,970298834.0,2858.103792189439,-11.78,7
15:06,282046994.0,-405.4346499999997,-155.06,5
15:07,679911053.0,3157.9816597397376,-4.89,7
15:13,762859681.0,3239.028599999999,-45.76,5
15:28,742223719.0,703.8167073048027,-25.98,4
15:31,352899149.0,588.5050499999987,-5.99,2
16:09,678330503.0,3512.591769495063,-28.15,7
16:13,340295966.0,-1647.2119500000003,-42.25,5
16:19,899742927.0,13544.992345985624,-77.84,2
16:25,409971170.0,3184.9863723725935,-24.74,5
16:26,462962606.0,1005.5600499999988,-13.01,1
16:26,653667523.0,3719.244899570016,-14.98,7
16:31,492215823.0,3148.144453815445,-86.0,2
16:38,698076160.0,6781.272357037961,-84.76,5
16:41,473820682.0,12110.281097255483,-74.59,4
16:41,670102069.0,1827.961985611104,-30.75,9
16:48,399538448.0,7588.334340054052,-18.62,7
16:49,738958551.0,9806.443410157446,-101.59,2
16:50,126929801.0,1567.8437015783834,-49.99,2
16:50,785210466.0,2315.7280199977117,-190.5,4
16:50,886921642.0,3499.0941926869637,-60.38,2
16:51,696333897.0,317.2524499999988,-85.0,2
16:59,399144202.0,1870.606117395205,-2.15,4
17:02,441142605.0,2105.7668422757292,-7.5,4
17:05,183186021.0,-1295.7875499999989,-8.24,5
17:07,916270283.0,2488.0262500000003,-124.99,2
17:07,228136274.0,1290.6945999999994,-43.02,6
17:07,331450202.0,8314.340827139364,-16.93,9
17:09,769311479.0,6537.474105353571,-59.16,5
17:12,939972497.0,1671.7295586000107,-94.48,2
17:13,518474507.0,14624.363639084717,-34.98,9
17:13,627723633.0,-2297.753828003762,-17.91,5
17:13,532478725.0,5072.483895384354,-28.99,9
17:16,494156462.0,-1266.3818364817605,-29.48,9
17:18,651756497.0,14907.372744350572,-50.23,7
17:18,471897866.0,8133.573597986911,-9.63,7
17:19,859603181.0,3724.405954315287,-0.35,2
17:20,534325901.0,7264.303737656503,-17.98,4
17:21,308505160.0,13951.73172777067,-26.7,9
17:22,187541224.0,2458.9674566485405,-20.47,7
17:24,506618547.0,15254.784328522315,-2.45,2
17:24,198051483.0,-943.716910408857,-26.97,5
17:25,141521177.0,8176.319900000015,-35.0,2
17:25,629078930.0,196.019479725602,-19.99,2
17:25,824916823.0,8928.787171629434,-17.08,4
17:26,556992209.0,12479.0560028539,-17.52,4
17:28,696333897.0,175.25244999999882,-142.0,2
17:29,939972497.0,1653.2495586000107,-18.48,2
17:30,255814263.0,4069.1345976099233,-23.96,1
17:30,487051121.0,1235.466210104039,-116.27,5
17:30,851181128.0,5156.242444327426,-28.95,4
17:31,151916463.0,-136.0124444008311,-116.99,5
17:31,996042490.0,6442.103769909778,-228.9,2
17:33,752362502.0,7886.6707490128,-38.18,7
17:36,815993333.0,6507.204235901713,-29.13,5
17:38,500843551.0,445.4841999999997,-49.99,7
17:38,522188082.0,8466.503607952785,-14.33,7
17:40,992204045.0,7586.094212502128,-15.01,4
17:40,147474476.0,3201.76480283296,-9.99,7
17:40,587202562.0,276.46919941706847,-50.0,2
17:41,152488934.0,2017.6823073137311,-119.0,5
17:41,138609932.0,2600.7350032945856,-16.5,4
17:42,113747882.0,12776.300290689533,-27.89,7
17:42,104832000.0,-3070.8898589058444,-50.74,5
17:42,310375875.0,2062.4250436663915,-33.48,9
17:43,586315521.0,13032.859857828757,-27.15,7
17:43,467207141.0,263.9512170482637,-36.05,5
17:44,785210466.0,2209.6030199977117,-106.12,7
17:45,482513594.0,6289.501341287858,-85.54,2
17:46,858989281.0,27614.381184638976,-12.59,1
17:46,475117511.0,7520.273679437446,-52.92,1
17:47,221868392.0,5254.885343857726,-31.87,7
17:49,256002321.0,6909.997909727138,-68.57,2
17:51,690523499.0,312.3909000000002,-8.97,7
17:53,435313070.0,2823.993333033221,-121.06,2
17:54,984783496.0,14855.074041588668,-29.04,2
17:54,538003940.0,2475.0100000000098,-31.99,2
17:55,705848712.0,28237.70550802413,-16.83,7
17:57,574548998.0,-392.04175000000095,-22.7,9
17:57,416060965.0,584.8122547005803,-60.0,2
17:59,117273481.0,9183.736720450745,-12.98,7
18:00,586315521.0,12830.559857828755,-202.3,2
18:01,939972497.0,1611.769558600011,-41.48,2
18:02,683319988.0,7671.094147673891,-27.99,8
18:05,492215823.0,3116.0044538154452,-32.14,9
18:07,901432314.0,3823.194950606524,-35.6,7
18:09,683078800.0,2208.931542731244,-143.7,5
18:09,709142813.0,954.2695499999992,-20.34,9
18:10,785210466.0,2165.3530199977117,-44.25,4
18:11,648644594.0,340.3465999999991,-32.84,9
18:15,939972497.0,1467.269558600011,-144.5,2
18:16,445240363.0,-1197.8292559632737,-60.57,5
18:20,903953091.0,3279.3928830548007,-125.3,2
18:21,651756497.0,14890.392744350573,-16.98,9
18:21,256002321.0,6872.211909727138,-37.79,2
18:23,280268430.0,5743.039684887756,-74.97,7
18:25,797184978.0,-416.7299134269806,-28.48,9
18:28,215404070.0,410.52458917984967,-22.29,9
18:31,851181128.0,5121.912444327426,-34.33,9
18:31,809499628.0,18201.108820511956,-87.12,5
18:41,675231808.0,18393.684066440375,-31.97,7
18:42,496395938.0,12776.43571670337,-26.0,5
18:43,653640811.0,18041.980351783543,-32.52,5
18:44,166019891.0,8536.951948916158,-55.85,5
18:44,736340277.0,9023.56800624576,-19.69,5
18:45,189757473.0,-2259.971149999999,-9.81,5
18:49,668692488.0,827.2152785738098,-35.1,9
18:50,221868392.0,5230.185343857726,-24.7,9
18:50,450896297.0,13988.38262751292,-46.08,9
18:51,633345190.0,6304.6046912134725,-57.5,7
18:51,423208402.0,4130.850150000003,-12.0,7
18:53,955035930.0,2331.4534791714777,-21.49,7
18:54,256002321.0,6795.211909727138,-77.0,2
18:54,113747882.0,12754.100290689532,-22.2,9
18:55,806358207.0,11707.540479903795,-4.12,7
19:00,124102251.0,3626.979301601066,-5.51,2
19:02,832564361.0,15900.236535167774,-69.83,5
19:05,631744379.0,-2258.486259491066,-30.43,5
19:05,668329719.0,9227.853814624155,-7.64,2
19:08,256002321.0,6586.611909727138,-208.6,2
19:09,180719578.0,-4545.977749999995,-44.28,5
19:12,550169791.0,22682.036696066953,-9.95,9
19:12,907987693.0,-2628.0019999999977,-45.45,5
19:13,489964679.0,21132.687802917226,-6.65,7
19:13,986267641.0,4503.407629245633,-30.75,2
19:16,705848712.0,28219.93298251613,-17.77,5
19:23,256002321.0,6531.311909727137,-55.3,2
19:28,441274121.0,12744.560535948076,-3.44,7
19:32,786141370.0,-142.0835000000008,-35.64,5
19:32,631111289.0,-458.42150000000095,-38.6,5
19:32,868014990.0,-3520.3260999999957,-36.2,5
19:33,420109571.0,553.0185607166795,-77.71,5
19:37,618514666.0,22354.630811468967,-88.51,5
19:38,587202562.0,193.5170994170685,-82.95,5
19:38,713057426.0,-1032.6267500000004,-28.55,5
19:39,996042490.0,6347.4147699097775,-94.69,5
19:46,768271776.0,-605.0665467665797,-69.41,5
19:49,344219145.0,8435.602063536788,-52.46,7
19:56,679911053.0,3088.114659739738,-69.87,5
19:59,285428103.0,10551.515808161064,-53.96,5
20:11,274818272.0,431.2941785671314,-27.53,5
20:11,282837512.0,14593.81351875255,-3.13,4
20:12,119943495.0,-1462.400062112858,-39.53,5
20:14,709608057.0,2829.4402925888485,-58.98,5
20:18,809499628.0,18183.918820511957,-17.19,9
20:31,315078351.0,8457.830957452694,-8.26,7
20:35,867987292.0,2011.106713414319,-8.17,7
20:35,815385232.0,11033.81612883302,-19.99,5
20:36,522188082.0,8443.303607952785,-23.2,9
20:41,785749304.0,8832.174724078499,-52.57,5
20:43,480198977.0,12931.84972089771,-22.05,5
20:48,322720763.0,6818.47300847846,-32.69,7
20:49,809499628.0,18153.12467804358,-30.79,2
20:53,409971170.0,3122.9103723725934,-62.08,5
20:58,229205098.0,8053.775162671918,-43.9,5
21:15,700138124.0,5188.956807686073,-0.98,2
21:20,749378808.0,4366.322430994462,-26.85,9
22:10,366550080.0,26107.97024522552,-17.3,7
00:48,678851253.0,4167.916033371816,-15.87,2
00:48,960208650.0,18188.11801904277,-71.27,7
02:25,383833857.0,26636.474669141116,-21.6,9
02:30,858989281.0,27595.281184638978,-19.1,9
02:38,120634201.0,5445.155329403303,-15.34,9
02:39,873693307.0,10827.06456143366,-24.23,9
02:42,706250160.0,13035.589661038748,-15.56,8
02:43,779236304.0,2109.4875954795334,-31.12,9
02:49,489964679.0,21103.857802917224,-28.83,9
02:49,572384506.0,7683.833047528045,-40.2,9
02:50,282837512.0,14553.63351875255,-40.18,9
02:56,383833857.0,26616.49238181011,-19.98,5
03:01,858989281.0,27584.70422119058,-10.58,2
03:04,587225252.0,6114.4992523531,-43.38,9
03:09,851181128.0,5095.772444327426,-26.14,9
03:13,305778936.0,10838.146600531598,-17.94,9
03:16,851649498.0,8684.7634850031,-4.94,5
03:21,399144202.0,1840.156117395205,-30.45,9
03:26,853907490.0,8025.144151786943,-0.18,7
03:31,216285378.0,25048.507384634904,-37.33,9
03:34,348325817.0,10964.665607836563,-30.49,9
03:38,987163717.0,4176.804131891316,-38.54,9
03:40,851181128.0,5060.28107866486,-35.49,4
03:42,873693307.0,10809.673129301873,-17.39,2
03:43,683319988.0,7648.144147673891,-22.95,9
03:44,601627384.0,4124.832882522681,-28.57,9
03:50,973086490.0,10604.397232643563,-15.3,9
03:52,399144202.0,1822.7255008189095,-17.43,5
03:54,187541224.0,2427.9774566485407,-30.99,9
03:54,613729471.0,8362.031539429796,-22.65,9
03:58,912705941.0,19389.42775246385,-30.15,9
04:02,196289502.0,16500.124545508374,-12.35,9
04:03,802697323.0,16977.806369414175,-29.32,9
04:03,252760664.0,7152.499882475576,-31.46,7
04:04,510101371.0,13926.405221803729,-28.37,9
04:05,480557476.0,11661.309489156967,-35.62,7
04:06,259015404.0,1327.20142437753,-31.12,9
04:15,984783496.0,14829.924041588669,-25.15,9
04:17,873701090.0,525.2909321043707,-30.72,2
04:25,613729471.0,8304.320560001031,-57.71,2
04:28,618514666.0,22344.21597749449,-10.41,7
04:33,534325901.0,7264.073480871634,-0.23,8
04:37,905860285.0,11632.239849121332,-45.04,5
04:39,749378808.0,4331.642430994461,-34.68,9
04:40,668329719.0,9207.41146260183,-20.44,2
04:41,678330503.0,3474.9799186440555,-37.61,5
04:42,834383043.0,5492.574033300414,-4.87,5
04:43,809499628.0,18126.23467804358,-26.89,9
04:43,480198977.0,12910.25502842848,-21.59,2
04:45,912705941.0,19387.655184770905,-1.77,2
04:48,213112754.0,7078.949578860249,-11.98,9
04:48,113747882.0,12722.720290689533,-31.38,9
04:49,779946617.0,17335.752549699915,-21.28,2
04:51,308505160.0,13899.86277254204,-51.87,2
04:52,633345190.0,6273.714691213472,-30.89,9
04:54,532478725.0,5047.153895384354,-25.33,9
04:55,414805878.0,13461.157440360284,-38.98,9
05:00,910730524.0,8146.815793153427,-15.5,8
05:00,270374623.0,10090.827851075368,-12.53,7
05:00,687135796.0,29400.288928843747,-1.8,5
05:02,203466392.0,3720.1295930593624,-9.31,7
05:02,145387690.0,5681.030744499661,-26.29,9
05:04,930277104.0,10676.875003266929,-27.92,9
05:10,657139925.0,14773.641652956234,-23.49,9
05:11,886921642.0,3457.265058861969,-41.83,8
05:15,683319988.0,7563.62149365791,-84.52,2
05:17,749378808.0,4325.352229200032,-6.29,7
05:23,897714622.0,9644.126283437405,-27.09,5
05:25,518474507.0,14591.123639084715,-33.24,9
05:33,315546581.0,29950.42075067228,-33.24,5
05:33,256002321.0,6511.911909727138,-19.4,9
05:35,930277104.0,10641.637530900589,-35.24,5
05:35,419550103.0,19380.103658774755,-12.06,2
05:35,215311171.0,6818.007598273492,-58.37,7
05:36,290818242.0,7403.122920085772,-6.41,8
05:37,940569402.0,5217.887525691128,-16.85,9
05:42,815385232.0,10997.388326207323,-36.43,5
05:42,994214354.0,10374.350624771212,-23.98,9
05:43,145387690.0,5670.615193402479,-10.42,5
05:47,433917275.0,8031.166639587273,-30.15,9
05:47,985188462.0,111.05638871122478,-41.08,9
05:48,169006407.0,12439.209096404187,-4.22,2
05:50,822250278.0,6827.033328662642,-81.1,2
05:50,718058208.0,2413.2549977260182,-11.22,2
05:51,124102251.0,3558.852918944562,-68.13,7
05:53,348325817.0,10931.724843900964,-32.94,5
05:53,108931112.0,14881.00412654393,-38.48,9
05:57,736340277.0,9011.07800624576,-12.49,9
05:59,519644021.0,3203.731762640789,-3.67,8
06:01,461990622.0,9978.674459107351,-51.17,5
06:03,675806859.0,7720.5443112492,-65.48,8
06:05,973086490.0,10599.540161440074,-4.86,2
06:05,899742927.0,13483.873654746829,-61.12,2
06:07,187111705.0,7333.788503684715,-43.56,7
06:12,229205098.0,7999.942916409888,-53.83,2
06:12,131388684.0,22218.937897549666,-8.04,4
06:13,730002588.0,14137.151376627768,-11.08,5
06:17,183888402.0,19586.747609767175,-41.42,9
06:17,588565416.0,6321.974417910288,-17.73,7
06:17,940569402.0,5174.581215622179,-43.31,2
06:17,709608057.0,2799.2502925888484,-30.19,9
06:22,795847804.0,24470.821524126208,-17.88,7
06:24,500043411.0,14111.51958089148,-34.42,8
06:25,713641917.0,1454.1374272716084,-42.28,7
06:26,435984758.0,4425.529538896588,-10.07,7
06:29,647472692.0,26765.513111585075,-17.22,7
06:29,679662108.0,16955.122560014977,-4.95,4
06:29,305778936.0,10797.015926121763,-41.13,5
06:31,609939116.0,7747.484207843519,-1.68,2
06:31,213112754.0,7021.9101298463875,-57.04,7
06:33,383625050.0,3102.5010753219913,-24.96,9
06:34,450896297.0,13935.546360754874,-52.84,2
06:41,688712152.0,6999.64788813209,-60.94,8
06:41,836110591.0,6751.922179572019,-29.24,9
06:42,324224854.0,4495.781510837689,-1.27,4
06:44,532478725.0,5023.873330101086,-23.28,4
06:46,975345315.0,37151.32406710485,-39.67,8
06:46,550169791.0,22680.702528502785,-1.33,7
06:48,183888402.0,19576.292457140135,-10.46,2
06:49,705848712.0,28209.942982516128,-9.99,9
06:50,987656636.0,4432.4209439796805,-32.32,5
06:52,586315521.0,12812.152093329269,-18.41,5
06:54,719586818.0,19274.96085589738,-18.1,8
06:54,558119802.0,34570.50944905524,-14.89,9
06:56,179173981.0,5194.684251096829,-24.75,9
06:56,417850087.0,16254.33550402732,-6.38,5
06:58,673025413.0,1167.3446947813866,-25.52,2
06:59,237684254.0,6176.39190168345,-15.3,5
07:00,670102069.0,1794.491985611104,-33.47,9
07:05,541639148.0,4368.798045090031,-57.79,7
07:06,859603181.0,3697.4873259407327,-26.92,7
07:06,653640811.0,18006.41855983081,-35.56,7
07:07,198946608.0,4651.17775414485,-65.08,2
07:08,639549973.0,7588.121686468934,-17.81,2
07:08,433917275.0,7987.066560213515,-44.1,4
07:08,285220959.0,12359.445600090075,-5.39,2
07:10,547010927.0,24642.56438236432,-55.39,7
07:11,421881811.0,2744.972913689908,-33.42,4
07:12,383625050.0,3068.558717114429,-33.94,5
07:16,506618547.0,15243.533637354414,-11.25,7
07:18,128033695.0,2245.530271919926,-42.43,7
07:19,108563213.0,25566.106713581397,-16.68,2
07:20,806358207.0,11703.059012564176,-4.48,2
07:23,842682241.0,6014.717475590894,-18.58,5
07:23,651756497.0,14874.43837917091,-15.95,2
07:25,581655972.0,43114.93380386736,-67.74,4
07:26,822135975.0,12047.959965034946,-29.09,2
07:29,511179916.0,7761.390735650056,-1.27,7
07:35,113747882.0,12695.36484474784,-27.36,2
07:38,554792076.0,29712.85672494469,-5.21,5
07:39,549414742.0,7888.700004082187,-34.17,9
07:41,984783496.0,14789.49328337144,-40.43,2
07:45,496395938.0,12711.729208723003,-64.71,8
07:49,699139822.0,1956.8699893462372,-10.1,7
07:51,482513594.0,6248.827381167898,-40.67,8
07:52,310375875.0,2057.599395154496,-4.83,5
07:53,473820682.0,12109.844426673051,-0.44,7
07:58,647936800.0,2548.1258306633467,-17.72,2
07:58,280268430.0,5732.790676137572,-10.25,2
07:58,441274121.0,12727.282894850412,-17.28,7
07:59,449871732.0,8014.717610777068,-19.61,5
08:03,108481285.0,9225.806731617304,-79.33,7
08:03,752362502.0,7842.693112418657,-43.98,8
08:05,146909202.0,3858.255931741731,-11.17,5
08:06,558119802.0,34561.37608545078,-9.13,8
08:06,992204045.0,7573.7597194637265,-12.33,7
08:08,245690309.0,10111.803578348869,-12.89,7
08:12,885259672.0,3497.0204155864963,-5.77,5
08:22,522188082.0,8431.0300136494,-12.27,2
08:24,518378868.0,-1516.8174000000004,-20.99,5
08:26,519935524.0,-10.234670262481178,-7.8,9
08:27,679911053.0,3015.2446104856467,-72.87,7
08:28,199016328.0,4654.323559268923,-43.69,8
08:29,887853850.0,10850.1540312643,-5.29,7
08:29,742223719.0,621.3833073048027,-82.43,5
08:30,604288474.0,1999.2901071903077,-14.28,5
08:31,224215364.0,-1830.8400920882789,-31.16,5
08:31,691012931.0,-1707.604750000001,-33.8,5
08:32,949032480.0,4249.158718968993,-17.1,8
08:32,598586358.0,-3582.447449999995,-58.76,5
08:33,151968462.0,7799.52051018355,-75.04,5
08:33,195895574.0,7691.216328054994,-47.39,7
08:38,822718326.0,11745.36598266141,-55.54,5
08:39,844835978.0,10636.396883329931,-16.09,5
08:41,605116158.0,2726.8841000000034,-44.22,5
08:41,585625048.0,2179.219974999358,-71.11,5
08:43,726913482.0,-896.8560985264763,-102.62,5
08:45,520447032.0,8529.694199969192,-26.4,9
08:47,736340277.0,8997.965962648603,-13.11,8
08:49,933491926.0,3756.816300000005,-29.36,5
08:50,718058208.0,2302.9209977260184,-110.33,5
08:53,455831435.0,-1881.3046048014944,-53.8,5
08:54,143003091.0,10695.523964968088,-3.21,4
08:55,124125096.0,137.924944387802,-125.11,5
08:56,604334058.0,343.8677999999993,-92.22,5
08:56,391688371.0,335.2833911585002,-53.89,5
08:58,687135796.0,29317.10092884375,-83.19,5
08:58,668329719.0,9116.22946260183,-91.18,5
09:03,322221939.0,3792.750664047921,-23.93,5
09:05,948069469.0,-809.3155000000011,-74.81,5
09:06,887156614.0,-650.2963710407738,-105.06,5
09:06,893134725.0,1187.1767376616676,-16.76,5
09:08,364357875.0,8694.302306336742,-13.08,2
09:09,425964226.0,4224.355764114707,-3.68,7
09:09,613729471.0,8299.570560001031,-4.75,9
09:10,639420537.0,-1456.85645,-29.65,5
09:10,975345315.0,37125.344067104845,-25.98,2
09:11,299871610.0,-202.47684694123325,-48.55,5
09:11,166019891.0,8533.32435856467,-3.63,2
09:14,660874296.0,3063.54744996085,-79.97,4
09:15,383833857.0,26608.69238181011,-7.8,9
09:15,856461967.0,-235.48864647050743,-157.75,5
09:16,520447032.0,8467.627951111213,-62.07,7
09:17,534325901.0,7208.157480871634,-55.92,5
09:17,489964679.0,21085.1884535483,-18.67,5
09:18,264208990.0,787.7970999999986,-25.98,4
09:20,706250160.0,13012.159661038748,-23.43,7
09:21,179173981.0,5106.724251096829,-87.96,2
09:23,975345315.0,37066.37406710484,-58.97,4
09:23,425964226.0,4193.305764114707,-31.05,2
09:24,471897866.0,8075.613597986911,-57.96,2
09:24,344522228.0,-2930.694488208393,-7.34,5
09:24,414454079.0,409.7578500000015,-9.11,4
09:26,758160963.0,8859.385125631088,-61.47,2
09:27,575652395.0,2555.847603846703,-18.89,5
09:27,741269136.0,2679.215950000002,-16.97,7
09:28,376271050.0,1617.5391885480565,-23.97,4
09:28,885259672.0,3451.965405586496,-45.06,4
09:29,499244466.0,-407.6309812834224,-39.04,5
09:29,224524792.0,-2324.150682430848,-35.74,5
09:30,844835978.0,10601.406883329932,-34.99,2
09:32,598793068.0,394.378399999998,-32.97,4
09:32,349614277.0,1722.6323999999995,-10.98,7
09:32,113747882.0,12686.05484474784,-9.31,4
09:32,704517789.0,18578.661077499117,-31.1,7
09:32,500051919.0,979.76209665059,-16.98,7
09:33,480198977.0,12881.295028428482,-28.96,7
09:34,450896297.0,13883.127800754874,-52.42,4
09:34,130154096.0,1135.044751705878,-52.99,4
09:35,703478110.0,5441.424083055678,-104.3,2
09:35,851649498.0,8643.5734850031,-41.19,2
09:35,242218612.0,39.20630000000058,-74.99,2
09:36,866941383.0,1895.1196500000071,-9.99,4
09:36,409370545.0,869.1292755455207,-7.04,7
09:38,215404070.0,310.53458917984966,-99.99,2
09:40,639549973.0,7522.871686468934,-65.25,2
09:41,370521542.0,28142.097851002436,-51.3,5
09:41,705848712.0,28165.69414107695,-44.25,7
09:41,897714622.0,9605.646283437403,-38.48,7
09:41,950234174.0,2179.678438608788,-3.45,4
09:42,237493332.0,15150.50758583992,-74.58,5
09:42,131388684.0,22151.227897549667,-67.71,2
09:42,348525881.0,1032.491624594936,-9.99,7
09:42,771125520.0,840.3140999999991,-187.0,2
09:42,951817450.0,9533.375148321524,-43.84,5
09:43,270374623.0,10077.547851075367,-13.28,2
09:44,514362267.0,697.9473191070603,-21.74,7
09:44,264550521.0,5575.114382090018,-1.88,5
09:44,885259672.0,3386.915405586496,-65.05,2
09:44,261793952.0,88.67126020381488,-213.47,2
09:44,769311479.0,6528.8230043618105,-8.65,7
09:44,624500124.0,3488.759779931194,-47.98,5
09:45,420109571.0,533.0285607166795,-19.99,4
09:46,703478110.0,5426.444083055679,-14.98,7
09:47,776431321.0,3346.9013590185336,-49.97,4
09:48,255814263.0,3959.164597609923,-109.97,4
09:49,138609932.0,2591.7650032945858,-8.97,4
09:50,469330905.0,-93.08144258725152,-85.97,2
09:50,365608668.0,180.80501047383257,-5.99,4
09:51,657139925.0,14673.641652956234,-100.0,2
09:52,361201224.0,3671.098615745994,-156.3,5
09:52,975345315.0,36899.774067104845,-166.6,2
09:53,678330503.0,3373.4799186440555,-101.5,2
09:53,905860285.0,11562.239849121332,-70.0,2
09:55,134461671.0,6363.865839712611,-82.6,2
09:55,887853850.0,10828.1140312643,-22.04,7
09:55,792845450.0,968.5351500000008,-27.96,1
09:55,441274121.0,12684.202894850412,-43.08,7
09:55,771125520.0,765.3140999999991,-75.0,2
09:56,874431242.0,9772.287106385616,-42.45,7
09:56,933491926.0,3525.8163000000045,-231.0,2
09:56,700138124.0,5179.113759316004,-9.84,2
09:56,310375875.0,2016.129395154496,-41.47,7
09:58,912705941.0,19335.471024770904,-52.18,4
09:59,514362267.0,679.1973191070603,-18.75,4
10:00,365608668.0,170.82501047383258,-9.98,4
10:00,108563213.0,25384.8067135814,-181.3,2
10:01,764450279.0,22275.854818719923,-167.27,2
10:02,423208402.0,4090.870150000003,-39.98,2
10:04,630691258.0,140.8365448748413,-148.5,2
10:04,261793952.0,-79.31473979618511,-167.99,2
10:05,929044080.0,-119.54610849437177,-31.39,5
10:06,951817450.0,9486.503148321524,-46.87,5
10:06,211493028.0,1004.5914499999992,-99.97,2
10:06,245690309.0,10074.514238348867,-37.29,4
10:07,169006407.0,12434.169096404186,-5.04,1
10:08,134461671.0,6246.279839712611,-117.59,2
10:09,975345315.0,36871.69006710484,-28.08,5
10:10,511179916.0,7679.973735650056,-81.42,5
10:10,134847904.0,5180.558844386297,-51.98,4
10:11,909676212.0,832.8325317876131,-36.97,4
10:11,905860285.0,11523.739849121332,-38.5,2
10:13,108563213.0,25277.0067135814,-107.8,2
10:14,761272540.0,116.65074999999878,-56.98,5
10:16,642924505.0,438.500720183526,-17.98,4
10:17,764450279.0,22265.86481871992,-9.99,2
10:20,416060965.0,535.8122547005803,-49.0,2
10:21,134461671.0,6174.90783971261,-71.37,2
10:23,510101371.0,13919.985221803729,-6.42,4
10:25,188263947.0,22.954000000000615,-19.99,2
10:25,471897866.0,7966.441597986912,-109.17,4
10:25,541639148.0,4348.188045090032,-20.61,2
10:25,514362267.0,673.5798191070603,-5.62,2
10:26,807714284.0,1440.3277607359998,-22.0,2
10:27,403383649.0,968.6643796543062,-7.0,1
10:27,815385232.0,10942.704326207324,-54.68,5
10:30,425964226.0,4158.275764114707,-35.03,1
10:30,822135975.0,12044.909965034947,-3.05,4
10:32,409971170.0,3120.5395809964793,-2.37,2
10:32,315546581.0,29889.200750672277,-61.22,2
10:35,815993333.0,6496.200119617267,-11.0,2
10:36,466649401.0,834.7304935520875,-26.97,4
10:36,134461671.0,6053.83583971261,-121.07,2
10:36,211493028.0,891.1114499999992,-113.48,2
10:38,630691258.0,6.836544874841309,-134.0,2
10:38,785749304.0,8797.0885806331,-35.09,8
10:39,416060965.0,452.3222547005803,-83.49,2
10:40,905860285.0,11377.439849121334,-146.3,2
10:42,709935470.0,230.9507376997723,-72.09,5
10:43,214339619.0,519.325050868356,-12.98,4
10:44,287480331.0,8348.38062315833,-264.6,2
10:47,261793952.0,-224.9007397961851,-145.59,2
10:48,583558311.0,-689.3232152486677,-88.98,5
10:49,538003940.0,2427.5100000000098,-47.5,2
10:49,349614277.0,1529.1323999999995,-193.5,2
10:50,471897866.0,7941.969597986912,-24.47,7
10:51,492215823.0,3105.5289338154453,-10.48,4
10:52,277562576.0,446.5179839436272,-57.27,5
10:52,225210798.0,1034.6717737592082,-66.07,5
10:53,994214354.0,10359.819309161134,-14.53,7
10:53,211493028.0,842.6214499999992,-48.49,2
10:55,832564361.0,15883.360491767711,-16.88,4
10:57,169006407.0,12261.171096404189,-173.0,5
11:02,329840194.0,1581.9822901431478,-20.15,4
11:04,134461671.0,5889.391839712611,-164.44,2
11:05,423208402.0,4040.880150000003,-49.99,2
11:06,912705941.0,19308.451024770904,-27.02,7
11:07,416060965.0,397.85225470058026,-54.47,2
11:08,349614277.0,1374.1323999999995,-155.0,2
11:08,200080192.0,9821.76051826488,-40.5,2
11:09,639409800.0,37616.75410460009,-9.56,7
11:12,141521177.0,8081.357900000015,-94.96,5
11:13,366550080.0,26004.86024522552,-103.11,5
11:14,261793952.0,-275.2867397961851,-50.39,2
11:17,630691258.0,-111.16345512515868,-118.0,2
11:19,366550080.0,25977.515582939686,-27.34,7
11:20,134461671.0,5661.205839712611,-228.19,2
11:20,287480331.0,8229.38062315833,-119.0,2
11:27,538003940.0,2385.5100000000098,-42.0,2
11:28,949032480.0,4238.468718968993,-10.69,7
11:29,722358036.0,464.47499062708295,-44.99,2
11:33,630691258.0,-220.6634551251587,-109.5,2
11:33,655368335.0,5041.124122195575,-72.65,7
11:34,639409800.0,37569.94510460009,-46.81,5
11:36,250895529.0,978.656932469288,-24.96,1
11:38,414805878.0,13458.274213019058,-2.88,8
11:40,134461671.0,5553.475839712612,-107.73,2
11:40,287480331.0,8138.380623158329,-91.0,2
11:40,471897866.0,7802.011597986912,-139.96,4
11:42,905860285.0,11301.139849121337,-76.3,2
11:43,630691258.0,-385.1634551251587,-164.5,2
11:45,583579399.0,2164.124050000001,-9.99,7
11:48,538003940.0,2310.5100000000098,-75.0,2
11:49,108563213.0,25148.9347135814,-128.07,2
11:51,903953091.0,3254.4328830548006,-24.96,7
11:52,277562576.0,396.5379839436272,-49.98,4
11:53,454129843.0,424.90284516656,-17.5,2
11:53,261793952.0,-476.8867397961851,-201.6,2
11:55,416060965.0,310.85225470058026,-87.0,2
11:58,494789005.0,3280.2769456986116,-94.5,2
11:59,905860285.0,11234.639849121337,-66.5,2
12:00,678330503.0,3087.179918644056,-286.3,2
12:01,287480331.0,7924.18062315833,-214.2,2
12:04,471897866.0,7651.539597986913,-150.47,7
12:07,298000165.0,27000.413664065934,-74.78,2
12:11,108563213.0,25031.3767135814,-117.56,2
12:11,764450279.0,22156.67881871992,-109.19,2
12:12,793781222.0,1821.8988789474056,-45.5,7
12:13,213930646.0,-1793.0045634725632,-28.45,9
12:13,454129843.0,382.90284516656,-42.0,2
12:13,261793952.0,-584.6587397961852,-107.77,2
12:14,853907490.0,8014.164151786944,-10.98,9
12:15,416060965.0,231.86225470058025,-78.99,2
12:16,213112754.0,6911.310129846387,-110.6,2
12:17,630691258.0,-435.1634551251587,-50.0,2
12:20,815385232.0,10933.754326207323,-8.95,9
12:20,822250278.0,6806.987328662642,-20.05,4
12:21,471897866.0,7457.681597986912,-193.86,7
12:24,494789005.0,2950.576945698612,-329.7,2
12:24,905860285.0,11110.739849121335,-123.9,2
12:28,538003940.0,2275.58000000001,-34.93,4
12:28,836110591.0,6741.815150350443,-10.11,8
12:28,719742742.0,-581.6850077779632,-31.43,9
12:29,416060965.0,208.37225470058024,-23.49,2
12:30,793781222.0,1585.998878947406,-235.9,4
12:31,857754342.0,1322.564226279814,-81.54,5
12:31,678330503.0,2922.679918644056,-164.5,2
12:33,822135975.0,12034.719965034948,-10.19,7
12:34,843174694.0,-5299.555999999998,-14.69,5
12:34,216285378.0,24968.717384634903,-79.79,2
12:35,211493028.0,804.1314499999992,-38.49,2
12:37,108563213.0,24880.2327135814,-151.14,2
12:39,657139925.0,14521.041652956234,-152.6,2
12:39,494789005.0,2940.3709456986116,-10.21,5
12:41,514362267.0,628.5798191070603,-45.0,7
12:41,441274121.0,12673.812894850413,-10.39,9
12:42,315078351.0,8382.882238503087,-74.95,7
12:43,624500124.0,3446.936340677038,-41.82,5
12:44,416060965.0,114.88225470058023,-93.49,2
12:45,859603181.0,3677.477325940733,-20.01,1
12:50,905860285.0,10916.139849121337,-194.6,2
12:50,216286013.0,17.72905665393987,-35.47,5
12:52,349614277.0,1175.6323999999995,-198.5,2
12:52,793781222.0,1487.998878947406,-98.0,2
12:56,191161970.0,-4036.437999999994,-62.79,5
12:56,758160963.0,8844.285125631088,-15.1,1
12:56,514362267.0,621.0948191070603,-7.49,4
12:57,471897866.0,7241.395597986912,-216.29,4
12:57,949032480.0,4210.688718968993,-27.78,9
12:58,480557476.0,11655.309489156967,-6.0,9
13:00,494789005.0,2873.8709456986116,-66.5,2
13:01,519644021.0,3060.761762640789,-142.97,2
13:03,538003940.0,2146.58000000001,-129.0,2
13:04,986267641.0,4472.00264832611,-31.4,5
13:06,764450279.0,22037.69281871992,-118.99,2
13:06,308897841.0,1269.0741999999989,-33.99,5
13:07,340680761.0,-3216.955599999997,-12.28,5
13:09,905860285.0,10828.639849121337,-87.5,2
13:10,256045540.0,-3708.6288999999992,-40.03,5
13:10,214765415.0,-340.2053988501354,-42.45,5
13:10,893134725.0,1150.5086376616675,-36.67,5
13:11,277562576.0,391.4879839436272,-5.05,9
13:11,322221939.0,3787.350664047921,-5.4,9
13:12,187111705.0,7328.088503684715,-5.7,9
13:15,454356905.0,2022.675922236307,-29.34,9
13:18,414454079.0,389.4478500000015,-20.31,2
13:18,407323346.0,-2645.605432555312,-76.48,5
13:18,764450279.0,21893.52081871992,-144.17,2
13:20,211493028.0,753.6514499999992,-50.48,2
13:21,514362267.0,567.8448191070603,-53.25,2
13:22,414454079.0,360.3778500000015,-29.07,9
13:27,474301748.0,-2052.3390056839676,-29.28,5
13:28,793781222.0,1281.498878947406,-206.5,2
13:28,538003940.0,2121.58000000001,-25.0,2
13:28,416060965.0,87.39225470058025,-27.49,2
13:29,143061865.0,7581.899818833739,-27.38,7
13:29,585625048.0,2173.569974999358,-5.65,9
13:30,965038148.0,-151.94001436767223,-17.45,5
13:30,657139925.0,14413.241652956234,-107.8,2
13:34,771125520.0,675.8140999999991,-89.5,2
13:35,213112754.0,6662.810129846387,-248.5,2
13:37,494789005.0,2727.5709456986115,-146.3,2
13:38,874431242.0,9740.797106385617,-31.49,9
13:39,158414827.0,-1492.4750000000015,-5.5,5
13:41,703478110.0,5200.344083055678,-226.1,2
13:41,108563213.0,24717.8607135814,-162.37,2
13:42,764450279.0,21745.83481871992,-147.69,2
13:42,639409800.0,37290.65910460009,-279.29,2
13:42,514362267.0,513.8523191070603,-53.99,2
13:44,930271460.0,255.3764975357763,-36.87,5
13:47,785749304.0,8783.848580633101,-13.24,9
13:52,833899961.0,1304.0465957180097,-62.82,5
13:53,211493028.0,611.1614499999991,-142.49,2
13:55,678330503.0,2657.3799186440556,-265.3,2
13:55,849096144.0,1736.828020751343,-30.96,1
13:56,454129843.0,228.23084516656004,-154.67,2
13:58,213112754.0,6586.510129846387,-76.3,2
13:58,793781222.0,1184.898878947406,-96.6,2
13:58,218795010.0,-553.2697500000006,-85.9,5
13:59,764450279.0,21633.84881871992,-111.99,2
14:00,657139925.0,14307.541652956234,-105.7,2
14:01,254018059.0,-50.8805,-105.46,5
14:02,416060965.0,82.40225470058026,-4.99,2
14:03,627917561.0,4034.275050000006,-4.99,7
14:10,611143859.0,1471.043550000012,-294.78,5
14:11,771125520.0,538.8140999999991,-137.0,2
14:14,293609137.0,-55.146507425501866,-91.08,5
14:14,639409800.0,37094.67310460009,-195.99,2
14:14,916225911.0,-2394.77425,-48.16,5
14:15,514362267.0,454.22731910706034,-59.62,2
14:16,793781222.0,1102.298878947406,-82.6,2
14:18,146909202.0,3725.285931741731,-132.97,2
14:18,261793952.0,-812.8167397961851,-228.16,2
14:19,703478110.0,5091.844083055678,-108.5,2
14:23,454129843.0,140.04484516656004,-88.19,2
14:23,949032480.0,4172.188718968993,-38.5,2
14:30,764450279.0,21583.46281871992,-50.39,2
14:33,514362267.0,427.97731910706034,-26.25,2
14:41,793781222.0,1019.698878947406,-82.6,2
14:42,678330503.0,2416.5799186440554,-240.8,2
14:42,466649401.0,658.2504935520875,-176.48,7
14:45,108563213.0,24565.9887135814,-151.87,2
14:48,454129843.0,52.55884516656003,-87.49,2
14:54,703478110.0,4916.844083055678,-175.0,2
14:55,514362267.0,344.73481910706033,-83.24,2
14:57,678330503.0,2189.779918644055,-226.8,2
14:58,140893085.0,7016.770056365463,-188.43,5
15:04,793781222.0,828.5988789474061,-191.1,2
15:09,108563213.0,24409.9167135814,-156.07,2
15:16,647936800.0,2507.0158306633466,-41.11,2
15:20,454129843.0,-88.12715483343997,-140.69,2
15:25,657139925.0,14231.241652956234,-76.3,2
15:27,886837068.0,928.9355999999992,-1.99,4
15:31,315546581.0,29763.59975067228,-125.6,5
15:31,221868392.0,5199.411308168721,-30.77,8
15:35,454356905.0,1987.7793543067185,-34.9,5
15:47,971010829.0,296.8250564442451,-20.97,7
15:51,514362267.0,314.3823191070603,-30.35,7
15:56,604288474.0,1815.1401071903076,-184.15,2
16:00,703478110.0,4718.044083055678,-198.8,2
16:01,508518911.0,10.594750279010322,-6.99,4
16:02,657139925.0,14039.455652956234,-191.79,2
16:02,211493028.0,540.6714499999991,-70.49,2
16:03,657139925.0,14037.8531370234,-1.6,8
16:04,466649401.0,517.7804935520875,-140.47,7
16:13,738958551.0,9801.61027266818,-4.83,2
16:15,108563213.0,24347.6447135814,-62.27,2
16:17,408057540.0,5156.59570369971,-43.72,7
16:20,466649401.0,448.2804935520875,-69.5,4
16:24,703478110.0,4498.244083055678,-219.8,2
16:25,514362267.0,228.8823191070603,-85.5,4
16:27,762700245.0,652.1247000000026,-261.1,2
16:28,657139925.0,13825.8091370234,-212.04,2
16:28,718058208.0,2267.890997726018,-35.03,4
16:32,146909202.0,3676.245931741731,-49.04,4
16:32,678330503.0,1915.3799186440551,-274.4,2
16:33,108563213.0,24111.744713581396,-235.9,2
16:33,494977194.0,1105.355070597578,-134.99,2
16:36,349614277.0,1060.6323999999995,-115.0,2
16:37,817294757.0,-2517.2007999999996,-39.09,5
16:40,670102069.0,1731.6761349669523,-62.82,8
16:46,762859681.0,3138.938599999999,-100.09,2
16:46,673025413.0,1113.4246947813865,-53.92,1
16:48,213112754.0,6394.010129846387,-192.5,2
16:49,128033695.0,2218.790271919926,-26.74,9
16:49,108563213.0,23869.558713581395,-242.19,2
16:50,466649401.0,350.31049355208745,-97.97,4
16:53,941285623.0,1190.5143990667705,-99.98,2
16:57,762700245.0,400.8247000000026,-251.3,2
16:57,108563213.0,23649.058713581395,-220.5,2
16:59,151278285.0,2081.86865,-99.99,2
17:00,514362267.0,211.2723191070603,-17.61,2
17:00,198946608.0,4557.39175414485,-93.79,4
17:05,678330503.0,1745.979918644055,-169.4,2
17:11,538003940.0,2108.60000000001,-12.98,4
17:11,551755686.0,7071.502485725706,-19.99,4
17:13,844206657.0,1611.7026551465697,-25.98,2
17:15,994214354.0,10316.492889161134,-43.33,4
17:20,678330503.0,1553.479918644055,-192.5,2
17:21,519935524.0,-64.56467026248117,-54.33,5
17:22,373875019.0,17623.862294408562,-7.41,2
17:23,108563213.0,23462.242713581396,-186.82,2
17:30,514362267.0,133.2723191070603,-78.0,2
17:32,180616589.0,1098.0471699949169,-15.39,5
17:33,213112754.0,6109.110129846387,-284.9,2
17:33,570575024.0,-1087.4500000000007,-133.35,5
17:35,867987292.0,1869.8817134143192,-141.22,5
17:39,425730826.0,2477.55190938872,-49.99,2
17:41,762700245.0,226.52470000000264,-174.3,2
17:49,854895960.0,3866.8677072291985,-99.99,2
17:52,678330503.0,1409.979918644055,-143.5,2
18:02,213112754.0,5979.610129846387,-129.5,2
18:03,399538448.0,7576.052875838913,-12.28,5
18:05,514362267.0,84.8973191070603,-48.38,2
18:09,892354433.0,-792.5799606343386,-17.86,5
18:15,310375875.0,1981.999395154496,-34.13,9
18:19,170637730.0,1885.882494317279,-72.03,2
18:24,211493028.0,523.6914499999991,-16.98,2
18:26,494977194.0,1025.794470597578,-79.56,5
18:41,345582855.0,520.3122528205494,-21.93,9
18:41,696758548.0,-3549.410396320137,-20.6,5
18:48,984783496.0,14730.38428337144,-59.11,7
18:51,331048953.0,-399.7926320215064,-130.49,5
18:55,587225252.0,6112.517883293281,-1.98,4
18:56,738958551.0,9767.63027266818,-33.98,9
18:58,213096759.0,-1421.8641082144395,-62.47,5
19:04,254853117.0,3336.0119407437555,-124.7,5
19:05,867987292.0,1849.0233893151249,-20.86,4
19:05,964702094.0,1001.100004305138,-165.86,5
19:11,675398089.0,-791.9165407746511,-68.99,5
19:26,180616589.0,1084.3411699949168,-13.71,5
19:27,982286721.0,-3614.15052401773,-57.59,5
19:39,373163757.0,11713.583471507694,-35.35,4
19:49,595800644.0,-995.3654000000002,-113.81,5
19:53,187541224.0,2255.4834566485406,-172.49,5
19:56,392270893.0,13560.832643916196,-26.48,7
20:06,738958551.0,9602.04527266818,-165.58,5
20:25,518474507.0,14550.073868162515,-41.05,5
20:29,226703987.0,2868.811136547074,-7.59,7
20:34,948558249.0,10024.098963903549,-19.07,5
20:44,486495235.0,1922.1911642021823,-120.7,5
20:45,287480331.0,7885.672921500902,-38.51,7
20:45,618514666.0,22334.225977494487,-9.99,9
20:58,221868392.0,5178.931308168721,-20.48,9
00:11,824916823.0,8898.447171629434,-30.34,9
00:14,473820682.0,12099.70126816372,-10.14,2
00:18,324224854.0,4472.928560162784,-22.85,5
00:18,113747882.0,12654.61484474784,-31.44,9
00:18,887853850.0,10792.1640312643,-35.95,9
00:18,311467864.0,-750.467300000001,-42.88,9
00:22,885259672.0,3365.9153946090337,-21.0,7
00:23,858989281.0,27560.554221190578,-24.15,9
00:24,853907490.0,8008.036956843911,-6.13,5
00:27,572384506.0,7644.233047528045,-39.6,9
00:31,601627384.0,4082.7028825226807,-42.13,9
00:37,905860285.0,10794.037797877356,-34.6,7
00:39,559995067.0,2400.394428991797,-4.08,7
00:43,651756497.0,14849.355084455356,-25.08,7
00:44,970298834.0,2830.914310450903,-27.19,5
00:44,873693307.0,10791.473129301872,-18.2,9
00:48,196289502.0,16494.388397636943,-5.74,7
00:50,169006407.0,12185.357286737984,-75.81,5
00:51,471897866.0,7236.751653375448,-4.64,7
00:54,482513594.0,6207.771782331106,-41.06,2
00:55,113747882.0,12653.267372362334,-1.35,2
01:01,541639148.0,4289.1376392098255,-59.05,7
01:01,540159353.0,11840.975845534402,-10.84,5
01:02,166019891.0,8513.13435856467,-20.19,9
01:04,874431242.0,9657.203484942816,-83.59,7
01:07,980500334.0,-1377.561933892904,-25.39,9
01:08,815385232.0,10894.844862402351,-38.91,2
01:11,704517789.0,18532.68440833245,-45.98,7
01:11,647936800.0,2476.6816233216778,-30.33,7
01:18,851181128.0,5033.54107866486,-26.74,9
01:18,433917275.0,7935.051756883582,-52.01,4
01:24,435984758.0,4404.7692512963695,-20.76,4
01:25,802697323.0,16938.616369414176,-39.19,9
01:30,858989281.0,27558.269081176717,-2.29,7
01:30,910730524.0,8127.795164515494,-19.02,7
01:36,196289502.0,16483.748397636944,-10.64,9
01:38,987656636.0,4427.401670268176,-5.02,5
01:44,537487133.0,-261.15165000000053,-24.73,9
01:45,355733816.0,5677.415577096019,-37.32,7
01:52,496395938.0,12694.057621330876,-17.67,7
01:53,806358207.0,11692.228931249088,-10.83,7
01:54,493640090.0,-2791.1959499999984,-22.98,9
01:57,264550521.0,5573.246118871798,-1.87,7
01:59,719586818.0,19264.28350674178,-10.68,7
02:01,586315521.0,12801.13920760797,-11.01,8
02:01,758160963.0,8817.118826340824,-27.17,7
02:02,940569402.0,5162.6412156221795,-11.94,9
02:03,667367404.0,9628.077043191855,-11.16,5
02:07,832564361.0,15832.978992998527,-50.38,2
02:10,534325901.0,7170.264682988999,-37.89,4
02:13,822135975.0,12001.853371733878,-32.87,7
02:14,145387690.0,5617.6454146950555,-52.97,7
02:16,450896297.0,13859.037800754872,-24.09,9
02:18,419550103.0,19359.976093257417,-20.13,2
02:19,441274121.0,12659.564873235944,-14.25,5
02:21,824916823.0,8842.898498122044,-55.55,2
02:24,795847804.0,24451.574033021367,-19.25,5
02:26,235881534.0,13972.77167005736,-61.07,2
02:27,873693307.0,10772.546923293086,-18.93,8
02:27,730002588.0,14127.644422907091,-9.51,5
02:34,987163717.0,4140.804131891316,-36.0,9
02:44,749378808.0,4292.502229200031,-32.85,9
02:50,145387690.0,5596.715414695055,-20.93,9
02:51,575652395.0,2500.523110853572,-55.32,4
02:51,699139822.0,1946.091661853552,-10.78,2
02:52,683319988.0,7536.99149365791,-26.63,9
02:52,120634201.0,5422.3053294033025,-22.85,9
02:53,214339619.0,490.1569108056876,-29.17,7
02:56,832564361.0,15813.778992998528,-19.2,9
02:58,252760664.0,7126.5475687764465,-25.95,5
02:59,290818242.0,7400.045256283232,-3.08,7
03:02,310375875.0,1951.799395154496,-30.2,9
03:03,930277104.0,10604.50753090059,-37.13,9
03:06,851649498.0,8639.85589212013,-3.72,7
03:07,285428103.0,10541.525808161065,-9.99,9
03:07,766941757.0,2793.901327254502,-38.86,9
03:16,679662108.0,16940.632560014976,-14.49,9
03:18,705848712.0,28156.19414107695,-9.5,9
03:18,237684254.0,6169.816438030304,-6.58,5
03:20,187541224.0,2214.1834566485404,-41.3,9
03:22,938992364.0,324.15912373139946,-29.69,9
03:22,586315521.0,12786.18920760797,-14.95,9
03:34,785749304.0,8777.544108346066,-6.3,7
03:41,461990622.0,9967.79159819074,-10.88,4
03:42,287480331.0,7850.222921500902,-35.45,9
03:48,195895574.0,7678.236328054994,-12.98,9
03:51,229205098.0,7986.73478580656,-13.21,2
03:56,450896297.0,13812.46478273837,-46.57,2
03:59,899742927.0,13467.15528470202,-16.72,5
04:00,370521542.0,28128.347851002436,-13.75,9
04:02,383833857.0,26584.19647389499,-24.5,2
04:03,986267641.0,4467.816868451738,-4.19,8
04:07,587225252.0,6080.6378832932805,-31.88,9
04:07,108931112.0,14849.81412654393,-31.19,9
04:09,179173981.0,5103.519616481436,-3.2,4
04:12,675398089.0,-817.1965407746511,-25.28,9
04:13,987229118.0,1219.312189895145,-0.05,2
04:13,912705941.0,19258.877528920963,-49.57,8
04:24,256002321.0,6494.611909727138,-17.3,9
04:25,994214354.0,10282.342889161137,-34.15,9
04:26,709608057.0,2758.0202925888484,-41.23,9
04:28,939972497.0,1440.0395586000109,-27.23,9
04:31,370521542.0,28062.43964209786,-65.91,5
04:32,348325817.0,10891.624843900963,-40.1,9
04:36,409971170.0,3064.566855287899,-55.97,8
04:38,519644021.0,3001.1734355799754,-59.59,5
04:38,679911053.0,2940.0240672214186,-75.22,7
04:40,203466392.0,3682.75689520306,-37.37,7
04:43,237493332.0,15114.214634842709,-36.29,5
04:54,950234174.0,2152.612027631395,-27.07,2
04:54,930277104.0,10578.527628014315,-25.98,8
05:02,225210798.0,1004.8859351225794,-29.79,7
05:03,675806859.0,7718.916485967084,-1.63,2
05:12,128033695.0,2209.9624292283374,-8.83,5
05:14,752362502.0,7834.610527331391,-8.08,2
05:16,270374623.0,10044.047772137435,-33.5,5
05:16,522188082.0,8375.329195006017,-55.7,2
05:18,678851253.0,4164.755554762705,-3.16,8
05:18,183888402.0,19540.402457140135,-35.89,9
05:20,124102251.0,3539.695569450475,-19.16,2
05:20,308505160.0,13888.207669594773,-11.66,5
05:25,556992209.0,12463.0060028539,-16.05,9
05:26,587225252.0,6051.270045998135,-29.37,5
05:27,518474507.0,14514.983868162515,-35.09,9
05:31,679662108.0,16885.996165862944,-54.64,2
05:33,639549973.0,7512.107657449359,-10.76,5
05:34,454356905.0,1950.7793543067185,-37.0,9
05:35,809499628.0,18109.39467804358,-16.84,9
05:37,749378808.0,4287.411709590118,-5.09,7
05:38,604288474.0,1783.6896624864094,-31.45,7
05:38,200080192.0,9791.446113679784,-30.31,5
05:39,769311479.0,6499.583004361811,-29.24,9
05:39,940569402.0,5144.184660115777,-18.46,2
05:43,673025413.0,1078.1002867277875,-35.32,5
05:46,282837512.0,14525.783518752549,-27.85,9
05:47,836110591.0,6717.509793091715,-24.31,2
05:47,510101371.0,13880.795221803728,-39.19,9
05:49,613729471.0,8294.287503198166,-5.28,2
05:54,901432314.0,3803.7569498202542,-19.44,8
05:55,668329719.0,9113.257954348584,-2.97,5
05:57,897714622.0,9577.656326609744,-27.99,7
05:57,366550080.0,25976.70694614077,-0.81,5
06:01,549414742.0,7849.020004082187,-39.68,9
06:01,108563213.0,23417.87988132918,-44.36,5
06:03,683319988.0,7534.939022717475,-2.05,7
06:05,690958123.0,21884.418298934183,-36.95,2
06:09,279149837.0,2065.220049999999,-33.23,9
06:10,256002321.0,6486.298265003547,-8.31,7
06:16,809499628.0,18067.961134269688,-41.43,5
06:17,282837512.0,14516.973986136176,-8.81,5
06:20,670102069.0,1719.7356556187794,-11.94,2
06:24,609939116.0,7732.364796463562,-15.12,7
06:27,489964679.0,21057.2584535483,-27.93,9
06:29,364357875.0,8659.345332981231,-34.96,8
06:30,624500124.0,3426.4620219584117,-20.47,2
06:30,532478725.0,5017.199140515155,-6.67,5
06:32,779946617.0,17305.1286723346,-30.62,7
06:32,994214354.0,10278.541727004207,-3.8,7
06:36,581655972.0,43091.71079399439,-23.22,2
06:37,960208650.0,18187.32764544775,-0.79,2
06:42,285220959.0,12357.668983649302,-1.78,2
06:50,822250278.0,6797.276340308613,-9.71,7
06:53,554792076.0,29692.763178452664,-20.09,5
06:53,700138124.0,5157.873759316004,-21.24,9
06:57,886921642.0,3435.9677969255176,-21.3,2
06:58,639409800.0,37089.292170180925,-5.38,7
07:01,310375875.0,1900.8435918726057,-50.96,7
07:01,259015404.0,1297.29142437753,-29.91,9
07:03,534204159.0,6015.450374481007,-8.31,5
07:08,216285378.0,24936.237384634904,-32.48,9
07:08,550169791.0,22672.0176951775,-8.68,7
07:09,973086490.0,10598.491461574607,-1.05,2
07:11,971010829.0,263.9350564442451,-32.89,9
07:14,108481285.0,9212.770056819774,-13.04,8
07:15,687135796.0,29268.887774469993,-48.21,7
07:20,776431321.0,3268.277793930783,-78.62,7
07:20,213112754.0,5956.328354773896,-23.28,2
07:21,392270893.0,13528.932643916198,-31.9,9
07:23,131388684.0,22140.965121684,-10.26,5
07:32,195895574.0,7659.207654476964,-19.03,5
07:38,151968462.0,7773.963441032694,-25.56,8
07:41,134461671.0,5549.021243171819,-4.45,7
07:45,700138124.0,5156.047060177341,-1.83,2
07:54,698076160.0,6748.037415135193,-33.23,5
08:16,221868392.0,5167.803473484751,-11.13,7
08:17,489964679.0,21050.615594614563,-6.64,2
08:20,240643705.0,304.2814462108992,-10.05,2
08:25,706250160.0,12993.227535770597,-18.93,2
08:33,520447032.0,8463.40797073869,-4.22,7
08:33,414805878.0,13422.390896827272,-35.88,7
08:40,678330503.0,1407.7513719395276,-2.23,7
08:41,873701090.0,513.2474004684359,-12.04,7
08:41,383625050.0,3064.5500823197717,-4.01,2
08:43,506618547.0,15230.136496061765,-13.4,2
08:46,480557476.0,11638.837857345818,-16.47,7
08:48,259015404.0,1296.4031039491008,-0.89,2
08:50,647472692.0,26758.562062720528,-6.95,7
08:54,187111705.0,7324.070300358729,-4.02,8
08:55,705848712.0,28154.880591425943,-1.31,2
09:01,386729293.0,31765.431026627484,-4.7,5
09:08,473820682.0,12036.02926816372,-63.67,2
09:12,767447966.0,5335.250062706572,-1.5,4
09:14,240643705.0,257.8014462108992,-46.48,4
09:15,361201224.0,3642.028615745993,-29.07,7
09:16,266777719.0,1489.5589337802396,-156.8,2
09:18,506618547.0,15194.836496061766,-35.3,7
09:19,245690309.0,10062.381524429253,-12.13,8
09:20,653640811.0,17995.35116100831,-11.07,7
09:24,547010927.0,24613.32086510031,-29.24,8
09:28,473820682.0,11875.72926816372,-160.3,2
09:31,355733816.0,5671.425577096019,-5.99,7
09:32,663479159.0,4883.367541827712,-83.29,2
09:33,581655972.0,42895.71079399439,-196.0,2
09:34,865748375.0,2585.6674474084884,-16.99,1
09:34,909676212.0,724.3325317876131,-108.5,2
09:34,266777719.0,1343.9589337802397,-145.6,2
09:35,802697323.0,16888.946109414177,-49.67,4
09:36,417850087.0,16186.635414990238,-67.7,2
09:36,853907490.0,7956.346956843911,-51.69,6
09:39,986774156.0,1695.476931625769,-29.96,7
09:40,776108637.0,1147.019053657495,-22.0,6
09:45,480198977.0,12723.12302842848,-158.17,2
09:45,547010927.0,24608.12086510031,-5.2,7
09:47,266777719.0,1201.8589337802398,-142.1,2
09:47,598793068.0,284.408399999998,-109.97,4
09:47,279149837.0,2059.230049999999,-5.99,7
09:49,558119802.0,34521.73512376626,-39.64,7
09:54,517190750.0,2270.458589915413,-35.03,6
09:56,581655972.0,42848.76079399439,-46.95,7
09:57,235881534.0,13896.47167005736,-76.3,2
09:59,373163757.0,11691.593471507696,-21.99,1
10:00,279149837.0,2017.2300499999992,-42.0,2
10:02,473820682.0,11823.94326816372,-51.79,2
10:05,842682241.0,5975.021781672416,-39.7,8
10:06,170637730.0,1866.802494317279,-19.08,7
10:08,663479159.0,4807.781541827711,-75.59,2
10:09,909676212.0,487.0325317876131,-237.3,2
10:10,480198977.0,12688.15102842848,-34.97,2
10:14,409971170.0,3049.186855287899,-15.38,1
10:16,540159353.0,11829.789845534402,-11.19,2
10:17,279149837.0,1828.9300499999993,-188.3,2
10:17,873693307.0,10736.606923293086,-35.94,2
10:19,473820682.0,11788.94326816372,-35.0,2
10:19,656812046.0,1065.175753732519,-60.16,2
10:19,994947671.0,1358.5357000000004,-11.94,4
10:20,657528784.0,50.61690000000073,-40.68,5
10:20,874431242.0,9646.943484942814,-10.26,2
10:21,280990953.0,952.3996999999983,-84.98,2
10:21,134847904.0,5163.5788443862975,-16.98,1
10:23,564214408.0,-128.72651527427402,-37.98,5
10:23,282837512.0,14455.280186136177,-61.69,4
10:23,266777719.0,1097.5589337802398,-104.3,2
10:24,585596026.0,2847.1367009019905,-19.96,4
10:25,581655972.0,42747.96079399439,-100.8,2
10:27,626989363.0,1037.5410633173751,-28.0,2
10:28,612304466.0,-2246.7132499999993,-23.67,5
10:28,541639148.0,4258.217639209825,-30.92,2
10:29,117308635.0,2488.8230072910496,-10.03,2
10:30,775790822.0,-3257.5209192160673,-15.96,5
10:30,679911053.0,2911.034067221419,-28.99,1
10:31,220183538.0,826.9514499999993,-5.5,4
10:31,491392945.0,5626.485500000011,-29.98,2
10:33,189335192.0,-1243.322051757861,-106.05,5
10:33,287230540.0,1433.132293293266,-81.99,2
10:34,821971408.0,1179.6291102355433,-73.99,2
10:35,828532554.0,362.3803095172897,-189.0,2
10:35,642924505.0,427.500720183526,-11.0,4
10:36,408057540.0,5137.5657742592275,-19.03,2
10:36,854513972.0,1882.0337000000004,-19.99,2
10:37,315078351.0,8313.952238503087,-68.93,2
10:39,690523499.0,300.4209000000002,-11.97,7
10:39,769311479.0,6450.933004361811,-48.65,2
10:39,973086490.0,10553.593461574608,-44.9,5
10:39,874431242.0,9562.585704942814,-84.36,4
10:39,581655972.0,42614.96079399439,-133.0,2
10:42,604288474.0,1766.3035024864091,-17.39,4
10:42,833899961.0,1294.0565957180097,-9.99,2
10:42,605116158.0,2696.8941000000036,-29.99,2
10:42,534204159.0,5987.960374481007,-27.49,4
10:43,140893085.0,6971.790056365463,-44.98,2
10:43,482513594.0,6109.861782331106,-97.91,2
10:43,124102251.0,3455.177569450475,-84.52,5
10:43,534325901.0,7149.684682988999,-20.58,2
10:44,489964679.0,21044.275594614563,-6.34,2
10:44,310171581.0,-2265.7112043409193,-58.54,5
10:44,625281433.0,-813.4749573707569,-159.7,5
10:44,736340277.0,8975.345962648602,-22.62,7
10:45,456246119.0,21657.54591063602,-76.8,5
10:45,108481285.0,9190.780056819774,-21.99,7
10:45,252701364.0,-3938.3286726779143,-39.94,5
10:45,122884111.0,-787.1585830729687,-49.44,5
10:46,975200042.0,-3174.4451999999965,-41.88,5
10:46,355602925.0,1483.5902265753275,-35.0,2
10:47,138609932.0,2571.815003294586,-19.95,4
10:47,815993333.0,6453.020119617267,-43.18,2
10:47,187111705.0,7275.700300358729,-48.37,5
10:48,500043411.0,14082.50958089148,-29.01,2
10:48,828532554.0,252.38030951728967,-110.0,2
10:49,628470485.0,690.2390299001231,-26.97,7
10:49,779946617.0,17205.7566723346,-99.37,5
10:51,478412511.0,12550.31107019746,-154.29,2
10:53,279149837.0,1678.4300499999993,-150.5,2
10:54,822135975.0,11923.985371733876,-77.87,5
10:54,266777719.0,972.9589337802398,-124.6,2
10:54,828750680.0,1278.65269521368,-34.99,2
10:54,815385232.0,10856.897882402352,-37.95,4
10:54,540159353.0,11656.889845534402,-172.9,2
10:54,836110591.0,6687.129793091715,-30.38,7
10:55,851649498.0,8587.21589212013,-52.64,5
10:55,570410059.0,2215.5709967763114,-131.01,5
10:55,979135922.0,1062.991300590451,-157.14,2
10:55,555804115.0,-1422.4910475587033,-27.18,5
10:55,534325901.0,7075.5346829889995,-74.15,2
10:56,659008214.0,-3454.8201022904227,-15.88,5
10:57,147474476.0,3168.81480283296,-32.95,7
10:57,264550521.0,5552.106118871798,-21.14,7
10:57,152488934.0,1984.7123073137311,-32.97,2
11:01,737547541.0,-460.4984004322256,-62.12,5
11:01,370757362.0,1351.341589812676,-159.98,2
11:01,549414742.0,7794.531916830305,-54.49,7
11:02,124102251.0,3336.087569450475,-119.09,2
11:02,982949451.0,-3935.279167052508,-35.33,5
11:02,117308635.0,2473.7830072910497,-15.04,1
11:02,685959099.0,2026.2998660992432,-278.6,2
11:03,215426302.0,161.88040402569192,-57.05,5
11:03,380911501.0,-207.38870000000085,-123.23,5
11:04,235881534.0,13723.57167005736,-172.9,2
11:07,266777719.0,860.9589337802398,-112.0,2
11:08,588565416.0,6207.419417910288,-114.55,5
11:08,833499132.0,1774.2120000000025,-11.98,7
11:08,517934629.0,534.0076787084264,-63.98,2
11:09,493855007.0,-2756.7966315743915,-11.62,5
11:09,858560423.0,12787.519253018789,-94.97,4
11:10,510101371.0,13846.485221803729,-34.31,4
11:10,348460748.0,-413.804850000001,-146.67,5
11:11,149684419.0,313.7701999999979,-91.0,2
11:12,424927189.0,-0.4361672558948157,-45.09,5
11:12,519933553.0,44.511004150728446,-42.09,5
11:13,610645022.0,-547.1748626449184,-91.24,5
11:16,822135975.0,11917.895371733875,-6.09,7
11:19,500043411.0,14059.74958089148,-22.76,1
11:19,914806976.0,289.86325018548655,-5.99,4
11:20,203466392.0,3646.244895203059,-36.51,5
11:20,828532554.0,173.88030951728967,-78.5,2
11:20,279149837.0,1605.6300499999993,-72.8,2
11:21,999752672.0,1761.3030935333345,-23.94,5
11:21,235881534.0,13577.97167005736,-145.6,2
11:23,540159353.0,11509.203845534405,-147.69,2
11:25,510101371.0,13840.12202014144,-6.36,7
11:25,494789005.0,2719.934832984268,-7.64,2
11:26,987656636.0,4421.361670268176,-6.04,2
11:26,266777719.0,700.6589337802399,-160.3,2
11:26,364396689.0,-544.38325,-109.51,5
11:27,685959099.0,1822.5998660992432,-203.7,2
11:31,806358207.0,11656.038931249088,-36.19,2
11:33,279149837.0,1494.3300499999991,-111.3,2
11:33,429235692.0,-1059.1545000000003,-43.53,5
11:36,871866387.0,289.18499999999915,-45.58,5
11:38,661295096.0,3479.7829241721993,-45.97,4
11:43,511179916.0,7630.2493578691165,-49.72,5
11:46,769311479.0,6425.494897097174,-25.44,5
11:46,588565416.0,6195.1706327285565,-12.25,5
11:47,828532554.0,44.380309517289675,-129.5,2
11:48,895331556.0,-503.6641000000009,-64.98,5
11:48,331450202.0,8256.970827139363,-57.37,2
11:50,858989281.0,27518.34908117672,-39.92,2
11:54,284905540.0,8496.251105087893,-16.56,5
11:54,758160963.0,8768.738826340825,-48.38,4
11:54,540159353.0,11474.203845534405,-35.0,2
11:55,715068825.0,-388.4955000000002,-41.52,5
11:55,279149837.0,1355.0300499999994,-139.3,2
11:55,259015404.0,1283.9031039491008,-12.5,7
11:58,170637730.0,1853.534091453356,-13.27,7
12:00,828532554.0,-90.11969048271033,-134.5,2
12:00,266777719.0,458.4589337802399,-242.2,2
12:01,913127700.0,1683.327438011116,-172.01,5
12:01,414805878.0,13361.560896827272,-60.83,2
12:03,500043411.0,14058.57794895181,-1.17,2
12:04,534325901.0,7062.144682988999,-13.39,9
12:04,815385232.0,10831.607882402352,-25.29,7
12:08,223207876.0,-2080.4628999999995,-36.13,9
12:08,331450202.0,8223.272827139363,-33.7,5
12:10,246753533.0,283.6234999999984,-46.5,5
12:10,414805878.0,13317.370896827271,-44.19,9
12:12,196289502.0,16458.178397636944,-25.57,2
12:13,460463595.0,-343.1429454185789,-34.2,9
12:13,516051449.0,1631.7327746508286,-21.96,1
12:14,266777719.0,403.15893378023986,-55.3,2
12:16,785749304.0,8765.594108346066,-11.95,9
12:19,806358207.0,11602.591471249088,-53.45,4
12:21,179173981.0,4946.0796164814365,-157.44,2
12:21,331450202.0,8210.301355142534,-12.97,7
12:22,939972497.0,1437.0395586000109,-3.0,4
12:24,279149837.0,1153.4300499999997,-201.6,2
12:26,987229118.0,1113.3421898951449,-105.97,2
12:26,298000165.0,26920.21953842846,-80.19,8
12:29,987656636.0,4401.211670268176,-20.15,2
12:29,266777719.0,212.05893378023987,-191.1,2
12:31,494789005.0,2704.494832984268,-15.44,9
12:31,727417797.0,5996.51434847887,-151.64,5
12:33,656317661.0,-241.01895845859727,-25.38,9
12:38,499410772.0,-2922.816862905162,-35.82,5
12:39,970298834.0,2745.764310450903,-85.15,2
12:41,667367404.0,9621.806053191856,-6.27,4
12:42,456246119.0,21651.57591063602,-5.97,7
12:43,321372947.0,-389.9117507890995,-42.25,5
12:43,162162212.0,-264.239956672691,-25.96,1
12:43,235881534.0,13419.07167005736,-158.9,2
12:44,673025413.0,1049.1402867277875,-28.96,1
12:44,409370545.0,863.0992755455208,-6.03,7
12:46,792845450.0,908.5351500000008,-60.0,2
12:47,221868392.0,5139.653473484751,-28.15,9
12:48,821971408.0,1117.6931102355434,-61.94,5
12:50,266777719.0,115.45893378023987,-96.6,2
12:51,844835978.0,10563.620883329932,-37.79,5
12:52,421881811.0,2735.5060779773507,-9.47,7
12:52,482513594.0,6073.391782331106,-36.47,5
12:54,310620484.0,58.93119509219828,-81.55,2
12:56,812692024.0,4076.47470666393,-26.97,4
12:56,188263947.0,-36.95599999999938,-59.91,7
12:58,593191200.0,389.36979999999903,-142.66,5
12:59,388862238.0,1619.0865284731938,-17.94,4
12:59,657139925.0,13812.3091370234,-13.5,9
13:00,585625048.0,2167.069974999358,-6.5,9
13:03,828532554.0,-270.1196904827103,-180.0,2
13:06,856957948.0,10880.719154533906,-33.0,4
13:07,558119802.0,34496.49512376626,-25.24,9
13:08,913127700.0,1645.337438011116,-37.99,2
13:08,266777719.0,-30.14106621976012,-145.6,2
13:08,698076160.0,6722.147415135193,-25.89,9
13:08,286484726.0,668.5640320337758,-119.99,2
13:10,815385232.0,10809.337882402351,-22.27,4
13:10,279149837.0,988.9300499999996,-164.5,2
13:11,971129830.0,-1149.440649999999,-28.32,5
13:12,909676212.0,371.5325317876131,-115.5,2
13:14,672994751.0,154.12629078600995,-35.0,2
13:15,891716230.0,376.24407670186423,-41.71,5
13:16,215311171.0,6789.057598273492,-28.95,7
13:17,245690309.0,10033.303524429251,-29.08,5
13:18,266777719.0,-57.23106621976012,-27.09,7
13:19,736340277.0,8964.453962648602,-10.89,5
13:20,277562576.0,386.13798394362715,-5.35,9
13:21,179173981.0,4915.8296164814365,-30.25,9
13:23,836110591.0,6652.779793091715,-34.35,9
13:23,690958123.0,21870.424318934183,-13.99,4
13:24,187111705.0,7269.500300358729,-6.2,9
13:26,679911053.0,2880.9840472214187,-30.05,4
13:27,742223719.0,615.3933073048026,-5.99,2
13:27,433917275.0,7902.211756883582,-32.84,9
13:27,491392945.0,5595.307500000011,-31.18,5
13:27,310740977.0,262.69043592968086,-33.99,2
13:29,853907490.0,7900.738956843911,-55.61,5
13:32,322720763.0,6797.505440753339,-20.97,2
13:32,639409800.0,36968.35217018092,-120.94,2
13:33,466649401.0,219.75769355208743,-130.55,5
13:34,672994751.0,127.17629078600996,-26.95,1
13:34,828532554.0,-369.6196904827103,-99.5,2
13:35,279149837.0,922.4300499999996,-66.5,2
13:37,909676212.0,214.03253178761315,-157.5,2
13:37,237493332.0,15093.714634842709,-20.5,9
13:42,816685391.0,-719.8721037084264,-36.95,5
13:45,429556122.0,4736.009429294684,-41.1,5
13:47,349107386.0,-3698.543473194561,-109.32,5
13:50,514362267.0,53.5073191070603,-31.39,9
13:53,913801979.0,141.0011799144938,-148.47,5
13:54,492215823.0,3088.128933815445,-17.4,1
13:55,822135975.0,11905.675371733878,-12.22,7
13:56,279149837.0,694.2300499999994,-228.2,2
14:05,828532554.0,-414.1196904827103,-44.5,2
14:08,857997794.0,929.6976651508868,-3.98,4
14:09,540159353.0,11432.903845534403,-41.3,2
14:10,623156843.0,4973.691725305416,-14.37,5
14:10,575652395.0,2466.433110853572,-34.09,2
14:11,128030172.0,-553.9501774498499,-44.45,5
14:11,857754342.0,1272.574226279814,-49.99,2
14:14,878989510.0,5074.34988614179,-77.04,5
14:15,408057540.0,5095.225774259227,-42.34,9
14:16,461029994.0,8232.577410314172,-6.86,7
14:19,266777719.0,-323.2310662197601,-266.0,2
14:22,279149837.0,666.9300499999995,-27.3,2
14:24,540159353.0,11412.631845534404,-20.27,2
14:26,815385232.0,10736.427882402351,-72.91,2
14:27,828532554.0,-497.6196904827103,-83.5,2
14:28,151968462.0,7731.963441032694,-42.0,2
14:33,718058208.0,2214.773685722474,-53.12,7
14:35,626989363.0,917.5617633173752,-119.98,5
14:40,985188462.0,81.47638871122479,-29.58,9
14:40,828532554.0,-605.6196904827103,-108.0,2
14:42,266777719.0,-358.2310662197601,-35.0,2
14:52,667367404.0,9518.150053191855,-103.66,5
14:52,868377987.0,3069.40754617788,-1.66,7
14:56,266777719.0,-389.7310662197601,-31.5,2
14:57,279149837.0,565.4300499999995,-101.5,2
14:58,147474476.0,2919.89865283296,-248.92,5
15:06,143003091.0,10652.505401469582,-43.02,7
15:06,672913754.0,11928.2335257277,-54.1,2
15:07,859603181.0,3666.098010992333,-11.38,2
15:10,143061865.0,7557.750044059655,-24.15,5
15:11,821971408.0,1094.733110235543,-22.96,7
15:11,758160963.0,8754.536106340825,-14.2,4
15:12,992204045.0,7542.422304566514,-31.34,5
15:12,417850087.0,16104.24541499024,-82.39,2
15:16,117308635.0,2374.5790072910495,-99.2,5
15:18,540159353.0,11394.725845534402,-17.91,5
15:20,581655972.0,42260.76079399439,-354.2,2
15:22,266777719.0,-517.8310662197601,-128.1,2
15:23,279149837.0,442.9300499999995,-122.5,2
15:23,146909202.0,3655.638182497598,-20.61,5
15:25,124102251.0,3312.1275694504748,-23.96,4
15:28,235881534.0,13230.07167005736,-189.0,2
15:29,315546581.0,29719.28019553247,-44.32,8
15:30,108481285.0,9123.832056819774,-66.95,5
15:30,414454079.0,357.8378500000015,-2.54,4
15:33,151968462.0,7721.893321032694,-10.07,4
15:37,601627384.0,4061.884144325869,-20.82,7
15:38,279149837.0,397.4300499999995,-45.5,2
15:45,184430449.0,2738.43351682489,-11.11,2
15:45,518474507.0,14501.074920416808,-13.91,5
15:46,851181128.0,4976.271718726205,-57.27,5
15:48,297823329.0,764.3542999999992,-25.96,1
15:51,901037631.0,1624.4993230964064,-48.13,2
15:55,348525881.0,1019.511624594936,-12.98,7
15:55,279149837.0,324.63004999999947,-72.8,2
15:58,235881534.0,13139.771670057362,-90.3,2
16:00,151968462.0,7669.393321032694,-52.5,2
16:02,266777719.0,-635.4310662197602,-117.6,2
16:12,639409800.0,36917.96217018092,-50.39,2
16:13,837876918.0,104.58220853457988,-103.98,2
16:18,581655972.0,42131.96079399439,-128.8,2
16:18,912584712.0,-476.24638045526694,-5.99,7
16:20,828532554.0,-759.1196904827103,-153.5,2
16:23,245198540.0,285.6113988017795,-13.98,1
16:24,738958551.0,9580.524164228756,-21.52,2
16:27,151968462.0,7557.393321032694,-112.0,2
16:29,329840194.0,1460.882290143148,-121.1,2
16:32,266777719.0,-711.7310662197601,-76.3,2
16:47,581655972.0,41928.96079399439,-203.0,2
16:47,329840194.0,1274.6822901431478,-186.2,2
16:48,355733816.0,5655.445577096019,-15.98,7
16:48,613427466.0,7079.790455264377,-41.97,4
16:51,496395938.0,12665.957621330876,-28.1,7
16:52,106601471.0,11347.681322793243,-16.16,5
16:53,151968462.0,7380.993321032694,-176.4,2
16:53,266777719.0,-957.4310662197602,-245.7,2
16:54,169006407.0,12167.207286737985,-18.15,1
16:57,889916166.0,197.5034014132266,-23.48,4
16:58,844206657.0,1444.7226551465697,-166.98,2
17:00,435984758.0,4371.68925129637,-33.08,1
17:06,233981231.0,2435.4922892297586,-14.97,4
17:19,670102069.0,1683.8956556187795,-35.84,9
17:21,266777719.0,-1006.4310662197602,-49.0,2
17:24,613729471.0,8192.697503198166,-101.59,6
17:24,844206657.0,1414.7326551465696,-29.99,6
17:29,815993333.0,6411.363631736713,-41.66,7
17:32,951817450.0,9481.621384158723,-4.88,2
17:38,143003091.0,10552.525401469582,-99.98,4
17:43,399144202.0,1779.5855008189096,-43.14,9
17:45,279149837.0,171.3300499999995,-153.3,2
17:47,151278285.0,1951.88865,-129.98,2
17:49,995615876.0,1997.0854315809793,-211.39,2
17:53,329840194.0,1038.082290143148,-236.6,2
17:58,266777719.0,-1139.4310662197602,-133.0,2
18:02,853907490.0,7891.238956843911,-9.5,9
18:05,308505160.0,13846.207669594773,-42.0,2
18:06,629078930.0,193.95141326707176,-2.07,8
18:11,522188082.0,8368.329195006017,-7.0,2
18:17,995615876.0,1747.1854315809792,-249.9,2
18:18,329840194.0,975.782290143148,-62.3,2
18:22,279149837.0,-29.56995000000049,-200.9,2
18:22,984783496.0,14716.44428337144,-13.94,9
18:22,532478725.0,4980.009140515155,-37.19,9
18:28,270374623.0,10031.667772137436,-12.38,9
18:29,308505160.0,13801.407669594772,-44.8,2
18:29,475117511.0,7476.248298219497,-44.03,7
18:40,279149837.0,-105.86995000000049,-76.3,2
18:41,834383043.0,5464.324033300414,-28.25,9
18:44,995615876.0,1572.1994315809793,-174.99,2
18:53,308505160.0,13657.935669594774,-143.47,2
18:56,779620857.0,-765.739646385176,-26.19,9
18:59,279149837.0,-265.4699500000005,-159.6,2
19:04,687135796.0,29252.23777446999,-16.65,9
19:24,822718326.0,11692.87479769716,-52.49,7
19:25,305778936.0,10753.310253919082,-43.71,7
19:32,279149837.0,-286.4699500000005,-21.0,2
19:41,473820682.0,11770.55326816372,-18.39,9
20:30,996042490.0,6327.716795933064,-19.7,2
20:43,867987292.0,1846.012836208451,-3.01,2
21:16,822250278.0,6772.906340308613,-24.37,9
21:33,198946608.0,4517.559085006792,-39.83,7
21:44,285873880.0,13025.211084401351,-3.11,7
00:11,987163717.0,4102.414131891315,-38.39,9
00:12,705848712.0,28138.23059142594,-16.65,9
00:15,143061865.0,7529.991610851514,-27.76,7
00:17,822135975.0,11832.602744543505,-73.07,7
00:22,433837402.0,-94.4358684641881,-33.48,9
00:24,858989281.0,27499.41908117672,-18.93,9
00:25,146909202.0,3619.5519734785544,-36.09,2
00:26,986267641.0,4391.621577996087,-76.2,7
00:26,718058208.0,2183.8468316570393,-30.93,8
00:29,235881534.0,13103.315906536458,-36.46,7
00:29,785749304.0,8754.067525244895,-11.53,8
00:30,647936800.0,2464.024110145718,-12.66,4
00:32,910730524.0,8069.155943402976,-58.64,5
00:35,704517789.0,18515.11356162832,-17.57,2
00:40,949032480.0,4143.048718968993,-29.14,9
00:41,146909202.0,3586.4619734785542,-33.09,9
00:42,540159353.0,11389.978866068956,-4.75,2
00:43,887853850.0,10649.2090312643,-26.3,9
00:45,795847804.0,24447.025967262085,-4.55,8
00:46,433917275.0,7867.872059836045,-34.34,7
00:52,282837512.0,14416.290186136175,-38.99,9
00:53,667367404.0,9505.609232023997,-12.54,2
00:55,188263947.0,-72.37599999999938,-35.42,9
00:56,858989281.0,27451.903873800253,-47.52,2
01:03,769311479.0,6408.880693723251,-16.61,2
01:05,196289502.0,16439.978397636944,-18.2,9
01:06,166019891.0,8478.73783116332,-34.4,2
01:07,429556122.0,4692.407503868459,-43.6,5
01:17,897714622.0,9570.364908255218,-7.29,7
01:19,417850087.0,16090.507971314655,-13.74,5
01:20,124102251.0,3307.9062956921275,-4.22,2
01:27,699139822.0,1917.701661853552,-28.39,9
01:27,518474507.0,14469.354920416808,-31.72,9
01:31,113747882.0,12626.047372362334,-27.22,9
01:33,237684254.0,6126.773834118288,-43.04,7
01:39,383625050.0,3063.432929877358,-1.12,8
01:41,419550103.0,19351.69457938607,-8.28,2
01:48,519644021.0,2984.151758514363,-17.02,2
01:56,867987292.0,1844.3970888476963,-1.62,7
01:56,859603181.0,3663.718852490086,-2.38,5
02:03,240643705.0,200.07627962056807,-57.73,5
02:05,699139822.0,1889.466022229297,-28.24,7
02:06,471897866.0,7198.218627987639,-38.53,8
02:08,949032480.0,4134.3254646172145,-8.72,2
02:08,264550521.0,5517.630075044991,-34.48,7
02:11,887853850.0,10642.514828091076,-6.69,2
02:12,985188462.0,48.88638871122479,-32.59,9
02:13,237493332.0,15044.65198874961,-49.06,5
02:15,108481285.0,9072.903438188088,-50.93,7
02:16,874431242.0,9542.706252362175,-19.88,2
02:17,912705941.0,19221.192678501706,-37.68,2
02:19,940569402.0,5128.494660115777,-15.69,9
02:19,950234174.0,2110.546681988826,-42.07,5
02:20,427909748.0,707.6332000000151,-40.12,9
02:25,657139925.0,13789.339137023402,-22.97,9
02:25,221868392.0,5074.350645107368,-65.3,2
02:27,256002321.0,6472.198265003547,-14.1,9
02:29,851649498.0,8580.311184576609,-6.9,7
02:32,925659248.0,-724.3655892295711,-32.14,9
02:34,815385232.0,10694.876145181386,-41.55,4
02:38,970298834.0,2703.2567244229067,-42.51,8
02:47,213112754.0,5952.463654257295,-3.86,2
02:50,145387690.0,5565.575414695055,-31.14,9
02:52,809499628.0,18053.561134269687,-14.4,9
02:56,441274121.0,12658.661256149277,-0.9,7
02:57,187541224.0,2178.5034566485406,-35.68,9
02:59,901432314.0,3776.807211871225,-26.95,2
03:00,541639148.0,4248.393547661742,-9.82,7
03:03,661295096.0,3472.3942205965345,-7.39,8
03:04,624500124.0,3424.643698955774,-1.82,2
03:12,435984758.0,4357.9730577413575,-13.72,5
03:16,960208650.0,18175.425130503187,-11.9,7
03:17,399144202.0,1748.0455008189097,-31.54,9
03:18,940569402.0,5108.994390966446,-19.5,8
03:20,815993333.0,6386.116815871328,-25.25,5
03:20,534325901.0,7058.444316403053,-3.7,2
03:21,899742927.0,13450.352778409842,-16.8,2
03:21,433917275.0,7824.742059836045,-43.13,9
03:24,482513594.0,6009.781283326072,-63.61,8
03:26,534325901.0,7047.494316403053,-10.95,9
03:26,421881811.0,2731.9925510933704,-3.51,5
03:30,604288474.0,1732.257170891709,-34.05,2
03:36,639549973.0,7471.896699525623,-40.21,5
03:37,221868392.0,5047.000645107368,-27.35,9
03:39,679662108.0,16873.949870440672,-12.05,2
03:41,853907490.0,7878.548468180431,-12.69,7
03:50,874431242.0,9515.126252362175,-27.58,9
03:58,473820682.0,11766.864586144076,-3.69,7
04:05,586315521.0,12726.755253595604,-59.43,8
04:05,973086490.0,10543.456158311794,-10.14,2
04:08,315546581.0,29717.19042175233,-2.09,8
04:13,252760664.0,7071.43595469102,-55.11,4
04:17,113747882.0,12625.920649289055,-0.13,7
04:17,383833857.0,26565.45647389499,-18.74,9
04:22,943829984.0,-427.444490886543,-9.99,9
04:22,183888402.0,19500.362457140134,-40.04,9
04:29,290818242.0,7354.015291708063,-46.03,5
04:30,575652395.0,2465.672321765024,-0.76,7
04:33,450896297.0,13772.084782738371,-40.38,9
04:35,120634201.0,5403.355329403303,-18.95,9
04:40,407574996.0,-500.5663906190631,-34.78,9
04:43,587225252.0,6017.180045998135,-34.09,9
04:43,324224854.0,4455.438560162785,-17.49,9
04:48,145387690.0,5563.418894532371,-2.16,4
04:49,687135796.0,29241.797774469993,-10.44,9
04:50,409971170.0,3025.6968552878993,-23.49,9
04:50,383833857.0,26534.322264279752,-31.13,5
04:51,705848712.0,28137.8525037727,-0.38,4
04:54,730002588.0,14083.690709648552,-43.95,8
04:54,549414742.0,7756.05585213078,-38.48,8
04:54,506618547.0,15182.868198505766,-11.97,2
04:55,547010927.0,24588.22086510031,-19.9,9
04:58,822250278.0,6701.966458777604,-70.94,2
05:08,639409800.0,36882.910844631704,-35.05,5
05:13,651756497.0,14834.540997386945,-14.81,7
05:15,169006407.0,12147.26488710774,-19.94,7
05:22,108931112.0,14815.47412654393,-34.34,9
05:23,572384506.0,7606.443047528045,-37.79,9
05:24,832564361.0,15796.533826054592,-17.25,2
05:27,865748375.0,2584.112460652927,-1.55,2
05:28,324224854.0,4408.711668980676,-46.73,5
05:31,409971170.0,2957.1302751713806,-68.57,2
05:32,450896297.0,13744.736626290238,-27.35,2
05:35,930277104.0,10543.247628014316,-35.28,9
05:38,285220959.0,12345.405988863768,-12.26,5
05:38,554792076.0,29681.9522157304,-10.81,7
05:39,587225252.0,5995.629734202711,-21.55,7
05:42,675806859.0,7680.383751585952,-38.53,2
05:43,348325817.0,10861.984843900966,-29.64,9
05:51,336557504.0,1222.308627642028,-21.09,5
05:54,510101371.0,13808.79202014144,-31.33,9
05:55,151968462.0,7344.150540906267,-36.84,8
05:59,738958551.0,9547.654164228754,-32.87,9
06:00,836110591.0,6615.490353054192,-37.29,2
06:03,245690309.0,10008.030120458645,-25.27,7
06:06,322221939.0,3746.49641270801,-40.85,8
06:16,370521542.0,28051.15220144371,-11.29,2
06:16,601627384.0,4029.2041443258686,-32.68,9
06:18,842682241.0,5963.416800887444,-11.6,7
06:18,996042490.0,6272.261923148934,-55.45,5
06:20,857754342.0,1263.3262538559438,-9.25,7
06:20,670102069.0,1655.9156556187795,-27.98,9
06:24,683319988.0,7501.499022717475,-33.44,9
06:24,366550080.0,25952.995007791247,-23.71,7
06:26,709608057.0,2717.6502925888485,-40.37,9
06:26,280268430.0,5701.378049488365,-31.41,7
06:28,310375875.0,1878.4035918726056,-22.44,9
06:29,511179916.0,7574.492840966633,-55.76,8
06:29,700138124.0,5091.788351413657,-64.26,5
06:35,518474507.0,14464.148056163216,-5.21,5
06:37,308505160.0,13642.92692339392,-15.01,7
06:39,143003091.0,10546.913910856769,-5.61,7
06:45,572384506.0,7582.546138480052,-23.9,7
06:46,414805878.0,13282.880896827271,-34.49,9
06:47,749378808.0,4268.966177898642,-18.45,2
06:49,930277104.0,10494.36273059576,-48.88,8
06:50,520447032.0,8423.96797073869,-39.44,9
06:51,752362502.0,7821.345778668288,-13.26,2
06:54,550169791.0,22650.163805359425,-21.85,5
06:57,844835978.0,10561.38422360686,-2.24,2
06:59,170637730.0,1851.118465216746,-2.42,5
07:03,613729471.0,8161.2604156285715,-31.44,7
07:03,492215823.0,3056.478933815445,-31.65,9
07:06,766941757.0,2761.5113272545022,-32.39,9
07:06,687135796.0,29231.27878711492,-10.52,8
07:08,653640811.0,17993.119260745898,-2.23,5
07:10,331450202.0,8199.811355142534,-10.49,9
07:15,305778936.0,10748.138203186872,-5.17,5
07:16,719586818.0,19250.79683476514,-13.49,5
07:18,829914501.0,1526.5088065709745,-6.85,9
07:18,776108637.0,1139.2190536574951,-7.8,9
07:21,461990622.0,9965.675079246072,-2.12,8
07:25,403383649.0,960.9909037471626,-7.67,7
07:25,286484726.0,666.3274891525708,-2.24,8
07:26,822135975.0,11820.652744543502,-11.95,9
07:29,802697323.0,16860.716109414177,-28.23,9
07:30,558119802.0,34465.14512376626,-31.35,9
07:30,706250160.0,12976.27743818061,-16.95,5
07:32,984783496.0,14703.20428337144,-13.24,9
07:32,203466392.0,3627.128418313751,-19.12,5
07:33,298000165.0,26912.895659772003,-7.32,2
07:34,547010927.0,24548.66873054269,-39.55,7
07:35,399144202.0,1744.10907030937,-3.94,5
07:35,994214354.0,10245.291727004207,-33.25,9
07:40,609939116.0,7688.862785308384,-43.5,5
07:45,256002321.0,6401.459646066118,-70.74,7
07:46,108563213.0,23372.087093476144,-45.79,7
07:51,522188082.0,8354.554141936827,-13.78,4
07:52,187111705.0,7217.569131427096,-51.93,5
08:01,558119802.0,34390.68682052104,-74.46,5
08:03,454356905.0,1938.5270754288467,-12.25,2
08:03,984783496.0,14691.337116137793,-11.87,5
08:03,885259672.0,3360.2653946090336,-5.65,9
08:05,500043411.0,14055.186771382165,-3.39,7
08:07,824916823.0,8840.202252023466,-2.7,7
08:08,395284483.0,1175.464340211308,-5.45,9
08:10,987656636.0,4391.8105296878475,-9.4,5
08:16,331450202.0,8195.334695195264,-4.48,2
08:20,833499132.0,1729.7833500000022,-44.43,5
08:21,494156986.0,-499.5704543276653,-29.91,5
08:22,788740658.0,2791.691477387849,-38.25,4
08:22,234952520.0,415.4438999999988,-15.73,5
08:23,270374623.0,10022.188649653232,-9.48,7
08:23,995615876.0,1549.6958315809793,-22.5,5
08:25,969697937.0,-4989.34526567055,-16.33,5
08:25,679943657.0,3283.3568891801374,-53.32,5
08:25,736310094.0,-781.854324027426,-34.65,5
08:26,120634201.0,5394.475443611923,-8.88,2
08:27,344522228.0,-2949.729488208393,-19.04,5
08:27,738958551.0,9518.89194140334,-28.76,8
08:27,675806859.0,7566.920751585952,-113.46,5
08:27,989506909.0,-2582.264870759437,-22.85,5
08:29,478651121.0,-498.3724204015303,-121.06,5
08:29,493571342.0,-2627.828380907047,-24.56,5
08:30,925037906.0,1489.8668000000014,-102.0,5
08:30,891513205.0,576.1185296590689,-43.67,5
08:30,119993184.0,-2175.721902910862,-33.86,5
08:32,503575533.0,8238.004874664672,-83.27,5
08:32,873693307.0,10666.956923293086,-69.65,5
08:34,119943495.0,-1547.930062112858,-85.53,5
08:34,197865285.0,-326.8680382687797,-47.44,5
08:34,920031185.0,-68.19942051629224,-145.4,5
08:36,666952234.0,-327.4843518755132,-104.44,5
08:37,678851253.0,4064.6485547627058,-100.11,5
08:39,613427466.0,6968.364455264376,-111.43,5
08:39,402438092.0,263.67309999999895,-46.23,5
08:40,215832575.0,-1436.16946374422,-36.26,5
08:40,943329213.0,-153.65438065024233,-100.99,5
08:40,480557476.0,11608.547952731526,-30.29,2
08:41,954263768.0,-235.88190000000023,-45.33,5
08:41,905860285.0,10789.673765676016,-4.36,2
08:42,799286313.0,-1110.0716128758615,-49.66,5
08:42,494404688.0,-2772.1732653362074,-40.83,5
08:42,170233640.0,-545.4316100501027,-16.52,5
08:42,469561218.0,-206.42055000000084,-92.07,5
08:42,744211756.0,-4391.038249999992,-11.84,5
08:43,460463595.0,-372.79794541857893,-29.66,5
08:43,697140785.0,-92.44738326389682,-138.6,5
08:43,859264768.0,-158.17881621806168,-115.73,5
08:45,623156843.0,4939.908692141996,-33.78,8
08:46,681955876.0,-1461.4831000000006,-52.95,5
08:47,374994043.0,-2360.4305500000005,-16.72,5
08:47,643610517.0,-3042.888690729657,-12.2,5
08:47,820686957.0,-1027.008866311196,-134.18,5
08:48,426474982.0,-3870.88975,-13.5,5
08:50,762896656.0,-1136.1950018481414,-33.55,5
08:51,696333897.0,145.76634999999882,-29.49,5
08:52,795847804.0,24388.498967262087,-58.53,5
08:52,520447032.0,8417.466548794135,-6.5,8
08:53,758160963.0,8672.118106340826,-82.42,5
08:54,758160963.0,8659.514286875628,-12.6,2
08:54,886921642.0,3421.5477969255176,-14.42,5
08:56,250957494.0,777.8329999999986,-66.19,5
08:56,550832673.0,3275.8420163955093,-30.63,5
08:59,322221939.0,3577.7824127080107,-168.71,5
08:59,854513972.0,1788.9869000000003,-93.05,5
08:59,409370545.0,805.2022755455207,-57.9,5
09:00,204855464.0,-993.1923886396162,-226.25,5
09:01,624563756.0,-353.58307121644356,-29.25,5
09:02,506618547.0,15151.368198505766,-31.5,5
09:03,290818242.0,7346.215291708063,-7.8,9
09:03,345514953.0,-932.3353000000006,-29.68,5
09:03,215311171.0,6737.460598273492,-51.6,5
09:04,683078800.0,2201.431542731244,-7.5,9
09:05,999752672.0,1755.9530935333346,-5.35,9
09:07,506618547.0,15146.118198505766,-5.25,9
09:07,653667523.0,3552.7988995700157,-166.45,5
09:07,804317849.0,-4025.216633020518,-121.0,5
09:08,624563756.0,-359.6830712164436,-6.1,9
09:08,179173981.0,4912.064751911237,-3.76,2
09:08,987229118.0,1042.4671898951449,-70.88,5
09:09,524425303.0,-941.9484000000012,-80.23,5
09:10,659415300.0,1785.1211305359598,-93.86,5
09:10,462962606.0,940.2500499999989,-65.31,5
09:10,656389634.0,-352.8968404219855,-47.5,5
09:13,690958123.0,21864.52431893418,-5.9,9
09:13,467207141.0,114.24641704826364,-149.7,5
09:15,214339619.0,483.3069108056876,-6.85,9
09:15,990461108.0,530.001068620611,-46.44,5
09:16,819515373.0,2360.7161360637933,-99.97,4
09:16,169006407.0,12140.81488710774,-6.45,9
09:16,383833857.0,26441.152264279754,-93.17,5
09:17,587225252.0,5960.899734202711,-34.73,1
09:17,472995101.0,1275.7927842428037,-14.99,4
09:17,575652395.0,2429.484081765024,-36.19,4
09:18,586315521.0,12720.605253595604,-6.15,9
09:18,540159353.0,11384.878866068955,-5.1,9
09:19,851649498.0,8574.961184576609,-5.35,9
09:19,403383649.0,919.0009037471626,-41.99,1
09:20,815993333.0,6384.5992658713285,-1.52,4
09:20,933491926.0,3458.1263000000044,-67.69,5
09:23,117273481.0,9177.536720450742,-6.2,9
09:23,475117511.0,7451.909298219497,-24.34,5
09:24,558875206.0,3454.5665393997806,-6.85,9
09:25,441274121.0,12651.861256149276,-6.8,9
09:25,180616589.0,1075.5351699949167,-8.81,5
09:25,680773155.0,344.7039833310914,-48.66,5
09:26,741903302.0,2643.648315014126,-31.48,4
09:27,667367404.0,9499.809232023996,-5.8,9
09:27,215311171.0,6698.437747564417,-39.02,2
09:27,414454079.0,352.2478500000015,-5.59,4
09:28,969804197.0,-537.6387500000008,-40.99,5
09:32,700138124.0,5002.972351413658,-88.82,5
09:34,518746136.0,-1073.0397282369167,-41.7,5
09:35,570269025.0,3512.6030729118297,-82.89,5
09:37,754141345.0,-3158.6853351157597,-25.4,5
09:37,984783496.0,14594.051116137793,-97.29,5
09:38,776431321.0,3174.7017939307834,-93.58,5
09:39,679943657.0,3171.3568891801374,-112.0,2
09:39,925037906.0,1457.9468000000013,-31.92,4
09:41,762859681.0,2968.292599999999,-170.65,5
09:42,601627384.0,3814.304144325869,-214.9,2
09:45,587225252.0,5928.169734202712,-32.73,2
09:47,128033695.0,2174.20570462469,-35.76,4
09:49,514362267.0,36.52731910706029,-16.98,4
09:49,527842638.0,365.73144263298343,-6.99,4
09:54,421881811.0,2606.8125510933705,-125.18,2
09:55,290751280.0,191.30354667482555,-57.98,2
09:55,550832673.0,3209.8620163955093,-65.98,2
09:56,145387690.0,5520.718894532371,-42.7,2
09:58,844206657.0,1279.7426551465696,-134.99,2
10:01,642015139.0,-69.23366253436174,-37.95,1
10:02,508518911.0,-117.39524972098968,-127.99,2
10:02,743630833.0,245.5095632847012,-27.94,9
10:03,679943657.0,3023.6988891801375,-147.66,2
10:03,585625048.0,2132.069974999358,-35.0,2
10:04,264550521.0,5511.541755044991,-6.09,4
10:09,792845450.0,763.5651500000008,-144.97,2
10:12,225210798.0,984.9059351225794,-19.98,4
10:12,601627384.0,3604.304144325869,-210.0,2
10:14,873701090.0,492.2174004684359,-21.03,1
10:15,652048867.0,498.55089999999893,-31.44,5
10:16,679943657.0,2967.3688891801376,-56.33,2
10:19,254853117.0,3281.9719407437556,-54.04,2
10:19,134461671.0,5547.411808659268,-1.61,7
10:20,655368335.0,4906.004122195575,-135.12,2
10:21,282837512.0,14409.140186136176,-7.15,9
10:23,749378808.0,4130.408177898642,-138.56,2
10:24,812692024.0,4048.47470666393,-28.0,2
10:24,472995101.0,1247.8327842428034,-27.96,7
10:24,844206657.0,1189.7526551465696,-89.99,2
10:24,383833857.0,26427.752264279752,-13.4,1
10:25,364357875.0,8647.519883024785,-11.83,5
10:34,165045150.0,697.4160614028557,-52.93,1
10:34,355940285.0,8042.972978189684,-52.92,7
10:36,454356905.0,1900.9589154288467,-37.57,4
10:42,779946617.0,17182.30595415953,-23.45,5
10:43,461029994.0,8006.505410314172,-226.07,2
10:45,657139925.0,13785.335437155389,-4.0,7
10:50,749378808.0,3972.236177898642,-158.17,2
10:50,673025413.0,962.9142867277876,-86.23,5
10:52,272538745.0,16904.19990000002,-112.98,2
10:52,873701090.0,326.7474004684359,-165.47,2
10:52,454356905.0,1866.738915428847,-34.22,7
10:55,856957948.0,10860.729154533909,-19.99,2
10:58,819515373.0,2333.823536063793,-26.89,5
10:58,741903302.0,2541.2250150141263,-102.42,5
10:59,522188082.0,8330.424141936828,-24.13,1
11:01,679943657.0,2904.396889180138,-62.97,2
11:02,611143859.0,1390.893550000012,-80.15,2
11:02,769319491.0,-62.64800000000079,-30.95,1
11:02,308897841.0,1217.0977999999989,-51.98,5
11:06,749378808.0,3684.564177898642,-287.67,2
11:09,480198977.0,12551.63002842848,-136.52,5
11:11,475117511.0,7434.9292982194975,-16.98,7
11:12,793781222.0,814.6288789474061,-13.97,4
11:13,254853117.0,3271.8509271559665,-10.12,7
11:13,985188462.0,23.38638871122479,-25.5,2
11:15,924045955.0,-108.59855734133512,-107.16,5
11:19,749378808.0,3597.424177898642,-87.14,2
11:21,256002321.0,6309.969646066118,-91.49,5
11:23,793781222.0,676.648878947406,-137.98,2
11:24,556992209.0,12459.830547360169,-3.18,4
11:29,108931112.0,14796.81972654393,-18.65,4
11:30,679943657.0,2628.6248891801374,-275.77,2
11:36,909676212.0,170.11453178761317,-43.92,5
11:40,749378808.0,3420.3381778986422,-177.09,2
11:41,916270283.0,2465.0562500000005,-22.97,1
11:44,948558249.0,10009.839963903549,-14.26,5
11:46,570269025.0,3487.63307291183,-24.97,7
11:47,441142605.0,2083.7968422757294,-21.97,7
11:48,364357875.0,8578.240883024784,-69.28,5
11:48,987229118.0,942.4771898951448,-99.99,2
11:50,901432314.0,3756.129211871225,-20.68,5
11:55,348325817.0,10859.794523900966,-2.19,4
11:55,534204159.0,5939.543359001646,-48.42,7
11:58,570269025.0,3428.66307291183,-58.97,4
11:59,586041848.0,-154.8213000000011,-25.98,4
12:05,909676212.0,150.12453178761314,-19.99,2
12:09,973086490.0,10536.206158311794,-7.25,9
12:09,766941757.0,2729.1459872545024,-32.37,4
12:12,570269025.0,3365.66307291183,-63.0,2
12:15,572384506.0,7486.606138480052,-95.94,2
12:17,749378808.0,3330.038177898642,-90.3,2
12:18,749378808.0,3295.198177898642,-34.84,9
12:22,679943657.0,2347.2528891801376,-70.0,2
12:22,280990953.0,916.2596999999984,-36.14,9
12:23,108812033.0,625.2019999999983,-15.49,9
12:25,550832673.0,3171.922016395509,-37.94,1
12:32,655368335.0,4904.459864897443,-1.54,2
12:48,679943657.0,2212.1808891801375,-135.07,2
12:48,904154012.0,458.0974581204316,-49.99,2
12:52,845648250.0,156.93884999999938,-63.74,5
12:53,284905540.0,8473.951105087894,-22.3,9
12:54,874506295.0,-1476.634256245572,-15.43,5
12:56,812839908.0,-1756.5573500000005,-49.09,5
13:00,252419513.0,-2294.698685813415,-33.8,5
13:00,245198540.0,195.2588988017795,-90.35,7
13:00,977899503.0,69.01289358085265,-133.0,2
13:00,358836279.0,228.5543428075857,-87.34,5
13:01,452974357.0,-3027.6664499999943,-29.16,5
13:02,779236304.0,2077.9075954795335,-31.58,9
13:06,189757473.0,-2278.188649999999,-18.22,5
13:07,285873880.0,12980.163398782335,-45.05,4
13:12,441142605.0,2005.8721422757296,-77.92,5
13:13,245198540.0,152.5163988017795,-42.74,4
13:14,195895574.0,7657.129822164485,-2.08,7
13:19,688712152.0,6994.19788813209,-5.45,9
13:22,892354433.0,-871.1799606343386,-78.6,5
13:32,948558249.0,9943.645881139864,-66.19,2
13:34,352291960.0,2410.298053303574,-13.0,2
13:36,818552503.0,317.78809999999896,-310.06,5
13:49,749378808.0,3071.912177898642,-223.29,2
13:51,165045150.0,673.3485614028557,-24.07,5
13:52,741903302.0,2526.2550150141265,-14.97,4
13:53,901432314.0,3746.019211871225,-10.11,1
13:55,195895574.0,7623.889822164485,-33.24,9
14:02,551755686.0,7044.542485725706,-26.96,1
14:07,899692478.0,-2066.550843524007,-109.37,5
14:11,679943657.0,2000.108889180137,-212.07,2
14:12,977899503.0,-76.58710641914735,-145.6,2
14:12,822250278.0,6667.316458777605,-34.65,5
14:24,660561861.0,344.8348316336894,-24.74,5
14:25,977899503.0,-336.28710641914734,-259.7,2
14:29,170637730.0,1788.897365216746,-62.22,4
14:29,679943657.0,1923.8368891801376,-76.27,2
14:33,749378808.0,2990.740177898642,-81.17,2
14:45,769319491.0,-90.6005000000008,-27.95,5
14:51,228136274.0,1258.8245999999997,-31.87,4
14:53,348325817.0,10847.620513177488,-12.17,7
14:58,673025413.0,960.0688548679992,-2.85,2
15:06,749378808.0,2747.868177898642,-242.87,2
15:10,165045150.0,532.3685614028557,-140.98,2
15:14,388862238.0,1607.6320088728069,-11.45,5
15:15,977899503.0,-609.2871064191473,-273.0,4
15:20,691843653.0,-3251.7658999999926,-29.08,5
15:21,550832673.0,3102.1320163955093,-69.79,5
15:24,993663752.0,-557.3701575896037,-154.91,5
15:25,448279144.0,1058.382199999999,-69.97,4
15:28,461029994.0,8000.515410314172,-5.99,4
15:30,259015404.0,1251.9231039491008,-31.98,9
15:31,198946608.0,4450.369085006792,-67.19,2
15:40,116598243.0,2096.1012217774505,-92.53,5
15:42,352899149.0,559.5450499999987,-28.96,7
15:48,749378808.0,2602.2821778986417,-145.59,2
16:03,977899503.0,-698.8031064191473,-89.52,5
16:05,274818272.0,278.0781785671314,-153.22,5
16:16,749378808.0,2567.9961778986417,-34.29,2
16:23,678330503.0,1357.0613719395276,-50.69,2
16:26,912584712.0,-505.2063804552669,-28.96,1
16:28,749378808.0,2290.0961778986416,-277.9,2
16:29,532478725.0,4946.819140515156,-33.19,9
16:31,158414827.0,-1508.7050000000015,-16.23,5
16:31,698076160.0,6716.157415135193,-5.99,2
16:32,198051483.0,-991.536910408857,-47.82,5
16:36,627723633.0,-2339.963828003762,-42.21,5
16:38,280990953.0,889.2796999999983,-26.98,4
16:40,604334058.0,336.8777999999993,-6.99,4
16:42,224112146.0,1933.9361,-40.95,7
16:46,709608057.0,2705.3369947509027,-12.31,2
16:51,744968736.0,-1582.856826569424,-32.8,5
16:51,126929801.0,1522.8537015783834,-44.99,2
16:51,583579399.0,2076.603400000001,-87.52,5
16:52,785210466.0,2137.994919997712,-27.36,5
16:52,749378808.0,2138.2381778986414,-151.86,2
16:57,354894456.0,-29.900000000000432,-31.39,9
16:59,345582855.0,470.7564528205494,-49.56,5
16:59,259015404.0,1213.1443356042248,-38.78,5
17:01,583579399.0,2051.643400000001,-24.96,7
17:02,886921642.0,3407.687647345955,-13.86,7
17:03,761272540.0,-16.47560000000125,-133.13,5
17:05,183186021.0,-1345.7750499999988,-49.99,5
17:14,216285378.0,24889.937384634904,-46.3,9
17:14,836110591.0,6585.390353054192,-30.1,9
17:15,512989907.0,-2509.9219039753657,-28.84,5
17:23,994214354.0,10239.984021321936,-5.31,2
17:30,147474476.0,2856.9086528329603,-62.99,2
17:30,742223719.0,468.39330730480265,-147.0,2
17:32,668692488.0,817.2252785738098,-9.99,4
17:33,229205098.0,7981.850123387161,-4.88,5
17:34,581655972.0,41922.58450228887,-6.38,5
17:35,700138124.0,4917.042351413657,-85.93,2
17:36,131388684.0,22114.533121684,-26.43,5
17:37,629078930.0,173.04381326707176,-20.91,5
17:38,500843551.0,443.9841999999997,-1.5,4
17:38,373163757.0,11669.593471507696,-22.0,4
17:39,627622066.0,3804.5562221696296,-70.98,2
17:40,417850087.0,15938.649971314657,-151.86,2
17:40,851181128.0,4866.294718726205,-109.98,5
17:40,532478725.0,4912.519140515155,-34.3,7
17:42,670427480.0,617.3908000000013,-129.5,2
17:43,479366718.0,2246.341447632401,-46.97,4
17:43,713910252.0,-1241.8984742714588,-103.06,5
17:44,857754342.0,1237.3662538559438,-25.96,7
17:44,540159353.0,11354.414866068955,-30.46,5
17:44,858560423.0,12707.019253018789,-80.5,2
17:46,169006407.0,11974.256887107738,-166.56,2
17:46,939972497.0,1379.0595586000106,-57.98,2
17:47,336557504.0,1167.318627642028,-54.99,2
17:47,383625050.0,2936.3619298773583,-127.07,5
17:48,277562576.0,381.78006997625704,-4.36,7
17:48,651756497.0,14737.646997386944,-96.89,5
17:48,886921642.0,3360.423647345955,-47.26,5
17:48,520418719.0,665.1596500000036,-38.6,5
17:50,956717493.0,1303.2298504359833,-47.0,2
17:50,618514666.0,22305.27597749449,-28.95,7
17:50,151968462.0,7143.370540906268,-200.78,2
17:50,141521177.0,8043.367900000016,-37.99,2
17:50,873693307.0,10582.29187035796,-84.67,5
17:51,876890798.0,3849.8709706999334,-12.99,2
17:52,290818242.0,7291.643291708063,-54.57,5
17:55,742223719.0,384.39330730480265,-84.0,2
17:55,361201224.0,3502.728615745993,-139.3,2
17:55,441274121.0,12539.311256149278,-112.55,2
17:56,365608668.0,107.1390104738326,-63.69,2
17:56,858560423.0,12557.919253018788,-149.1,2
18:02,605116158.0,2637.8941000000036,-59.0,2
18:02,851181128.0,4842.914718726205,-23.38,9
18:03,506618547.0,15125.118198505766,-21.0,2
18:03,417850087.0,15757.349971314658,-181.3,2
18:04,873693307.0,10568.54187035796,-13.75,9
18:06,344219145.0,8347.360063536787,-88.24,5
18:06,776108637.0,1066.4190536574952,-72.8,2
18:06,749378808.0,1989.8661778986416,-148.37,2
18:06,280130290.0,-317.8797500000005,-35.48,9
18:08,698955014.0,251.92393020319673,-109.94,5
18:08,670427480.0,542.8908000000013,-74.5,2
18:09,678851253.0,4040.732015254582,-23.92,5
18:09,532478725.0,4864.219140515155,-48.3,7
18:12,642924505.0,215.541070183526,-71.96,5
18:17,365608668.0,10.539010473832604,-96.6,2
18:19,776108637.0,806.7610536574953,-259.66,2
18:21,939972497.0,1231.6091086000106,-147.45,5
18:22,435984758.0,4336.306737741357,-21.67,7
18:25,361201224.0,3238.128615745993,-264.6,2
18:26,235881534.0,13086.197706536455,-17.12,7
18:26,858560423.0,12436.819253018786,-121.1,2
18:27,532478725.0,4717.919140515155,-146.3,4
18:29,198051483.0,-1023.686910408857,-32.15,9
18:32,506618547.0,15069.818198505767,-55.3,2
18:34,749378808.0,1912.8801778986413,-76.99,2
18:39,213112754.0,5833.407654257296,-119.06,5
18:42,835736339.0,2205.258066146472,-15.01,7
18:50,506618547.0,14948.018198505768,-121.8,2
18:50,986267641.0,4371.0625779960865,-20.56,5
18:51,496395938.0,12635.731621330877,-30.23,5
18:53,175452235.0,-1657.9647499999996,-68.21,5
18:56,315546581.0,29702.13042175233,-15.06,4
19:00,696758548.0,-3604.137896320137,-54.73,5
19:01,532478725.0,4672.375310946562,-45.54,5
19:03,776108637.0,749.3715536574953,-57.39,5
19:03,270374623.0,9924.244649653234,-97.94,5
19:07,424397946.0,974.7437836054002,-110.75,5
19:16,854895960.0,3772.9837072291984,-93.88,5
19:18,392270893.0,13439.955643916195,-88.98,5
19:18,287230540.0,1413.980997763875,-19.15,4
19:18,163470640.0,1026.1106999999995,-56.99,5
19:20,471897866.0,7143.688627987639,-54.53,5
19:21,951817450.0,9404.271384158725,-77.35,5
19:29,824916823.0,8823.862252023466,-16.34,9
19:30,668329719.0,9103.646284777366,-9.61,2
19:31,975345315.0,36804.12606710485,-67.56,5
19:32,637433131.0,0.012699999998972,-188.9,5
19:32,408057540.0,5026.395709325733,-68.83,7
19:44,386729293.0,31764.61935721876,-0.81,4
19:46,656812046.0,1027.285753732519,-37.89,9
19:53,550169791.0,22640.763805359424,-9.4,9
19:55,683319988.0,7444.344605490019,-57.15,2
20:07,390747457.0,570.4256999999978,-48.51,5
20:10,287480331.0,7809.140593022307,-31.34,2
20:18,736340277.0,8935.347962648602,-29.11,5
20:31,287480331.0,7770.500593022307,-38.64,9
20:34,885259672.0,3302.3068362591157,-57.96,7
20:38,229205098.0,7947.158123387161,-34.69,5
20:43,469330905.0,-112.1235713766444,-19.04,2
20:44,920830317.0,-275.39612936251865,-90.91,5
20:48,310375875.0,1828.158049308053,-50.25,4
20:49,885259672.0,3273.1568362591156,-29.15,9
20:51,771125520.0,459.3332999999991,-79.48,5
20:51,670427480.0,454.63200000000126,-88.26,5
00:14,984783496.0,14582.761116137792,-11.29,9
00:19,348325817.0,10817.040513177488,-30.58,9
00:23,779236304.0,2049.5175954795336,-28.39,9
00:30,305778936.0,10719.238203186873,-28.9,9
00:41,766941757.0,2697.865987254502,-31.28,9
00:44,973086490.0,10524.256158311791,-11.95,9
00:50,556631012.0,-44.126676914321905,-28.22,9
00:53,899742927.0,13423.715653969475,-26.64,7
01:08,340321732.0,1810.7955500000037,-27.43,9
01:15,973086490.0,10476.925300630084,-47.33,8
01:41,215311171.0,6678.2297198973,-20.21,7
01:48,613729471.0,8116.735937535595,-44.52,2
02:27,691789577.0,-940.7453,-16.14,9
02:42,108563213.0,23344.447592983222,-27.64,7
02:43,480557476.0,11589.222309720397,-19.33,5
02:43,532478725.0,4645.695310946562,-26.68,9
02:48,187541224.0,2138.9134566485404,-39.59,9
02:50,822250278.0,6664.657138035657,-2.66,5
02:56,558119802.0,34368.736820521044,-21.95,9
02:59,282837512.0,14378.910186136178,-30.23,9
03:00,305778936.0,10715.263931701204,-3.97,8
03:01,252760664.0,7052.718524932486,-18.72,2
03:03,987163717.0,4064.214131891315,-38.2,9
03:08,417850087.0,15757.069330736074,-0.28,7
03:17,604288474.0,1724.8671708917088,-7.39,9
03:19,802697323.0,16821.076109414178,-39.64,9
03:20,196289502.0,16418.088397636944,-21.89,9
03:23,575652395.0,2401.495375860366,-27.99,7
03:26,532478725.0,4639.327168629736,-6.37,7
03:38,322720763.0,6765.715440753339,-31.79,9
03:41,949032480.0,4110.635464617215,-23.69,9
03:46,421881811.0,2570.3047136073124,-36.51,5
03:46,216285378.0,24855.197384634903,-34.74,9
03:46,779946617.0,17150.41595415953,-31.89,9
03:49,518474507.0,14437.878056163216,-26.27,9
03:53,886921642.0,3356.2947422267835,-4.13,8
03:55,858989281.0,27440.953873800252,-10.95,9
04:01,549414742.0,7727.25585213078,-28.8,9
04:02,806358207.0,11579.374645019116,-23.22,5
04:03,221868392.0,5020.520645107368,-26.48,9
04:05,639549973.0,7449.706699525624,-22.19,9
04:10,370521542.0,28040.66220144371,-10.49,9
04:10,657139925.0,13762.585437155389,-22.75,9
04:18,623156843.0,4939.655459318962,-0.25,8
04:18,124102251.0,3255.804133288864,-52.1,2
04:19,324224854.0,4392.105343062968,-16.61,2
04:23,950234174.0,2107.8991844001803,-2.65,8
04:28,547010927.0,24511.978730542687,-36.69,9
04:33,873693307.0,10559.05187035796,-9.49,9
04:34,169006407.0,11973.972223267188,-0.28,7
04:36,187541224.0,2114.957766441192,-23.96,7
04:37,809499628.0,18036.631134269686,-16.93,9
04:40,779946617.0,17141.0288660422,-9.39,7
04:40,670102069.0,1632.4756556187797,-23.44,9
04:41,475117511.0,7369.488471991136,-65.44,5
04:48,885259672.0,3262.997028743877,-10.16,5
04:48,679662108.0,16840.031161951305,-33.92,5
04:53,647936800.0,2438.4665210440485,-25.56,8
04:54,270374623.0,9911.754649653234,-12.49,9
04:58,705848712.0,28091.769679808232,-46.08,5
05:01,170637730.0,1783.7958101790298,-5.1,5
05:05,408057540.0,5012.762414954283,-13.63,5
05:05,887853850.0,10614.064828091075,-28.45,9
05:06,310375875.0,1793.718049308053,-34.44,9
05:07,547010927.0,24509.614198454325,-2.36,2
05:07,550169791.0,22618.47618323605,-22.29,2
05:08,489964679.0,20973.055594614565,-44.05,9
05:08,730002588.0,14030.101499175013,-53.59,5
05:10,873693307.0,10554.273372220943,-4.78,2
05:13,187111705.0,7170.328279945586,-47.24,2
05:14,647472692.0,26726.882062720528,-31.68,9
05:18,667367404.0,9478.423423898868,-21.39,5
05:19,836110591.0,6558.710353054192,-26.68,9
05:19,256002321.0,6288.929646066118,-21.04,9
05:19,994214354.0,10207.834021321936,-32.15,9
05:22,910730524.0,8056.095161492804,-13.06,2
05:25,270374623.0,9894.798532005429,-16.96,4
05:35,120634201.0,5380.445443611923,-14.03,9
05:35,586315521.0,12700.165253595604,-20.44,9
05:36,887853850.0,10598.212303248943,-15.85,2
05:37,310375875.0,1723.0887034370517,-70.63,5
05:37,203466392.0,3595.9333166587744,-31.2,7
05:44,851181128.0,4819.674718726205,-23.24,9
05:49,183888402.0,19458.362457140134,-42.0,9
05:50,237684254.0,6101.37783783559,-25.4,7
05:50,471897866.0,7138.109244938097,-5.58,7
05:54,699139822.0,1867.811017201628,-21.66,2
05:54,108931112.0,14767.24972654393,-29.57,9
05:55,940569402.0,5071.787605151155,-37.21,2
05:56,489964679.0,20941.144294356283,-31.91,2
06:00,601627384.0,3571.4841443258683,-32.82,9
06:00,143003091.0,10533.067813535044,-13.85,5
06:03,414805878.0,13242.460896827271,-40.42,9
06:03,683319988.0,7418.014605490019,-26.33,9
06:05,290818242.0,7268.096368764662,-23.55,7
06:07,758160963.0,8640.614286875629,-18.9,9
06:09,519644021.0,2913.3812031157963,-70.77,7
06:10,506618547.0,14911.370358352651,-36.65,5
06:13,549414742.0,7704.48820815215,-22.77,2
06:16,709608057.0,2661.366994750903,-43.97,9
06:16,832564361.0,15795.32364221297,-1.21,7
06:19,229205098.0,7884.632157137973,-62.53,5
06:22,264550521.0,5424.614784543898,-86.93,2
06:22,994214354.0,10206.766068798115,-1.07,7
06:26,706250160.0,12954.427136816412,-21.85,2
06:30,558119802.0,34312.712973167305,-56.02,2
06:30,383625050.0,2933.8944229229796,-2.47,7
06:31,675806859.0,7538.089846735999,-28.83,2
06:34,221868392.0,5015.10335263462,-5.42,7
06:37,108481285.0,9067.552295121688,-5.35,7
06:39,822135975.0,11783.18336371828,-37.47,4
06:41,679911053.0,2880.740239337816,-0.24,2
06:41,851181128.0,4814.80359228586,-4.87,5
06:42,364357875.0,8539.426473294176,-38.81,5
06:42,195895574.0,7593.649822164485,-30.24,9
06:43,683319988.0,7360.440720189382,-57.57,2
06:44,668329719.0,9095.652889443918,-7.99,2
06:44,588565416.0,6137.014507525978,-58.16,2
06:45,621652856.0,-98.13403038946002,-39.08,9
06:47,678851253.0,3966.788431633632,-73.94,4
06:48,128033695.0,2153.30570462469,-20.9,9
06:48,766941757.0,2681.0585102455257,-16.81,2
06:48,448004226.0,1626.0575686648797,-11.02,2
06:50,473820682.0,11759.53889598551,-7.33,8
06:51,809499628.0,18023.58248379754,-13.05,4
06:51,853907490.0,7866.348468180431,-12.2,9
06:54,718058208.0,2177.035607011628,-6.81,2
06:57,259015404.0,1188.3443356042249,-24.8,9
07:03,287480331.0,7707.196202348877,-63.3,2
07:04,179173981.0,4907.593539623546,-4.47,2
07:04,450896297.0,13713.406626290238,-31.33,9
07:08,366550080.0,25914.31151191985,-38.68,2
07:08,992204045.0,7540.626852566713,-1.8,5
07:11,572384506.0,7443.306138480052,-43.3,9
07:11,145387690.0,5489.1331506971055,-31.59,4
07:13,308505160.0,13637.21456277535,-5.71,8
07:15,581655972.0,41915.32597549715,-7.26,8
07:21,237493332.0,15026.40581065192,-18.25,8
07:21,496395938.0,12633.091096560876,-2.64,7
07:24,633345190.0,6230.774691213473,-42.94,9
07:24,639549973.0,7386.924897849938,-62.78,4
07:26,120634201.0,5317.802556707921,-62.64,5
07:27,673025413.0,947.4658479844418,-12.6,2
07:28,587225252.0,5886.229734202712,-41.94,9
07:30,461990622.0,9963.867614904708,-1.81,7
07:32,930277104.0,10478.16273059576,-16.2,9
07:33,200080192.0,9734.047843707624,-57.4,7
07:33,853907490.0,7840.756576264685,-25.59,7
07:35,450896297.0,13712.983710653076,-0.42,2
07:39,776431321.0,3138.61198917516,-36.09,8
07:41,736340277.0,8901.989869605728,-33.36,8
07:41,214339619.0,468.6989785105091,-14.61,2
07:42,414805878.0,13203.227842879169,-39.23,5
07:46,586315521.0,12692.421493141475,-7.74,7
07:47,815385232.0,10680.26223512116,-14.61,2
07:47,851649498.0,8546.820677504898,-28.14,8
07:47,874431242.0,9453.737381877509,-61.39,7
07:49,551196328.0,4466.742890225607,-18.17,2
07:50,285220959.0,12301.613993755793,-43.79,4
07:55,842682241.0,5960.1093665687085,-3.31,2
07:58,143061865.0,7511.551610851515,-18.44,9
07:59,256002321.0,6286.639797919202,-2.29,5
07:59,151968462.0,7139.326264370867,-4.04,2
08:02,960208650.0,18150.75277836084,-24.67,5
08:03,885259672.0,3257.3470287438768,-5.65,9
08:04,482513594.0,5957.539516535092,-52.24,2
08:05,520447032.0,8407.83607558695,-9.63,2
08:05,719586818.0,19213.30122111238,-37.5,2
08:07,235881534.0,13044.591907440905,-41.61,8
08:09,639409800.0,36881.14913152037,-1.76,5
08:09,510101371.0,13766.87202014144,-41.92,9
08:12,408057540.0,5007.412414954282,-5.35,9
08:13,749378808.0,1839.4660148926105,-73.41,2
08:14,795847804.0,24371.96103039575,-16.54,7
08:15,572384506.0,7402.650687246606,-40.66,7
08:16,785749304.0,8719.453899684468,-34.61,7
08:16,195895574.0,7590.745269143951,-2.9,7
08:19,395284483.0,1169.1143402113082,-6.35,9
08:23,648644594.0,303.85804999999914,-36.49,5
08:24,905860285.0,10737.405895896696,-52.27,2
08:24,212560376.0,-185.29687422089785,-45.95,5
08:25,752362502.0,7817.5364670621075,-3.81,7
08:28,967989787.0,421.9897826407272,-45.63,5
08:30,298000165.0,26897.586929724195,-15.31,5
08:31,511179916.0,7557.18025579865,-17.31,2
08:37,146686559.0,-690.822511173478,-51.28,5
08:38,499244466.0,-570.7222312834224,-163.09,5
08:38,578131296.0,689.5466194440437,-35.47,5
08:38,554792076.0,29594.197233380302,-6.9,4
08:39,534908754.0,-1033.1012500000002,-17.54,5
08:42,775790822.0,-3295.1559192160676,-37.63,5
08:43,659008214.0,-3495.5826022904225,-40.76,5
08:44,214765415.0,-451.7857488501354,-111.58,5
08:44,779816907.0,-3095.90358292291,-64.61,5
08:54,166019891.0,8475.828037039579,-2.91,8
08:55,158766229.0,-703.28828589347,-46.06,5
08:56,898104045.0,-1679.1080500000023,-106.17,5
08:57,128033695.0,2151.644618368749,-1.66,2
08:57,709632525.0,-1580.4123500000003,-61.56,5
08:57,534583529.0,883.0877880547653,-156.5,5
09:03,339791565.0,-3730.0261999999966,-13.03,5
09:03,741903302.0,2503.9170679352605,-22.34,8
09:05,683078800.0,2196.081542731244,-5.35,9
09:05,422955974.0,-305.3680650009502,-55.38,5
09:06,500843551.0,330.78789999999964,-113.2,5
09:07,999752672.0,1750.1530935333346,-5.8,9
09:07,124102251.0,3250.304133288864,-5.5,9
09:09,873701090.0,316.6231047428821,-10.12,5
09:09,895750759.0,-356.2852880756658,-49.82,5
09:09,425964226.0,4152.575764114707,-5.7,9
09:09,624563756.0,-365.3830712164436,-5.7,9
09:12,282837512.0,14345.603440395998,-33.31,8
09:13,387957305.0,-2808.1211059800785,-47.96,5
09:13,663479159.0,4791.811541827711,-15.97,7
09:14,987229118.0,933.7754942488864,-8.7,2
09:16,851649498.0,8541.320677504898,-5.5,9
09:17,618138606.0,1442.035902870066,-5.8,9
09:18,581655972.0,41909.92597549715,-5.4,9
09:18,690958123.0,21859.174318934183,-5.35,9
09:18,657139925.0,13726.475437155388,-36.11,2
09:18,586315521.0,12687.421493141475,-5.0,9
09:19,386277162.0,295.8999999999994,-4.99,1
09:19,475277431.0,1150.1881369436192,-32.97,4
09:20,558875206.0,3448.5165393997804,-6.05,9
09:20,857997794.0,901.7276651508868,-27.97,4
09:20,169006407.0,11968.972223267188,-5.0,9
09:20,120634201.0,5279.622556707921,-38.18,1
09:21,409370545.0,799.1722755455207,-6.03,7
09:21,383833857.0,26397.671850776747,-30.08,8
09:22,822250278.0,6635.102138035657,-29.55,4
09:22,417850087.0,15749.469330736074,-7.6,9
09:22,703537476.0,1025.754249999999,-56.04,2
09:22,506618547.0,14905.670358352652,-5.7,9
09:23,287480331.0,7684.853402348876,-22.34,4
09:23,700138124.0,4890.8532368660435,-26.19,5
09:24,901432314.0,3529.0243036754287,-6.99,2
09:24,540159353.0,11347.614866068956,-6.8,9
09:26,214339619.0,462.8989785105091,-5.8,9
09:27,317161035.0,-3757.785099999997,-80.84,5
09:27,366477356.0,186.04624999999984,-261.54,5
09:28,240643705.0,62.99982962056808,-137.08,5
09:28,180616589.0,1030.9171699949168,-44.62,5
09:33,668175891.0,695.0341231584989,-39.98,4
09:34,176922958.0,1413.9595471976495,-22.33,2
09:38,472213568.0,-508.1421442060534,-60.01,5
09:40,454356905.0,1755.4389154288467,-111.3,2
09:40,657139925.0,13723.841072751671,-2.63,5
09:40,370521542.0,27973.476201443707,-67.19,2
09:43,138351025.0,-1027.4656000000004,-154.13,5
09:45,718058208.0,2147.995607011628,-29.04,7
09:45,519935524.0,-114.66467026248117,-50.1,2
09:47,684988568.0,-381.7395734272015,-68.31,5
09:47,324046160.0,-796.8313832130711,-125.82,5
09:49,448004226.0,1620.0675686648797,-5.99,2
09:51,781554833.0,1076.8067255639664,-50.0,2
09:54,151278285.0,1875.1011,-76.79,5
09:54,930277104.0,10410.57382839463,-67.59,2
09:55,588565416.0,6065.024507525978,-71.99,2
10:00,711045550.0,2249.6623500000037,-39.98,2
10:00,904154012.0,447.1174581204316,-10.98,7
10:06,454356905.0,1720.4389154288467,-35.0,2
10:08,385685918.0,10.30994084155219,-333.2,2
10:11,441142605.0,1999.9021422757296,-5.97,4
10:11,106601471.0,11347.64280297289,-0.04,5
10:12,370521542.0,27757.904201443707,-215.57,2
10:12,647472692.0,26627.092062720527,-99.79,2
10:15,399144202.0,1712.5003332682377,-31.61,8
10:17,282837512.0,14340.503440395998,-5.1,9
10:18,828750680.0,1135.1323952136802,-143.52,5
10:20,137822385.0,3645.861101541067,-5.7,9
10:21,613427466.0,6956.384455264377,-11.98,7
10:21,248142083.0,-105.92056529748324,-97.17,5
10:22,215404070.0,227.54458917984965,-82.99,2
10:25,259015404.0,1172.9651950598018,-15.38,8
10:26,454356905.0,1546.8809154288467,-173.56,2
10:28,849096144.0,1723.542020751343,-13.29,2
10:28,792845450.0,761.5751500000008,-1.99,4
10:28,998390769.0,-205.72854905947585,-153.87,5
10:42,391688371.0,234.3573911585002,-100.93,5
10:43,815993333.0,6326.521972336888,-58.08,8
10:45,849096144.0,1600.370020751343,-123.17,2
10:49,414454079.0,346.66785000000147,-2.54,4
10:50,370521542.0,27605.332201443707,-152.57,2
10:52,355733816.0,5637.475577096019,-17.97,7
10:53,293191074.0,709.558149999999,-71.98,2
10:53,479456865.0,1823.8294995833055,-5.5,4
10:54,670102069.0,1624.5491575261656,-7.93,5
10:57,454356905.0,1432.8089154288468,-114.07,2
10:58,548907062.0,652.6187887682885,-1.5,4
11:00,456246119.0,21594.57591063602,-57.0,2
11:04,933491926.0,3445.1063000000045,-13.02,7
11:07,480198977.0,12475.66002842848,-75.97,2
11:10,284905540.0,8436.91619306173,-37.03,2
11:11,849096144.0,1407.884020751343,-192.49,2
11:11,834383043.0,5409.344033300415,-54.98,2
11:15,456246119.0,21537.59591063602,-56.98,4
11:21,298000165.0,26895.596929724194,-1.99,4
11:25,776431321.0,3127.63198917516,-10.98,1
11:34,738958551.0,9495.575619189758,-23.32,2
11:39,587225252.0,5825.680176666447,-60.55,7
11:45,494789005.0,2617.6499329842677,-86.84,4
11:45,570323670.0,3431.155979534806,-50.18,4
11:46,340321732.0,1778.8055500000037,-31.99,2
11:52,480557476.0,11550.282309720396,-38.94,7
11:57,551755686.0,7029.552485725706,-14.99,4
11:59,522188082.0,8179.924141936828,-150.5,2
12:05,385685918.0,-65.9900591584478,-76.3,2
12:06,480557476.0,11544.132309720397,-6.15,6
12:08,179173981.0,4859.763539623546,-47.83,9
12:09,749378808.0,1803.82601489261,-35.64,9
12:09,767447966.0,5174.250062706572,-161.0,2
12:14,812692024.0,4032.6250918987175,-15.85,2
12:17,899742927.0,13388.575653969476,-35.14,2
12:22,385685918.0,-246.5900591584478,-180.6,2
12:24,280200287.0,235.03954661305104,-162.99,2
12:27,534204159.0,5923.482323157726,-16.06,7
12:29,613427466.0,6889.414455264377,-66.97,4
12:33,987390838.0,-3059.6987412103776,-12.59,5
12:36,522188082.0,8033.624141936828,-146.3,2
12:38,933491926.0,3426.256300000005,-18.85,9
12:43,519644021.0,2802.081203115796,-111.3,2
12:43,767447966.0,4945.350062706572,-228.9,2
12:45,700138124.0,4818.083236866043,-72.77,2
12:49,867679563.0,-24.66154629828418,-53.67,5
12:50,550644516.0,-389.3602500000015,-116.77,5
12:53,322221939.0,3559.186249452131,-18.6,2
12:55,333054026.0,244.1558940231901,-150.73,2
13:03,762785862.0,703.3816999999993,-67.93,5
13:04,399144202.0,1685.3503332682376,-27.15,9
13:05,688712152.0,6988.14788813209,-6.05,9
13:07,910730524.0,8050.745161492804,-5.35,9
13:07,383833857.0,26358.511850776747,-39.16,1
13:08,932820758.0,-2704.8740667755537,-27.2,5
13:09,403765849.0,-2573.9854999999966,-37.69,5
13:11,298000165.0,26797.61692972419,-97.98,2
13:12,522188082.0,7914.624141936828,-119.0,2
13:17,783650950.0,-881.8286434110116,-71.88,5
13:18,385685918.0,-350.8900591584478,-104.3,2
13:20,766812921.0,-218.33550000000085,-119.98,2
13:23,383833857.0,26337.281850776748,-21.23,9
13:24,128030172.0,-688.3333774498499,-134.38,5
13:28,793781222.0,589.9608789474061,-86.69,5
13:35,522188082.0,7743.824141936828,-170.8,2
13:38,865748375.0,2567.591733112927,-16.52,7
13:49,522188082.0,7694.824141936828,-49.0,2
13:55,198946608.0,4429.404004586726,-20.97,5
13:55,435313070.0,2794.0033330332208,-29.99,6
13:57,522188082.0,7649.324141936828,-45.5,2
14:05,385685918.0,-474.7900591584478,-123.9,2
14:14,522188082.0,7434.424141936828,-214.9,2
14:15,340680761.0,-3243.490599999997,-26.54,5
14:24,385685918.0,-648.3900591584478,-173.6,2
14:26,522188082.0,7326.624141936828,-107.8,2
14:27,984783496.0,14553.074315515543,-29.69,7
14:38,414454079.0,342.61785000000145,-4.05,4
14:42,610450243.0,-668.7245999999998,-11.89,5
14:42,385685918.0,-730.9900591584478,-82.6,2
14:54,556992209.0,12378.188987360169,-81.64,4
14:57,385685918.0,-916.4900591584478,-185.5,2
15:14,985188462.0,-5.093611288775207,-28.48,9
15:21,121113546.0,205.67015606986968,-91.1,5
15:31,127809299.0,792.7931657577852,-80.94,5
15:34,385685918.0,-1094.2900591584478,-177.8,2
15:35,549414742.0,7680.26470815215,-24.22,4
15:37,742223719.0,279.39330730480265,-25.0,2
15:42,570323670.0,3418.334905894806,-12.82,2
15:49,769319491.0,-120.5905000000008,-29.99,2
15:56,834383043.0,5347.2087400680575,-62.14,7
15:59,899742927.0,13124.731653969477,-263.84,5
16:03,709608057.0,2640.89735590314,-20.47,4
16:06,385685918.0,-1274.1900591584476,-179.9,2
16:11,145553416.0,-2739.3306499999985,-13.48,5
16:19,550832673.0,3087.1420163955095,-14.99,4
16:19,698076160.0,6707.658954572463,-8.5,8
16:21,385685918.0,-1414.1900591584476,-140.0,2
16:22,885259672.0,3207.2569887438767,-50.09,4
16:29,534097839.0,-4378.973549999997,-13.85,5
16:35,241459011.0,576.9436132723467,-52.87,5
16:35,425730826.0,2417.55190938872,-60.0,2
16:41,901432314.0,3519.815103675429,-9.21,4
16:43,527842638.0,290.7514426329834,-74.98,2
16:43,385685918.0,-1567.4900591584476,-153.3,2
16:44,880546403.0,-1505.769500000002,-63.24,5
16:49,305778936.0,10679.513931701204,-35.75,1
16:54,603721739.0,27.213899483183894,-95.07,5
17:00,286484726.0,610.3374891525708,-55.99,2
17:00,385685918.0,-1859.3900591584477,-291.9,2
17:09,165691047.0,89.1416999999989,-37.84,5
17:10,551755686.0,7012.093984537539,-17.46,8
17:17,653640811.0,17966.119260745898,-27.0,1
17:17,435984758.0,4267.499896898349,-68.81,5
17:18,224112146.0,1878.9461,-54.99,2
17:20,285428103.0,10481.645808161064,-59.88,4
17:21,409971170.0,2918.2594221482645,-38.87,2
17:23,203466392.0,3571.0273166587745,-24.91,5
17:24,633345190.0,6162.574691213473,-68.2,2
17:25,449871732.0,7997.737610777069,-16.98,1
17:26,314980178.0,4094.5388500000063,-35.0,2
17:28,824916823.0,8764.892252023466,-58.97,7
17:29,996042490.0,6266.271923148935,-5.99,2
17:32,425964226.0,4132.585764114708,-19.99,4
17:32,807714284.0,1383.7229607359998,-56.6,5
17:34,350921975.0,-173.39202892612576,-91.47,5
17:35,868377987.0,2947.2137961778803,-122.19,5
17:37,152488934.0,1919.742307313731,-64.97,2
17:43,331450202.0,8098.734695195264,-96.6,2
17:44,233981231.0,2194.0202892297584,-241.47,2
17:44,417850087.0,15693.199330736074,-56.27,2
17:45,117273481.0,9150.566720450744,-26.97,4
17:45,385685918.0,-1929.3900591584477,-70.0,2
17:46,297823329.0,707.3542999999992,-57.0,2
17:46,785749304.0,8706.513899684467,-12.94,9
17:46,558875206.0,3442.5265393997806,-5.99,2
17:47,605116158.0,2632.904100000004,-4.99,7
17:47,143061865.0,7509.448714145881,-2.1,5
17:47,897592348.0,15980.396358560774,-5.97,7
17:47,138609932.0,2412.110003294586,-159.7,5
17:48,651756497.0,14709.481532118638,-28.17,5
17:49,834581602.0,264.69884999999914,-71.99,2
17:50,987656636.0,4370.423840569336,-21.39,2
17:50,229205098.0,7878.502157137973,-6.13,7
17:51,116169597.0,1007.5879499999996,-99.98,4
17:51,893134725.0,1131.9019376616675,-18.61,5
17:54,385685918.0,-2081.9900591584474,-152.6,2
17:54,478986718.0,-1081.8812000000012,-67.32,5
17:56,117273481.0,9123.596720450743,-26.97,7
17:56,586315521.0,12675.901493141477,-11.52,7
17:57,703478110.0,2039.294083055678,-38.95,7
17:57,500043411.0,14039.388674210575,-15.8,7
17:59,429556122.0,4617.117503868459,-75.29,2
18:00,627622066.0,3704.56622216963,-99.99,2
18:00,806358207.0,11453.290645019117,-126.08,5
18:02,858989281.0,27408.806346864105,-32.15,2
18:04,879091637.0,-509.606476262023,-36.39,9
18:07,996042490.0,6208.794923148935,-57.48,5
18:08,940569402.0,5056.4376051511545,-15.35,9
18:08,687135796.0,29209.32496757309,-21.95,7
18:09,331450202.0,7858.634695195264,-240.1,2
18:11,540159353.0,11290.396866068955,-57.22,5
18:12,237493332.0,14965.01581065192,-61.39,5
18:13,113747882.0,12570.899251102555,-55.02,8
18:14,385685918.0,-2207.9900591584474,-126.0,2
18:15,176922958.0,1386.4895471976497,-27.47,9
18:17,237493332.0,14950.08581065192,-14.93,9
18:19,113747882.0,12537.069251102555,-33.83,9
18:23,769311479.0,6366.926179803839,-41.95,8
18:24,909669130.0,-510.0701152632333,-34.64,9
18:26,706250160.0,12895.627136816413,-58.8,2
18:29,503575533.0,8202.664874664672,-35.34,9
18:32,414454079.0,308.88785000000144,-33.73,9
18:32,687135796.0,29198.62496757309,-10.7,9
18:33,912705941.0,19220.70707676664,-0.49,7
18:33,874431242.0,9422.367381877506,-31.37,9
18:35,520447032.0,8377.54607558695,-30.29,9
18:36,859264768.0,-172.15881621806167,-13.98,9
18:41,999752672.0,1695.5898435333347,-54.56,5
18:42,226703987.0,2713.3901365470742,-155.42,5
18:43,970298834.0,2683.6474733955824,-19.61,8
18:43,336557504.0,1042.4914776420278,-124.83,5
18:44,758160963.0,8610.109294000917,-30.5,2
18:47,738958551.0,9467.985619189758,-27.59,9
18:51,706250160.0,12813.027136816412,-82.6,2
18:51,824916823.0,8685.231297447443,-73.48,5
18:55,933491926.0,3419.2252700000045,-7.03,7
18:55,891716230.0,330.27407670186426,-45.97,7
18:59,517190750.0,2214.786089915413,-55.67,5
18:59,213112754.0,5767.2220976499375,-18.99,9
19:00,993039226.0,-4424.696999999995,-21.43,5
19:00,623156843.0,4692.800459318963,-246.85,5
19:03,780463728.0,3480.1102209422393,-93.11,5
19:06,730002588.0,13872.209499175013,-157.89,5
19:06,786141370.0,-225.6607000000008,-83.58,5
19:07,857455726.0,-837.9452641243158,-289.77,5
19:08,897714622.0,9566.568171432742,-3.8,2
19:10,392270893.0,13400.671838151437,-39.28,5
19:14,425730826.0,2380.75690938872,-36.8,5
19:19,137913631.0,537.4181999999996,-145.85,5
19:23,701070224.0,-1247.44215,-204.69,5
19:24,245690309.0,9968.004120458643,-40.03,5
19:27,713057426.0,-379.9117500000004,-27.29,5
19:28,235310449.0,95.37018483031,-157.16,5
19:33,419550103.0,19329.4148045084,-22.28,7
19:35,541639148.0,4244.597045095957,-3.8,7
19:37,151968462.0,7109.737264370867,-29.59,5
19:40,487051121.0,1170.574420870394,-64.89,5
19:42,836110591.0,6525.192487715942,-33.52,4
19:52,576188756.0,-4260.103999999998,-57.47,5
19:57,315078351.0,8269.822238503088,-44.13,9
19:58,137822385.0,3519.2783515410674,-126.58,5
20:00,624500124.0,3358.2136989557744,-66.43,5
20:00,522188082.0,7324.251157900333,-2.37,2
20:03,986267641.0,4344.838341087221,-26.22,4
20:04,461029994.0,7978.4234103141725,-22.09,5
20:08,605711527.0,-305.31348616741633,-163.69,5
20:09,308068836.0,-661.2514774318078,-81.63,5
20:12,678330503.0,1330.157632237935,-26.9,2
20:14,585596026.0,2829.1967009019904,-17.94,9
20:16,370521542.0,27592.07932987991,-13.25,5
20:18,627622066.0,3563.7790721696297,-140.79,5
20:18,609939116.0,7679.132920323332,-9.73,2
20:23,287480331.0,7658.923402348876,-25.93,9
20:28,699997811.0,798.3557500000038,-43.85,5
20:33,348325817.0,10755.993513177487,-61.05,5
20:35,893134725.0,1076.2547376616674,-55.65,5
20:36,842682241.0,5847.003366568709,-113.11,5
20:37,170637730.0,1663.0878101790297,-120.71,5
20:38,720221651.0,-2585.038866598434,-47.13,5
20:39,824916823.0,8657.791297447442,-27.44,9
20:42,897714622.0,9547.02817143274,-19.54,9
20:51,423208402.0,4022.945100000003,-17.94,5
21:10,604288474.0,1702.5444555282568,-22.32,8
21:42,766812921.0,-238.83550000000085,-20.5,9
02:23,120634201.0,5263.982556707921,-15.64,9
02:37,554792076.0,29581.419325387826,-12.78,2
02:42,108563213.0,23339.598019696525,-4.85,2
02:42,113747882.0,12503.789251102557,-33.28,9
02:50,196289502.0,16392.938397636943,-25.15,9
02:55,572384506.0,7366.920687246607,-35.73,9
02:56,331048953.0,65.82736797849361,-14.38,9
03:09,705848712.0,28073.269679808232,-18.5,9
03:09,421881811.0,2541.1047136073125,-29.2,9
03:10,766941757.0,2646.358510245526,-34.7,9
03:11,324224854.0,4390.251543950277,-1.85,2
03:15,758160963.0,8596.979440377158,-13.13,5
03:34,657139925.0,13699.901072751672,-23.94,9
03:36,229205098.0,7856.81579499468,-21.69,5
03:41,873693307.0,10536.083372220945,-18.19,9
03:41,237684254.0,6069.227542524664,-32.15,5
03:43,216285378.0,24818.607384634903,-36.59,9
03:46,195895574.0,7555.305269143952,-35.44,9
03:47,949032480.0,4084.095464617215,-26.54,9
03:50,471897866.0,7109.605190418309,-28.5,8
03:51,842682241.0,5805.1541178676,-41.85,2
03:52,776431321.0,3125.873783158774,-1.76,5
03:54,719586818.0,19211.116870608028,-2.18,4
04:02,885259672.0,3193.8501222908326,-13.41,2
04:04,287480331.0,7625.403402348876,-33.52,9
04:05,386729293.0,31729.609853780166,-35.01,7
04:05,473820682.0,11678.262901354272,-81.28,7
04:11,541639148.0,4243.112428413713,-1.48,2
04:14,858989281.0,27361.847008518653,-46.96,7
04:19,609939116.0,7675.989922385396,-3.14,7
04:26,832564361.0,15785.896369972872,-9.43,7
04:26,310375875.0,1697.0887034370517,-26.0,9
04:28,873693307.0,10527.207090648457,-8.88,5
04:30,822250278.0,6612.328472378908,-22.77,5
04:32,264550521.0,5418.625885719515,-5.99,2
04:35,213112754.0,5753.882097649937,-13.34,9
04:42,815385232.0,10607.327066888314,-72.94,5
04:44,421881811.0,2519.1237451085385,-21.98,4
04:47,433917275.0,7786.2220598360445,-38.52,9
04:49,108481285.0,9035.685555116748,-31.87,5
04:50,752362502.0,7772.844214696151,-44.69,7
04:50,492215823.0,3014.428933815445,-42.05,9
04:51,905860285.0,10733.646570812423,-3.76,7
04:53,996042490.0,6172.309524885624,-36.49,2
04:55,282837512.0,14258.1513929655,-82.35,5
05:00,290818242.0,7226.899042388617,-35.0,5
05:03,698076160.0,6705.848045214075,-1.81,8
05:04,143003091.0,10505.227813535044,-27.84,9
05:11,364357875.0,8502.84639304664,-36.58,5
05:13,586315521.0,12636.369256914451,-39.53,5
05:13,435984758.0,4265.303998484657,-2.2,7
05:14,108931112.0,14736.82972654393,-30.42,9
05:17,113747882.0,12479.070960539466,-24.72,5
05:18,973086490.0,10467.541316158162,-9.38,5
05:19,709608057.0,2607.62735590314,-33.27,9
05:23,738958551.0,9438.305619189758,-29.68,9
05:25,930277104.0,10360.69663921117,-49.88,2
05:30,749378808.0,1796.2044193242575,-7.62,7
05:30,510101371.0,13729.74202014144,-37.13,9
05:30,718058208.0,2104.673709393656,-43.32,2
05:31,203466392.0,3564.9116435061196,-6.12,7
05:32,887853850.0,10566.762303248945,-31.45,9
05:32,532478725.0,4617.157168629736,-22.17,9
05:33,169006407.0,11966.836907258486,-2.14,7
05:35,987163717.0,4022.6641318913153,-41.55,9
05:35,853907490.0,7830.366576264684,-10.39,9
05:39,809499628.0,18001.58248379754,-22.0,9
05:39,851181128.0,4780.9535922858595,-33.85,9
05:40,949032480.0,4032.8830733445466,-51.21,5
05:41,670102069.0,1592.5291575261656,-32.02,9
05:41,285220959.0,12290.592031530365,-11.02,5
05:46,575652395.0,2398.7842652931536,-2.71,4
05:51,836110591.0,6488.292487715942,-36.9,9
05:54,984783496.0,14538.074315515543,-15.0,9
05:54,383625050.0,2917.1413973017466,-16.75,8
05:58,482513594.0,5943.232944620432,-14.31,2
06:04,678851253.0,3949.319377767524,-17.47,7
06:05,795847804.0,24369.583348028376,-2.38,7
06:06,414805878.0,13173.207842879168,-30.02,9
06:10,131388684.0,22098.303121684,-16.23,9
06:13,399144202.0,1646.2103332682375,-39.14,9
06:14,899742927.0,13121.203847207777,-3.53,2
06:16,851649498.0,8532.29933928899,-9.02,8
06:18,511179916.0,7515.942642862602,-41.24,7
06:19,221868392.0,4972.72335263462,-42.38,9
06:21,479456865.0,1793.7894995833055,-30.04,9
06:22,836110591.0,6470.693394599743,-17.6,5
06:26,940569402.0,5054.263865790227,-2.17,7
06:28,558119802.0,34297.10884908576,-15.6,8
06:33,287480331.0,7617.015106378662,-8.39,7
06:35,213112754.0,5708.146304365524,-45.74,5
06:37,910730524.0,8012.340319139113,-38.4,2
06:39,489964679.0,20901.944294356283,-39.2,9
06:39,187541224.0,2070.707766441192,-44.25,9
06:40,534204159.0,5923.051702611258,-0.43,4
06:41,305778936.0,10650.920219815527,-28.59,2
06:41,131388684.0,22069.51947341469,-28.78,5
06:45,124102251.0,3242.4301170107997,-7.87,7
06:45,187111705.0,7159.257533226953,-11.07,8
06:47,633345190.0,6127.584691213473,-34.99,9
06:47,822135975.0,11778.837155927384,-4.35,2
06:49,550169791.0,22614.328151848084,-4.15,4
06:50,348325817.0,10725.243513177487,-30.75,9
06:50,461990622.0,9944.23022131334,-19.64,7
06:51,675806859.0,7520.929416312864,-17.16,7
06:53,315546581.0,29683.57637224045,-18.55,2
06:59,532478725.0,4580.877338797774,-36.28,8
07:01,992204045.0,7500.562917315257,-40.06,5
07:02,547010927.0,24501.91807303581,-7.7,2
07:04,254018059.0,-83.1005,-32.22,9
07:05,519644021.0,2773.54185478061,-28.54,2
07:06,134461671.0,5530.534256609409,-16.88,7
07:06,145387690.0,5485.431622422387,-3.7,4
07:10,859603181.0,3617.1317100154806,-46.59,5
07:10,912705941.0,19198.34413407346,-22.36,7
07:11,116598243.0,2090.2012217774504,-5.9,9
07:11,128033695.0,2127.155819331339,-24.49,2
07:11,901037631.0,1618.9993230964064,-5.5,9
07:14,366550080.0,25906.053835112103,-8.26,2
07:14,370521542.0,27575.97736599978,-16.1,4
07:14,601627384.0,3530.854144325868,-40.63,9
07:15,699139822.0,1862.4767597268956,-5.33,7
07:16,414805878.0,13130.437620015324,-42.77,2
07:16,170637730.0,1659.737149636188,-3.35,2
07:17,183888402.0,19424.622457140133,-33.74,9
07:17,970298834.0,2652.9706918851857,-30.68,7
07:17,679662108.0,16837.150595137944,-2.88,5
07:18,520447032.0,8333.56607558695,-43.98,9
07:18,673025413.0,912.470505571736,-35.0,4
07:19,829914501.0,1521.5588065709744,-4.95,9
07:21,348325817.0,10715.821662193148,-9.42,5
07:21,738958551.0,9429.785985949036,-8.52,2
07:27,886921642.0,3326.0267554428283,-30.27,8
07:29,549414742.0,7652.52470815215,-27.74,9
07:31,802697323.0,16793.736109414178,-27.34,9
07:31,450896297.0,13703.554999537244,-9.43,5
07:32,587225252.0,5787.440176666447,-38.24,9
07:32,270374623.0,9885.429715229651,-9.37,2
07:33,108931112.0,14726.967530357895,-9.86,5
07:34,779946617.0,17091.26185286109,-49.77,2
07:39,187541224.0,2020.7350565611528,-49.97,7
07:40,506618547.0,14895.96156981725,-9.71,2
07:43,399144202.0,1619.5211654962886,-26.69,8
07:43,853907490.0,7823.240569108619,-7.13,7
07:45,518474507.0,14411.822679327312,-26.06,8
07:46,216285378.0,24788.00751145933,-30.6,7
07:48,985188462.0,-44.0836112887752,-38.99,9
07:49,500043411.0,13998.63281181547,-40.76,2
07:50,408057540.0,4960.917098436851,-46.5,7
07:56,815993333.0,6326.298016520962,-0.22,7
07:57,613729471.0,8077.635021876152,-39.1,8
07:57,687135796.0,29195.378220190636,-3.25,5
07:58,581655972.0,41871.16249376848,-38.76,7
08:03,769311479.0,6357.358634326839,-9.57,2
08:04,417850087.0,15690.477443022004,-2.72,2
08:06,987656636.0,4370.409795995227,-0.01,5
08:10,336557504.0,1036.3414776420277,-6.15,9
08:11,383833857.0,26284.45041166376,-52.83,7
08:12,195895574.0,7543.965687797732,-11.34,4
08:12,730002588.0,13865.634228071418,-6.58,7
08:13,280200287.0,229.53954661305104,-5.5,9
08:15,806358207.0,11442.484102910475,-10.81,4
08:16,667367404.0,9465.560721087066,-12.86,2
08:23,520447032.0,8281.56029139865,-52.01,7
08:24,146909202.0,3579.9619734785542,-6.5,9
08:26,215404070.0,209.6945891798497,-17.85,5
08:30,518474507.0,14351.132679327313,-60.69,5
08:31,824916823.0,8646.703817624893,-11.09,5
08:32,764450279.0,21448.97881871992,-134.48,5
08:33,647472692.0,26617.872146718833,-9.22,2
08:34,768271776.0,-634.9316967665796,-29.87,5
08:34,986267641.0,4319.954697275705,-24.88,5
08:35,165098840.0,-565.7931263623731,-33.05,5
08:35,785749304.0,8664.359912205675,-42.15,7
08:36,213930646.0,-1839.7745634725632,-46.77,5
08:37,760753808.0,-11.006650000000576,-44.85,5
08:37,668329719.0,9085.01881042812,-10.63,2
08:38,837876918.0,39.24220853457989,-65.34,5
08:38,202320275.0,-918.3133000000006,-144.26,5
08:39,111137699.0,-271.0770999999994,-110.44,5
08:44,184430449.0,2644.78821682489,-93.65,5
08:46,902798190.0,-695.1336344310265,-108.05,5
08:47,682194230.0,-2450.4483499999988,-58.6,5
08:49,897714622.0,9508.922964890848,-38.11,2
08:50,374994043.0,-2406.8105500000006,-46.38,5
08:52,969697937.0,-5011.530265670551,-22.18,5
08:54,657528784.0,-54.65609999999926,-105.27,5
08:59,497772347.0,959.5484999999978,-149.25,5
09:00,482513594.0,5910.654944620432,-32.58,5
09:00,627917561.0,4028.875050000006,-5.4,9
09:03,169006407.0,11961.336907258486,-5.5,9
09:05,322221939.0,3542.754381597245,-16.43,7
09:09,999752672.0,1689.8398435333347,-5.75,9
09:09,683319988.0,7354.790720189382,-5.65,9
09:09,998405607.0,-593.1914999999981,-57.08,5
09:10,540159353.0,11283.496866068956,-6.9,9
09:12,558875206.0,3435.2265393997804,-7.3,9
09:13,570269025.0,3361.131884930085,-4.53,7
09:13,242218612.0,-10.271199999999418,-49.48,5
09:15,383833857.0,26279.20041166376,-5.25,9
09:15,143061865.0,7478.536714145881,-30.91,5
09:16,744211756.0,-4414.318249999992,-23.28,5
09:17,506618547.0,14889.46156981725,-6.5,9
09:17,679662108.0,16808.600595137945,-28.55,7
09:18,613729471.0,8072.935021876152,-4.7,9
09:19,586315521.0,12630.969256914452,-5.4,9
09:19,950234174.0,2085.0942143102957,-22.8,2
09:20,117273481.0,9117.796720450744,-5.8,9
09:21,865748375.0,2547.581733112927,-20.01,2
09:22,992204045.0,7495.512917315257,-5.05,9
09:23,480557476.0,11441.512309720394,-102.62,5
09:23,214339619.0,456.5489785105091,-6.35,9
09:24,874431242.0,9294.582381877506,-127.78,5
09:25,116169597.0,968.6479499999996,-38.94,7
09:27,322221939.0,3531.648141597245,-11.11,4
09:27,409370545.0,774.0422755455207,-25.13,7
09:27,550169791.0,22537.202151848083,-77.13,5
09:28,331048953.0,40.82736797849361,-25.0,2
09:29,290818242.0,7221.799042388617,-5.1,9
09:29,448004226.0,1554.3123686648796,-65.76,5
09:29,762859681.0,2941.292599999999,-27.0,7
09:30,815993333.0,6272.538016520962,-53.76,5
09:38,215311171.0,6472.4297198973,-205.8,2
09:39,849096144.0,1366.894020751343,-40.99,2
09:40,700138124.0,4817.61606702225,-0.47,5
09:40,246753533.0,254.78909999999837,-28.83,5
09:41,762859681.0,2901.332599999999,-39.96,4
09:45,398429109.0,692.562500000001,-54.92,7
09:46,655368335.0,4737.859864897443,-166.6,2
09:49,135937041.0,-1167.800348268412,-34.7,5
09:50,480557476.0,11392.756722702006,-48.76,2
09:53,849096144.0,1354.914020751343,-11.98,4
09:53,441274121.0,12534.361256149276,-4.95,9
09:53,454356905.0,1429.3451923653624,-3.46,2
09:55,575652395.0,2342.465815293154,-56.32,4
09:57,518466565.0,829.1154499999993,-98.27,5
09:59,655368335.0,4543.959864897443,-193.9,2
10:04,215311171.0,6251.9297198973,-220.5,2
10:09,497772347.0,943.5684999999978,-15.98,7
10:10,799861885.0,722.5615499999988,-31.99,2
10:13,287480331.0,7610.215106378661,-6.8,9
10:13,143003091.0,10472.926099372136,-32.3,2
10:15,930277104.0,10274.88663921117,-85.81,2
10:16,179173981.0,4850.064079636657,-9.7,2
10:19,727417797.0,5819.54434847887,-9.99,4
10:20,727417797.0,5779.040543377722,-40.5,2
10:25,854895960.0,3747.9837072291984,-25.0,2
10:26,215311171.0,6127.3297198973,-124.6,2
10:27,134461671.0,5497.504256609409,-33.03,7
10:30,194745206.0,287.45637209124317,-20.05,2
10:36,727417797.0,5722.040543377722,-57.0,2
10:39,308505160.0,13635.948536243764,-1.27,5
10:41,994947671.0,1184.0657000000003,-174.47,2
10:43,655368335.0,4287.059864897444,-256.9,4
10:45,618514666.0,22296.295977494487,-8.98,4
10:45,414454079.0,304.8378500000014,-4.05,4
10:52,254853117.0,3136.7309271559666,-135.12,2
10:55,661295096.0,3438.4442205965347,-33.95,1
11:01,941285623.0,1168.5443990667704,-21.97,1
11:02,386277162.0,282.4199999999994,-13.48,4
11:06,994947671.0,1129.5657000000003,-54.5,2
11:08,264550521.0,5413.5958857195155,-5.03,7
11:09,823208989.0,1644.1414638695314,-152.6,2
11:11,497772347.0,879.5884999999978,-63.98,2
11:17,298000165.0,26763.423611291433,-34.19,2
11:21,941285623.0,1105.3343990667704,-63.21,5
11:35,386277162.0,275.4299999999994,-6.99,7
11:36,331048953.0,14.867367978493611,-25.96,1
11:48,331048953.0,-36.62263202150639,-51.49,4
11:53,259015404.0,1160.6759511857597,-12.29,7
12:05,119943495.0,-1581.150062112858,-33.22,9
12:07,823208989.0,1525.1414638695314,-119.0,2
12:09,687135796.0,29160.758220190637,-34.62,4
12:10,916270283.0,2389.4842500000004,-75.57,2
12:13,259015404.0,1127.3559511857595,-33.32,7
12:13,978951113.0,-774.9881425904191,-25.69,9
12:15,259015404.0,1097.4359511857594,-29.92,9
12:17,655368335.0,4140.059864897444,-147.0,4
12:18,494789005.0,2600.8639329842676,-16.79,5
12:22,155317149.0,211.84989999999905,-75.67,5
12:25,994947671.0,1113.0857000000003,-16.48,2
12:28,895750759.0,-380.2552880756658,-23.97,7
12:35,454356905.0,1387.1051923653624,-42.24,9
12:39,446720287.0,-2002.4650591815944,-19.49,5
12:40,749378808.0,1767.5044193242577,-28.7,9
12:43,973086490.0,10458.59131615816,-8.95,9
12:45,823208989.0,1264.0414638695315,-261.1,2
12:45,421475159.0,-432.3197373255874,-61.72,5
12:47,655368335.0,4063.059864897444,-77.0,7
12:51,386277162.0,238.75999999999937,-36.67,9
12:56,355733816.0,5493.485577096019,-143.99,2
12:57,643610517.0,-3079.6086907296567,-36.72,5
13:00,266777719.0,-1227.9460662197605,-88.51,5
13:00,687135796.0,29146.558220190636,-14.2,9
13:00,807098817.0,194.66829999999905,-69.96,5
13:01,426474982.0,-3892.54225,-21.65,5
13:01,322221939.0,3514.5781415972447,-17.07,1
13:04,910730524.0,8005.540319139112,-6.8,9
13:05,688712152.0,6983.14788813209,-5.0,9
13:06,333054026.0,145.1408940231901,-99.01,5
13:06,277562576.0,375.28006997625704,-6.5,9
13:08,426466211.0,-3491.5657499999993,-47.16,5
13:08,849096144.0,1349.914020751343,-5.0,9
13:09,585625048.0,2126.569974999358,-5.5,9
13:13,340321732.0,1772.4555500000038,-6.35,9
13:16,383345285.0,-896.4734235880761,-31.5,5
13:16,635679314.0,-3066.195829119518,-37.17,5
13:24,455052690.0,-71.98226005137238,-139.73,5
13:28,187111705.0,7152.457533226952,-6.8,9
13:34,189757473.0,-2333.0511499999993,-54.86,5
13:43,668175891.0,667.0341231584989,-28.0,2
14:03,310620484.0,32.79119509219828,-26.14,7
14:18,497772347.0,749.6084999999978,-129.98,2
14:19,311467864.0,-872.880500000001,-122.41,5
14:30,868014990.0,-3572.788599999996,-52.46,5
15:03,414454079.0,289.62785000000144,-15.21,4
15:19,823208989.0,1166.0414638695315,-98.0,2
15:28,173335108.0,2653.914000000001,-14.99,4
15:28,497772347.0,726.6384999999977,-22.97,4
15:28,310620484.0,10.64119509219828,-22.15,2
15:35,678330503.0,1260.4414343793817,-69.72,2
15:39,679911053.0,2796.690239337816,-84.05,2
15:46,867987292.0,1816.3670888476963,-28.03,2
15:54,329840194.0,187.569290143148,-108.21,5
16:03,321372947.0,-407.56085078909945,-17.65,5
16:15,252760664.0,7030.625889603873,-22.09,5
16:24,435313070.0,2761.053333033221,-32.95,7
16:37,272538745.0,16806.19990000002,-98.0,2
16:41,653667523.0,3509.848899570016,-42.95,7
16:42,128033695.0,2111.005819331339,-16.15,4
16:45,492215823.0,2998.643943815445,-15.78,4
16:47,632065391.0,-402.0161499999995,-105.87,5
16:52,198946608.0,4427.61835251165,-1.79,2
16:56,604334058.0,143.8777999999993,-193.0,2
16:57,624500124.0,3355.735979763854,-2.48,7
16:57,823208989.0,869.9414638695316,-296.1,2
17:03,987656636.0,4340.179795995227,-30.23,2
17:06,388862238.0,1495.0342088728069,-112.6,5
17:06,939972497.0,1221.6191086000106,-9.99,7
17:06,994214354.0,10203.487861633392,-3.28,7
17:07,296972867.0,-980.8285000000008,-45.61,5
17:08,647936800.0,2431.228336894477,-7.24,7
17:08,272538745.0,16642.399900000022,-163.8,2
17:09,679911053.0,2779.4197609625785,-17.27,5
17:10,256002321.0,6254.747554565723,-12.94,9
17:10,536924114.0,-924.3392055930964,-126.16,5
17:10,706250160.0,12773.9137890398,-39.11,4
17:12,628470485.0,542.3150299001231,-147.92,5
17:12,624500124.0,3249.465979763854,-106.27,2
17:13,280268430.0,5164.924813058767,-26.45,2
17:15,673818591.0,1768.1821753758406,-22.94,9
17:17,842682241.0,5762.7241178675995,-42.43,9
17:17,851181128.0,4760.220292995647,-20.73,5
17:19,235881534.0,12977.399205109376,-67.19,7
17:21,604334058.0,16.877799999999297,-127.0,2
17:27,429556122.0,4588.027503868459,-29.09,2
17:27,956717493.0,1288.2398504359833,-14.99,4
17:27,626989363.0,895.5617633173752,-22.0,2
17:28,169006407.0,11884.586907258486,-76.75,2
17:29,187541224.0,2013.575056561153,-7.16,7
17:30,471897866.0,7042.545190418308,-67.06,4
17:31,535804582.0,1719.9810499999987,-43.98,2
17:31,386729293.0,31691.619853780165,-37.99,2
17:31,138609932.0,2395.610003294586,-16.5,4
17:32,823208989.0,743.9414638695316,-126.0,2
17:33,516051449.0,1548.4327746508286,-83.3,2
17:33,486495235.0,1852.2011642021823,-69.99,2
17:33,287230540.0,1381.030997763875,-32.95,1
17:35,409971170.0,2779.7694221482643,-138.49,4
17:35,651372390.0,-3703.4757499999982,-53.33,5
17:35,315078351.0,8232.764588503087,-37.06,4
17:36,809499628.0,17990.683073902088,-10.9,2
17:36,245690309.0,9967.094932142809,-0.91,8
17:37,310375875.0,1684.500544082098,-12.59,2
17:38,120634201.0,5243.32744599849,-20.66,5
17:38,949032480.0,4020.053073344546,-12.83,7
17:38,639409800.0,36827.72913152037,-53.42,2
17:40,482513594.0,5833.654944620432,-77.0,2
17:41,994214354.0,10172.047861633391,-31.44,9
17:42,951817450.0,9375.849276328694,-28.42,4
17:45,887853850.0,10555.913698242624,-10.85,7
17:45,272538745.0,16635.399900000022,-7.0,2
17:46,113747882.0,12466.110960539469,-12.96,4
17:47,901432314.0,3498.595103675429,-21.22,1
17:48,237493332.0,14936.685797183114,-13.4,2
17:48,516051449.0,1493.1327746508289,-55.3,2
17:48,358846516.0,720.8832725272174,-77.0,4
17:49,450896297.0,13669.064999537244,-34.49,9
17:50,651756497.0,14697.426411881872,-12.06,2
17:50,846550094.0,1781.588165171468,-16.98,4
17:50,255814263.0,1571.2545976099234,-57.91,1
17:51,854513972.0,1761.0269000000003,-27.96,7
17:52,874431242.0,9262.899421877506,-31.68,4
17:53,939972497.0,996.6491086000104,-143.99,2
17:54,497772347.0,638.7184999999978,-87.92,4
17:55,822135975.0,11766.617155927384,-12.22,7
17:55,859603181.0,3536.554710015481,-80.58,5
17:55,482513594.0,5735.654944620432,-98.0,2
17:57,874431242.0,9239.859421877503,-23.04,9
18:01,516051449.0,1298.5327746508287,-194.6,2
18:02,897592348.0,15847.151358560774,-133.25,5
18:03,683319988.0,7335.710720189382,-19.08,9
18:03,198630866.0,-456.98527356126857,-22.2,9
18:06,605116158.0,2598.4571000000037,-34.45,5
18:07,736340277.0,8879.839869605728,-22.15,9
18:07,272538745.0,16440.799900000024,-194.6,2
18:08,627917561.0,3992.415050000006,-36.46,9
18:08,491392945.0,5545.481500000011,-49.83,5
18:11,297823329.0,642.7761499999992,-64.58,5
18:14,699139822.0,1835.7967597268955,-26.68,9
18:15,824916823.0,8610.563817624894,-36.14,9
18:16,424397946.0,948.8137836054002,-25.93,9
18:17,858989281.0,27345.85700851865,-15.99,9
18:19,992204045.0,7398.555917315257,-96.96,5
18:20,704517789.0,18463.232135533963,-51.88,8
18:23,373163757.0,11551.657471507697,-117.94,5
18:23,214339619.0,446.55897851050906,-9.99,7
18:25,270374623.0,9879.799715229652,-5.63,7
18:26,489964679.0,20851.514714356283,-50.43,4
18:26,939972497.0,920.1591086000104,-76.49,2
18:28,518474507.0,14317.70267932731,-33.43,9
18:29,516051449.0,1183.0327746508287,-115.5,2
18:31,482513594.0,5693.654944620432,-42.0,2
18:32,960208650.0,14763.571680233572,-37.18,5
18:36,490868147.0,-324.4532208786984,-28.22,9
18:37,129018172.0,9964.940815571274,-42.7,2
18:40,291128777.0,-2812.7014405263685,-18.03,5
18:41,939972497.0,895.1591086000105,-25.0,2
18:41,736310094.0,-824.6537240274259,-42.8,5
18:45,170637730.0,1607.133409636188,-52.6,7
18:45,833899961.0,1208.9299457180098,-85.13,5
18:48,581655972.0,41836.73649376848,-34.43,5
18:48,456221621.0,152.39836730262795,-61.65,5
18:49,352291960.0,2318.885053303574,-91.41,5
18:53,631744379.0,-2291.606259491066,-33.12,5
18:53,785210466.0,2074.7534199977117,-63.24,5
18:53,675398089.0,-862.0640907746512,-44.87,5
18:53,624563756.0,-380.3854712164436,-15.0,5
18:54,344219145.0,8321.779242229135,-25.58,2
18:55,546760202.0,-1987.183027675968,-48.88,5
18:57,180719578.0,-4561.562749999995,-15.59,5
19:00,516051449.0,1066.1327746508289,-116.9,2
19:01,482513594.0,5657.254944620432,-36.4,2
19:01,200080192.0,9629.509843707625,-104.54,5
19:01,516051449.0,1047.7927746508287,-18.34,9
19:05,858560423.0,12345.511253018787,-91.31,5
19:07,964702094.0,922.2009186515938,-78.9,7
19:13,901432314.0,3469.209103675429,-29.39,5
19:13,929044080.0,-147.19110849437175,-27.64,5
19:19,298007503.0,1736.298103625634,-135.05,5
19:24,930271460.0,179.40689753577635,-75.97,5
19:25,279149837.0,-376.6859500000005,-90.22,5
19:27,535744551.0,293.5744659956258,-104.66,5
19:29,522188082.0,7321.865906424057,-2.39,7
19:29,489964679.0,20813.639441578245,-37.88,5
19:34,596463612.0,-902.345104725138,-48.18,5
19:37,690523499.0,144.69120000000015,-155.73,5
19:46,683319988.0,7327.58781880881,-8.12,2
19:47,844835978.0,10488.39767950703,-72.99,5
20:05,940569402.0,5045.313865790227,-8.95,9
20:05,822718326.0,11647.03879769716,-45.84,5
20:08,331450202.0,7822.556695195263,-36.08,5
20:09,166019891.0,8460.898037039578,-14.93,9
20:14,441274121.0,12527.658934353078,-6.7,4
20:15,706361191.0,210.4516984940779,-89.89,5
20:20,672913754.0,11869.872042977237,-58.36,8
20:38,282837512.0,14220.611392965498,-37.54,9
20:50,653640811.0,17904.503371692983,-61.62,7
20:50,654329190.0,-705.6038990514808,-61.98,5
20:58,865748375.0,2542.869545908299,-4.71,7
21:12,930277104.0,10234.246639211173,-40.64,9
01:35,421881811.0,2465.652451441336,-53.47,7
01:38,575652395.0,2327.3825766245527,-15.08,4
02:21,898104045.0,-1809.1080500000023,-130.0,5
02:27,970298834.0,2576.81035915783,-76.16,7
02:36,370521542.0,27574.851541727858,-1.13,7
02:38,285873880.0,12911.571824616502,-68.59,5
02:43,738958551.0,9387.215985949037,-42.57,9
02:45,858989281.0,27332.37700851865,-13.48,9
02:48,788740658.0,2771.491477387849,-20.2,9
02:48,824916823.0,8591.033817624893,-19.53,9
02:51,264550521.0,5393.8472546030725,-19.75,2
02:51,532478725.0,4555.977338797775,-24.9,9
02:53,414805878.0,13095.197620015324,-35.24,9
02:58,873701090.0,305.0054949611758,-11.62,7
03:04,108563213.0,23309.262828296793,-30.34,7
03:18,687135796.0,29138.81221296902,-7.75,2
03:18,993238248.0,-532.127487392884,-26.88,9
03:22,815993333.0,6224.475886789974,-48.06,7
03:27,500043411.0,13991.242811815471,-7.39,9
03:27,482513594.0,5644.193213368729,-13.06,7
03:29,586315521.0,12622.71189527114,-8.26,4
03:31,547010927.0,24465.701391781306,-36.22,7
03:37,639549973.0,7360.906927429252,-11.78,5
03:37,541639148.0,4224.3754854775825,-18.74,7
03:40,348325817.0,10674.481662193148,-41.34,9
03:43,897714622.0,9478.614856384842,-30.31,5
03:45,145387690.0,5463.531622422387,-21.9,9
03:49,480557476.0,11365.761917940494,-26.99,5
03:51,473820682.0,11671.996248314746,-6.27,2
03:55,779236304.0,2024.5675954795336,-24.95,9
03:59,769311479.0,6334.448240092876,-22.91,2
04:07,842682241.0,5762.379526402036,-0.34,5
04:11,779946617.0,17079.539975884076,-11.72,4
04:12,851181128.0,4730.680292995647,-29.54,9
04:14,678330503.0,1259.198335249868,-1.24,5
04:14,905860285.0,10731.824218273114,-1.82,2
04:18,709608057.0,2561.87735590314,-45.75,9
04:27,399144202.0,1592.8911654962883,-26.63,9
04:27,683078800.0,2183.5051915763797,-12.58,2
04:31,414805878.0,13077.885097576278,-17.31,7
04:32,237493332.0,14927.185797183114,-9.5,9
04:33,679662108.0,16759.75955653874,-48.84,2
04:35,270374623.0,9835.070552901949,-44.73,2
04:38,987163717.0,3978.534131891315,-44.13,9
04:40,853907490.0,7821.185967012346,-2.05,5
04:41,383833857.0,26254.634674158253,-24.57,2
04:43,601627384.0,3497.224144325868,-33.63,9
04:45,433917275.0,7768.632059836044,-17.59,9
04:45,572384506.0,7335.480687246607,-31.44,9
04:45,994214354.0,10171.425220343295,-0.62,4
04:48,678851253.0,3937.101252507553,-12.22,5
04:50,196289502.0,16368.488397636942,-24.45,9
04:53,785749304.0,8651.160494736594,-13.2,2
04:53,366550080.0,25882.101995729852,-23.95,5
04:55,873693307.0,10510.467090648455,-16.74,9
04:56,683319988.0,7298.29781880881,-29.29,9
04:57,802697323.0,16757.50610941418,-36.23,9
04:58,399144202.0,1592.2861576732896,-0.61,7
05:00,822135975.0,11753.832408478194,-12.78,4
05:01,131388684.0,22050.446269073484,-19.07,2
05:02,108931112.0,14691.167530357898,-35.8,9
05:03,216285378.0,24760.48751145933,-27.52,9
05:03,520447032.0,8250.58029139865,-30.98,9
05:13,489964679.0,20774.199441578246,-39.44,9
05:13,170637730.0,1596.1858817148654,-10.95,4
05:13,518474507.0,14291.222679327311,-26.48,9
05:15,975345315.0,36744.969970600294,-59.16,4
05:16,596171893.0,-649.6044051744893,-28.44,9
05:17,910730524.0,7986.009340876369,-19.53,2
05:18,705848712.0,28060.81967980823,-12.45,9
05:32,699139822.0,1784.0640757769468,-51.73,8
05:35,985188462.0,-78.7536112887752,-34.67,9
05:38,822250278.0,6593.8652595538815,-18.46,4
05:39,749378808.0,1736.2944193242577,-31.21,9
05:41,858989281.0,27282.94973710404,-49.43,8
05:45,195895574.0,7514.68243299404,-29.28,2
05:50,496395938.0,12633.044434999943,-0.05,2
05:52,675806859.0,7468.363635333805,-52.57,7
05:52,187541224.0,1984.7850565611527,-28.79,9
05:52,113747882.0,12421.220960539467,-44.89,9
05:55,657139925.0,13679.911072751673,-19.99,9
05:56,151968462.0,7097.908196788727,-11.83,2
05:56,305778936.0,10621.200219815528,-29.72,9
05:58,324224854.0,4355.999076858074,-34.25,2
05:58,285220959.0,12228.470239060103,-62.12,2
05:59,604288474.0,1684.0559300800096,-18.49,7
05:59,187111705.0,7104.774847004104,-47.68,7
06:01,588565416.0,6064.746273481441,-0.28,7
06:01,120634201.0,5224.727445998489,-18.6,9
06:02,992204045.0,7385.996627764974,-12.56,8
06:03,229205098.0,7775.611366300008,-81.2,7
06:07,221868392.0,4942.181787899825,-30.54,2
06:07,194023154.0,-2670.839671784733,-30.47,9
06:10,259015404.0,1067.528792042534,-29.91,5
06:10,806358207.0,11442.059938869694,-0.42,5
06:11,749378808.0,1729.3105556436708,-6.98,2
06:12,361201224.0,3211.800704333806,-26.33,2
06:12,788740658.0,2768.723631271804,-2.77,7
06:13,108481285.0,9029.486566959034,-6.2,5
06:16,949032480.0,3984.0230733445464,-36.03,9
06:23,256002321.0,6243.517554565723,-11.23,9
06:24,688712152.0,6938.873777664469,-44.27,2
06:25,851649498.0,8488.760741358423,-43.54,2
06:28,679911053.0,2717.7831791181234,-61.64,8
06:29,534325901.0,7038.4446350718945,-9.05,2
06:31,417850087.0,15677.659967111102,-12.82,7
06:32,558119802.0,34247.850335196934,-49.26,5
06:33,518474507.0,14272.917028071686,-18.31,7
06:33,874431242.0,9217.219421877506,-22.64,9
06:34,670102069.0,1564.3491575261655,-28.18,9
06:38,290818242.0,7207.794258436563,-14.0,7
06:40,128033695.0,2104.379281430292,-6.63,7
06:41,815385232.0,10589.337066888314,-17.99,9
06:41,973086490.0,10391.790274152198,-66.8,5
06:49,534204159.0,5921.8953993838295,-1.16,8
06:49,383625050.0,2915.4810675578133,-1.66,2
06:54,984783496.0,14513.624315515544,-24.45,9
06:56,633345190.0,6097.294691213473,-30.29,9
06:56,705848712.0,28028.122270152795,-32.7,7
06:57,519644021.0,2749.58185478061,-23.96,9
06:58,901037631.0,1582.7693230964064,-36.23,9
06:58,766941757.0,2619.378510245526,-26.98,9
07:00,865748375.0,2541.105690705494,-1.76,7
07:01,912705941.0,19191.521771786665,-6.82,8
07:03,949032480.0,3953.852818021823,-30.17,7
07:03,887853850.0,10523.973698242622,-31.94,9
07:04,613729471.0,8052.623062233666,-20.31,2
07:04,874431242.0,9200.539048965751,-16.68,7
07:06,667367404.0,9402.299456397468,-63.26,7
07:09,506618547.0,14867.465456547014,-22.0,5
07:09,647936800.0,2367.1907711816752,-64.04,5
07:10,282837512.0,14157.702147064618,-62.91,2
07:12,670102069.0,1518.6036270545894,-45.75,7
07:13,510101371.0,13693.87202014144,-35.87,9
07:13,668329719.0,9081.302143772888,-3.72,7
07:16,245690309.0,9911.546247474264,-55.55,7
07:16,718058208.0,2098.115981523423,-6.56,7
07:17,836110591.0,6439.353394599743,-31.34,9
07:22,183888402.0,19389.172457140132,-35.45,9
07:22,829914501.0,1514.4588065709745,-7.1,9
07:27,532478725.0,4539.51766023103,-16.46,2
07:32,147474476.0,2853.051537310334,-3.86,2
07:33,252760664.0,7026.262589025834,-4.36,7
07:37,873693307.0,10507.498452170856,-2.97,7
07:42,237493332.0,14891.785684407056,-35.4,2
07:42,987656636.0,4332.466939236691,-7.71,5
07:43,683319988.0,7270.65261900097,-27.65,2
07:46,441274121.0,12517.561446017586,-10.1,8
07:48,169006407.0,11847.578162993275,-37.01,5
07:50,719586818.0,19156.353743974076,-54.76,2
07:51,752362502.0,7756.364214696151,-16.48,9
07:51,706250160.0,12770.552207418365,-3.36,2
07:51,500043411.0,13947.77154841411,-43.47,2
07:52,461990622.0,9928.213247357624,-16.02,7
07:55,930277104.0,10191.866639211172,-42.38,9
08:00,651756497.0,14674.185034461014,-23.24,7
08:00,200080192.0,9547.795775244214,-81.71,5
08:01,519644021.0,2695.673354918688,-53.91,8
08:07,213112754.0,5704.323099214046,-3.82,7
08:08,940569402.0,5018.872008136156,-26.44,2
08:11,550169791.0,22525.158829271462,-12.04,2
08:14,336557504.0,1030.2914776420278,-6.05,9
08:14,549414742.0,7615.874708152151,-36.65,9
08:15,795847804.0,24368.670631142315,-0.91,2
08:16,280200287.0,223.53954661305104,-6.0,9
08:16,399538448.0,7570.252875838913,-5.8,9
08:18,960208650.0,14763.196518780918,-0.38,5
08:21,340321732.0,1738.4255500000038,-34.03,9
08:23,108931112.0,14683.706076981687,-7.46,7
08:23,885259672.0,3186.9501222908325,-6.9,9
08:24,449387287.0,166.33569383510138,-54.66,5
08:25,419084831.0,-439.9264255261032,-67.19,5
08:27,203466392.0,3485.2236435061195,-79.69,5
08:29,280098744.0,-1334.4716221283345,-86.86,5
08:30,986267641.0,4254.119697275705,-65.84,5
08:32,435984758.0,4247.7746096461215,-17.53,7
08:32,644751433.0,-1634.2156584655384,-18.8,5
08:36,890830949.0,944.3939999999976,-126.68,5
08:36,930277104.0,10184.989559214177,-6.88,5
08:38,229205098.0,7688.209366300008,-87.4,5
08:38,836110591.0,3350.2892425904784,-9.06,2
08:38,752362502.0,7732.933493805151,-23.43,7
08:38,162162212.0,-298.619956672691,-34.38,9
08:43,187111705.0,7042.9368470041045,-61.84,5
08:44,760704118.0,360.7983127174892,-119.53,5
08:45,449871732.0,7993.89792266945,-3.84,5
08:47,624563756.0,-394.0445712164436,-13.66,5
08:49,786927378.0,-1675.2402796373165,-40.89,5
08:49,668329719.0,8998.618143772888,-82.68,5
08:51,730002588.0,13862.490040535922,-3.14,5
08:54,131388684.0,22034.92026907348,-15.53,5
08:55,750094757.0,-1801.449300000001,-32.21,5
08:56,305778936.0,10575.48760870768,-45.71,7
08:56,609939116.0,7669.207127453547,-6.78,8
09:01,975345315.0,36739.91997060029,-5.05,9
09:02,668175891.0,619.5930231584989,-47.44,5
09:02,169006407.0,11842.178162993276,-5.4,9
09:03,417850087.0,15672.009967111102,-5.65,9
09:04,441274121.0,12512.061446017586,-5.5,9
09:04,290818242.0,7201.694258436562,-6.1,9
09:06,832564361.0,15773.184369972872,-12.71,5
09:07,520447032.0,8246.360274381164,-4.22,7
09:10,558875206.0,3429.5765393997804,-5.65,9
09:11,322221939.0,3512.7871459539874,-1.79,2
09:11,667367404.0,9397.199456397468,-5.1,9
09:12,903468956.0,649.1139999999994,-95.39,5
09:13,743630833.0,120.8220632847012,-124.69,5
09:13,162370388.0,-2444.3653999999988,-20.23,5
09:17,581655972.0,41830.23649376848,-6.5,9
09:18,287480331.0,7603.864061065994,-6.35,2
09:19,214339619.0,440.9089785105091,-5.65,9
09:20,741903302.0,2497.4170679352605,-6.5,9
09:20,618514666.0,22196.923977494487,-99.37,2
09:20,117273481.0,9111.996720450745,-5.8,9
09:20,851649498.0,8409.184741358424,-79.58,5
09:20,690958123.0,21853.674318934183,-5.5,9
09:21,506618547.0,14861.765456547011,-5.7,9
09:22,540159353.0,11277.496866068956,-6.0,9
09:22,919185264.0,4134.702230989973,-27.95,7
09:23,570410059.0,2117.0809967763116,-98.49,2
09:23,586315521.0,12616.11189527114,-6.6,9
09:23,308505160.0,13634.267555634851,-1.68,8
09:24,333054026.0,133.1008940231901,-12.04,1
09:24,673025413.0,876.5906618245202,-35.88,5
09:26,992204045.0,7380.996627764974,-5.0,9
09:27,851649498.0,8403.484741358423,-5.7,9
09:29,874506295.0,-1509.971756245572,-33.34,5
09:31,108931112.0,14650.704536981688,-33.0,4
09:32,145387690.0,5460.081814138627,-3.45,2
09:32,903953091.0,3179.4528830548006,-74.98,2
09:34,929044080.0,288.85889150562826,-33.95,7
09:35,570410059.0,2017.6009967763116,-99.48,2
09:35,373875019.0,17606.89229440856,-16.97,1
09:36,709151315.0,-195.13578162584017,-59.98,5
09:37,117308635.0,2291.2590072910493,-83.32,2
09:40,903663593.0,217.39438004355392,-32.96,7
09:41,857997794.0,850.7876651508866,-50.94,1
09:42,282837512.0,14095.502147064615,-62.2,2
09:42,659415300.0,1750.1211305359598,-35.0,2
09:43,494156986.0,-586.4726543276653,-86.9,5
09:45,895750759.0,-460.22528807566584,-79.97,2
09:45,687135796.0,29112.58221296902,-26.23,1
09:46,473820682.0,11618.529318314746,-53.47,4
09:47,553734946.0,86.04399999999828,-49.66,5
09:48,248658670.0,1356.33165,-15.98,2
09:48,986774156.0,1678.5069316257693,-16.97,7
09:49,352291960.0,2095.5850533035737,-223.3,2
09:51,479456865.0,1782.7994995833055,-10.99,4
09:53,454356905.0,1379.9987923653623,-7.11,4
09:56,996042490.0,6112.242882563543,-60.07,2
09:57,572384506.0,7289.732607246608,-45.75,4
09:59,979892433.0,-1490.3678000000011,-92.62,5
10:01,941285623.0,1029.3643990667704,-75.97,4
10:03,264550521.0,5362.6372546030725,-31.21,7
10:03,930277104.0,10136.003559214174,-48.99,2
10:05,497809732.0,3505.899869552595,-15.98,4
10:06,538003940.0,2086.63000000001,-21.97,7
10:08,570410059.0,1969.1109967763116,-48.49,2
10:09,352291960.0,1931.7850533035737,-163.8,2
10:11,903953091.0,3156.9728830548006,-22.48,4
10:14,699139822.0,1731.5640757769468,-52.5,2
10:14,462962606.0,886.1500499999987,-54.1,2
10:16,909676212.0,124.16453178761311,-25.96,7
10:19,518466565.0,772.1254499999993,-56.99,2
10:22,812692024.0,3982.2530918987177,-50.37,5
10:23,348325817.0,10654.673186050311,-19.81,2
10:25,352291960.0,1827.4850533035735,-104.3,2
10:31,950234174.0,1941.5942143102957,-143.5,2
10:34,570410059.0,1955.6209967763116,-13.49,2
10:40,497809732.0,3492.9098695525954,-12.99,2
10:40,699139822.0,1567.0640757769468,-164.5,2
10:43,179173981.0,4839.755298547818,-10.31,5
10:47,348325817.0,10597.578146050311,-57.1,4
10:47,601627384.0,3466.334144325868,-30.89,1
10:49,655368335.0,4030.1437686128697,-32.92,7
10:51,904154012.0,416.1574581204316,-30.96,7
10:53,828750680.0,1129.1423952136802,-5.99,4
11:01,601627384.0,3416.854144325868,-49.48,2
11:02,421881811.0,2427.843931441336,-37.81,4
11:03,237684254.0,6036.561292100974,-32.67,2
11:04,871866387.0,194.5554999999991,-94.63,5
11:06,950234174.0,1770.0942143102957,-171.5,2
11:07,570410059.0,1828.1309967763116,-127.49,2
11:09,930277104.0,10049.917559214176,-86.09,2
11:10,134461671.0,5458.007209322092,-39.5,7
11:13,699139822.0,1275.164075776947,-291.9,2
11:19,700138124.0,4794.050513450298,-23.57,5
11:22,933745726.0,-38.23144357067673,-45.34,5
11:28,699139822.0,1083.364075776947,-191.8,2
11:30,570410059.0,1767.1409967763116,-60.99,2
11:31,618514666.0,22098.25197749449,-98.67,2
11:32,987656636.0,4312.326939236691,-20.14,7
11:33,930277104.0,9829.431559214174,-220.49,2
11:43,950234174.0,1620.2942143102955,-149.8,2
11:44,570410059.0,1737.1409967763116,-30.0,2
11:47,409370545.0,731.8532755455208,-42.19,5
11:50,585625048.0,1985.5339749993575,-141.04,5
11:53,618514666.0,21955.50797749449,-142.74,2
11:54,699139822.0,796.364075776947,-287.0,2
11:56,950234174.0,1344.4942143102958,-275.8,2
12:00,930277104.0,9656.559559214174,-172.87,2
12:02,822250278.0,6567.185259553881,-26.68,9
12:02,364357875.0,8186.446393046641,-316.4,2
12:13,930277104.0,9634.187559214177,-22.37,2
12:14,284905540.0,8425.461113056128,-11.46,7
12:18,973086490.0,10375.740274152198,-16.05,9
12:19,364357875.0,7997.446393046641,-189.0,2
12:21,454356905.0,1351.0887923653625,-28.91,9
12:29,462962606.0,853.1200499999987,-33.03,1
12:33,987656636.0,4232.358939236691,-79.97,5
12:34,699139822.0,692.064075776947,-104.3,2
12:36,348325817.0,10533.668146050311,-63.91,2
12:37,950234174.0,1197.4942143102958,-147.0,2
12:39,554792076.0,29561.326093684664,-20.09,2
12:44,570410059.0,1665.6509967763116,-71.49,2
12:54,414454079.0,284.03785000000147,-5.59,4
12:56,570410059.0,1640.6509967763116,-25.0,2
12:59,845648250.0,12.181649999999363,-144.76,5
13:03,344522228.0,-2963.9719882083928,-14.24,5
13:04,722358036.0,459.72499062708295,-4.75,9
13:05,950234174.0,1037.1942143102958,-160.3,2
13:05,849096144.0,1344.214020751343,-5.7,9
13:13,655450953.0,-2933.042378455529,-24.22,5
13:13,709142813.0,846.4397999999992,-107.83,5
13:13,688712152.0,6933.873777664469,-5.0,9
13:15,593378953.0,477.8696500000049,-6.45,9
13:16,277562576.0,367.38006997625706,-7.9,9
13:18,187111705.0,7035.636847004104,-7.3,9
13:18,809499628.0,17987.78036396098,-2.9,8
13:20,896821055.0,-919.9564407329176,-128.16,5
13:21,348325817.0,10528.318146050313,-5.35,9
13:21,569687509.0,-2301.0828999999994,-46.31,5
13:22,812692024.0,3975.7530918987177,-6.5,9
13:23,585625048.0,1978.6339749993576,-6.9,9
13:24,684284526.0,-3359.651366745756,-16.2,5
13:24,809499628.0,17973.53036396098,-14.25,9
13:28,570410059.0,1561.6509967763116,-79.0,2
13:32,287480331.0,7573.714061065994,-30.15,9
13:35,950234174.0,1029.64377876474,-7.55,7
14:04,570323670.0,3415.892183405255,-2.44,4
14:14,618514666.0,21855.43597749449,-100.07,2
14:38,414454079.0,111.01885000000148,-173.02,5
15:05,857997794.0,830.7976651508866,-19.99,4
15:13,950234174.0,855.3437787647399,-174.3,2
15:19,954263768.0,-265.38130000000024,-29.5,5
15:23,618514666.0,21784.035977494488,-71.4,2
15:24,985188462.0,77.4263887112248,-93.82,2
15:30,699139822.0,197.164075776947,-188.3,2
15:33,950234174.0,649.54377876474,-205.8,2
16:03,699139822.0,53.66407577694699,-143.5,2
16:15,886921642.0,3288.958958361032,-37.07,2
16:18,699139822.0,-257.835924223053,-311.5,2
16:22,587225252.0,5749.031176666447,-38.41,5
16:22,151278285.0,1783.1310999999998,-91.97,2
16:23,303843160.0,-242.15659999999852,-24.15,9
16:31,145553416.0,-2789.8206499999983,-50.49,5
16:31,914806976.0,199.56325018548657,-90.3,2
16:36,587225252.0,5687.661176666447,-61.37,2
16:38,950234174.0,489.24377876474,-160.3,2
16:40,492215823.0,2890.8439438154446,-107.8,2
16:43,699139822.0,-488.835924223053,-231.0,2
16:46,914806976.0,-97.93674981451346,-297.5,2
16:49,641764023.0,-1106.0888037720044,-14.45,5
16:52,950234174.0,238.64377876474,-250.6,2
16:52,885259672.0,3135.0941747354927,-51.86,5
16:53,618514666.0,21630.063977494487,-153.97,2
16:54,914806976.0,-323.33674981451344,-225.4,2
16:57,587225252.0,5657.941176666447,-29.72,9
17:03,492215823.0,2826.4579438154447,-64.39,2
17:03,294474095.0,-2576.431286499238,-58.22,5
17:11,331450202.0,7801.316695195264,-21.24,9
17:13,788740658.0,2763.7336312718044,-4.99,7
17:14,391559884.0,-168.41770000000068,-182.84,5
17:14,832564361.0,15759.944369972873,-13.24,9
17:15,613729471.0,8027.243062233666,-25.38,7
17:15,416060965.0,50.172254700580254,-32.23,9
17:15,492215823.0,2816.1979438154444,-10.26,7
17:16,899742927.0,13118.572618585891,-2.63,5
17:16,556992209.0,12351.673235569277,-26.52,7
17:16,510101371.0,13668.13202014144,-25.74,4
17:17,198946608.0,4401.409012188328,-26.21,2
17:17,815385232.0,10568.433184991893,-20.9,5
17:20,887853850.0,10496.267901538997,-27.71,8
17:22,802697323.0,16752.538234294047,-4.97,2
17:23,699139822.0,-724.0359242230529,-235.2,2
17:24,314980178.0,3938.466850000006,-156.07,2
17:24,169006407.0,11815.958162993276,-26.22,7
17:26,857754342.0,1137.3962538559438,-99.97,4
17:26,886837068.0,906.4555999999992,-22.48,4
17:28,858989281.0,27267.18973710404,-15.76,7
17:31,500843551.0,295.78789999999964,-35.0,2
17:33,399144202.0,1587.9846976732897,-4.3,4
17:34,229205098.0,7652.369366300008,-35.84,2
17:34,143061865.0,7457.473245040237,-21.06,2
17:37,683078800.0,2162.53519157638,-20.97,7
17:39,315078351.0,8184.004588503087,-48.76,2
17:40,683319988.0,7020.05261900097,-250.6,2
17:40,152488934.0,1883.4623073137311,-36.28,9
17:43,285428103.0,10419.359808161063,-62.29,5
17:43,140893085.0,6911.800056365463,-59.99,2
17:46,964702094.0,651.3009186515939,-270.9,2
17:46,971010829.0,235.98505644424512,-27.95,7
17:46,626989363.0,714.0617633173752,-181.5,2
17:47,352899149.0,495.0450499999987,-64.5,2
17:47,769311479.0,6317.228240092876,-17.22,1
17:47,986267641.0,4245.509847275705,-8.61,4
17:47,559995067.0,2316.646428991797,-83.75,5
17:48,492215823.0,2645.4119438154444,-170.79,2
17:51,316793091.0,697.3024600549509,-13.97,4
17:51,893134725.0,1040.304737661667,-35.95,7
17:52,506618547.0,14851.665456547013,-10.1,2
17:52,951817450.0,9315.859276328694,-59.99,7
17:52,486495235.0,1797.2111642021823,-54.99,2
17:54,994214354.0,10144.955220343296,-26.47,9
17:55,124102251.0,3228.415365468293,-14.01,5
17:55,429556122.0,4567.957503868459,-20.07,2
17:56,867987292.0,1764.6308183931,-51.74,7
17:58,138609932.0,2304.630003294586,-90.98,2
17:59,423208402.0,4004.990100000003,-17.96,5
18:00,475117511.0,7257.488471991136,-112.0,4
18:00,651756497.0,14613.235034461011,-60.95,2
18:00,383625050.0,2864.831067557813,-50.65,2
18:02,482513594.0,5630.993213368729,-13.2,9
18:09,316793091.0,646.3102600549508,-50.99,5
18:09,270374623.0,9820.080552901947,-14.99,9
18:13,308505160.0,13600.687555634851,-33.58,9
18:14,950234174.0,147.64377876474,-91.0,2
18:14,475117511.0,7173.488471991136,-84.0,7
18:16,626989363.0,597.5617633173752,-116.5,2
18:18,352899149.0,403.5550499999987,-91.49,2
18:19,419550103.0,19168.4148045084,-161.0,2
18:19,220183538.0,340.9714499999993,-15.98,7
18:20,340295966.0,-1686.3019500000005,-39.09,9
18:20,964702094.0,346.80091865159386,-304.5,2
18:21,366477356.0,145.90624999999983,-40.14,9
18:27,494789005.0,2577.7639329842677,-23.1,5
18:28,605116158.0,2586.4771000000037,-11.98,7
18:32,496395938.0,12578.834434999946,-54.21,7
18:32,475117511.0,7034.188471991136,-139.3,2
18:32,196289502.0,16352.138397636942,-16.35,7
18:35,955035930.0,2325.463479171478,-5.99,7
18:37,628470485.0,517.3350299001231,-24.98,7
18:40,290818242.0,7099.298258436563,-102.4,5
18:40,429556122.0,4560.9740478193535,-6.98,4
18:40,690958123.0,21843.68431893418,-9.99,7
18:41,585133606.0,5338.313459392841,-9.99,7
18:41,657528784.0,-83.99609999999926,-29.34,9
18:41,221868392.0,4906.641787899825,-35.54,9
18:42,466649401.0,171.81769355208746,-47.94,7
18:42,494789005.0,2547.1205229842676,-30.64,7
18:44,651756497.0,14564.465034461013,-48.77,7
18:46,445240363.0,-1140.7692559632735,-22.94,9
18:50,558119802.0,34168.99533519693,-78.85,5
18:51,633345190.0,6035.381493184007,-61.91,2
18:54,471897866.0,7019.942731699046,-22.6,2
18:54,331684336.0,-1555.6888699513215,-19.71,5
18:55,224524792.0,-2355.0356824308483,-30.88,5
18:56,687135796.0,29100.13221296902,-12.45,9
18:57,987390838.0,-3075.8162412103775,-16.12,5
18:57,639409800.0,36825.703051520366,-2.03,7
18:59,146909202.0,3514.767398120112,-65.19,8
19:04,256045540.0,-3750.141399999999,-41.51,5
19:05,736340277.0,8861.637713512146,-18.2,5
19:09,993039226.0,-4456.234499999995,-31.54,5
19:10,779620857.0,-888.491996385176,-122.75,5
19:11,345582855.0,416.02695282054935,-54.73,5
19:14,336171116.0,-203.61840000000055,-108.43,5
19:15,187541224.0,1964.9302783028456,-19.85,7
19:15,480198977.0,12473.65775411439,-2.0,5
19:18,943329213.0,-194.79438065024232,-41.14,9
19:18,581655972.0,41772.98923650419,-57.25,7
19:20,859603181.0,3480.236827834488,-56.32,2
19:21,600585971.0,132.65189999999956,-154.67,5
19:22,844835978.0,10474.69167950703,-13.71,5
19:24,704517789.0,18418.616409349655,-44.62,5
19:27,639409800.0,36813.02495112542,-12.68,8
19:27,628470485.0,474.5850299001231,-42.75,9
19:31,433917275.0,7755.764844214671,-12.87,2
19:38,736340277.0,8818.125713512145,-43.51,5
19:42,256002321.0,6240.480361335518,-3.04,8
19:45,450896297.0,13624.384999537244,-44.68,9
19:57,151916463.0,-232.5074444008311,-96.5,5
19:59,872286364.0,-764.7838958130998,-67.55,5
20:00,195895574.0,7494.93243299404,-19.75,9
20:00,386729293.0,31662.71947818558,-28.9,2
20:02,585596026.0,2786.3253883810667,-42.87,2
20:02,834581602.0,200.51969999999915,-64.18,5
20:05,522188082.0,7260.067363778226,-61.8,2
20:06,203466392.0,3483.5127002998984,-1.71,4
20:12,252701364.0,-3969.4986726779143,-31.17,5
20:13,235881534.0,12973.903532517574,-3.5,7
20:15,461029994.0,7959.439410314172,-18.98,5
20:15,618138606.0,1430.5391715212995,-6.55,5
20:16,703588001.0,-344.88645000000054,-97.26,5
20:19,851181128.0,4688.172208195041,-42.51,4
20:19,623156843.0,4654.123928261723,-38.68,2
20:21,473820682.0,11516.385318314746,-102.14,5
20:28,984783496.0,14476.092316003138,-37.53,2
20:29,698076160.0,6569.453045214075,-136.39,5
20:32,280268430.0,5159.128955134349,-5.8,2
20:34,224112146.0,1719.8248999999998,-159.12,5
20:39,719586818.0,19018.509743974075,-137.84,5
20:50,766812921.0,-387.7622500000009,-148.93,5
20:52,229205098.0,7642.419366300008,-9.95,9
20:53,475117511.0,6983.851471991135,-50.34,5
20:57,129018172.0,9698.324815571274,-266.62,5
21:00,489964679.0,20761.74770095581,-12.45,8
21:06,120634201.0,5222.280919080845,-2.45,8
01:12,108931112.0,14622.204536981688,-28.5,9
01:23,779946617.0,17042.02361867615,-37.52,7
01:32,679662108.0,16756.77319165067,-2.99,7
01:39,699139822.0,-747.235924223053,-23.2,9
01:39,687135796.0,29088.88322650562,-11.25,8
02:28,647472692.0,26577.602146718833,-40.27,9
02:28,858989281.0,27243.03973710404,-24.15,9
02:32,259015404.0,1051.558792042534,-15.97,9
02:37,541639148.0,4202.80886300907,-21.57,4
02:43,120634201.0,5208.940919080845,-13.34,9
02:47,639549973.0,7360.041967864997,-0.86,7
02:52,821971408.0,1081.733110235543,-13.0,9
02:54,970298834.0,2511.0148152505412,-65.8,5
02:57,853907490.0,7784.793469105808,-36.39,4
02:57,950234174.0,87.27365138923021,-60.37,5
02:59,657139925.0,13659.021072751671,-20.89,9
03:12,832564361.0,15759.854725328956,-0.09,5
03:27,134847904.0,5136.64033347907,-26.94,5
03:30,949032480.0,3917.492818021823,-36.36,9
03:33,441274121.0,12505.071446017586,-6.99,9
03:33,987163717.0,3942.554131891315,-35.98,9
03:34,718058208.0,2093.35145038192,-4.76,8
03:37,399144202.0,1544.3446976732896,-43.64,9
03:39,779236304.0,1987.6375954795335,-36.93,9
03:42,270374623.0,9811.255886629871,-8.82,2
03:45,633345190.0,5999.941493184007,-35.44,9
03:46,324224854.0,4355.84571275716,-0.15,8
03:47,572384506.0,7259.872607246608,-29.86,9
03:49,203466392.0,3446.040360205947,-37.47,5
03:52,824916823.0,8550.243140104021,-40.79,9
03:58,259015404.0,1038.1726255827998,-13.39,8
04:05,179173981.0,4767.916666232538,-71.84,5
04:05,252760664.0,6989.495942549688,-36.77,2
04:06,298000165.0,26755.093931827356,-8.33,2
04:06,117273481.0,9088.616118264998,-23.38,2
04:06,245690309.0,9904.743562942804,-6.8,2
04:20,287480331.0,7532.704665065717,-41.01,7
04:22,417850087.0,15647.590169153687,-24.42,2
04:25,285220959.0,12197.956424724987,-30.51,8
04:30,519644021.0,2671.0465949604627,-24.63,5
04:30,489964679.0,20725.357700955807,-36.39,9
04:33,558119802.0,34145.01533519693,-23.98,9
04:35,752362502.0,7654.080555974059,-78.85,2
04:37,719586818.0,19011.42320438408,-7.09,2
04:37,322221939.0,3490.818045690187,-21.97,4
04:40,549414742.0,7581.434708152151,-34.44,9
04:41,822250278.0,6561.633005665926,-5.55,2
04:43,216285378.0,24727.34751145933,-33.14,9
04:50,613729471.0,8020.026510109371,-7.22,7
04:50,108481285.0,9007.6254371377,-21.86,7
04:51,647936800.0,2360.986955815339,-6.2,7
04:53,421881811.0,2361.6099267619434,-66.23,7
04:55,520447032.0,8220.210274381165,-26.15,9
04:58,482513594.0,5576.823752987814,-54.17,5
05:01,166019891.0,8440.898037039578,-20.0,9
05:02,986267641.0,4239.641593260764,-5.87,4
05:04,370521542.0,27566.223507900584,-8.63,8
05:04,851181128.0,4667.282208195041,-20.89,9
05:04,187541224.0,1930.2902783028453,-34.64,9
05:09,886921642.0,3284.8921047530544,-4.07,7
05:11,187111705.0,6973.925009080959,-61.71,2
05:12,237493332.0,14877.677503988354,-14.11,8
05:14,473820682.0,11459.899677145584,-56.49,2
05:14,308505160.0,13540.532978639576,-60.15,7
05:15,836110591.0,3324.3092425904783,-25.98,9
05:16,873693307.0,10487.748452170856,-19.75,9
05:16,709608057.0,2535.9473559031403,-25.93,9
05:17,550169791.0,22519.564499301898,-5.59,7
05:19,930277104.0,9603.897559214174,-30.29,9
05:25,522188082.0,7185.226087938863,-74.84,2
05:28,496395938.0,12537.890712545342,-40.94,5
05:29,809499628.0,17961.04036396098,-12.49,9
05:29,633345190.0,5997.612818027235,-2.33,5
05:29,532478725.0,4503.01766023103,-36.5,9
05:30,169006407.0,11793.235554844085,-22.72,2
05:30,450896297.0,13602.75099352736,-0.4,7
05:34,653640811.0,17899.82262589409,-4.68,2
05:42,124102251.0,3210.61797122575,-17.8,5
05:42,885259672.0,3127.146637495149,-7.95,4
05:46,373875019.0,17572.80229440856,-34.09,9
05:54,322720763.0,6762.998156446922,-2.72,2
05:54,858989281.0,27197.117196010648,-45.92,7
05:59,586315521.0,12578.851808176578,-37.26,8
06:00,370521542.0,27549.723507900584,-16.5,9
06:00,809499628.0,17956.490068779596,-4.55,7
06:02,200080192.0,9545.772514847766,-2.02,8
06:04,675806859.0,7446.762396055005,-21.6,2
06:06,511179916.0,7502.873221551551,-13.07,7
06:06,766941757.0,2584.948510245526,-34.43,9
06:07,651756497.0,14511.678159767276,-52.79,4
06:08,414805878.0,13045.99509757628,-31.89,9
06:09,408057540.0,4903.027997671693,-57.89,4
06:11,824916823.0,8536.913925081419,-13.33,5
06:11,679911053.0,2711.526872864683,-6.26,4
06:15,179173981.0,4745.096666232538,-22.82,9
06:16,960208650.0,14715.875270594724,-47.32,5
06:18,601627384.0,3381.0241443258683,-35.83,9
06:19,700138124.0,4791.509151722597,-2.54,7
06:19,113747882.0,12386.120960539469,-35.1,9
06:22,795847804.0,24296.72280236537,-71.95,2
06:23,704517789.0,18389.16537759615,-29.45,2
06:24,609939116.0,7651.279433530374,-17.93,7
06:26,673025413.0,851.2817411790421,-25.31,5
06:31,383833857.0,26236.149822546,-3.99,7
06:31,480557476.0,11350.45734500756,-15.3,7
06:33,310620484.0,-24.05880490780172,-34.7,9
06:34,549414742.0,7530.932766458994,-50.5,5
06:34,433917275.0,7727.664844214671,-28.1,9
06:37,749378808.0,1703.3705556436707,-25.94,9
06:37,806358207.0,11432.87199836248,-9.19,8
06:38,670102069.0,1492.4136270545894,-26.19,9
06:41,822135975.0,11752.30233169194,-1.53,4
06:43,518474507.0,14245.647028071686,-27.27,9
06:46,738958551.0,9354.075985949035,-33.14,9
06:48,256002321.0,6219.1380641577725,-21.34,2
06:50,713641917.0,1421.7783729031098,-32.36,2
06:50,113747882.0,12348.3121044175,-37.81,8
06:52,348325817.0,10493.688146050314,-34.63,9
06:52,554792076.0,29541.30517112565,-20.02,7
06:54,949032480.0,3912.589922956062,-4.9,7
06:56,305778936.0,10550.98760870768,-24.5,9
06:56,705848712.0,28026.570201251656,-1.55,5
06:57,802697323.0,16706.238234294047,-46.3,9
07:01,897592348.0,15794.862095187857,-52.29,5
07:04,587225252.0,5624.411176666447,-33.53,9
07:05,183888402.0,19359.482457140133,-29.69,9
07:06,897714622.0,9474.261212503265,-4.35,2
07:07,994214354.0,10108.775220343296,-36.18,9
07:07,196289502.0,16339.138397636942,-13.0,9
07:08,749378808.0,1699.2265472652448,-4.14,2
07:08,873693307.0,10473.484496689623,-14.26,2
07:09,581655972.0,41770.48412154504,-2.51,5
07:15,667367404.0,9393.133008833784,-4.07,7
07:17,130154096.0,751.1682981961067,-53.88,7
07:23,534325901.0,7034.531070052687,-3.91,2
07:28,213112754.0,5694.7823775023035,-9.54,7
07:29,683319988.0,6985.51261900097,-34.54,9
07:29,170637730.0,1563.5153969701705,-32.67,2
07:29,910730524.0,7978.532313852072,-7.48,7
07:33,540159353.0,11223.11623004348,-54.38,5
07:36,874431242.0,9173.426088748489,-27.11,2
07:38,987229118.0,910.0794794093156,-23.7,2
07:38,842682241.0,5707.995053153993,-54.38,2
07:40,510101371.0,13625.25202014144,-42.88,9
07:40,905860285.0,10683.610174673797,-48.21,7
07:43,738958551.0,9271.461172434694,-82.61,5
07:48,987656636.0,4211.20349758916,-21.16,8
07:53,196289502.0,16288.745919962274,-50.39,8
07:56,604288474.0,1679.058738744681,-5.0,5
07:56,195895574.0,7484.809763983049,-10.12,8
07:56,558119802.0,34100.19194845555,-44.82,8
08:00,675231808.0,18370.298099424563,-23.39,2
08:04,395284483.0,1163.714340211308,-5.4,9
08:06,930277104.0,9592.124785307697,-11.77,7
08:07,994214354.0,10077.04647045276,-31.73,8
08:08,506618547.0,14791.365381602962,-60.3,7
08:09,237684254.0,6032.7437749889295,-3.82,2
08:10,280200287.0,218.08954661305103,-5.45,9
08:10,948558249.0,9937.945881139864,-5.7,9
08:11,510101371.0,13606.572076426706,-18.68,2
08:13,305778936.0,10546.900428224768,-4.09,5
08:16,399538448.0,7562.452875838912,-7.8,9
08:23,737547541.0,-508.5674004322256,-48.07,5
08:23,564214408.0,-168.706315274274,-39.98,5
08:23,575652395.0,2301.3965430658423,-25.99,8
08:24,108563213.0,23285.32556560003,-23.94,7
08:24,221868392.0,4871.634752354047,-35.01,8
08:27,766692943.0,-2067.21425,-19.55,5
08:30,405945930.0,5830.349275568806,-91.08,5
08:31,604288474.0,1607.168738744681,-71.89,5
08:32,131388684.0,22011.70826907348,-23.21,5
08:35,290818242.0,7097.628474822418,-1.67,5
08:37,624563756.0,-443.0550712164436,-49.01,5
08:38,758160963.0,8518.618007825015,-78.36,2
08:38,430910686.0,-320.8624999999996,-126.86,5
08:40,215426302.0,120.79040402569191,-41.09,5
08:42,194023154.0,-2709.044671784733,-38.2,5
08:44,730002588.0,13854.187852568866,-8.3,2
08:45,138969884.0,642.8962499999994,-91.87,5
08:45,435984758.0,4237.602890840892,-10.17,4
08:46,429556122.0,4487.810047819354,-73.16,5
08:47,261793952.0,-826.025739796185,-13.21,5
08:50,722358036.0,334.9377406270829,-124.79,5
08:55,583558311.0,-715.5522152486677,-26.23,5
08:58,138609932.0,2299.630003294586,-5.0,9
09:01,741903302.0,2491.2670679352605,-6.15,9
09:05,547010927.0,24464.262106096114,-1.44,7
09:06,613729471.0,8014.326510109371,-5.7,9
09:06,175452235.0,-1748.8107499999996,-90.85,5
09:06,131388684.0,22006.05826907348,-5.65,9
09:07,417850087.0,15642.290169153688,-5.3,9
09:07,683319988.0,6978.412619000969,-7.1,9
09:08,618138606.0,1425.5391715212995,-5.0,9
09:08,555804115.0,-1446.1210475587034,-23.63,5
09:08,999752672.0,1202.7398435333348,-7.1,9
09:09,624563756.0,-449.1050712164436,-6.05,9
09:11,678851253.0,3897.491583749582,-39.61,7
09:11,169006407.0,11787.035554844084,-6.2,9
09:13,549414742.0,7513.432766458994,-17.5,4
09:13,572136270.0,-1016.3742884119766,-25.24,5
09:13,423208402.0,3972.0201000000034,-32.97,4
09:14,558875206.0,3425.2265393997804,-4.35,9
09:16,108931112.0,14587.021076981688,-35.18,4
09:16,587202562.0,80.12129941706844,-113.4,5
09:19,690958123.0,21837.68431893418,-6.0,9
09:20,214339619.0,352.7166785105091,-88.19,5
09:20,851649498.0,8396.684741358424,-6.8,9
09:21,310620484.0,-47.19880490780172,-23.14,2
09:21,414454079.0,106.97885000000149,-4.04,4
09:21,270374623.0,9783.635886629872,-27.62,7
09:21,816685391.0,-826.3120037084263,-106.44,5
09:22,540159353.0,11217.31623004348,-5.8,9
09:22,170637730.0,1362.6433969701702,-200.87,2
09:22,117273481.0,9083.016118264995,-5.6,9
09:23,695607232.0,-392.18250538944005,-156.77,5
09:23,667367404.0,9387.083008833786,-6.05,9
09:24,158766229.0,-720.80438589347,-17.52,5
09:25,570323670.0,3415.298958271594,-0.59,7
09:26,506618547.0,14785.66538160296,-5.7,9
09:27,441274121.0,12499.421446017586,-5.65,9
09:28,948069469.0,-840.0252000000011,-30.71,5
09:28,214339619.0,344.8166785105091,-7.9,9
09:29,663479159.0,4781.821541827711,-9.99,7
09:33,703537476.0,984.7242499999992,-41.03,2
09:35,549414742.0,7428.760766458994,-84.67,7
09:38,743630833.0,-75.67793671529881,-196.5,2
09:39,145387690.0,5453.095147302215,-6.99,7
09:42,762859681.0,2894.332599999999,-7.0,7
09:42,170637730.0,1168.0433969701703,-194.6,2
09:45,985188462.0,50.93638871122481,-26.49,7
09:48,152616936.0,286.60500786306477,-99.99,2
09:49,541639148.0,4159.47886300907,-43.33,2
09:59,743630833.0,-134.6779367152988,-59.0,2
10:01,549414742.0,7306.960766458994,-121.8,2
10:03,762859681.0,2743.860599999999,-150.47,2
10:08,195895574.0,7454.77976398305,-30.03,5
10:10,767447966.0,4943.847062706573,-1.5,4
10:13,519644021.0,2652.9165949604626,-18.13,7
10:15,262767079.0,-1392.7040000000004,-107.01,5
10:16,298007503.0,1703.828103625634,-32.47,2
10:18,903663593.0,110.89438004355392,-106.5,2
10:20,743630833.0,-326.6779367152988,-192.0,2
10:22,366550080.0,25880.991957324644,-1.11,2
10:22,668175891.0,612.6030231584989,-6.99,4
10:28,823208989.0,735.7017038695317,-8.24,4
10:33,364357875.0,7975.919717814798,-21.53,8
10:36,585133606.0,5307.363459392841,-30.95,1
10:42,866941383.0,1797.8035500000074,-97.32,5
10:42,743630833.0,-464.6779367152988,-138.0,2
10:46,588565416.0,6052.766273481441,-11.98,1
10:55,647472692.0,26573.908036718833,-3.69,4
11:01,348525881.0,996.541624594936,-22.97,1
11:01,815993333.0,6221.829302159121,-2.65,4
11:04,143003091.0,10463.087469051134,-9.84,5
11:07,475277431.0,1128.2081369436191,-21.98,4
11:08,162162212.0,-310.599956672691,-11.98,2
11:09,743630833.0,-524.6779367152988,-60.0,2
11:15,514362267.0,-14.962680892939709,-51.49,4
11:20,903663593.0,6.644380043553923,-104.25,2
11:24,743630833.0,-592.1779367152988,-67.5,2
11:29,655368335.0,3999.15376861287,-30.99,7
11:40,941285623.0,980.3643990667704,-49.0,2
11:42,679943657.0,1782.8008891801371,-141.04,5
11:43,688712152.0,6869.370718137199,-64.5,7
11:44,310740977.0,64.60443592968085,-198.09,2
11:47,134461671.0,5446.527024999884,-11.48,7
11:49,743630833.0,-670.6779367152988,-78.5,2
11:57,762859681.0,2533.902599999999,-209.96,2
11:58,941285623.0,905.4923990667704,-74.87,2
12:04,585625048.0,1808.6639749993576,-169.97,2
12:07,412823730.0,204.14171585048973,-34.19,9
12:08,609939116.0,7550.489433530374,-100.79,2
12:08,442079728.0,133.2851192193139,-38.58,9
12:10,985188462.0,19.74638871122481,-31.19,9
12:10,722358036.0,169.4477406270829,-165.49,2
12:11,973086490.0,10356.342669906522,-19.4,8
12:13,941285623.0,880.3203990667704,-25.17,2
12:14,270374623.0,9699.685886629872,-83.95,2
12:15,743630833.0,-770.1779367152988,-99.5,2
12:22,460463595.0,-413.4979454185789,-40.7,9
12:24,909676212.0,68.40253178761313,-55.76,5
12:25,903663593.0,-45.85561995644608,-52.5,2
12:40,520447032.0,8192.200259368554,-28.01,4
12:44,722358036.0,16.46774062708289,-152.98,2
12:45,245198540.0,133.2713988017795,-19.25,5
12:47,264550521.0,5360.738103046271,-1.9,5
12:49,191992682.0,-2938.766460292063,-27.42,5
12:55,556631012.0,-80.99427691432192,-36.87,5
12:57,715068825.0,-456.22800000000024,-67.73,5
12:57,903663593.0,-84.85561995644608,-39.0,2
13:04,743630833.0,-939.6779367152988,-169.5,2
13:05,187111705.0,6968.125009080959,-5.8,9
13:05,503575533.0,8166.608854664672,-36.06,4
13:07,956717493.0,1249.6207504359832,-12.99,2
13:09,155867488.0,-227.84730000000155,-134.23,5
13:11,277562576.0,360.4800699762571,-6.9,9
13:11,572333122.0,-3884.237549999996,-45.69,5
13:12,903663593.0,-118.23061995644608,-33.38,2
13:13,910730524.0,7972.832313852072,-5.7,9
13:14,799861885.0,606.2330999999988,-116.33,5
13:20,322221939.0,3485.718045690187,-5.1,9
13:21,688712152.0,6863.9707181372,-5.4,9
13:22,290751280.0,184.95354667482556,-6.35,9
13:28,310740977.0,-81.66756407031912,-146.27,2
13:32,503575533.0,8161.618854664672,-4.99,7
13:34,280268430.0,5155.892874795457,-3.24,5
13:40,743630833.0,-1012.1779367152988,-72.5,2
13:49,941285623.0,843.7203990667704,-36.6,9
13:51,392790315.0,-4777.531394372064,-118.52,5
13:53,316793091.0,564.3202600549508,-81.99,2
13:54,993238248.0,-672.7014873928839,-140.57,5
13:54,310740977.0,-298.6395640703191,-216.97,2
14:05,441142605.0,1917.9221422757296,-81.98,2
14:18,348525881.0,976.561624594936,-19.98,2
14:20,718058208.0,2046.10012038192,-47.25,4
14:35,680773155.0,301.0400833310914,-43.66,5
14:44,678851253.0,3780.857583749582,-116.63,5
14:45,494789005.0,2525.657508222032,-21.46,2
14:59,762859681.0,2319.716599999999,-214.19,2
15:04,919185264.0,4002.171230989973,-132.53,5
15:14,762859681.0,2196.544599999999,-123.17,2
15:21,504055745.0,-317.58573865823314,-75.89,5
15:49,321372947.0,-418.1875507890995,-10.63,5
15:56,158414827.0,-1521.6950000000018,-12.99,5
16:08,899742927.0,13065.234873338142,-53.34,2
16:10,762859681.0,2118.158599999999,-78.39,2
16:16,541639148.0,4137.838863009069,-21.64,1
16:29,564744955.0,-71.34314141115813,-57.89,5
16:39,678330503.0,1242.8873528113777,-16.31,2
16:39,585133606.0,5131.677459392841,-175.69,2
16:41,198946608.0,4375.359012188328,-26.05,1
16:43,376271050.0,1604.0591885480565,-13.48,4
16:52,670102069.0,1479.1436270545894,-13.27,7
16:54,280200287.0,187.51204661305104,-30.58,5
16:57,170233640.0,-613.5608600501026,-68.13,5
16:57,448279144.0,912.0688999999992,-146.31,5
17:09,441142605.0,1891.942142275729,-25.98,2
17:19,996042490.0,6101.242882563543,-11.0,7
17:23,834581602.0,55.53969999999916,-144.98,2
17:23,433917275.0,7720.079084214671,-7.59,4
17:24,272538745.0,16290.819900000024,-149.98,2
17:28,534325901.0,7016.631070052687,-17.9,9
17:28,575652395.0,2284.315453065842,-17.08,4
17:31,166019891.0,8430.48383703958,-10.41,4
17:31,999752672.0,1191.7598435333348,-10.98,7
17:32,706250160.0,12734.743202298534,-35.81,7
17:33,941285623.0,793.3343990667704,-50.39,2
17:34,639409800.0,36792.01465898635,-7.05,7
17:35,138609932.0,2279.630003294586,-20.0,4
17:36,220183538.0,266.9914499999993,-73.98,2
17:36,280098744.0,2507.538377871666,-127.99,2
17:37,531186970.0,5008.407883735821,-106.98,2
17:37,633345190.0,5983.752818027236,-13.86,1
17:37,229205098.0,7615.839366300008,-26.58,7
17:38,435984758.0,4185.438890840892,-52.16,5
17:39,450896297.0,13521.88874352736,-80.86,4
17:39,256002321.0,6208.438064157773,-10.7,9
17:40,413557825.0,169.10269999999943,-201.65,5
17:42,120634201.0,5106.012919080845,-102.93,5
17:43,310375875.0,1680.4299784614227,-4.07,5
17:43,559995067.0,2146.4864289917973,-170.16,2
17:44,859603181.0,3479.177162183086,-1.06,5
17:48,912705941.0,19189.345169271914,-2.18,7
17:49,626989363.0,574.5917633173751,-22.97,7
17:49,113747882.0,12223.7721044175,-124.54,2
17:49,828750680.0,1001.1523952136802,-127.99,2
17:49,461990622.0,9900.13646251418,-28.08,7
17:51,633345190.0,5943.852338027236,-39.9,4
17:56,690523499.0,138.71120000000016,-5.98,4
17:57,496395938.0,12478.040712545342,-59.85,5
17:58,758885184.0,713.9971822743446,-40.98,2
17:58,762859681.0,1999.858599999999,-118.3,2
17:59,399538448.0,7552.875238871796,-9.58,5
17:59,844206657.0,1072.4067551465696,-117.35,5
18:00,887853850.0,10454.752927668997,-41.51,5
18:00,815385232.0,10468.543184991891,-99.89,5
18:02,229205098.0,7567.153403688621,-48.69,7
18:02,769311479.0,6312.68758112892,-4.54,7
18:04,941285623.0,774.4483990667704,-18.89,2
18:04,844835978.0,10453.70567950703,-20.99,5
18:04,815385232.0,10462.545257340587,-6.0,2
18:07,940569402.0,5001.710389253676,-17.16,5
18:07,902798190.0,-722.0236344310265,-26.89,9
18:09,489964679.0,20686.773216242687,-38.58,7
18:10,642924505.0,131.05282018352602,-84.49,5
18:10,581655972.0,41716.80812154504,-53.68,5
18:11,984783496.0,14461.092316003138,-15.0,9
18:12,574548998.0,-511.42255000000097,-119.38,5
18:14,653640811.0,17863.534625894088,-36.29,5
18:15,975200042.0,-3194.7851999999966,-20.34,9
18:16,762859681.0,1824.8725999999988,-174.99,2
18:18,844835978.0,10433.71567950703,-19.99,7
18:19,134847904.0,4964.41198347907,-172.23,5
18:19,213112754.0,5687.2823775023035,-7.5,9
18:20,822135975.0,11742.12233169194,-10.18,7
18:22,886921642.0,3254.8341047530544,-30.06,5
18:23,992204045.0,7345.951617764974,-35.05,7
18:24,758885184.0,616.0171822743446,-97.98,2
18:26,287480331.0,7507.604665065716,-25.1,9
18:28,683319988.0,6950.05021546052,-28.36,2
18:30,532478725.0,4491.894582676293,-11.12,5
18:37,274818272.0,248.69817856713135,-29.38,9
18:39,130154096.0,670.2311481961067,-80.94,5
18:40,668329719.0,8992.954679169106,-5.66,7
18:42,322720763.0,6758.008156446922,-4.99,7
18:43,556992209.0,12346.163235569276,-5.51,7
18:45,213096759.0,-1459.4541082144394,-37.59,5
18:45,856957948.0,10810.739154533909,-49.99,7
18:47,656812046.0,967.4987537325188,-59.79,5
18:48,173317688.0,-2425.601234884284,-29.15,5
18:48,705848712.0,28010.630201251657,-15.94,9
18:49,340680761.0,-3280.810599999997,-37.32,5
18:50,130154096.0,635.2611481961067,-34.97,7
18:51,996042490.0,6067.272882563543,-33.97,7
18:52,235881534.0,12958.236310021082,-15.67,4
18:52,409971170.0,2771.2648689940265,-8.5,8
18:54,832564361.0,15743.348725328957,-16.51,5
18:57,829914501.0,1439.2998065709744,-75.16,5
18:58,119993184.0,-2183.9644029108617,-8.24,5
18:59,414805878.0,13040.154685425776,-5.84,8
19:02,149684419.0,292.8426499999979,-20.93,5
19:05,195895574.0,7426.48976398305,-28.29,9
19:06,365608668.0,-118.7502895261674,-129.29,5
19:09,687135796.0,29081.893226505617,-6.99,9
19:09,785749304.0,8617.462494736594,-33.7,5
19:10,282837512.0,14067.162147064617,-28.34,9
19:12,984783496.0,14433.4965952214,-27.6,7
19:15,331450202.0,7777.92615156888,-23.39,7
19:17,940569402.0,4980.724389253676,-20.99,5
19:19,531186970.0,4994.344253959389,-14.06,8
19:21,690958123.0,21765.389586515623,-72.29,2
19:21,180719578.0,-4608.467749999994,-46.91,5
19:22,151278285.0,1728.7074999999998,-54.42,5
19:23,491392945.0,5484.2035000000105,-61.28,5
19:23,490868147.0,-400.2002208786984,-75.75,5
19:25,518474507.0,14215.634166683589,-30.01,2
19:28,395654270.0,-2146.9837028122,-20.09,5
19:30,836110591.0,3320.0924342083813,-4.22,7
19:30,835736339.0,2105.1720661464724,-100.09,5
19:31,221868392.0,4842.454752354047,-29.18,9
19:36,768271776.0,-682.9712967665796,-48.04,5
19:36,198946608.0,4366.03159048714,-9.33,7
19:40,999752672.0,1133.7452435333348,-58.01,5
19:44,315546581.0,29678.752430853525,-4.82,7
19:51,851649498.0,8381.051892551193,-15.63,5
19:55,441274121.0,12494.87995079159,-4.54,5
19:58,383625050.0,2842.4159727463343,-22.42,2
19:59,216285378.0,24699.924598763617,-27.42,7
20:12,610450243.0,-683.7595999999998,-15.04,5
20:12,854895960.0,3685.8790895518146,-62.1,8
20:15,660789920.0,-2555.9233473823724,-35.8,5
20:24,550169791.0,22507.614499301893,-11.95,9
20:32,957821152.0,-1665.1504535715496,-39.41,5
20:41,587225252.0,5621.959991410819,-2.45,8
20:41,940569402.0,4964.794389253676,-15.93,9
20:44,773633520.0,-250.94753906148853,-55.8,5
20:45,308068836.0,-810.1204774318078,-148.87,5
20:45,264208990.0,672.1668999999986,-115.63,5
20:46,419550103.0,19138.646461015367,-29.77,7
20:47,349614277.0,718.1338499999995,-32.5,5
20:49,128033695.0,2092.4952748370497,-11.88,5
20:56,245690309.0,9877.023562942804,-27.72,5
20:57,358846516.0,197.4225725272174,-103.46,5
21:02,586315521.0,12548.561808176575,-30.29,9
21:07,282837512.0,14011.940776259698,-55.22,5
00:17,961077907.0,296.37025,-28.0,9
00:47,270374623.0,9682.424585371611,-17.26,4
00:51,678851253.0,3766.496817915429,-14.36,7
02:21,113747882.0,12197.5821044175,-26.19,9
02:30,940569402.0,4947.854389253676,-16.94,9
02:39,213112754.0,5671.632377502304,-15.65,9
02:40,670102069.0,1449.453627054589,-29.69,9
02:43,108563213.0,23245.571909579015,-39.75,7
02:44,461990622.0,9897.759671237747,-2.38,7
02:47,264550521.0,5351.831145611599,-8.91,2
02:48,245690309.0,9855.783562942805,-21.24,9
02:50,216285378.0,24664.194598763617,-35.73,9
02:51,572384506.0,7226.692607246608,-33.18,9
02:53,687135796.0,29071.903226505616,-9.99,9
02:53,967989787.0,397.5497826407272,-24.44,9
02:53,203466392.0,3425.481175079958,-20.56,5
03:03,912705941.0,19179.897099859525,-9.45,7
03:06,683319988.0,6919.41021546052,-30.64,9
03:10,213112754.0,5596.921945382936,-74.71,7
03:17,370521542.0,27522.434394486085,-27.29,2
03:19,324224854.0,4354.5115654422725,-1.33,5
03:21,441274121.0,12484.43995079159,-10.44,9
03:28,930277104.0,9568.944785307694,-23.18,9
03:29,736340277.0,8796.875713512145,-21.25,9
03:33,550169791.0,22502.19454367849,-5.42,7
03:36,949032480.0,3881.639922956062,-30.95,9
03:36,287480331.0,7467.264665065716,-40.34,9
03:37,187541224.0,1892.3502783028453,-37.94,9
03:37,853907490.0,7774.493469105808,-10.3,9
03:38,285220959.0,12196.677952077354,-1.28,4
03:40,992204045.0,7297.173611813457,-48.78,5
03:40,510101371.0,13577.882076426706,-28.69,9
03:42,414454079.0,74.23885000000149,-32.74,9
03:42,145387690.0,5425.945147302215,-27.15,9
03:52,409971170.0,2745.5348689940265,-25.73,9
03:55,657139925.0,13646.931072751671,-12.09,9
04:00,113747882.0,12186.948806833663,-10.63,7
04:01,120634201.0,5083.522919080845,-22.49,9
04:03,851181128.0,4647.912208195041,-19.37,9
04:06,683319988.0,6888.120881585771,-31.29,5
04:10,229205098.0,7550.77241598946,-16.38,5
04:12,433917275.0,7703.380293701972,-16.7,7
04:14,282837512.0,13978.400776259698,-33.54,9
04:15,633345190.0,5911.122338027237,-32.73,9
04:17,480557476.0,11337.032281113708,-13.43,2
04:20,166019891.0,8418.033837039578,-12.45,9
04:21,705848712.0,27992.60020125166,-18.03,9
04:21,511179916.0,7465.278674699056,-37.59,5
04:22,822250278.0,6533.044228104035,-28.59,8
04:22,310375875.0,1648.6999784614227,-31.73,9
04:25,709608057.0,2505.7673559031405,-30.18,9
04:26,940569402.0,4872.961427087308,-74.89,7
04:26,758160963.0,8505.6853073716,-12.93,4
04:28,779946617.0,17028.700784192497,-13.32,7
04:28,417850087.0,15622.850169153688,-19.44,9
04:29,876890798.0,3801.0009706999335,-48.87,9
04:32,873693307.0,10451.201797727785,-22.28,2
04:34,836110591.0,3288.692434208381,-31.4,9
04:34,851181128.0,4630.170566174319,-17.74,2
04:36,399144202.0,1544.2129219613796,-0.13,5
04:36,950234174.0,74.97318207427206,-12.3,5
04:38,522188082.0,7144.928948907831,-40.3,5
04:38,549414742.0,7274.070766458994,-32.89,9
04:38,419550103.0,19135.66745921441,-2.98,8
04:42,128033695.0,2056.6552748370495,-35.84,9
04:48,383833857.0,26207.570043899017,-23.58,2
04:50,668329719.0,8991.330482524,-1.62,8
04:50,973086490.0,10343.402669906522,-12.94,9
04:50,601627384.0,3343.934144325868,-37.09,9
04:55,348325817.0,10460.708146050314,-32.98,9
04:57,108481285.0,9002.25509737919,-5.37,2
04:57,719586818.0,18987.957163535673,-23.47,2
04:58,254853117.0,3125.8228531148234,-10.91,7
04:59,417850087.0,15593.388437147209,-29.46,7
05:01,305778936.0,10517.060428224768,-29.84,9
05:03,287480331.0,7464.276462599925,-2.99,5
05:03,705848712.0,27978.210813573,-14.39,2
05:05,836110591.0,3275.0008131293334,-13.69,5
05:07,237493332.0,14835.53651772719,-42.14,2
05:10,479366718.0,2213.661348140041,-32.68,5
05:10,575652395.0,2221.8433297207134,-62.47,5
05:12,506618547.0,14717.050172170384,-68.62,5
05:12,145387690.0,5404.408042101158,-21.54,4
05:12,429556122.0,4470.038415022292,-17.77,4
05:12,675806859.0,7400.286806220298,-46.48,4
05:13,200080192.0,9510.85371708569,-34.92,7
05:14,899742927.0,13064.493935121898,-0.74,2
05:23,776108637.0,735.7315536574953,-13.64,9
05:27,749378808.0,1685.757896352859,-13.47,4
05:32,885259672.0,3064.5523980785324,-62.59,7
05:33,832564361.0,15719.47654569552,-23.87,5
05:35,995615876.0,1508.7558315809792,-40.94,9
05:40,930277104.0,9547.432598632957,-21.51,5
05:42,853907490.0,7773.129008068079,-1.36,8
05:48,647936800.0,2326.8044485055807,-34.18,8
05:49,237684254.0,6021.947095764013,-10.8,5
05:53,198946608.0,4348.419393735594,-17.61,5
05:54,549414742.0,7260.524539572423,-13.55,7
05:55,450896297.0,13485.44874352736,-36.44,9
05:57,435984758.0,4146.3342404259965,-39.1,8
05:57,518474507.0,14178.298591872985,-37.34,2
06:00,482513594.0,5573.22200506794,-3.6,7
06:01,736340277.0,8776.115382865435,-20.76,5
06:02,151968462.0,7043.9603670721535,-53.95,7
06:04,769311479.0,6294.36529359778,-18.32,8
06:10,970298834.0,2509.6160020114744,-1.4,5
06:11,541639148.0,4134.079718357636,-3.76,7
06:11,809499628.0,17936.600068779597,-19.89,9
06:11,874431242.0,9148.52608874849,-24.9,9
06:16,441274121.0,12482.423541122404,-2.02,5
06:16,985188462.0,-17.92361128877519,-37.67,9
06:18,532478725.0,4449.674582676293,-42.22,9
06:20,169006407.0,11765.10127952962,-21.93,7
06:25,392270893.0,13385.43063353263,-15.24,7
06:27,673025413.0,846.6818734181616,-4.6,7
06:30,802697323.0,16669.36823429405,-36.87,9
06:31,409971170.0,2738.112052381882,-7.42,5
06:34,738958551.0,9236.581172434697,-34.88,9
06:34,887853850.0,10418.362927668995,-36.39,9
06:38,897714622.0,9457.22958571408,-17.03,7
06:40,996042490.0,6061.490839238832,-5.78,7
06:40,256002321.0,6205.090089158922,-3.35,2
06:43,259015404.0,1008.5026255828,-29.67,9
06:45,308505160.0,13533.365256393465,-7.17,7
06:45,679911053.0,2706.810540178292,-4.72,2
06:50,815385232.0,10413.889420105508,-48.66,2
06:52,195895574.0,7406.849763983049,-19.64,9
06:52,975345315.0,36732.79296027359,-7.13,8
06:56,859603181.0,3422.265016648254,-56.91,2
06:58,984783496.0,14426.5065952214,-6.99,9
06:59,587225252.0,5582.46999141082,-39.49,9
07:02,245690309.0,9855.399970775716,-0.38,5
07:02,108931112.0,14549.191076981688,-37.83,9
07:04,730002588.0,13829.784211730232,-24.4,2
07:06,183888402.0,19315.842457140137,-43.64,9
07:08,752362502.0,7627.184990399987,-26.9,2
07:09,613729471.0,8011.332143916132,-2.99,8
07:10,366550080.0,25880.27085847146,-0.72,8
07:10,858989281.0,27181.87545465446,-15.24,5
07:16,679662108.0,16728.576826762088,-28.2,2
07:21,196289502.0,16282.755919962274,-5.99,9
07:21,822135975.0,11673.293073998631,-68.83,5
07:22,718058208.0,2007.8062945278496,-38.29,8
07:24,310375875.0,1630.096397912872,-18.6,2
07:25,987163717.0,3902.734131891315,-39.82,9
07:26,473820682.0,11391.58319686917,-68.32,8
07:26,187111705.0,6964.014609791913,-4.11,5
07:28,588565416.0,6050.72958280878,-2.04,7
07:29,984783496.0,14392.454238031714,-34.05,2
07:30,124102251.0,3181.355893435731,-29.26,4
07:30,587225252.0,5577.1169142288945,-5.35,2
07:31,235881534.0,12956.848185752073,-1.39,2
07:32,806358207.0,11428.995743528292,-3.88,7
07:33,785749304.0,8617.412870431004,-0.05,2
07:33,454356905.0,1337.548014220197,-13.54,2
07:34,221868392.0,4808.364752354047,-34.09,9
07:35,651756497.0,14495.068730144136,-16.61,8
07:36,331450202.0,7725.6830307008995,-52.24,4
07:37,547010927.0,24451.005741672405,-13.26,5
07:40,647472692.0,26567.331584613057,-6.58,2
07:41,170637730.0,1166.5215954918144,-1.52,2
07:42,348325817.0,10454.024862922442,-6.68,2
07:42,166019891.0,8376.684440233399,-41.35,7
07:44,554792076.0,29515.363324571827,-25.94,5
07:53,500043411.0,13920.434334835074,-27.34,5
07:57,795847804.0,24266.125740426596,-30.6,5
08:04,609939116.0,7546.0652082112065,-4.42,4
08:06,280200287.0,182.51204661305104,-5.0,9
08:07,305778936.0,10512.941209186423,-4.12,2
08:09,949032480.0,3872.510661339254,-9.13,7
08:13,519644021.0,2621.3231750438995,-31.59,8
08:13,280268430.0,5132.103788569028,-23.79,2
08:13,960208650.0,14702.010873936615,-13.86,5
08:15,851649498.0,8346.545718145442,-34.51,7
08:20,824916823.0,8469.339069057192,-67.57,5
08:22,948558249.0,9932.695881139864,-5.25,9
08:25,558119802.0,34082.74695151495,-17.44,7
08:26,532478725.0,4446.962781260449,-2.71,5
08:27,246753533.0,240.70439999999837,-14.08,5
08:27,973086490.0,10342.27410556845,-1.13,2
08:28,980500334.0,-1390.7469338929038,-13.18,5
08:29,706250160.0,12704.553202298534,-30.19,9
08:29,641764023.0,-1129.8188037720045,-23.73,5
08:30,554792076.0,29429.067324571828,-86.3,5
08:31,520447032.0,8149.680259368553,-42.52,9
08:32,143061865.0,7394.991245040237,-62.48,5
08:33,994214354.0,10069.817550392278,-7.23,8
08:34,971129830.0,-1173.8606499999992,-24.42,5
08:35,399538448.0,7547.825238871796,-5.05,9
08:35,672913754.0,11838.393042977235,-31.48,5
08:36,534908754.0,-1119.7640500000002,-86.66,5
08:36,956717493.0,1187.9220504359832,-61.7,5
08:36,331450202.0,7709.597030700899,-16.09,5
08:37,143003091.0,10456.48365741288,-6.6,5
08:38,308505160.0,13389.809256393462,-143.56,5
08:38,366550080.0,25803.63485847146,-76.64,5
08:38,978410962.0,-2885.123339548972,-13.57,5
08:39,346874167.0,8.82964999999902,-73.34,5
08:39,126929801.0,1412.1207015783834,-110.73,5
08:40,291580432.0,-121.06774999999963,-161.26,5
08:40,648644594.0,253.20499999999913,-50.65,5
08:40,340295966.0,-1715.4169500000005,-29.12,5
08:41,690958123.0,21701.759586515625,-63.63,5
08:41,661295096.0,3341.0672205965348,-97.38,5
08:42,670427480.0,1.8097000000012429,-102.82,5
08:43,290751280.0,53.80224667482557,-131.15,5
08:44,414805878.0,13000.034685425777,-40.12,9
08:45,581655972.0,41712.45313659627,-4.35,7
08:46,559995067.0,2143.7319462221685,-2.75,2
08:49,625658193.0,-563.2456402437831,-251.31,5
08:50,124377686.0,-2931.817399999997,-42.34,5
08:52,711045550.0,2173.5373500000037,-76.12,5
08:52,503575533.0,8061.133854664672,-100.48,5
08:53,749371623.0,-2704.9816535173422,-33.5,5
08:53,383625050.0,2814.2367613684396,-28.18,5
08:53,618514666.0,21573.43397749449,-56.63,5
08:54,776431321.0,3124.5101354603767,-1.36,5
08:56,290818242.0,7086.129845683824,-11.5,2
08:56,132400709.0,653.8297851539397,-78.88,5
08:57,867987292.0,1755.298467399944,-9.33,7
08:59,390747457.0,483.8426999999979,-86.58,5
09:00,838415080.0,-3527.1764999999987,-45.42,5
09:02,969697937.0,-5057.745265670551,-46.21,5
09:03,905860285.0,10675.635954712803,-7.97,2
09:04,741903302.0,2485.3670679352604,-5.9,9
09:06,259015404.0,969.4577791854364,-39.04,8
09:07,277562576.0,160.8071699762571,-199.67,5
09:07,137822385.0,3481.5135271943145,-37.76,5
09:08,383833857.0,26201.920043899016,-5.65,9
09:09,899983008.0,-3294.538649999996,-43.58,5
09:12,280098744.0,2490.058377871666,-17.48,4
09:13,555393405.0,-894.2228000000002,-94.84,5
09:13,409370545.0,661.7972755455207,-70.06,5
09:15,461029994.0,7937.459410314173,-21.98,4
09:15,613729471.0,8005.282143916132,-6.05,9
09:16,516051449.0,995.8127746508288,-51.98,4
09:17,235881534.0,12868.564185752071,-88.28,5
09:17,621181115.0,-285.5582495707711,-31.42,5
09:19,632065391.0,-71.98614999999953,-99.97,4
09:20,706250160.0,12673.17351651638,-31.38,5
09:20,544961962.0,631.874323005609,-212.1,2
09:21,450896297.0,13458.83874352736,-26.61,7
09:22,987163717.0,3889.364131891315,-13.37,2
09:22,762859681.0,1799.8825999999988,-24.99,7
09:23,352899149.0,371.5950499999987,-31.96,1
09:26,124102251.0,3041.355893435731,-140.0,2
09:26,901037631.0,216.5833230964064,-186.19,2
09:26,581655972.0,41674.46313659628,-37.99,2
09:26,361201224.0,3201.770704333806,-10.03,7
09:27,907987693.0,-2643.444499999998,-15.44,5
09:28,986267641.0,4198.3615932607645,-41.28,2
09:29,441274121.0,12480.756641122403,-1.67,4
09:30,558875206.0,3377.2365393997807,-47.99,2
09:30,315078351.0,8177.247268065289,-6.76,7
09:30,833499132.0,1608.6669000000022,-121.12,5
09:31,221868392.0,4784.544752354047,-23.82,1
09:32,679911053.0,2696.8005401782916,-10.01,4
09:32,203466392.0,3276.381175079958,-149.1,2
09:32,280098744.0,2417.068377871666,-72.99,2
09:32,170637730.0,1142.4215954918143,-24.1,7
09:32,987163717.0,3875.994131891315,-13.37,2
09:33,631111289.0,-485.89650000000097,-27.48,5
09:34,698955014.0,221.93393020319672,-29.99,4
09:34,143061865.0,7385.001245040237,-9.99,7
09:35,534325901.0,6938.281070052687,-78.35,2
09:37,960208650.0,14623.950873936616,-78.06,2
09:37,971010829.0,224.9950564442451,-10.99,7
09:37,478412511.0,12514.29107019746,-36.02,1
09:37,824916823.0,8401.959069057193,-67.38,2
09:39,441142605.0,1882.9721422757293,-8.97,4
09:39,833499132.0,1597.6869000000022,-10.98,7
09:41,124102251.0,2971.355893435731,-70.0,2
09:42,500051919.0,855.8120966505901,-17.97,1
09:43,482513594.0,5538.11000506794,-35.11,5
09:43,828750680.0,964.20239521368,-36.95,7
09:44,364357875.0,7891.835717814798,-84.08,5
09:44,758160963.0,8362.1853073716,-143.5,2
09:45,629078930.0,112.06381326707177,-60.98,2
09:45,901037631.0,67.4973230964064,-149.09,2
09:47,461990622.0,9730.459671237748,-167.3,2
09:48,975345315.0,36694.312960273586,-38.48,4
09:49,583579399.0,6.673400000000839,-94.97,4
09:50,639409800.0,36743.98765898635,-48.03,5
09:50,203466392.0,3098.581175079958,-177.8,2
09:50,741269136.0,2648.255950000002,-30.96,7
09:50,520447032.0,8140.906517225579,-8.77,2
09:51,623156843.0,4594.030615724917,-5.99,2
09:52,999752672.0,1013.7652435333348,-119.98,2
09:53,833899961.0,1179.9699457180095,-28.96,7
09:54,124102251.0,2708.1558934357313,-263.2,2
09:55,187541224.0,1870.8602783028452,-21.49,7
09:55,842682241.0,5450.395053153992,-257.6,2
09:55,940569402.0,4739.961427087308,-133.0,2
09:56,364357875.0,7827.420790034717,-64.41,7
09:57,865748375.0,2393.433690705494,-147.67,2
09:57,667367404.0,9351.860790879467,-35.22,4
09:58,146909202.0,3444.382657770963,-70.38,5
09:58,971010829.0,185.01505644424512,-39.98,2
09:59,421881811.0,2290.5300461842394,-71.08,7
10:00,719586818.0,18924.787163535675,-63.17,2
10:00,854513972.0,1733.0269000000003,-28.0,2
10:00,442070890.0,1301.2024124443708,-64.98,2
10:01,815993333.0,6210.388857701798,-11.44,2
10:01,685959099.0,1802.6098660992432,-19.99,4
10:02,897592348.0,15777.882095187855,-16.98,1
10:02,910730524.0,7949.7992958666355,-23.03,5
10:03,758160963.0,8279.585307371599,-82.6,2
10:05,639420537.0,-1488.04145,-31.18,5
10:07,331450202.0,7692.187030700899,-17.41,7
10:08,741269136.0,2586.2859500000022,-61.97,2
10:10,322221939.0,3480.8641003613466,-4.85,8
10:10,698076160.0,6532.296697588816,-37.16,2
10:11,277562576.0,54.32216997625707,-106.49,2
10:13,471897866.0,6977.704731699046,-42.24,5
10:15,940569402.0,4657.361427087308,-82.6,2
10:15,496395938.0,12476.258703317102,-1.78,2
10:15,548907062.0,642.6287887682885,-9.99,2
10:15,298000165.0,26678.63993182735,-76.45,5
10:16,165691047.0,53.8035999999989,-35.34,5
10:17,491392945.0,5456.2435000000105,-27.96,7
10:19,461990622.0,9403.559671237748,-326.9,2
10:21,951817450.0,9285.047442839612,-30.81,2
10:22,355602925.0,1456.6302265753277,-26.96,7
10:24,429235692.0,-1123.1820000000002,-64.03,5
10:24,137822385.0,3475.3635271943144,-6.15,9
10:26,865748375.0,2262.547690705494,-130.89,2
10:27,421881811.0,2259.4505061842397,-31.08,4
10:29,179173981.0,4728.809442859012,-16.29,7
10:29,730002588.0,13824.704211730234,-5.08,7
10:30,471897866.0,6950.840050648956,-26.86,7
10:30,282837512.0,13964.467817855,-13.93,7
10:33,945054126.0,248.98809999999992,-39.55,5
10:35,940569402.0,4501.961427087308,-155.4,2
10:37,675398089.0,-1015.5992907746512,-153.54,5
10:37,758160963.0,7998.885307371599,-280.7,2
10:39,610645022.0,-640.1019626449184,-92.93,5
10:42,386277162.0,212.79999999999936,-25.96,7
10:42,494789005.0,2513.8656956144414,-11.79,7
10:44,873693307.0,10420.381797727783,-30.82,2
10:46,461990622.0,9263.559671237748,-140.0,2
10:46,280990953.0,883.2896999999983,-5.99,4
10:46,842682241.0,5187.195053153992,-263.2,2
10:50,822135975.0,11525.413073998634,-147.88,2
10:50,647936800.0,2296.7244485055808,-30.08,2
10:51,586315521.0,12541.461321514416,-7.1,5
10:52,901037631.0,20.62532309640641,-46.87,2
10:54,605116158.0,2555.3950000000036,-31.08,5
10:54,623156843.0,4558.4595882155845,-35.57,2
10:55,604288474.0,1590.7312670550975,-16.44,7
10:59,713641917.0,1366.7983729031098,-54.98,2
11:00,310375875.0,1560.0832979128722,-70.01,4
11:00,842682241.0,4869.395053153992,-317.8,2
11:01,433917275.0,7694.0302937019715,-9.35,4
11:02,758160963.0,7908.585307371599,-90.3,2
11:04,544961962.0,391.77432300560895,-240.1,2
11:06,194745206.0,132.01637209124317,-155.44,2
11:09,758160963.0,7770.685307371599,-137.9,2
11:13,604288474.0,1545.6972670550977,-45.03,4
11:13,461990622.0,9044.459671237748,-219.1,2
11:14,713641917.0,1253.3183729031098,-113.48,2
11:14,986267641.0,4139.6602120429525,-58.7,7
11:15,534204159.0,5916.233270978442,-5.66,2
11:15,500043411.0,13894.484334835071,-25.95,2
11:18,131388684.0,21993.209230314445,-12.85,8
11:22,184430449.0,2634.79821682489,-9.99,2
11:26,842682241.0,4694.395053153992,-175.0,2
11:26,758160963.0,7644.685307371599,-126.0,2
11:26,895331556.0,-560.2689000000008,-56.6,5
11:27,134461671.0,5314.287024999884,-132.24,6
11:28,700138124.0,4701.909151722597,-89.6,2
11:31,887853850.0,10381.574442890904,-36.79,8
11:35,824916823.0,8396.779069057193,-5.18,4
11:35,909676212.0,54.42253178761312,-13.98,4
11:38,679911053.0,2571.500540178291,-125.3,2
11:38,901037631.0,-133.31867690359357,-153.94,2
11:39,264208990.0,663.1868999999986,-8.98,4
11:40,752362502.0,7438.184990399987,-189.0,2
11:40,461990622.0,8785.459671237748,-259.0,2
11:40,859603181.0,3353.693016648254,-68.57,2
11:41,700138124.0,4517.809151722597,-184.1,2
11:44,581655972.0,41661.483136596275,-12.98,7
11:45,842682241.0,4368.195053153992,-326.2,2
11:46,471897866.0,6919.821550648956,-31.02,4
11:47,758160963.0,7494.185307371599,-150.5,2
11:48,544961962.0,224.47432300560897,-167.3,2
11:49,795847804.0,24256.9557404266,-9.17,4
11:50,277562576.0,-85.91283002374294,-140.24,2
11:53,203466392.0,2910.281175079958,-188.3,2
11:53,124102251.0,2482.0558934357314,-226.1,2
11:54,752362502.0,7375.884990399987,-62.3,2
11:57,632065391.0,-140.61114999999953,-68.62,2
11:57,461990622.0,8610.459671237748,-175.0,2
12:01,873693307.0,10406.631797727783,-13.75,9
12:01,544961962.0,22.87432300560897,-201.6,2
12:02,779236304.0,1968.2975954795336,-19.34,9
12:04,700138124.0,4370.809151722597,-147.0,2
12:07,752362502.0,7348.584990399987,-27.3,2
12:08,679911053.0,2495.9145401782916,-75.59,2
12:09,785210466.0,2072.763419997712,-1.99,4
12:09,277562576.0,-208.89783002374293,-122.98,2
12:16,632065391.0,-184.86114999999953,-44.25,2
12:20,203466392.0,2861.281175079958,-49.0,2
12:20,818552503.0,292.018099999999,-25.77,9
12:22,758160963.0,7349.2853073716,-144.9,2
12:24,124102251.0,2217.4558934357315,-264.6,2
12:25,713641917.0,1101.8283729031098,-151.49,2
12:26,518474507.0,14140.108591872984,-38.19,9
12:26,544961962.0,-195.525676994391,-218.4,2
12:26,874431242.0,9139.980875863468,-8.55,4
12:28,535804582.0,1647.9910499999987,-71.99,2
12:29,510101371.0,13309.782076426703,-268.1,2
12:29,858989281.0,27162.385454654457,-19.49,9
12:34,245198540.0,113.3013988017795,-19.97,1
12:34,321372947.0,-431.5939507890995,-13.41,5
12:38,752362502.0,7184.084990399987,-164.5,2
12:38,678330503.0,1230.828358086089,-12.06,7
12:42,108481285.0,8965.26509737919,-36.99,1
12:43,229502829.0,-3856.166124186247,-50.03,5
12:44,532525712.0,-832.6643000000004,-26.6,5
12:45,632065391.0,-322.1111499999995,-137.25,2
12:46,795847804.0,24200.8657404266,-56.09,2
12:47,461990622.0,8382.259671237747,-228.2,2
12:53,807714284.0,1338.9285607359998,-44.79,5
12:54,912705941.0,19171.370079859524,-8.53,4
12:55,769311479.0,6277.1452935977795,-17.22,1
12:58,203466392.0,2770.9811750799577,-90.3,2
12:59,285428103.0,10321.359808161063,-98.0,2
13:00,585625048.0,1802.5639749993577,-6.1,9
13:00,704517789.0,18366.512101809814,-22.65,2
13:02,461990622.0,8103.659671237747,-278.6,2
13:02,143606916.0,-8.697795970810347,-220.55,5
13:03,970298834.0,2493.606002011474,-16.01,7
13:06,187111705.0,6956.114609791914,-7.9,9
13:06,749378808.0,1680.757896352859,-5.0,9
13:06,296972867.0,-1060.668400000001,-79.84,5
13:09,254853117.0,3115.8228531148234,-10.0,7
13:09,124102251.0,2136.9558934357315,-80.5,2
13:13,259015404.0,963.7577791854362,-5.7,9
13:15,414805878.0,12988.503868509555,-11.53,5
13:15,203466392.0,2639.3811750799578,-131.6,2
13:16,480557476.0,11330.432281113706,-6.6,9
13:19,450896297.0,13451.244128143391,-7.59,7
13:19,859603181.0,3198.986016648254,-154.71,5
13:23,742223719.0,177.96750730480264,-101.43,5
13:23,285428103.0,10259.059808161066,-62.3,2
13:23,448004226.0,1533.3323686648796,-20.98,4
13:23,987656636.0,4191.982991107162,-19.22,5
13:24,277562576.0,-356.64033002374293,-147.74,2
13:26,426474982.0,-3924.46225,-31.92,5
13:28,187541224.0,1715.4882783028452,-155.37,2
13:28,203466392.0,2584.0811750799576,-55.3,2
13:29,189335192.0,-1296.3092517578607,-52.99,5
13:29,632065391.0,-415.8611499999995,-93.75,2
13:31,544961962.0,-279.525676994391,-84.0,2
13:33,718058208.0,2001.7962945278496,-6.01,2
13:37,461990622.0,7977.659671237747,-126.0,2
13:38,344522228.0,-2975.814488208393,-11.84,5
13:40,241459011.0,527.2282132723467,-49.72,5
13:42,277562576.0,-429.75783002374294,-73.12,2
13:45,806358207.0,11424.875743528291,-4.12,4
13:46,544961962.0,-460.82567699439096,-181.3,2
13:47,940569402.0,4466.961427087308,-35.0,2
13:47,489964679.0,20659.573216242687,-27.2,9
13:47,698076160.0,6500.3266975888155,-31.97,4
13:48,632065391.0,-490.1111499999995,-74.25,2
13:48,659415300.0,1681.5928805359597,-68.53,5
13:50,124102251.0,2050.1558934357313,-86.8,2
13:52,203466392.0,2388.0811750799576,-196.0,2
13:53,187541224.0,1455.1022783028452,-260.39,2
13:53,308897841.0,1176.7056999999988,-40.39,5
13:55,632065391.0,-542.2361499999995,-52.12,2
13:58,838830098.0,98.96769208778436,-37.47,5
14:01,141521177.0,7983.727900000015,-59.64,5
14:01,842682241.0,4186.895053153992,-181.3,2
14:05,807098817.0,101.02299999999904,-93.65,5
14:05,940569402.0,4417.961427087308,-49.0,2
14:06,478412511.0,12501.27107019746,-13.02,6
14:08,203466392.0,2332.0811750799576,-56.0,2
14:10,626989363.0,544.6017633173751,-29.99,2
14:17,315546581.0,29651.282424237485,-27.47,7
14:18,489964679.0,20656.611197136383,-2.96,8
14:19,632065391.0,-650.9861499999995,-108.75,2
14:22,322720763.0,6757.807136244892,-0.2,4
14:22,570410059.0,1555.6609967763115,-5.99,2
14:24,510101371.0,13205.482076426706,-104.3,2
14:26,627723633.0,-2381.791328003762,-41.83,5
14:30,940569402.0,4272.361427087308,-145.6,2
14:30,203466392.0,2152.1811750799575,-179.9,2
14:33,461990622.0,7706.059671237746,-271.6,2
14:34,632065391.0,-695.9861499999995,-45.0,2
14:38,548907062.0,562.6587887682884,-79.97,4
14:39,124102251.0,1876.5558934357312,-173.6,2
14:40,544961962.0,-746.4256769943909,-285.6,2
14:43,627917561.0,3957.415050000006,-35.0,2
14:47,632065391.0,-818.9861499999995,-123.0,2
14:48,859603181.0,2977.786016648254,-221.2,2
14:51,698955014.0,201.94393020319671,-19.99,2
14:53,544961962.0,-931.2256769943908,-184.8,2
14:54,461990622.0,7542.259671237746,-163.8,2
14:56,510101371.0,12997.582076426706,-207.9,2
15:01,752362502.0,7051.084990399987,-133.0,2
15:04,535804582.0,1606.0110499999987,-41.98,2
15:04,544961962.0,-1011.7256769943908,-80.5,2
15:06,203466392.0,2117.1811750799575,-35.0,2
15:06,510101371.0,12858.282076426707,-139.3,2
15:08,146909202.0,3309.2326577709628,-135.15,2
15:14,632065391.0,-876.7361499999995,-57.75,2
15:16,475277431.0,1120.2181369436191,-7.99,4
15:18,544961962.0,-1300.8256769943907,-289.1,2
15:22,752362502.0,6970.584990399987,-80.5,2
15:34,842682241.0,3927.895053153992,-259.0,2
15:36,203466392.0,2044.3811750799575,-72.8,2
15:38,672913754.0,11835.965967668666,-2.43,2
15:41,245690309.0,9822.762890775715,-32.64,4
15:48,752362502.0,6784.384990399987,-186.2,2
15:51,538003940.0,2076.6400000000103,-9.99,4
15:51,632065391.0,-1000.1111499999996,-123.38,2
16:04,203466392.0,1830.8811750799575,-213.5,2
16:10,842682241.0,3767.595053153992,-160.3,2
16:11,853907490.0,7677.929008068079,-95.2,2
16:15,752362502.0,6621.284990399987,-163.1,2
16:19,544961962.0,-1426.1256769943907,-125.3,2
16:25,203466392.0,1803.5811750799576,-27.3,2
16:28,180616589.0,1006.4451699949168,-24.47,5
16:30,941285623.0,701.6413990667704,-72.81,5
16:32,788740658.0,2751.7436312718046,-11.99,7
16:38,551755686.0,6961.1239845375385,-50.97,2
16:39,128033695.0,2056.1338781876257,-0.52,7
16:40,752362502.0,6519.784990399987,-101.5,2
16:41,842682241.0,3759.2040475040462,-8.39,2
16:42,544961962.0,-1596.2256769943906,-170.1,2
16:44,203466392.0,1705.5811750799576,-98.0,2
16:44,452974357.0,-3045.718949999994,-18.05,5
16:46,604288474.0,1414.1672670550977,-131.53,2
16:46,668692488.0,766.2552785738097,-50.97,4
16:52,252760664.0,6887.8279425496885,-101.67,5
16:54,653640811.0,17837.783133588295,-25.75,7
16:58,762859681.0,1669.7725999999989,-130.11,2
17:00,376271050.0,1585.9502261784878,-18.11,2
17:01,752362502.0,6435.784990399987,-84.0,2
17:04,399538448.0,7528.925238871796,-18.9,5
17:05,252760664.0,6869.261987615385,-18.57,2
17:05,198946608.0,4227.123393735594,-121.3,5
17:06,203466392.0,1594.9811750799577,-110.6,2
17:14,124102251.0,1786.2558934357314,-90.3,2
17:20,948558249.0,9922.373956046182,-10.32,5
17:22,842682241.0,3542.9040475040465,-216.3,2
17:26,752362502.0,6268.484990399987,-167.3,2
17:37,203466392.0,1382.1811750799577,-212.8,2
17:37,653667523.0,3414.676899570016,-95.17,2
17:37,738958551.0,9058.801172434694,-177.78,2
17:38,670102069.0,1423.3429322160123,-26.11,5
17:40,752362502.0,6233.484990399987,-35.0,2
17:47,280268430.0,5125.113788569029,-6.99,4
17:49,956717493.0,1151.9720504359832,-35.95,1
17:53,474951915.0,-2680.9385952340112,-55.91,5
17:57,106601471.0,11342.96848993868,-4.67,5
17:57,618514666.0,21531.95397749449,-41.48,4
17:59,242218612.0,-110.2611999999994,-99.99,2
18:03,510101371.0,12656.682076426709,-201.6,2
18:07,461990622.0,7305.659671237746,-236.6,2
18:10,752362502.0,6128.484990399987,-105.0,2
18:11,203466392.0,1215.5811750799578,-166.6,2
18:12,613729471.0,7976.352143916131,-28.93,9
18:15,785749304.0,8605.162870431004,-12.25,9
18:15,383833857.0,26195.920043899016,-6.0,9
18:17,901432314.0,3464.128890763738,-5.08,4
18:24,203466392.0,1188.2811750799578,-27.3,2
18:28,256002321.0,6172.025589158922,-33.06,7
18:30,752362502.0,6079.484990399987,-49.0,2
18:30,604334058.0,6.9077999999992965,-9.97,7
18:34,228136274.0,1175.3338499999995,-83.49,5
18:36,520418719.0,641.6585500000036,-23.5,5
18:37,461990622.0,7232.159671237746,-73.5,2
18:40,522188082.0,7080.558948907831,-64.37,7
18:41,203466392.0,972.6811750799578,-215.6,2
18:45,170637730.0,1091.8298554918144,-50.59,7
18:47,522188082.0,7029.866568907831,-50.69,7
18:48,322720763.0,6649.132136244892,-108.67,5
18:53,124102251.0,1740.9378934357314,-45.32,5
18:55,461029994.0,7841.531410314173,-95.93,5
18:57,696333897.0,99.92124999999882,-45.85,5
19:00,180616589.0,989.9551699949168,-16.49,7
19:01,392270893.0,13321.821633532629,-63.61,5
19:01,887156614.0,-681.3186210407738,-31.02,5
19:07,493571342.0,-2667.465880907047,-39.64,5
19:08,203466392.0,799.7811750799578,-172.9,2
19:14,954263768.0,-272.01800000000026,-6.64,5
19:19,809499628.0,17932.484502946478,-4.12,7
19:26,472213568.0,-559.1742442060533,-51.03,5
19:28,713910252.0,-1373.9475242714589,-132.05,5
19:29,687135796.0,29060.955523775945,-10.95,4
19:32,398429109.0,543.117050000001,-149.45,5
19:35,873701090.0,302.60470363956097,-2.4,2
19:40,736310094.0,-915.865124027426,-91.21,5
19:45,331048953.0,-158.48563202150638,-121.86,5
19:50,163470640.0,958.2673999999996,-67.84,5
20:00,331684336.0,-1584.7738699513216,-29.09,5
20:01,256002321.0,6155.875589158923,-16.15,9
20:03,124125096.0,41.80584438780198,-96.12,5
20:03,618514666.0,21522.17747271649,-9.78,7
20:14,348525881.0,900.4516245949359,-76.11,5
20:25,709608057.0,2488.5735328588985,-17.19,7
20:29,901432314.0,3452.130890763738,-12.0,5
20:34,195895574.0,7397.378601342051,-9.47,7
20:44,604334058.0,-125.1213000000007,-132.03,5
20:47,547010927.0,24422.97574167241,-28.03,9
22:36,822250278.0,6502.844228104035,-30.2,9
00:11,647936800.0,2250.4308673537375,-46.29,7
00:11,601627384.0,3279.622484911979,-64.31,8
00:13,518378868.0,-1557.0574000000004,-40.24,9
00:16,575652395.0,2221.2191645138114,-0.62,5
00:22,873693307.0,10394.651797727784,-11.98,9
00:25,853907490.0,7652.992683539701,-24.94,5
00:26,492215823.0,2624.5219438154445,-20.89,9
00:26,433917275.0,7667.400293701971,-26.63,9
00:27,730002588.0,13798.65181454138,-26.05,5
00:28,138609932.0,2237.030003294586,-42.6,9
00:30,795847804.0,24197.4763111905,-3.39,2
00:31,887853850.0,10351.947382853485,-29.63,7
00:33,987656636.0,4188.723057731287,-3.26,8
00:42,324224854.0,4296.776847798723,-57.73,8
00:48,940569402.0,4236.619784028416,-35.74,2
00:48,802697323.0,16634.74823429405,-34.62,9
00:48,651756497.0,14479.873620860188,-15.2,5
00:53,873693307.0,10379.762001077695,-14.89,2
00:56,601627384.0,3249.992484911979,-29.63,9
00:58,143061865.0,7331.19669121873,-53.8,5
01:06,572384506.0,7191.3526072466075,-35.34,9
01:06,704517789.0,18361.393955323525,-5.12,7
01:07,195895574.0,7366.620410194219,-30.76,2
01:08,986267641.0,4133.937440047421,-5.72,2
01:10,196289502.0,16269.375919962276,-13.38,9
01:14,419550103.0,19087.78519748706,-47.88,5
01:15,806358207.0,11348.224042799142,-76.65,2
01:22,435984758.0,4070.37443188015,-75.96,5
01:36,145387690.0,5381.268042101157,-23.14,9
01:36,905860285.0,10654.741729960788,-20.89,2
01:36,496395938.0,12442.35127040862,-33.91,2
01:38,887853850.0,10321.397382853484,-30.55,9
01:38,815385232.0,10413.545716531016,-0.34,5
01:40,824916823.0,8376.789069057193,-19.99,9
01:42,534325901.0,6937.061967087834,-1.22,7
01:45,836110591.0,3223.496782363922,-51.5,2
01:45,417850087.0,15538.915698938725,-54.47,5
01:50,482513594.0,5526.16000506794,-11.95,9
01:50,421881811.0,2238.21050618424,-21.24,9
01:53,113747882.0,12161.048806833664,-25.9,9
02:00,506618547.0,14669.848315028928,-47.2,2
02:01,534325901.0,6923.561967087834,-13.5,9
02:13,633345190.0,5870.1523380272365,-40.97,9
02:15,630691258.0,-466.1334551251587,-30.97,9
02:16,832564361.0,15659.036763775854,-60.44,5
02:22,705848712.0,27965.970813572996,-12.24,9
02:30,475117511.0,6916.120820968269,-67.73,5
02:31,361201224.0,3160.330704333806,-41.44,9
02:33,970298834.0,2473.379085890176,-20.23,2
02:41,473820682.0,11383.999375876978,-7.58,5
02:41,331450202.0,7668.9970307009,-23.19,9
02:44,836110591.0,3188.3567823639223,-35.14,9
02:45,779236304.0,1939.4175954795337,-28.88,9
02:45,809499628.0,17917.084502946476,-15.4,9
02:51,832564361.0,15648.836763775853,-10.2,9
02:53,705848712.0,27945.295627645133,-20.68,7
02:55,815993333.0,6172.9981041374185,-37.39,7
02:55,541639148.0,4125.443930641264,-8.64,2
02:55,738958551.0,9012.201172434694,-46.6,9
03:00,987163717.0,3837.3541318913153,-38.64,9
03:05,108931112.0,14514.601076981688,-34.59,9
03:06,678851253.0,3701.5026532212687,-64.99,7
03:06,766941757.0,2559.328510245526,-25.62,9
03:07,183888402.0,19287.312457140135,-28.53,9
03:09,623156843.0,4506.148555036101,-52.31,5
03:10,383833857.0,26177.990043899015,-17.93,9
03:12,331450202.0,7619.979121212727,-49.02,2
03:14,719586818.0,18922.357093984057,-2.43,7
03:15,471897866.0,6916.602965422017,-3.22,5
03:19,482513594.0,5493.142087319258,-33.02,5
03:20,441274121.0,12465.766641122404,-14.99,9
03:25,667367404.0,9316.234670897416,-35.63,5
03:32,987229118.0,845.3958720086789,-64.68,5
03:37,169006407.0,11705.949297170746,-59.15,8
03:40,549414742.0,7224.424539572423,-36.1,9
03:40,264550521.0,5318.8757670625455,-32.96,2
03:41,383833857.0,26168.55583895315,-9.43,2
03:45,547010927.0,24398.845741672405,-24.13,9
03:46,670102069.0,1400.5629322160123,-22.78,9
03:49,200080192.0,9509.787395969415,-1.07,5
03:51,441274121.0,12444.46740632883,-21.3,5
03:52,912705941.0,19150.55757870803,-20.81,7
03:53,237493332.0,14817.44730360396,-18.09,5
03:54,940569402.0,4226.229784028415,-10.39,9
04:03,709608057.0,2450.6835328588986,-37.89,9
04:05,433917275.0,7651.674670893467,-15.73,2
04:09,897714622.0,9439.274831948122,-17.95,4
04:10,874431242.0,9117.230875863468,-22.75,9
04:12,179173981.0,4702.908471849936,-25.9,5
04:14,949032480.0,3861.518130839107,-10.99,7
04:20,290818242.0,7082.461397731527,-3.67,5
04:21,187541224.0,1409.0122783028453,-46.09,9
04:30,355733816.0,5451.597023100916,-41.89,5
04:34,670102069.0,1396.5691060015583,-3.99,4
04:35,511179916.0,7438.701391005064,-26.58,7
04:35,145387690.0,5356.429323998796,-24.84,5
04:38,518474507.0,14101.878591872985,-38.23,9
04:39,950234174.0,36.550865062409905,-38.42,5
04:40,785749304.0,8590.262870431005,-14.9,9
04:42,874431242.0,9090.200550427022,-27.03,8
04:42,348325817.0,10421.604862922442,-32.42,9
04:48,994214354.0,10036.557550392276,-33.26,9
04:53,960208650.0,14588.470865351042,-35.48,2
04:57,547010927.0,24395.30981728852,-3.54,7
05:00,510101371.0,12618.302076426708,-38.38,9
05:05,858989281.0,27147.678004085035,-14.71,2
05:05,752362502.0,6010.818203624053,-68.67,7
05:06,519644021.0,2598.0413942393297,-23.28,5
05:10,985188462.0,-43.56361128877519,-25.64,9
05:12,370521542.0,27517.883270946324,-4.55,7
05:15,930277104.0,9524.799262449744,-22.63,2
05:16,146909202.0,3307.748059544434,-1.48,5
05:18,639409800.0,36742.73172626248,-1.26,7
05:19,180616589.0,971.9528282361094,-18.0,8
05:20,170637730.0,1050.7207458444557,-41.11,2
05:21,532478725.0,4407.462781260449,-39.5,9
05:22,256002321.0,6136.685589158923,-19.19,9
05:22,549414742.0,7164.1220960733435,-60.3,5
05:24,414805878.0,12946.613868509556,-41.89,9
05:28,348325817.0,10365.351809846765,-56.25,5
05:31,809499628.0,17894.11624635475,-22.97,8
05:36,700138124.0,4366.659407211794,-4.15,7
05:36,653640811.0,17813.30573628829,-24.48,8
05:39,270374623.0,9616.565521912298,-65.86,7
05:39,673025413.0,844.4405557102183,-2.24,5
05:39,383625050.0,2811.699826748423,-2.54,2
05:40,558119802.0,34064.54695151495,-18.2,9
05:43,285220959.0,12189.405603641504,-7.27,2
05:43,399144202.0,1508.6229219613797,-35.59,9
05:43,221868392.0,4757.364752354047,-27.18,9
05:46,358836279.0,195.2743428075857,-33.28,9
05:50,216285378.0,24623.694598763617,-40.5,9
05:52,749378808.0,1648.707896352859,-32.05,9
05:54,520447032.0,8106.726517225578,-34.18,9
05:59,554792076.0,29374.732643531308,-54.33,7
06:02,984783496.0,14381.554238031717,-10.9,9
06:02,683319988.0,6858.180881585771,-29.94,9
06:06,203466392.0,798.2430852718132,-1.54,2
06:07,235881534.0,12804.70580613022,-63.86,2
06:08,865748375.0,2260.5499467414215,-2.0,5
06:14,221868392.0,4720.265442727248,-37.1,8
06:18,450896297.0,13437.81996161442,-13.42,8
06:20,842682241.0,3513.4336755083623,-29.47,7
06:22,851649498.0,8331.879493386004,-14.67,8
06:25,120634201.0,5067.282919080845,-16.24,9
06:26,706250160.0,12671.305772325622,-1.87,8
06:30,534204159.0,5844.908580413206,-71.32,5
06:30,373163757.0,11551.42069792349,-0.24,7
06:33,992204045.0,7286.996144022239,-10.18,2
06:36,518474507.0,14069.926615862987,-31.95,5
06:38,749378808.0,1578.72330866936,-69.98,5
06:38,229205098.0,7529.600017960056,-21.17,7
06:41,449871732.0,7982.002462932801,-11.9,2
06:43,609939116.0,7543.530061977253,-2.54,7
06:46,310375875.0,1536.1332979128722,-23.95,9
06:46,489964679.0,20621.691197136384,-34.92,9
06:48,886921642.0,3236.8329016185403,-18.0,2
06:56,899742927.0,13063.92843341453,-0.57,2
06:57,851181128.0,4625.975225242089,-4.2,5
07:03,788740658.0,2727.4674690169986,-24.28,2
07:06,973086490.0,10323.834105568449,-18.44,9
07:07,822250278.0,6451.736042372476,-51.11,7
07:09,550169791.0,22490.03574576469,-12.16,8
07:11,287480331.0,7441.376462599926,-22.9,9
07:15,213112754.0,5590.993979330037,-5.93,2
07:17,633345190.0,5861.34322180791,-8.81,5
07:22,108563213.0,23236.88144420653,-8.69,8
07:27,308505160.0,13378.069238345346,-11.74,7
07:31,480557476.0,11300.747509460822,-29.68,7
07:32,409971170.0,2716.7860980898154,-21.33,5
07:34,822135975.0,11523.934748657644,-1.48,7
07:35,128033695.0,2001.0266505636853,-55.11,4
07:41,885259672.0,3035.827133703083,-28.73,8
07:43,461990622.0,7203.693368780073,-28.47,7
07:43,718058208.0,1919.9582189063656,-81.84,5
07:46,679662108.0,16656.026739776633,-72.55,7
07:46,973086490.0,10320.098988851438,-3.74,5
07:48,613729471.0,7921.579581539646,-54.77,2
07:49,687135796.0,29035.953260648203,-25.0,7
07:50,657139925.0,13624.531072751672,-22.4,9
07:51,532478725.0,4391.62021554027,-15.84,2
07:54,683319988.0,6821.103848397486,-37.08,5
07:56,668329719.0,8975.686408709886,-15.64,5
08:03,143003091.0,10417.559073127695,-38.92,2
08:04,994214354.0,10015.877222899937,-20.68,5
08:12,456246119.0,21533.05845106606,-4.54,8
08:12,113747882.0,12146.535693835054,-14.51,7
08:16,520447032.0,8088.290862508554,-18.44,7
08:23,639549973.0,7324.568902193736,-35.47,7
08:23,996042490.0,6057.869106191618,-3.62,5
08:32,657139925.0,13571.29803545683,-53.23,7
08:34,769311479.0,6253.064380789706,-24.08,5
08:39,282837512.0,13928.117817855,-36.35,9
08:39,766941757.0,2524.6145636721053,-34.71,7
08:43,655368335.0,3995.642986184048,-3.51,7
08:51,237684254.0,5976.137832689365,-45.81,2
08:53,572384506.0,7154.364425449724,-36.99,4
08:54,421881811.0,2211.44895171138,-26.76,5
08:56,364357875.0,7795.775750187383,-31.65,2
08:59,679911053.0,2466.8903640818176,-29.02,5
09:00,131388684.0,21986.813154718868,-6.4,5
09:11,570323670.0,3398.510705669957,-16.79,8
09:13,108481285.0,8962.101898786786,-3.16,5
09:14,187111705.0,6939.771404064286,-16.34,4
09:15,887853850.0,10315.087382853484,-6.31,7
09:17,822718326.0,11634.058797697162,-12.98,7
09:20,355733816.0,5437.617023100916,-13.98,7
09:21,859603181.0,2941.766016648254,-36.02,1
09:22,834383043.0,5345.218740068058,-1.99,4
09:22,391688371.0,202.56424120504477,-31.79,5
09:22,616924659.0,55.27457982308522,-145.12,2
09:23,779946617.0,17028.004988406483,-0.7,7
09:27,383625050.0,2780.924886748423,-30.77,4
09:27,510101371.0,12575.054368522822,-43.25,2
09:28,361201224.0,3123.230704333806,-37.1,7
09:28,642015139.0,-89.20366253436174,-19.97,1
09:30,214339619.0,324.8266785105091,-19.99,4
09:32,785749304.0,8566.715125785131,-23.55,2
09:32,653640811.0,17808.31573628829,-4.99,1
09:32,836110591.0,3093.8767823639223,-94.48,6
09:33,282837512.0,13918.37041291142,-9.75,2
09:34,846550094.0,1750.098165171468,-31.49,4
09:34,795847804.0,24152.6563111905,-44.82,1
09:35,116169597.0,892.6779499999996,-75.97,4
09:36,500043411.0,13864.424334835074,-30.06,7
09:37,108931112.0,14495.840726981687,-18.76,4
09:37,834383043.0,5317.258740068058,-27.96,7
09:43,403383649.0,893.0009037471626,-26.0,1
09:44,113747882.0,12107.105693835054,-39.43,1
09:45,184430449.0,2597.84821682489,-36.95,1
09:47,141521177.0,7770.241900000015,-213.49,7
09:47,179173981.0,4638.638471849936,-64.27,6
09:50,259015404.0,961.0650330670854,-2.69,2
09:53,588565416.0,5980.294235384766,-70.44,5
09:55,866941383.0,1760.843550000007,-36.96,7
09:56,661295096.0,3321.077220596535,-19.99,4
09:56,370521542.0,27507.325710946323,-10.56,4
09:59,405945930.0,5618.249275568805,-212.1,2
10:01,973388795.0,372.0536761636215,-28.99,7
10:02,124102251.0,1732.9971322827469,-7.94,2
10:05,581655972.0,41643.22068041106,-18.26,2
10:06,833499132.0,1458.1869000000022,-139.5,2
10:07,419550103.0,19037.59501748706,-50.19,4
10:08,949032480.0,3696.346130839107,-165.17,2
10:08,678330503.0,1228.597262265526,-2.23,5
10:11,776431321.0,3109.540135460377,-14.97,1
10:13,376271050.0,1514.4702261784878,-71.48,4
10:13,624563756.0,-524.0750712164436,-74.97,2
10:13,659415300.0,1675.9428805359596,-5.65,9
10:14,424397946.0,679.3137836054002,-269.5,2
10:16,688712152.0,6809.9807181372,-53.99,2
10:17,425730826.0,2291.7669093887203,-88.99,2
10:17,314980178.0,3812.4968500000064,-125.97,2
10:17,517190750.0,2129.716089915413,-85.07,6
10:18,627622066.0,3433.7990721696297,-129.98,2
10:21,616924659.0,-8.475420176914781,-63.75,2
10:22,141521177.0,7659.655900000015,-110.59,7
10:24,420109571.0,376.0485607166795,-156.98,2
10:24,575652395.0,2177.9898645138114,-43.23,4
10:24,409971170.0,2635.6017480898154,-81.18,4
10:24,973388795.0,314.02367616362153,-58.03,2
10:25,405945930.0,5467.749275568805,-150.5,2
10:25,949032480.0,3590.674130839107,-105.67,2
10:25,570269025.0,3333.131884930085,-28.0,2
10:25,653640811.0,17733.275736288288,-75.04,2
10:26,970298834.0,2373.189085890176,-100.19,2
10:27,534204159.0,5826.628580413207,-18.28,4
10:27,224112146.0,1647.3348999999998,-72.49,2
10:27,492215823.0,2475.3519438154444,-149.17,2
10:28,897592348.0,15771.892095187855,-5.99,2
10:28,344219145.0,8282.635242229135,-39.14,5
10:28,690958123.0,21538.659586515627,-163.1,2
10:29,948069469.0,-912.3240000000012,-72.3,5
10:29,425964226.0,4060.750764114707,-6.0,2
10:30,722971557.0,-1045.6122791569244,-31.71,5
10:31,310375875.0,1514.6006755605697,-21.53,7
10:31,792845450.0,626.0411500000008,-135.53,5
10:31,833499132.0,1417.3119000000022,-40.88,2
10:33,990461108.0,459.996518620611,-70.0,5
10:33,121858569.0,305.7011500000024,-34.5,5
10:34,767447966.0,4891.179062706573,-52.67,5
10:35,776108637.0,687.7717536574953,-47.96,5
10:35,489964679.0,20606.3801898712,-15.31,2
10:35,108812033.0,582.7483999999982,-42.45,5
10:36,678330503.0,1157.627262265526,-70.97,2
10:36,854513972.0,1680.8377000000005,-52.19,5
10:38,754141345.0,-3164.1453351157597,-5.46,5
10:38,878989510.0,5052.34988614179,-22.0,2
10:38,145387690.0,5278.043323998795,-78.39,2
10:39,833499132.0,1349.8119000000022,-67.5,2
10:40,844835978.0,10378.73567950703,-54.98,2
10:41,482513594.0,5441.552087319258,-51.59,2
10:42,405945930.0,5385.149275568805,-82.6,2
10:42,198051483.0,-1079.111910408857,-55.43,5
10:42,424397946.0,533.0137836054002,-146.3,2
10:43,949032480.0,3452.088130839107,-138.59,2
10:43,224112146.0,1543.3348999999998,-104.0,2
10:45,612304466.0,-2273.705749999999,-26.99,5
10:45,225210798.0,934.9159351225794,-49.99,4
10:45,713641917.0,967.8483729031096,-133.98,2
10:47,384497904.0,585.8345999999991,-68.37,5
10:47,196289502.0,16258.861431502695,-10.51,7
10:47,497809732.0,3438.9298695525954,-53.98,2
10:49,472995101.0,1197.8327842428034,-50.0,2
10:50,836110591.0,3027.746782363922,-66.13,2
10:51,990461108.0,431.996518620611,-28.0,2
10:53,224112146.0,1472.3548999999998,-70.98,2
10:53,248658670.0,1302.82665,-53.51,5
10:54,815993333.0,6112.708104137419,-60.29,2
10:54,263882093.0,-1306.7488000000003,-43.39,5
10:54,916270283.0,2241.5042500000004,-147.98,2
10:54,197865285.0,-367.3066882687797,-40.44,5
10:55,322221939.0,3452.4189596831575,-28.45,5
10:55,324224854.0,4254.166847798723,-42.61,2
10:56,867987292.0,1726.937078205846,-28.36,2
10:56,141521177.0,7591.069900000015,-68.59,4
10:57,771125520.0,284.3532999999991,-174.98,2
10:58,224215364.0,-1847.9025920882789,-17.06,5
10:58,570269025.0,3295.793884930085,-37.34,5
10:58,520239952.0,-1711.916826654763,-231.16,5
11:00,868377987.0,2889.2337961778803,-57.98,2
11:00,405945930.0,5266.149275568805,-119.0,2
11:02,726913482.0,-1016.5959985264764,-119.74,5
11:03,655368335.0,3918.572986184048,-77.07,2
11:03,690958123.0,21489.659586515627,-49.0,2
11:04,851181128.0,4596.9352252420895,-29.04,2
11:05,762896656.0,-1153.6475018481417,-17.45,5
11:06,424397946.0,340.51378360540025,-192.5,2
11:08,257633312.0,-315.08630000000096,-42.03,5
11:09,673025413.0,763.9265557102183,-80.51,5
11:09,752362502.0,5980.618203624053,-30.2,7
11:13,703537476.0,877.5402499999991,-107.18,5
11:14,775790822.0,-3314.9259192160675,-19.77,5
11:17,616924659.0,-98.47542017691478,-90.0,2
11:17,141521177.0,7544.069900000015,-47.0,2
11:18,851649498.0,8313.819493386005,-18.06,7
11:21,151968462.0,6935.922867072153,-108.04,4
11:22,779376323.0,3455.93583398134,-56.81,7
11:22,822135975.0,11427.040748657642,-96.89,5
11:23,226703987.0,2623.8321365470742,-89.56,2
11:23,857754342.0,1055.3962538559438,-82.0,2
11:23,245690309.0,9773.468494240604,-49.29,7
11:24,195895574.0,7354.320410194218,-12.3,7
11:24,366550080.0,25784.648976767283,-18.99,2
11:24,535804582.0,1506.5110499999987,-99.5,2
11:25,143061865.0,7176.52469121873,-154.67,2
11:26,134847904.0,4914.42198347907,-49.99,2
11:26,282046994.0,-541.3676499999997,-135.93,5
11:26,815385232.0,10378.025716531016,-35.52,2
11:27,859603181.0,2936.9188856420283,-4.85,2
11:28,767447966.0,4841.079062706573,-50.1,6
11:28,758160963.0,7244.159307371599,-105.13,5
11:29,857997794.0,733.4836651508866,-97.31,5
11:30,224112146.0,1308.3748999999998,-163.98,2
11:32,704517789.0,18329.973955323527,-31.42,2
11:32,424397946.0,99.01378360540028,-241.5,2
11:36,405945930.0,5117.049275568805,-149.1,2
11:37,654329190.0,-737.6635490514808,-32.06,5
11:37,196289502.0,16249.661431502696,-9.2,4
11:37,776431321.0,3080.199004870256,-29.34,2
11:38,792845450.0,620.0511500000008,-5.99,4
11:38,558119802.0,34048.1907714364,-16.36,8
11:39,535804582.0,1281.0110499999987,-225.5,2
11:40,143061865.0,7093.92469121873,-82.6,2
11:41,672994751.0,-13.803709213990018,-140.98,2
11:41,141521177.0,7506.983900000015,-37.09,2
11:41,540159353.0,11167.32623004348,-49.99,2
11:43,647472692.0,26482.974584613057,-84.36,5
11:43,583558311.0,-769.6692152486677,-54.12,5
11:44,690958123.0,21371.359586515628,-118.3,2
11:45,642015139.0,-138.28366253436172,-49.08,5
11:46,402438092.0,219.33089999999896,-44.34,5
11:46,637649383.0,423.20454999999833,-75.91,5
11:46,518474507.0,14063.636615862986,-6.29,2
11:47,897592348.0,15742.676752403624,-29.22,2
11:48,405945930.0,4854.549275568805,-262.5,2
11:48,408057540.0,4874.5079976716925,-28.52,2
11:50,370757362.0,1261.986589812676,-89.35,5
11:50,534204159.0,5803.802980413207,-22.83,4
11:51,625281433.0,-920.7261573707568,-107.25,5
11:52,196289502.0,16202.593201502694,-47.07,4
11:53,226703987.0,2443.260136547074,-180.57,2
11:54,450896297.0,13409.12996161442,-28.69,2
11:54,535804582.0,1216.0110499999987,-65.0,2
11:56,758160963.0,7217.7134173716,-26.45,4
11:57,214339619.0,314.8366785105091,-9.99,2
11:57,758160963.0,7213.860922890028,-3.85,5
11:58,595800644.0,-1126.1177000000002,-130.75,5
11:59,920830317.0,-578.7757793625186,-303.38,5
11:59,449871732.0,7909.012462932801,-72.99,2
12:00,651756497.0,14469.723620860188,-10.15,2
12:01,450896297.0,13383.03996161442,-26.09,9
12:03,586315521.0,12518.560772031127,-22.9,7
12:03,975345315.0,36627.342960273585,-66.97,4
12:06,298000165.0,26664.68696153477,-13.95,2
12:07,941285623.0,700.1413990667704,-1.5,4
12:08,287230540.0,884.0509977638749,-116.98,2
12:09,287480331.0,7433.936348773826,-7.44,5
12:10,296972867.0,-1076.668400000001,-16.0,9
12:11,668692488.0,739.2627785738098,-26.99,4
12:11,585596026.0,2658.335388381067,-127.99,2
12:14,226703987.0,2351.588136547074,-91.67,2
12:14,605116158.0,2508.4150000000036,-46.98,2
12:18,500043411.0,13831.818334835074,-32.61,5
12:18,141521177.0,7408.997900000015,-97.99,2
12:18,690958123.0,21295.05958651563,-76.3,2
12:19,616924659.0,-168.60042017691478,-70.12,2
12:21,151968462.0,6907.956141652957,-27.97,8
12:24,605711527.0,-326.9034861674163,-21.59,9
12:25,534204159.0,5767.162980413206,-36.64,9
12:26,117273481.0,9048.066118264996,-34.95,7
12:27,668692488.0,683.0202785738097,-56.24,7
12:28,540159353.0,11106.04823004348,-61.28,5
12:35,690958123.0,21267.75958651563,-27.3,2
12:35,195895574.0,7336.380410194219,-17.94,9
12:36,912705941.0,19100.46757870803,-50.09,2
12:38,298007503.0,1672.6981036256338,-31.13,9
12:40,585596026.0,2626.415388381067,-31.92,4
12:40,975345315.0,36564.28696027359,-63.06,5
12:41,822718326.0,11583.294797697165,-50.76,5
12:46,424397946.0,-78.7862163945997,-177.8,2
12:46,143061865.0,6978.42469121873,-115.5,2
12:47,683319988.0,6759.873848397487,-61.23,2
12:48,703537476.0,854.5402499999991,-23.0,2
12:49,494789005.0,2481.847695614442,-32.02,5
12:50,534325901.0,6880.483967087834,-43.08,5
12:50,581618317.0,-5176.221701873204,-61.08,5
12:51,659008214.0,-3520.2576022904227,-24.67,5
12:51,224112146.0,1272.8948999999998,-35.48,2
12:52,616924659.0,-191.1004201769148,-22.5,2
12:53,494404688.0,-2818.478265336207,-46.3,5
12:53,456246119.0,21513.068451066058,-19.99,4
12:56,264208990.0,608.1968999999985,-54.99,2
12:57,535804582.0,1056.5110499999987,-159.5,2
12:58,843174694.0,-5342.493499999998,-42.94,5
12:59,668329719.0,8963.436408709886,-12.25,9
12:59,480557476.0,11293.847509460822,-6.9,9
13:01,187111705.0,6934.4214040642855,-5.35,9
13:01,489964679.0,20576.7401898712,-29.64,2
13:01,179173981.0,4605.348471849936,-33.29,9
13:01,667367404.0,9281.196920897415,-35.04,4
13:03,141521177.0,7168.911900000015,-240.09,7
13:03,768271776.0,-767.0804967665796,-84.11,5
13:05,793781222.0,587.970878947406,-1.99,4
13:05,690958123.0,21169.75958651563,-98.0,2
13:05,585596026.0,2591.425388381067,-34.99,2
13:06,943829984.0,-487.520590886543,-60.08,5
13:06,303843160.0,-339.45939999999854,-97.3,5
13:07,853907490.0,7646.002683539701,-6.99,9
13:07,668692488.0,648.1527785738098,-34.87,2
13:08,146686559.0,-787.327311173478,-96.5,5
13:09,143061865.0,6843.36669121873,-135.06,2
13:10,624500124.0,3165.5219797638542,-83.94,5
13:11,766692943.0,-2103.71675,-36.5,5
13:14,104832000.0,-3120.6223589058445,-49.73,5
13:14,945054126.0,163.9980999999999,-84.99,2
13:15,424397946.0,-330.7862163945997,-252.0,2
13:15,322221939.0,3444.9189596831575,-7.5,9
13:15,419084831.0,-566.0902255261033,-126.16,5
13:16,287480331.0,7421.6968287738255,-12.24,4
13:17,703478110.0,2002.275749908584,-37.02,4
13:17,226703987.0,2261.316136547074,-90.27,2
13:17,585625048.0,1797.1639749993576,-5.4,9
13:18,535804582.0,938.0110499999988,-118.5,2
13:20,117308635.0,2256.0420072910492,-35.22,5
13:26,690523499.0,135.71120000000016,-3.0,4
13:26,255814263.0,1439.8040476099234,-131.45,5
13:28,408057540.0,4762.437997671693,-112.07,2
13:29,891716230.0,228.18992670186427,-102.08,5
13:30,885259672.0,3022.323643703083,-13.5,4
13:30,192202372.0,-409.0942650194005,-263.0,5
13:30,226703987.0,2184.316136547074,-77.0,2
13:32,517190750.0,2035.2460899154128,-94.47,2
13:32,950234174.0,-14.45813493759008,-51.01,5
13:33,424397946.0,-540.7862163945997,-210.0,2
13:36,191161970.0,-4063.2969999999946,-26.86,5
13:40,820686957.0,-1098.848816311196,-71.84,5
13:45,535804582.0,833.5110499999987,-104.5,2
13:47,769311479.0,6217.624380789706,-35.44,1
13:49,226703987.0,2010.0161365470744,-174.3,2
13:50,517190750.0,1924.2535899154127,-110.99,2
13:51,949032480.0,3422.458130839107,-29.63,9
13:52,138609932.0,2209.530003294586,-27.5,4
13:54,475277431.0,1105.248136943619,-14.97,4
13:55,821971408.0,1042.1271102355431,-39.61,5
13:56,867987292.0,1704.917078205846,-22.02,2
14:03,802697323.0,16463.11823429405,-171.63,2
14:06,145387690.0,5229.057323998795,-48.99,2
14:09,821971408.0,1009.1771102355432,-32.95,7
14:10,535804582.0,699.0110499999987,-134.5,2
14:11,424397946.0,-708.0862163945997,-167.3,2
14:17,801500539.0,-3648.5186999999983,-93.57,5
14:19,802697323.0,16363.357014294048,-99.76,4
14:19,166019891.0,8313.1524402334,-63.53,5
14:20,736340277.0,8769.945382865435,-6.17,7
14:23,943329213.0,-294.27138065024235,-99.48,5
14:25,668692488.0,610.2927785738098,-37.86,2
14:26,517190750.0,1758.5185899154126,-165.74,2
14:27,598586358.0,-3634.804949999995,-52.36,5
14:27,226703987.0,1986.9441365470743,-23.07,2
14:29,795847804.0,24120.967311190503,-31.69,5
14:30,405945930.0,4547.2492755688045,-307.3,2
14:33,224112146.0,1180.9148999999998,-91.98,2
14:35,783650950.0,-1000.6256434110117,-118.8,5
14:37,517190750.0,1693.658589915413,-64.86,2
14:38,145387690.0,5093.299323998795,-135.76,2
14:44,534325901.0,6819.912717087834,-60.57,4
14:50,709151315.0,-243.14178162584017,-48.01,5
14:53,572384506.0,7143.944425449724,-10.42,7
14:55,616924659.0,-312.2254201769148,-121.12,2
14:56,517190750.0,1640.0485899154128,-53.61,2
14:57,141521177.0,6970.153900000015,-198.76,7
14:57,226703987.0,1959.6441365470744,-27.3,2
14:57,668692488.0,573.9327785738097,-36.36,2
14:57,166019891.0,8290.7024402334,-22.45,9
15:04,224112146.0,1115.9248999999998,-64.99,2
15:07,405945930.0,4281.949275568804,-265.3,2
15:10,873701090.0,297.78538885378106,-4.82,7
15:12,246753533.0,196.98729999999836,-43.72,5
15:12,141521177.0,6889.653900000015,-80.5,4
15:13,409370545.0,622.5772755455207,-39.22,7
15:13,380228542.0,-1643.5520081844345,-290.65,5
15:13,678330503.0,934.187262265526,-223.44,5
15:14,616924659.0,-396.2254201769148,-84.0,2
15:14,668692488.0,518.8152785738098,-55.12,2
15:17,131388684.0,21940.38915471887,-46.42,5
15:23,824916823.0,8372.497060894211,-4.29,4
15:24,500043411.0,13788.218334835074,-43.6,4
15:25,603721739.0,-68.0421005168161,-95.26,5
15:25,833499132.0,1280.8119000000022,-69.0,2
15:27,405945930.0,4017.349275568805,-264.6,2
15:27,141521177.0,6778.367900000015,-111.29,4
15:30,668692488.0,485.4402785738098,-33.38,2
15:39,690958123.0,21113.75958651563,-56.0,2
15:42,145387690.0,4844.099323998796,-249.2,2
15:45,141521177.0,6630.695900000015,-147.67,7
15:45,121858569.0,270.7011500000024,-35.0,6
15:45,224112146.0,967.4348999999996,-148.49,2
15:47,616924659.0,-515.8504201769148,-119.62,2
15:48,910730524.0,7923.256827163701,-26.54,7
15:52,672913754.0,11822.985967668666,-12.98,7
15:53,405945930.0,3657.5492755688047,-359.8,2
15:53,226703987.0,1829.4581365470744,-130.19,2
15:54,833499132.0,1094.8119000000022,-186.0,2
15:54,690958123.0,21057.75958651563,-56.0,2
15:57,705848712.0,27839.80562764513,-105.49,6
15:57,668175891.0,578.6130231584989,-33.99,2
15:59,950234174.0,-44.65813493759008,-30.2,7
16:01,497772347.0,635.7184999999978,-3.0,4
16:01,290818242.0,7021.561397731527,-60.9,2
16:14,605116158.0,2448.4350000000036,-59.98,4
16:14,690958123.0,20938.75958651563,-119.0,2
16:18,833499132.0,1003.3119000000022,-91.5,2
16:19,224112146.0,792.4548999999997,-174.98,2
16:21,226703987.0,1793.0581365470744,-36.4,2
16:24,613427466.0,6848.464455264377,-40.95,7
16:26,424397946.0,-888.6862163945997,-180.6,2
16:33,226703987.0,1717.4721365470743,-75.59,2
16:36,833499132.0,840.1869000000022,-163.12,2
16:38,228136274.0,1141.7903399999996,-33.54,4
16:38,386729293.0,31634.408119274463,-28.31,5
16:39,948558249.0,9916.383956046182,-5.99,1
16:41,506618547.0,14647.608315028929,-22.24,2
16:42,424397946.0,-1067.1862163945998,-178.5,2
16:46,690958123.0,20844.95958651563,-93.8,2
16:49,454356905.0,1323.8907875522557,-13.66,8
16:53,833499132.0,752.4369000000022,-87.75,2
17:00,106601471.0,11304.88848993868,-38.08,9
17:06,226703987.0,1640.4721365470743,-77.0,2
17:08,833499132.0,709.3119000000022,-43.12,2
17:09,675806859.0,7341.943497617263,-58.34,7
17:15,690958123.0,20837.95958651563,-7.0,2
17:21,298007503.0,1638.2381036256338,-34.46,7
17:28,517190750.0,1601.8060899154127,-38.24,2
17:36,919185264.0,3969.0267933418545,-33.14,5
17:37,462962606.0,815.3900499999987,-37.73,9
17:37,405945930.0,3441.2492755688045,-216.3,2
17:37,226703987.0,1592.1861365470745,-48.29,2
17:46,252760664.0,6814.601166940439,-54.66,2
17:48,405945930.0,3196.9492755688043,-244.3,2
17:51,527842638.0,258.7614426329834,-31.99,9
17:53,854895960.0,3445.779089551814,-240.1,2
17:54,226703987.0,1560.6861365470745,-31.5,2
17:54,517190750.0,1422.9310899154127,-178.88,2
18:02,744968736.0,-1597.846826569424,-14.99,9
18:04,616924659.0,-649.7254201769148,-133.88,2
18:06,305778936.0,10504.770629128756,-8.17,5
18:08,158766229.0,-746.58438589347,-25.78,9
18:11,478986718.0,-1102.8312000000012,-20.95,9
18:12,173317688.0,-2465.491234884284,-39.89,9
18:12,721393911.0,-630.7665425357167,-28.13,9
18:12,305778936.0,10478.130629128756,-26.64,9
18:22,405945930.0,2949.8492755688044,-247.1,2
18:22,226703987.0,1447.3001365470743,-113.39,2
18:23,517190750.0,1380.9385899154126,-41.99,2
18:30,616924659.0,-672.2254201769148,-22.5,2
19:13,736340277.0,8765.878661515526,-4.07,7
19:37,198946608.0,4212.723577091825,-14.4,7
19:43,128033695.0,1957.6466505636856,-43.38,9
19:44,399144202.0,1482.94048738414,-25.68,2
19:52,587225252.0,5540.036914228895,-37.08,9
20:49,984783496.0,14367.853860899637,-13.7,2
20:57,901432314.0,3447.3253458889294,-4.81,5
21:03,259015404.0,933.1850330670854,-27.88,9
21:09,556992209.0,12322.884404663426,-23.28,7
21:25,127809299.0,769.8931657577853,-22.9,9
21:27,256002321.0,6123.441513369773,-13.24,2
22:54,624500124.0,3159.2053744673503,-6.32,5
00:19,970298834.0,2370.4123994709025,-2.78,7
00:20,572384506.0,7102.274425449724,-41.67,9
00:26,987163717.0,3803.114131891315,-34.24,9
00:33,727417797.0,5712.334838831692,-9.71,2
00:40,949032480.0,3399.058130839107,-23.4,9
00:41,264550521.0,5308.524830116393,-10.35,7
00:41,113747882.0,12074.775557494338,-32.33,2
00:41,441274121.0,12399.25704732795,-45.21,2
00:42,910730524.0,7921.1550377457725,-2.1,5
00:43,912705941.0,19100.15018308995,-0.32,5
00:45,433917275.0,7617.874670893467,-33.8,9
00:45,897714622.0,9407.91327465389,-31.36,2
00:45,760753808.0,-50.60665000000057,-39.6,9
00:50,350921975.0,-199.34202892612575,-25.95,9
00:51,851649498.0,8299.521962456563,-14.3,5
00:51,858989281.0,27134.478004085035,-13.2,9
00:52,540159353.0,11102.234196122265,-3.81,8
00:56,802697323.0,16325.017014294048,-38.34,9
00:56,647936800.0,2245.203771070814,-5.23,7
00:57,657139925.0,13553.40803545683,-17.89,9
01:01,633345190.0,5830.993221807909,-30.35,9
01:05,586315521.0,12509.12369035953,-9.44,7
01:16,471897866.0,6902.877205890379,-13.73,8
01:19,419550103.0,19034.09196819245,-3.5,2
01:22,541639148.0,4124.97432760483,-0.47,2
01:23,785749304.0,8546.77512578513,-19.94,9
01:25,824916823.0,8348.257060894211,-24.24,9
01:28,836110591.0,3007.25141367979,-20.5,5
01:28,651756497.0,14455.507371852054,-14.22,7
01:29,581655972.0,41639.63118127737,-3.59,5
01:32,887853850.0,10302.75047785599,-12.34,7
01:32,633345190.0,5816.862622204951,-14.13,2
01:36,679911053.0,2457.3723179489643,-9.52,7
01:47,196289502.0,16182.703201502694,-19.89,9
01:48,221868392.0,4719.952612923253,-0.31,7
01:53,124102251.0,1732.6471007731882,-0.35,5
01:54,221868392.0,4696.052612923253,-23.9,9
01:55,237493332.0,14814.928592126113,-2.52,2
02:05,704517789.0,18324.5410309528,-5.43,2
02:05,213112754.0,5578.5439793300375,-12.45,9
02:07,131388684.0,21904.03537015158,-36.35,2
02:10,795847804.0,24063.810965374018,-57.16,2
02:10,179173981.0,4556.215596703626,-49.13,8
02:12,604288474.0,1406.325506174216,-7.84,4
02:14,282837512.0,13915.643626268173,-2.73,2
02:36,519644021.0,2592.4319311731892,-5.61,5
02:38,290818242.0,7009.777494970442,-11.78,8
02:39,429556122.0,4466.778723431802,-3.26,2
02:41,348325817.0,10340.141809846766,-25.21,9
02:41,593378953.0,444.8396500000049,-33.03,9
02:44,310620484.0,-74.13880490780173,-26.94,9
02:44,414805878.0,12918.253868509555,-28.36,9
02:48,987163717.0,3802.140223888187,-0.97,2
02:48,639409800.0,36730.323276519855,-12.41,2
02:49,518474507.0,14062.28022085677,-1.36,7
02:53,954263768.0,-284.90800000000024,-12.89,9
02:54,113747882.0,12031.235557494338,-43.54,9
02:54,905860285.0,10634.643002431823,-20.1,7
03:01,480557476.0,11291.07474075596,-2.77,7
03:03,383625050.0,2755.869926872058,-25.05,7
03:14,769311479.0,6211.344744029432,-6.28,5
03:18,370521542.0,27480.365568922814,-26.96,5
03:25,187111705.0,6920.304131337472,-14.12,2
03:30,858989281.0,27105.16408923202,-29.31,2
03:33,690958123.0,20834.199069580285,-3.76,2
03:35,738958551.0,8974.811172434695,-37.39,9
03:42,500043411.0,13728.06618681864,-60.15,8
03:44,587225252.0,5493.4069142288945,-46.63,9
03:47,836110591.0,2975.32141367979,-31.93,9
03:47,213112754.0,5566.372628757543,-12.17,5
03:49,679662108.0,16613.73330771882,-42.29,5
03:50,667367404.0,9250.416232151116,-30.78,7
03:50,824916823.0,8344.392377436598,-3.86,2
03:55,623156843.0,4501.837113492435,-4.31,2
03:59,324224854.0,4213.689859831045,-40.48,5
04:02,496395938.0,12405.5498696065,-36.8,5
04:03,146909202.0,3255.310566544931,-52.44,8
04:04,310375875.0,1491.1606755605696,-23.44,9
04:05,899742927.0,13063.808184749234,-0.12,7
04:06,256002321.0,6102.201513369773,-21.24,9
04:07,145387690.0,4823.489699627043,-20.61,2
04:13,806358207.0,11333.517198165124,-14.71,5
04:14,588565416.0,5959.39636771387,-20.9,2
04:14,229205098.0,7527.340667958821,-2.26,5
04:14,558119802.0,34002.91780764065,-45.27,5
04:15,216285378.0,24582.84459876362,-40.85,9
04:20,859603181.0,2922.7997236720576,-14.12,7
04:23,120634201.0,5051.582919080845,-15.7,9
04:28,235881534.0,12789.542312604392,-15.16,7
04:28,718058208.0,1914.8569513930752,-5.1,2
04:28,315546581.0,29649.580676726884,-1.7,5
04:28,809499628.0,17875.91624635475,-18.2,9
04:29,435984758.0,4064.4653190012914,-5.91,2
04:30,361201224.0,3093.6394746538026,-29.59,4
04:30,196289502.0,16165.756597162874,-16.95,7
04:32,601627384.0,3214.012484911979,-35.98,9
04:32,166019891.0,8268.958648513624,-21.74,2
04:40,510101371.0,12548.534368522822,-26.52,9
04:41,128033695.0,1922.0966505636857,-35.55,9
04:42,874431242.0,9054.158717513534,-36.04,7
04:42,383833857.0,26118.643871786546,-49.91,2
04:43,417850087.0,15502.951272034898,-35.96,7
04:47,992204045.0,7253.798602286291,-33.2,5
04:48,779946617.0,17005.574988406483,-22.43,9
05:01,675806859.0,7298.465702155988,-43.48,7
05:04,986267641.0,4125.271602825348,-8.67,7
05:04,506618547.0,14573.593349299332,-74.01,2
05:05,842682241.0,3506.028089181775,-7.41,5
05:07,108931112.0,14456.010726981687,-39.83,9
05:10,815385232.0,10362.281327845069,-15.74,5
05:11,657139925.0,13535.729445543837,-17.68,7
05:13,478412511.0,12464.12107019746,-37.15,9
05:15,489964679.0,20539.1101898712,-37.63,9
05:16,183888402.0,19253.052457140137,-34.26,9
05:21,170637730.0,1014.5809982833651,-36.14,2
05:24,310375875.0,1412.8188448461117,-78.34,2
05:30,853907490.0,7627.808412400062,-18.19,8
05:31,547010927.0,24383.32981728852,-11.98,9
05:31,128033695.0,1910.0527341062332,-12.04,7
05:33,687135796.0,29028.9632606482,-6.99,9
05:34,661295096.0,3300.269311666083,-20.81,2
05:36,534325901.0,6814.369127980728,-5.54,2
05:36,973086490.0,10285.78751485803,-34.31,2
05:36,822135975.0,11406.485031434426,-20.56,7
05:36,308505160.0,13376.914471716243,-1.15,2
05:37,256002321.0,6101.683885549215,-0.52,5
05:40,510101371.0,12546.580398193568,-1.95,2
05:41,549414742.0,7141.392096073344,-22.73,9
05:41,613729471.0,7907.391491998889,-14.19,7
05:41,834383043.0,5298.350579814327,-18.91,7
05:43,678851253.0,3673.8168900110218,-27.69,2
05:45,550169791.0,22477.09574576469,-12.94,9
05:47,709608057.0,2412.7435328588986,-37.94,9
05:48,950234174.0,-58.803993536956334,-14.15,2
05:51,706250160.0,12604.111474392284,-67.19,2
05:52,414805878.0,12889.049676014338,-29.2,2
05:55,195895574.0,7330.150612896538,-6.23,7
05:55,482513594.0,5438.416685677242,-3.14,2
05:56,252760664.0,6767.446679036271,-47.15,2
06:00,473820682.0,11340.598737947135,-43.4,2
06:05,399538448.0,7497.5759263988175,-31.35,2
06:05,169006407.0,11641.001073330945,-64.95,8
06:06,930277104.0,9503.459262449744,-21.34,9
06:08,203466392.0,777.1679074364171,-21.08,5
06:10,749378808.0,1574.9534127855854,-3.77,7
06:12,549414742.0,7133.229215813129,-8.16,7
06:14,873693307.0,10377.527166004846,-2.23,2
06:15,570323670.0,3376.352018723773,-22.16,5
06:16,550169791.0,22468.15859227521,-8.94,7
06:22,994214354.0,9991.687222899936,-24.19,9
06:22,668329719.0,8919.970554197322,-43.47,5
06:23,336557504.0,1023.0690758737816,-7.22,7
06:23,522188082.0,7014.100481059592,-15.77,8
06:30,653640811.0,17721.50820918975,-11.77,7
06:35,815993333.0,6061.024406962437,-51.68,8
06:39,420109571.0,342.29842589324585,-33.75,8
06:39,639549973.0,5009.511404045389,-5.06,5
06:43,237684254.0,5974.260582506683,-1.88,5
06:45,108481285.0,8946.425683793686,-15.68,2
06:45,960208650.0,14556.74726624251,-31.72,7
06:48,678330503.0,922.5712130886196,-11.62,7
06:48,554792076.0,29374.7157182192,-0.02,7
06:53,520447032.0,8055.710862508554,-32.58,9
06:56,461990622.0,7162.5538472950675,-41.14,2
06:57,403383649.0,830.4581252948917,-62.54,5
06:59,134461671.0,5312.113986352414,-2.17,7
07:00,779236304.0,1904.5575954795336,-34.86,9
07:01,551755686.0,6957.947926654151,-3.18,5
07:01,399144202.0,1450.3004873841398,-32.64,9
07:02,885259672.0,3010.9927701985416,-11.33,2
07:02,450896297.0,13349.64996161442,-33.39,9
07:06,127809299.0,1333.8423467244631,-16.05,8
07:07,322720763.0,6641.019592500611,-8.11,5
07:09,736340277.0,8749.998661515527,-15.88,9
07:09,108563213.0,23201.8876719356,-34.99,5
07:12,670102069.0,1364.5791060015583,-31.99,9
07:14,601627384.0,3183.4494356183327,-30.56,5
07:14,766941757.0,2485.9745636721054,-38.64,9
07:25,822250278.0,6404.049970688001,-47.69,5
07:30,151968462.0,6907.765520342314,-0.19,8
07:43,994214354.0,9977.13582397937,-14.55,5
07:46,322221939.0,3427.6041642801138,-17.31,5
07:47,270374623.0,9556.938959289198,-59.63,7
07:50,683319988.0,6724.904682023829,-34.97,5
07:58,785749304.0,8508.531430341773,-38.24,2
07:59,719586818.0,18884.787223559895,-37.57,7
08:03,885259672.0,3005.5927701985415,-5.4,9
08:09,348325817.0,10329.1252769293,-11.02,2
08:17,187541224.0,1370.7722783028453,-38.24,9
08:20,395284483.0,1156.564340211308,-7.15,9
08:23,425730826.0,2264.25690938872,-27.51,5
08:24,652048867.0,-43.284250000001066,-41.84,5
08:27,147341222.0,-1937.2255253207957,-40.86,5
08:27,951817450.0,9251.223442839611,-33.82,5
08:27,215426302.0,76.97040402569192,-43.82,5
08:28,752362502.0,5965.17499164193,-15.44,7
08:28,435984758.0,4021.919319001291,-42.55,5
08:29,730002588.0,13786.870601872952,-11.78,2
08:31,851181128.0,4567.799788170413,-29.14,2
08:31,280268430.0,5124.442503818151,-0.67,2
08:34,954263768.0,-307.21210000000025,-22.3,5
08:34,995615876.0,1477.2747315809793,-31.48,5
08:34,472995101.0,1106.2024342428035,-91.63,5
08:39,901432314.0,3416.007345888929,-31.32,5
08:39,519933553.0,7.371004150728446,-37.14,5
08:40,618138606.0,1381.1105215212997,-44.43,5
08:40,734161378.0,-2830.792669434212,-37.24,5
08:44,556992209.0,12296.214404663426,-26.67,5
08:47,679662108.0,16456.69530771882,-157.04,5
08:49,975200042.0,-3240.6851999999967,-45.9,5
08:51,655368335.0,3834.189474751675,-84.38,5
08:51,643610517.0,-3124.4436907296567,-44.84,5
08:53,556631012.0,-169.03362691432193,-88.04,5
08:53,684988568.0,-532.2024734272015,-150.46,5
08:55,335698481.0,-2482.880496694939,-25.34,5
08:56,298000165.0,26635.560282989405,-29.13,2
08:56,691789577.0,-1151.3973500000002,-210.65,5
08:58,712474734.0,-1950.669331236004,-21.22,5
08:59,234952520.0,355.5863999999988,-59.86,5
08:59,194745206.0,69.89837209124317,-62.12,5
09:01,441274121.0,12392.75704732795,-6.5,9
09:02,331450202.0,7590.075121212727,-29.9,5
09:02,290818242.0,7002.627494970442,-7.15,9
09:03,593191200.0,305.85909999999905,-83.51,5
09:03,581655972.0,41633.48118127737,-6.15,9
09:03,349614277.0,605.9549999999995,-112.18,5
09:03,588565416.0,5812.16536771387,-147.23,5
09:03,214339619.0,310.4866785105091,-4.35,9
09:03,899692478.0,-2110.9358435240074,-44.38,5
09:03,903953091.0,3125.269790134573,-31.7,8
09:04,553734946.0,6.895699999998271,-79.15,5
09:04,938992364.0,202.90512373139947,-121.25,5
09:04,667367404.0,9244.716232151117,-5.7,9
09:06,644751433.0,-1660.7506584655384,-26.54,5
09:07,117273481.0,9042.716118264996,-5.35,9
09:08,690958123.0,20827.699069580285,-6.5,9
09:10,151968462.0,6830.716520342314,-77.05,5
09:11,999752672.0,1008.0652435333348,-5.7,9
09:13,518378868.0,-1612.9549000000004,-55.9,5
09:15,987229118.0,707.4258720086789,-137.97,5
09:16,744211756.0,-4454.548249999992,-40.23,5
09:16,781554833.0,999.3209255639664,-77.49,5
09:16,169006407.0,11635.001073330945,-6.0,9
09:16,618138606.0,1373.9605215212996,-7.15,9
09:17,217540156.0,-3632.0548199999935,-38.27,5
09:19,272538745.0,16245.839900000024,-44.98,4
09:19,128033695.0,1888.8027341062332,-21.25,4
09:19,992204045.0,7248.19860228629,-5.6,9
09:20,506618547.0,14568.243349299331,-5.35,9
09:21,663479159.0,4755.861541827711,-25.96,7
09:22,886921642.0,3223.5609016185404,-13.27,5
09:22,135937041.0,-1205.930348268412,-38.13,5
09:23,540159353.0,11096.484196122265,-5.75,9
09:23,168414279.0,-178.93271572507865,-57.85,5
09:23,403383649.0,702.0011252948917,-128.46,5
09:25,955035930.0,2283.473479171478,-41.99,2
09:26,948558249.0,9892.485956046185,-23.9,5
09:26,127809299.0,1235.8623467244631,-97.98,2
09:26,986774156.0,1578.5169316257693,-99.99,2
09:27,240643705.0,-78.98017037943193,-81.98,2
09:28,987656636.0,4175.6934830500295,-13.03,7
09:28,285220959.0,12162.707077830728,-26.7,7
09:29,176922958.0,1330.6795471976498,-55.81,2
09:33,558875206.0,3062.1105393997805,-315.13,5
09:33,129018172.0,9692.334815571274,-5.99,2
09:33,611143859.0,1232.7355500000122,-158.16,2
09:34,945054126.0,36.61209999999993,-127.39,2
09:38,558875206.0,3056.0605393997803,-6.05,9
09:39,554792076.0,29277.4157182192,-97.3,2
09:40,948558249.0,9857.495956046185,-34.99,2
09:44,901432314.0,3405.755785888929,-10.25,4
09:44,776431321.0,3028.219004870256,-51.98,4
09:45,280098744.0,2402.0783778716664,-14.99,4
09:47,673818591.0,1586.1821753758406,-182.0,2
09:48,299871610.0,205.53315305876671,-121.99,2
09:51,769319491.0,-125.58050000000078,-4.99,1
09:53,254853117.0,3109.8228531148234,-6.0,7
09:54,865748375.0,2217.26773160587,-43.28,8
10:00,984783496.0,14356.749002254655,-11.1,7
10:01,554792076.0,29145.1437182192,-132.27,2
10:06,727417797.0,5660.844838831692,-51.49,4
10:06,611143859.0,1076.6635500000125,-156.07,2
10:07,399144202.0,1422.8785705096686,-27.42,2
10:07,741903302.0,2465.3770679352606,-19.99,4
10:09,548907062.0,451.8365387682885,-110.82,5
10:10,930277104.0,9496.691848622284,-6.77,5
10:12,815993333.0,6054.004406962436,-7.02,7
10:12,310620484.0,-80.16880490780173,-6.03,7
10:12,522188082.0,6899.356481059593,-114.74,5
10:14,673818591.0,1434.1821753758406,-152.0,2
10:16,865748375.0,2165.670731605869,-51.6,5
10:16,370521542.0,27340.673568922815,-139.69,5
10:16,659415300.0,1670.2428805359596,-5.7,9
10:17,812692024.0,3905.7530918987177,-70.0,2
10:18,741903302.0,2408.4670679352607,-56.91,7
10:19,570410059.0,1366.9539467763116,-188.71,5
10:20,779236304.0,1855.9475954795337,-48.61,6
10:24,570269025.0,3220.803884930085,-74.99,2
10:33,366550080.0,25736.69440356781,-47.95,5
10:36,788740658.0,2483.8674690169987,-243.6,2
10:39,556992209.0,12291.224404663426,-4.99,4
10:42,527842638.0,216.7914426329834,-41.97,4
10:42,673025413.0,759.7864974995953,-4.14,2
10:49,812692024.0,3825.995091898718,-79.76,2
10:49,497809732.0,3338.9398695525956,-99.99,2
10:52,454356905.0,1308.6599075522556,-15.23,4
10:59,973388795.0,247.52367616362153,-66.5,2
11:02,479456865.0,1732.8194995833055,-21.98,4
11:08,613427466.0,6842.474455264377,-5.99,4
11:11,866941383.0,1759.343550000007,-1.5,4
11:11,454356905.0,1297.4397510789356,-11.22,7
11:13,788740658.0,2434.8674690169987,-49.0,2
11:14,575652395.0,2169.165410127267,-8.82,2
11:16,611143859.0,1024.1635500000125,-52.5,2
11:18,518746136.0,-1121.0547282369168,-48.02,5
11:20,264550521.0,5287.384830116393,-21.14,7
11:23,819515373.0,2321.843536063793,-11.98,7
11:25,355940285.0,7917.002978189684,-125.97,2
11:25,812692024.0,3773.495091898718,-52.5,2
11:31,613427466.0,6744.026455264377,-98.45,5
11:33,272538745.0,16111.859900000023,-133.98,2
11:36,788740658.0,2268.267469016999,-166.6,2
11:38,611143859.0,894.0195500000123,-130.14,2
11:44,703537476.0,816.5202499999991,-38.02,2
11:49,187111705.0,6914.234131337473,-6.07,7
11:49,198946608.0,4204.849777478254,-7.87,5
11:53,425730826.0,2215.88190938872,-48.38,2
11:53,933491926.0,3322.5412700000043,-96.68,5
11:57,788740658.0,2177.9674690169986,-90.3,2
12:06,475277431.0,1094.268136943619,-10.98,7
12:09,948558249.0,9697.895956046184,-159.6,2
12:10,673818591.0,1346.6821753758406,-87.5,2
12:11,460463595.0,-489.7579454185789,-76.26,5
12:15,788740658.0,1988.9674690169984,-189.0,2
12:23,425730826.0,2100.00690938872,-115.88,2
12:23,673818591.0,1294.6821753758406,-52.0,2
12:25,812692024.0,3724.509091898718,-48.99,2
12:26,257633312.0,-358.426300000001,-43.34,9
12:26,398429109.0,479.13705000000095,-63.98,2
12:26,973086490.0,10270.55751485803,-15.23,9
12:28,564744955.0,-90.53314141115813,-19.19,9
12:31,195895574.0,7298.510612896538,-31.64,9
12:35,970298834.0,2239.9219394709025,-130.49,4
12:41,673818591.0,1117.1821753758406,-177.5,2
12:46,948558249.0,9548.795956046182,-149.1,2
12:50,116169597.0,772.2429499999996,-120.43,5
12:53,425730826.0,1939.88190938872,-160.12,2
12:56,180616589.0,961.0328282361096,-10.92,5
12:58,982286721.0,-3662.4730240177296,-48.32,5
12:59,119943495.0,-1626.412562112858,-45.26,5
13:00,520447032.0,8050.809900542992,-4.9,2
13:01,857997794.0,683.4936651508866,-49.99,4
13:02,985188462.0,-84.41361128877519,-40.85,9
13:02,688712152.0,6802.8307181372,-7.15,9
13:04,823208989.0,634.1117038695317,-101.59,2
13:04,910730524.0,7914.6550377457725,-6.5,9
13:04,673818591.0,1002.6821753758406,-114.5,2
13:05,899742927.0,13031.688184749231,-32.12,2
13:06,655450953.0,-2971.7123784555292,-38.67,5
13:14,945054126.0,-51.573900000000066,-88.19,2
13:16,679943657.0,1747.5008891801374,-35.3,9
13:17,284905540.0,8312.691113056128,-112.77,5
13:20,892354433.0,-894.7699606343386,-23.59,5
13:22,929044080.0,252.66389150562827,-36.2,5
13:25,425730826.0,1917.38190938872,-22.5,2
13:26,405416860.0,2488.136506880905,-29.99,2
13:26,215832575.0,-1484.7694637442198,-48.6,5
13:30,700138124.0,4284.997407211794,-81.66,5
13:32,364357875.0,7728.273991684061,-67.5,2
13:34,455831435.0,-1930.4746048014947,-49.17,5
13:41,212560376.0,-283.0938742208979,-97.8,5
13:44,406862520.0,28.158626537410385,-269.05,5
13:45,635679314.0,-3108.1508291195178,-41.95,5
13:47,344522228.0,-3005.4094882083928,-29.59,5
13:47,305778936.0,10454.468954064603,-23.66,7
13:50,233981231.0,2175.5402892297584,-18.48,4
13:53,425730826.0,1792.50690938872,-124.88,2
13:57,653667523.0,3375.163594121481,-39.51,5
14:01,120634201.0,5026.061199685602,-25.52,5
14:05,909676212.0,32.422531787613124,-22.0,2
14:39,259015404.0,896.1950330670854,-36.99,9
14:46,280098744.0,2301.4673778716665,-100.61,5
14:51,788740658.0,1785.9674690169986,-203.0,2
14:53,613729471.0,7871.801491998889,-35.59,6
14:54,479366718.0,2126.691348140041,-86.97,4
14:58,425730826.0,1729.50690938872,-63.0,2
15:04,587225252.0,5481.994573655331,-11.41,5
15:10,550832673.0,3043.3360163955094,-43.81,5
15:13,873701090.0,264.0173888537811,-33.77,5
15:14,425730826.0,1585.50690938872,-144.0,2
15:24,788740658.0,1643.8674690169987,-142.1,2
15:26,480198977.0,12471.503032593251,-2.15,2
15:30,873701090.0,201.42177477375063,-62.6,5
15:34,421881811.0,2147.33895171138,-64.11,2
15:44,948558249.0,9332.495956046185,-216.3,2
15:45,945054126.0,-197.85990000000004,-146.29,2
15:50,425730826.0,1512.75690938872,-72.75,2
15:50,321372947.0,-490.8720507890995,-59.28,5
15:51,973388795.0,13.73767616362153,-233.79,2
15:56,565175333.0,-4022.568522729826,-41.3,5
15:58,700138124.0,4238.8541161179555,-46.14,2
15:58,670102069.0,1301.3203732246538,-63.26,2
15:59,838830098.0,60.38769208778437,-38.58,9
16:02,948558249.0,9147.695956046184,-184.8,2
16:05,945054126.0,-329.45990000000006,-131.6,2
16:06,886921642.0,3173.7489016185405,-49.81,5
16:08,388862238.0,1470.0542088728068,-24.98,4
16:11,933491926.0,3272.3412700000044,-50.2,2
16:11,788740658.0,1566.8674690169987,-77.0,2
16:15,973388795.0,-68.83432383637847,-82.57,2
16:16,624500124.0,3107.0016144673505,-52.2,4
16:18,532478725.0,4334.637526388852,-56.98,2
16:29,652048867.0,-73.26425000000107,-29.98,4
16:30,516051449.0,988.8227746508288,-6.99,7
16:32,624500124.0,3090.3312060973185,-16.67,2
16:38,885259672.0,2965.5727701985415,-40.02,2
16:39,691012931.0,-1733.532250000001,-25.93,5
16:39,512989907.0,-2035.3169039753657,-25.39,5
16:43,948558249.0,8968.495956046183,-179.2,2
16:45,310375875.0,1326.1518448461118,-86.67,5
16:48,788740658.0,1437.3674690169987,-129.5,2
16:55,425730826.0,1361.63190938872,-151.12,2
17:02,409971170.0,2622.6324910836142,-12.97,7
17:04,788740658.0,1375.0674690169988,-62.3,2
17:06,948558249.0,8787.895956046183,-180.6,2
17:10,348325817.0,10312.6349969293,-16.49,4
17:14,425730826.0,1271.63190938872,-90.0,2
17:17,948558249.0,8641.595956046183,-146.3,2
17:20,454129843.0,-118.03220483343998,-29.91,5
17:21,851181128.0,4548.459788170413,-19.34,9
17:21,865748375.0,2140.650731605869,-25.02,2
17:22,812692024.0,3662.111091898718,-62.4,5
17:23,314980178.0,3782.5168500000063,-29.98,2
17:23,788740658.0,1091.5674690169988,-283.5,2
17:26,873693307.0,10363.337166004843,-14.19,9
17:30,117273481.0,8997.746118264997,-44.97,4
17:32,802697323.0,16193.407014294047,-131.61,2
17:32,771125520.0,209.36329999999907,-74.99,6
17:33,854895960.0,3400.789089551815,-44.99,2
17:35,143061865.0,6823.37669121873,-19.99,2
17:35,897714622.0,9361.253274653893,-46.66,2
17:35,518474507.0,13848.78022085677,-213.5,2
17:37,809499628.0,17848.73624635475,-27.18,2
17:37,333054026.0,105.0108940231901,-28.09,7
17:37,822135975.0,11385.075031434426,-21.41,7
17:39,581655972.0,41612.51118127737,-20.97,7
17:41,425730826.0,1221.38190938872,-50.25,2
17:41,758160963.0,7213.690268001393,-0.17,5
17:45,857754342.0,466.90625385594376,-58.49,2
17:45,948558249.0,8501.595956046183,-140.0,2
17:46,141521177.0,6500.715900000016,-129.98,2
17:46,143061865.0,6693.40669121873,-129.97,2
17:49,518474507.0,13674.48022085677,-174.3,2
17:50,282102606.0,267.76136242282644,-125.78,5
17:50,780463728.0,3427.1102209422393,-53.0,2
17:50,788740658.0,944.5674690169988,-147.0,2
17:50,237493332.0,14795.356592126112,-19.57,5
17:51,480198977.0,12391.523032593252,-79.98,2
17:52,939972497.0,845.1591086000105,-50.0,2
17:53,996042490.0,6049.86502666687,-8.0,8
17:55,510101371.0,12522.860398193568,-23.72,4
17:56,163470640.0,883.2973999999995,-74.97,4
17:56,874431242.0,9040.411277513536,-13.75,4
17:57,678851253.0,3637.4168900110217,-36.4,7
17:57,730002588.0,13750.230601872952,-36.64,7
17:59,450896297.0,13331.783959980909,-17.87,7
18:00,945054126.0,-455.4319,-125.97,2
18:01,720742759.0,272.00608088300726,-127.94,5
18:01,586041848.0,2060.132699999999,-95.05,5
18:02,878989510.0,4913.833886141791,-138.52,5
18:04,425730826.0,1162.13190938872,-59.25,2
18:05,245690309.0,9736.382494240605,-37.09,5
18:07,857754342.0,416.90625385594376,-50.0,2
18:10,832564361.0,15646.847901436804,-1.99,5
18:11,532478725.0,4312.937526388852,-21.7,9
18:12,893134725.0,1017.7213376616672,-22.58,5
18:15,788740658.0,718.4674690169987,-226.1,2
18:19,930271460.0,39.85664753577635,-139.55,5
18:20,986267641.0,4092.681602825348,-32.59,9
18:22,678851253.0,3577.2448900110217,-60.17,4
18:22,370757362.0,1251.3660236036174,-10.62,2
18:23,398429109.0,439.287050000001,-39.85,9
18:23,822135975.0,11379.975031434426,-5.1,7
18:25,809499628.0,17838.194794205752,-10.54,8
18:25,769311479.0,6191.244744029432,-20.1,9
18:26,948558249.0,8215.995956046183,-285.6,2
18:29,227104649.0,456.1670343161778,-41.13,9
18:34,639409800.0,36724.30327651986,-6.02,7
18:35,433917275.0,7601.043852546029,-16.83,7
18:40,907987693.0,-2664.804499999998,-21.36,5
18:41,259015404.0,874.3585698514945,-21.84,5
18:44,788740658.0,683.4674690169987,-35.0,2
18:45,857754342.0,374.93625385594373,-41.97,4
18:46,940569402.0,4222.529857088905,-3.7,2
18:49,492215823.0,2452.3719438154444,-22.98,9
18:50,749378808.0,1543.9634127855854,-30.99,9
18:50,345582855.0,387.04625282054934,-28.98,5
18:52,500843551.0,241.20469999999963,-54.58,5
18:52,940569402.0,4201.829857088906,-20.7,9
18:54,771125520.0,123.25909999999908,-86.1,5
18:55,132400709.0,625.0797851539397,-28.75,9
18:57,762700245.0,84.24970000000266,-142.27,5
18:57,822250278.0,6373.859970688001,-30.19,9
18:59,678851253.0,3456.1868900110217,-121.06,2
19:05,296770890.0,303.3100103790831,-93.18,5
19:06,282837512.0,13884.043626268172,-31.6,9
19:07,518474507.0,13640.340220856771,-34.14,9
19:09,874431242.0,9009.121277513534,-31.29,9
19:11,609939116.0,7531.82696593004,-11.7,4
19:12,158414827.0,-1527.085000000002,-5.39,5
19:13,285115279.0,-3522.198510789287,-101.03,5
19:13,373163757.0,11400.997697923489,-150.42,5
19:14,678851253.0,3354.0148900110216,-102.17,2
19:14,854895960.0,3269.3710895518147,-131.42,5
19:14,901432314.0,3376.5357683766124,-29.22,2
19:15,200080192.0,9507.916020545885,-1.87,2
19:15,266777719.0,-1373.7910662197603,-145.84,5
19:16,788740658.0,478.3674690169987,-205.1,2
19:18,856461967.0,-371.19064647050743,-135.7,5
19:24,705848712.0,27820.60562764513,-19.2,9
19:30,405945930.0,2944.3208136754088,-5.53,7
19:32,949032480.0,3388.1166443773973,-10.94,8
19:32,788740658.0,437.0674690169987,-41.3,2
19:33,478651121.0,-545.4544204015303,-47.08,5
19:36,285428103.0,10194.449808161064,-64.61,5
19:38,547010927.0,24382.176948214383,-1.15,5
19:42,146909202.0,3225.3205665449314,-29.99,9
19:43,978410962.0,-2906.325839548972,-21.2,5
19:47,517190750.0,1359.0385899154126,-21.9,9
19:48,610450243.0,-710.6345999999998,-26.88,5
19:54,744968736.0,-1627.9168265694238,-30.07,5
19:59,996042490.0,5930.69002666687,-119.17,5
19:59,511179916.0,7391.061705308704,-47.64,2
20:11,449871732.0,7885.743783966988,-23.27,5
20:19,421881811.0,2146.6791389382324,-0.66,2
20:20,687135796.0,29020.16919828602,-8.79,4
20:21,478986718.0,-1153.690400000001,-50.86,5
20:25,887853850.0,10264.610477855991,-38.14,9
20:31,705848712.0,27805.159720359345,-15.45,2
20:38,287480331.0,7400.506828773826,-21.19,9
20:43,962295212.0,-2240.767649999996,-37.0,5
20:45,285873880.0,12837.331198911548,-74.24,5
20:46,370521542.0,27328.423568922815,-12.25,9
20:49,844835978.0,10337.64567950703,-41.09,5
00:11,973086490.0,10268.06440078456,-2.49,8
00:25,480557476.0,11283.684740755962,-7.39,9
00:35,899742927.0,12988.837280912849,-42.85,2
00:39,284905540.0,8234.675445891466,-78.02,8
00:47,169689461.0,129.58314999999905,-25.52,9
00:59,779236304.0,1821.5175954795336,-34.43,9
01:02,613729471.0,7862.135111927784,-9.67,4
01:13,886921642.0,3125.463730086657,-48.29,7
01:13,480557476.0,11251.19530850013,-32.49,7
01:19,305778936.0,10428.038954064605,-26.43,9
01:28,984783496.0,14355.988617845176,-0.76,5
01:36,475117511.0,6903.62692199365,-12.49,8
01:49,984783496.0,14343.748617845176,-12.24,9
02:18,588565416.0,5795.603389475904,-16.56,5
02:19,399144202.0,1379.338570509669,-43.54,9
02:38,550169791.0,22461.168592275204,-6.99,9
02:47,510101371.0,12473.770398193568,-49.09,9
02:53,996042490.0,5887.3493598607165,-43.34,8
02:57,572384506.0,7066.1744254497235,-36.1,9
03:01,738958551.0,8941.421172434695,-33.39,9
03:01,348325817.0,10294.3549969293,-18.28,9
03:04,195895574.0,7289.52201404234,-8.99,8
03:07,940569402.0,4188.489857088905,-13.34,9
03:09,399144202.0,1378.0720779873686,-1.27,2
03:14,511179916.0,7368.526515156866,-22.54,2
03:18,749378808.0,1519.073412785585,-24.89,9
03:19,985188462.0,-121.3636112887752,-36.95,9
03:22,120634201.0,5006.061199685602,-20.0,9
03:29,124102251.0,1732.4644806529047,-0.18,7
03:30,809499628.0,17822.554794205753,-15.64,9
03:36,287480331.0,7362.766828773826,-37.74,9
03:38,940569402.0,4148.392735019805,-40.1,5
03:40,221868392.0,4668.112612923253,-27.94,9
03:42,987163717.0,3766.450223888187,-35.69,9
03:46,414805878.0,12853.74967601434,-35.3,9
03:46,705848712.0,27793.869720359344,-11.29,9
03:49,522188082.0,6883.433589627197,-15.92,7
03:49,887853850.0,10242.620477855991,-21.99,9
03:50,383625050.0,2732.7574655815006,-23.11,2
03:53,471897866.0,6866.760602186263,-36.12,8
03:56,802697323.0,16151.917014294047,-41.49,9
03:59,290818242.0,6988.503593370101,-14.12,7
04:00,749378808.0,1494.6421499080047,-24.43,7
04:08,366550080.0,25725.05440356781,-11.64,9
04:11,221868392.0,4645.6274199981635,-22.49,8
04:14,518474507.0,13604.670220856771,-35.67,9
04:14,639549973.0,4960.132469009101,-49.38,2
04:14,287480331.0,7358.961903381768,-3.8,8
04:16,930277104.0,9466.551848622285,-30.14,9
04:17,282837512.0,13882.737580345132,-1.31,8
04:21,179173981.0,4513.835596703626,-42.38,9
04:26,912705941.0,19089.805625222903,-10.34,2
04:27,802697323.0,16149.892927774628,-2.02,2
04:34,604288474.0,1381.3564854799793,-24.97,8
04:34,203466392.0,733.5376960955241,-43.63,7
04:35,653640811.0,17705.447284626258,-16.06,8
04:41,506618547.0,14563.745148989272,-4.5,7
04:44,169006407.0,11623.6727153493,-11.33,2
04:46,496395938.0,12372.198799212249,-33.35,8
04:47,414805878.0,12851.032686314546,-2.72,5
04:49,709608057.0,2371.6535328588984,-41.09,9
04:50,383833857.0,26035.801002947897,-57.06,7
04:52,550169791.0,22403.593081213497,-57.58,2
04:53,586315521.0,12431.907741093732,-77.22,5
04:53,305778936.0,10410.45522517954,-17.58,5
04:55,824916823.0,8318.952377436597,-25.44,9
04:56,758160963.0,7203.365003987657,-10.33,7
04:57,873701090.0,161.18563359574682,-40.24,2
04:57,836110591.0,2936.6414136797903,-38.68,9
04:59,930277104.0,9463.884886789576,-2.67,2
04:59,704517789.0,18321.617479466015,-2.92,4
05:00,647936800.0,2236.111941675571,-9.09,8
05:03,259015404.0,840.4585698514945,-33.9,9
05:03,370521542.0,27314.783568922816,-13.64,9
05:05,992204045.0,7192.980230041156,-55.22,2
05:06,519644021.0,2571.4821845778843,-20.95,7
05:10,683319988.0,6699.572545811045,-25.33,2
05:11,324224854.0,4211.743246615434,-1.95,7
05:11,366550080.0,25712.088287530605,-12.97,8
05:14,187541224.0,1327.8322783028452,-42.94,9
05:16,994214354.0,9940.73582397937,-36.4,9
05:16,252760664.0,6692.515396805163,-74.93,5
05:24,769311479.0,6169.303347854633,-21.94,8
05:25,960208650.0,14545.583404219618,-11.16,7
05:25,270374623.0,9539.657050160622,-17.28,5
05:29,758885184.0,579.6671822743446,-36.35,9
05:30,183888402.0,19212.832457140135,-40.22,9
05:31,417850087.0,15470.002468708037,-32.95,2
05:37,450896297.0,13292.083959980908,-39.7,9
05:39,520447032.0,8014.119900542993,-36.69,9
05:41,858989281.0,27094.21408923202,-10.95,9
05:43,310620484.0,-113.03880490780172,-32.87,9
05:48,832564361.0,15641.364416993303,-5.48,5
05:57,461990622.0,7155.165139255774,-7.39,2
05:59,851649498.0,8225.67813744453,-73.84,7
06:00,235881534.0,12762.94964960052,-26.59,5
06:03,651756497.0,14423.40300763642,-32.1,5
06:05,853907490.0,7616.0448964299985,-11.76,2
06:06,699139822.0,-788.615924223053,-41.38,9
06:07,108931112.0,14422.540726981688,-33.47,9
06:10,842682241.0,3503.620183503895,-2.41,4
06:11,117308635.0,2224.083170706712,-31.96,2
06:11,146909202.0,3212.3913216966193,-12.93,7
06:12,450896297.0,13271.270104178007,-20.81,7
06:14,280268430.0,5110.158692483257,-14.28,2
06:14,951817450.0,9200.308323278034,-50.92,8
06:15,587225252.0,5454.414573655331,-27.58,9
06:15,910730524.0,7853.07205836806,-61.58,8
06:16,454356905.0,1262.7197510789356,-34.72,9
06:17,216285378.0,24550.054598763614,-32.79,9
06:22,779946617.0,16998.41319646678,-7.16,2
06:27,897714622.0,9358.924992768903,-2.33,5
06:28,858989281.0,27064.25250921957,-29.96,7
06:30,867987292.0,1693.9779443797795,-10.94,8
06:30,824916823.0,8269.74512843225,-49.21,8
06:31,679911053.0,2431.146573006402,-26.23,8
06:36,718058208.0,1899.8236618668868,-15.03,4
06:41,541639148.0,4075.0437550526094,-49.93,2
06:45,310375875.0,1309.2118448461115,-16.94,9
06:46,213112754.0,5549.672628757543,-16.7,9
06:48,532478725.0,4275.187526388852,-37.75,9
06:49,657139925.0,13519.799445543837,-15.93,9
06:49,187111705.0,6893.447718127369,-20.79,2
06:50,752362502.0,5952.29247277011,-12.88,7
06:50,885259672.0,2900.873436098032,-64.7,2
06:50,433837402.0,-127.2658684641881,-32.83,9
06:53,601627384.0,3149.059435618333,-34.39,9
06:54,667367404.0,9205.14243633718,-39.57,8
06:55,331450202.0,7563.783751072179,-26.29,7
06:56,113747882.0,11999.705557494335,-31.53,9
06:58,285220959.0,12162.56025645906,-0.15,2
07:01,549414742.0,7133.149710393999,-0.08,8
07:01,489964679.0,20501.593892415294,-37.52,8
07:01,670102069.0,1281.540373224654,-19.78,9
07:02,473820682.0,11339.132799860728,-1.47,5
07:02,170637730.0,988.087015321238,-26.49,7
07:02,370521542.0,27273.901890817346,-40.88,5
07:05,256002321.0,6084.502575345055,-17.18,7
07:06,675806859.0,7279.694288594183,-18.77,7
07:08,866941383.0,1738.347680303673,-21.0,7
07:10,987656636.0,4159.7430165226,-15.95,2
07:10,719586818.0,18879.90164938704,-4.89,2
07:14,822250278.0,6356.641328060907,-17.22,7
07:15,633345190.0,5781.672622204951,-35.19,9
07:16,517934629.0,527.1076787084264,-6.9,9
07:16,556992209.0,12284.547639219349,-6.68,4
07:16,949032480.0,3382.729865792496,-5.39,2
07:19,785749304.0,8487.367448505,-21.16,2
07:19,673025413.0,726.7679223629174,-33.02,8
07:19,554792076.0,29135.100089857948,-10.04,7
07:20,547010927.0,24344.206948214385,-37.97,9
07:21,196289502.0,16146.866597162874,-18.89,9
07:22,829914501.0,1433.1498065709743,-6.15,9
07:23,950234174.0,-61.10414384532082,-2.3,2
07:26,441274121.0,12370.15704732795,-22.6,9
07:33,809499628.0,17793.00506507589,-29.55,5
07:35,229205098.0,7480.46407773269,-46.88,5
07:36,108563213.0,23196.517501634997,-5.37,5
07:36,248658670.0,1052.82665,-250.0,4
07:37,679662108.0,16442.863181301156,-13.83,7
07:37,237493332.0,14769.538409061315,-25.82,8
07:37,905860285.0,10630.775599982162,-3.87,8
07:38,815385232.0,10354.741356100085,-7.54,5
07:39,518474507.0,13577.61362991409,-27.06,7
07:50,558119802.0,33977.57780764066,-25.34,9
07:52,264550521.0,5256.379968186453,-31.0,5
07:53,581655972.0,41598.71249613239,-13.8,7
07:58,873693307.0,10318.739532624208,-44.6,7
08:03,987229118.0,692.6925800724163,-14.73,5
08:06,547010927.0,24304.902004388507,-39.3,5
08:06,308505160.0,13361.490638605304,-15.42,2
08:10,196289502.0,16127.196137017992,-19.67,4
08:12,322221939.0,3379.4644540671597,-48.14,5
08:13,970298834.0,2209.147411553174,-30.77,2
08:14,237684254.0,5951.630936486651,-22.63,7
08:14,336557504.0,1016.5690758737816,-6.5,9
08:18,885259672.0,2894.423436098032,-6.45,9
08:21,395284483.0,1150.064340211308,-6.5,9
08:22,151968462.0,6787.470386602772,-43.25,7
08:23,795847804.0,24050.786661355494,-13.02,7
08:23,696758548.0,-3617.615396320137,-13.48,5
08:26,979135922.0,974.455300590451,-88.54,5
08:29,121113546.0,115.20215606986967,-90.47,5
08:33,670102069.0,1219.443838050896,-62.1,5
08:33,564214408.0,-207.090115274274,-38.38,5
08:34,719742742.0,-610.9800077779631,-29.3,5
08:36,905860285.0,10550.03059998216,-80.75,5
08:38,850290152.0,-3095.4259999999963,-35.57,5
08:39,609939116.0,7529.378128380764,-2.45,7
08:39,558119802.0,33926.94403444236,-50.63,2
08:40,857754342.0,298.2018880227201,-76.73,7
08:40,572136270.0,-1068.6033884119763,-52.23,5
08:42,687135796.0,28955.26758935726,-64.9,5
08:47,876890798.0,3177.1358706999335,-33.88,5
08:47,142791593.0,-263.1554000000003,-71.98,5
08:48,315546581.0,29591.15248304774,-58.43,5
08:49,849096144.0,1188.919020751343,-155.3,5
08:50,511179916.0,7233.223515156866,-135.3,5
08:52,520447032.0,7948.50549129172,-65.61,2
08:53,248625662.0,-537.3619157151476,-104.61,5
08:55,678726554.0,-537.4772476516102,-102.94,5
08:57,215311171.0,6117.663734342205,-9.67,7
09:00,338022396.0,-570.5154606242611,-87.92,5
09:00,773633520.0,-292.02458906148854,-41.08,5
09:01,140893085.0,6671.329056365463,-240.47,5
09:02,999752672.0,1002.6652435333348,-5.4,9
09:02,667367404.0,9198.74243633718,-6.4,9
09:04,506618547.0,14558.045148989271,-5.7,9
09:04,235663459.0,484.8064298120151,-28.14,5
09:05,176922958.0,1317.4705471976497,-13.21,5
09:05,851649498.0,8220.278137444531,-5.4,9
09:06,259015404.0,781.0866088179295,-59.37,2
09:06,639409800.0,36669.53527651986,-54.77,5
09:06,187111705.0,6865.055718127369,-28.39,5
09:08,581655972.0,41590.91249613239,-7.8,9
09:09,657528784.0,-170.13809999999927,-86.14,5
09:10,117273481.0,8991.846118264997,-5.9,9
09:11,690958123.0,20820.199069580285,-7.5,9
09:13,618138606.0,1368.6105215212997,-5.35,9
09:13,151278285.0,1641.0272499999996,-87.68,5
09:14,214339619.0,303.9866785105091,-6.5,9
09:14,540159353.0,11090.384196122264,-6.1,9
09:14,138609932.0,2203.030003294586,-6.5,9
09:15,642015139.0,-172.2336625343617,-33.95,7
09:15,143003091.0,10413.855482882138,-3.7,5
09:16,933745726.0,-138.57394357067673,-100.34,5
09:17,364357875.0,7709.658153842708,-18.62,2
09:18,551755686.0,6944.957926654151,-12.99,2
09:18,355733816.0,5432.627023100917,-4.99,7
09:20,586315521.0,12425.907741093732,-6.0,9
09:21,933491926.0,3266.3212700000045,-6.02,7
09:21,417850087.0,15464.052468708034,-5.95,9
09:22,134461671.0,5283.142289979489,-28.97,5
09:23,215404070.0,171.70458917984965,-37.99,2
09:24,165045150.0,481.3535614028557,-51.02,5
09:25,399144202.0,1326.1920779873683,-51.88,7
09:28,441274121.0,12365.15704732795,-5.0,9
09:30,520418719.0,482.9363500000036,-158.72,5
09:31,849096144.0,1148.939020751343,-39.98,4
09:31,656389634.0,-366.4493404219855,-13.55,5
09:33,490790931.0,248.47894999999855,-72.34,5
09:36,556992209.0,12222.261639219349,-62.29,2
09:39,475117511.0,6897.6369219936505,-5.99,4
09:39,986774156.0,1550.5169316257693,-28.0,2
09:39,551755686.0,6922.987926654151,-21.97,4
09:40,322221939.0,3323.05845406716,-56.41,5
09:41,120634201.0,4993.991199685603,-12.07,4
09:41,254853117.0,2808.2208531148235,-301.6,5
09:43,766941757.0,2422.6545636721053,-63.32,4
09:48,340321732.0,1647.105550000004,-85.97,2
09:52,609939116.0,7487.378128380764,-42.0,2
09:55,480557476.0,11192.54530850013,-58.65,2
09:57,547010927.0,24298.652004388507,-6.25,7
09:57,815993333.0,6025.449511009047,-28.55,8
09:59,370521542.0,27234.821890817344,-39.08,2
09:59,461029994.0,7819.551410314173,-21.98,4
10:01,779376323.0,3449.9458339813405,-5.99,6
10:02,727417797.0,5650.854838831692,-9.99,1
10:08,106601471.0,11190.78848993868,-114.1,2
10:09,903953091.0,3120.0697901345734,-5.2,9
10:11,670102069.0,1113.0578380508962,-106.39,2
10:13,984783496.0,14322.210117845176,-21.54,4
10:14,285873880.0,12792.202198911547,-45.13,5
10:14,572384506.0,7006.259265449724,-59.92,4
10:14,834383043.0,5198.360579814327,-99.99,2
10:16,198946608.0,4177.174052493314,-27.68,7
10:17,609939116.0,7434.878128380764,-52.5,2
10:20,340321732.0,1538.0987500000035,-109.01,5
10:23,391688371.0,175.70524120504476,-26.86,5
10:25,575652395.0,1974.5654101272671,-194.6,2
10:30,844206657.0,1016.4267551465696,-55.98,2
10:31,986774156.0,1527.5569316257693,-22.96,7
10:33,248658670.0,907.22665,-145.6,2
10:34,221356538.0,853.4120999999997,-15.98,2
10:44,145387690.0,4799.776469634089,-23.71,2
10:45,248658670.0,837.22665,-70.0,2
10:48,127809299.0,1157.8623467244631,-78.0,2
10:53,211493028.0,973.7114499999992,-29.98,6
10:55,575652395.0,1700.865410127267,-273.7,2
10:57,955035930.0,2133.098479171478,-150.38,2
11:04,766941757.0,2346.4745636721054,-76.18,2
11:15,700138124.0,4229.057574909071,-9.8,4
11:17,127809299.0,1116.9873467244631,-40.88,2
11:27,955035930.0,1968.8484791714784,-164.25,2
11:36,886921642.0,3086.163730086657,-39.3,7
11:36,556992209.0,12126.375639219346,-95.89,2
11:37,955035930.0,1917.0984791714784,-51.75,2
11:39,348325817.0,9994.7549969293,-299.6,2
11:46,709608057.0,2331.3835328588984,-40.27,7
11:58,248658670.0,676.22665,-161.0,2
12:01,673025413.0,698.5779223629174,-28.19,9
12:02,904154012.0,401.1774581204316,-14.98,7
12:05,145387690.0,4767.576469634089,-32.2,9
12:07,987656636.0,4089.133016522599,-70.61,2
12:08,348325817.0,9861.7549969293,-133.0,2
12:09,127809299.0,1079.940196724463,-37.05,5
12:12,414454079.0,38.608850000001496,-35.63,9
12:17,670102069.0,1064.0578380508962,-49.0,2
12:19,857997794.0,673.5036651508866,-9.99,4
12:20,549414742.0,7099.269710393999,-33.88,9
12:24,570323670.0,3363.68301907084,-12.67,7
12:25,248658670.0,517.32665,-158.9,2
12:27,901432314.0,3351.5407201877315,-25.0,5
12:27,128033695.0,1885.418684600411,-3.38,4
12:34,613427466.0,6716.086455264377,-27.94,9
12:37,348325817.0,9728.7549969293,-133.0,2
12:38,812839908.0,-1796.5998500000003,-40.04,5
12:41,555804115.0,-1466.6060475587033,-20.48,5
12:44,282046994.0,-576.6076499999997,-35.24,9
12:46,655730067.0,-311.5818500000005,-44.41,5
12:47,245198540.0,85.4313988017795,-27.87,5
12:51,753525749.0,-2458.803399999999,-42.12,5
12:51,213096759.0,-1489.439108214439,-29.98,5
12:53,670102069.0,926.9138380508962,-137.14,2
12:54,248658670.0,379.42665,-137.9,2
12:57,910730524.0,7848.07205836806,-5.0,9
12:59,524425303.0,-1030.5796000000012,-88.63,5
13:04,766941757.0,2307.4845636721057,-38.99,9
13:07,688712152.0,6795.0307181372,-7.8,9
13:12,127809299.0,944.940196724463,-135.0,2
13:15,252419513.0,-2334.238685813415,-39.54,5
13:22,237684254.0,5807.444936486651,-144.19,2
13:23,849096144.0,1143.439020751343,-5.5,9
13:25,874506295.0,-1546.9242562455722,-36.95,5
13:25,955035930.0,1736.7234791714782,-180.38,2
13:28,218795010.0,-661.0995000000006,-107.83,5
13:28,706361191.0,170.97064849407792,-39.48,5
13:35,248658670.0,303.12665,-76.3,2
13:37,358836279.0,93.86849280758572,-101.41,5
13:42,348325817.0,9401.1549969293,-327.6,2
13:43,455052690.0,-201.4052600513724,-129.42,5
13:44,987656636.0,3966.0430165225994,-123.09,2
13:49,127809299.0,836.565196724463,-108.38,2
13:53,120634201.0,4971.008433437469,-22.98,2
13:58,106601471.0,10953.48848993868,-237.3,2
13:59,520447032.0,7938.26549129172,-10.24,7
14:01,472213568.0,-674.1660442060534,-114.99,5
14:02,348325817.0,9220.5549969293,-180.6,2
14:02,248658670.0,123.22665,-179.9,2
14:05,575652395.0,1571.365410127267,-129.5,2
14:13,556992209.0,11926.203639219346,-200.17,2
14:14,127809299.0,734.190196724463,-102.38,2
14:15,106601471.0,10869.48848993868,-84.0,2
14:20,670102069.0,875.1558380508961,-51.76,2
14:26,583558311.0,-851.2752152486677,-81.61,5
14:30,248658670.0,-130.17334999999997,-253.4,2
14:33,233981231.0,2145.5502892297586,-29.99,2
14:37,305778936.0,10357.71522517954,-52.74,2
14:43,556992209.0,11780.631639219346,-145.57,2
14:48,738958551.0,8872.23834371225,-69.18,5
14:50,812692024.0,3645.621091898718,-16.49,4
14:56,670102069.0,736.5558380508961,-138.6,2
15:07,108481285.0,8943.839436828153,-2.59,7
15:16,556992209.0,11595.173639219343,-185.46,2
15:22,955035930.0,1620.4734791714782,-116.25,2
15:36,668175891.0,433.6330231584989,-144.98,2
15:46,556992209.0,11320.787639219345,-274.39,2
15:46,829914501.0,1358.9638065709744,-74.19,7
15:53,670102069.0,508.3838380508961,-228.17,2
16:06,955035930.0,1483.5984791714782,-136.88,2
16:15,556992209.0,11179.429639219345,-141.36,2
16:18,183186021.0,-185.48504999999884,-19.71,5
16:24,492215823.0,2442.091943815444,-10.28,1
16:28,286484726.0,588.3374891525708,-22.0,2
16:30,829914501.0,1246.2918065709744,-112.67,2
16:35,670102069.0,365.6258380508961,-142.76,2
16:37,679911053.0,2360.670573006402,-70.48,5
16:44,348325817.0,9003.554996929299,-217.0,2
16:45,769319491.0,-141.5605000000008,-15.98,1
16:47,670102069.0,234.0258380508961,-131.6,2
16:48,556992209.0,11008.657639219344,-170.77,2
16:48,807714284.0,1146.9685607359995,-191.96,2
16:49,517934629.0,447.1276787084264,-79.98,2
16:54,248658670.0,-457.07334999999995,-326.9,2
16:57,256002321.0,6077.512575345056,-6.99,9
16:58,785210466.0,1947.773419997712,-124.99,2
16:59,812692024.0,3632.619590521821,-13.0,5
17:02,556992209.0,10864.485639219343,-144.17,2
17:02,106601471.0,10632.88848993868,-236.6,2
17:03,829914501.0,1161.6338065709745,-84.66,2
17:04,670102069.0,101.73983805089613,-132.29,2
17:15,874431242.0,8974.171277513533,-34.95,9
17:15,130154096.0,626.2811481961066,-8.98,4
17:15,556992209.0,10718.927639219342,-145.56,2
17:16,807714284.0,1073.4785607359995,-73.49,2
17:16,433917275.0,7568.873852546029,-32.17,9
17:22,990461108.0,399.04651862061104,-32.95,7
17:22,352899149.0,322.6750499999987,-48.92,1
17:22,575652395.0,1301.165410127267,-270.2,2
17:22,141521177.0,6450.715900000016,-50.0,2
17:22,730002588.0,13692.43040889276,-57.8,5
17:22,873693307.0,10267.239532624208,-51.5,2
17:22,905860285.0,10523.61059998216,-26.42,2
17:22,653640811.0,17699.447284626258,-6.0,1
17:23,873693307.0,10245.789532624209,-21.45,9
17:27,670102069.0,18.45383805089611,-83.29,2
17:28,556992209.0,10716.935649219342,-1.99,4
17:28,807714284.0,980.4985607359996,-92.98,2
17:29,315546581.0,29570.96203304774,-20.19,4
17:29,992204045.0,7130.022230041156,-62.96,2
17:30,373163757.0,11377.00769792349,-23.99,4
17:32,829914501.0,1017.4478065709744,-144.19,2
17:32,633345190.0,5736.772622204951,-44.9,4
17:34,196289502.0,16119.026137017992,-8.17,4
17:35,832564361.0,15598.972416993303,-42.39,5
17:35,939972497.0,818.1991086000105,-26.96,7
17:35,532478725.0,4269.546084656701,-5.64,2
17:37,736340277.0,8712.968661515526,-37.03,1
17:37,237493332.0,14749.338409061314,-20.2,9
17:37,229205098.0,7411.86407773269,-68.6,2
17:37,496395938.0,12323.842799212249,-48.36,5
17:38,822135975.0,11352.485677699013,-27.49,2
17:38,639409800.0,36665.95454620595,-3.58,7
17:40,616924659.0,-697.3279201769147,-25.1,5
17:41,897592348.0,15738.78632329499,-3.89,2
17:41,248658670.0,-738.47335,-281.4,2
17:42,705848712.0,27732.69748179943,-61.17,5
17:42,203466392.0,681.0796960955241,-52.46,5
17:43,456221621.0,55.78716730262797,-96.61,5
17:43,583579399.0,-114.10389999999916,-120.78,5
17:45,815385232.0,10349.161356100083,-5.58,7
17:46,829914501.0,919.4618065709744,-97.99,2
17:47,355602925.0,1418.6402265753277,-37.99,2
17:47,575652395.0,1190.5654101272671,-110.6,2
17:48,624500124.0,3071.1531062306185,-19.18,5
17:50,531186970.0,4880.272253959389,-114.07,5
17:50,678330503.0,919.6074802961772,-2.96,5
17:52,948558249.0,8203.015956046183,-12.98,7
17:53,482513594.0,5423.030685677241,-15.39,5
17:53,990461108.0,165.04651862061104,-234.0,2
17:54,846550094.0,1738.4492671741446,-11.65,2
17:55,698076160.0,6454.396697588815,-45.93,1
17:57,807714284.0,868.5085607359997,-111.99,2
17:58,280268430.0,5013.558692483257,-96.6,2
17:58,213112754.0,5470.882628757543,-78.79,2
17:58,373163757.0,11357.01769792349,-19.99,7
17:59,678851253.0,3340.9648900110215,-13.05,2
18:00,587225252.0,5403.284573655331,-51.13,2
18:00,166019891.0,8248.978648513625,-19.98,9
18:02,225210798.0,903.4369351225794,-31.48,5
18:02,835736339.0,2073.877599690938,-31.29,2
18:07,785210466.0,1855.152219997712,-92.62,5
18:10,687135796.0,28935.81758935726,-19.45,9
18:13,248658670.0,-972.97335,-234.5,2
18:14,807714284.0,801.0285607359997,-67.48,2
18:14,449871732.0,7778.538783966988,-107.2,5
18:15,180616589.0,933.3548282361096,-27.68,5
18:16,683319988.0,6670.952545811045,-28.62,9
18:19,487051121.0,1111.582270870394,-58.99,5
18:21,986267641.0,4083.1604105436218,-9.52,5
18:26,990461108.0,68.04651862061104,-97.0,2
18:26,346874167.0,-27.07035000000098,-35.9,9
18:31,280268430.0,4961.058692483257,-52.5,2
18:38,348325817.0,8985.980713977864,-17.57,8
18:38,380911501.0,-243.29870000000085,-35.91,5
18:38,108812033.0,504.06559999999826,-78.68,5
18:43,158414827.0,-1540.005000000002,-12.92,5
18:46,965038148.0,-38.61751436767224,-26.68,5
18:48,113747882.0,11978.89917447141,-20.81,2
18:50,534325901.0,6798.386005278434,-15.98,5
18:51,678851253.0,3336.9116107282453,-4.05,7
18:51,541639148.0,4062.7598350526096,-12.28,7
18:52,489964679.0,20466.2938924153,-35.3,9
18:54,973086490.0,10252.864400784558,-15.2,9
18:54,261894284.0,-2627.8287999999966,-16.63,5
18:54,480198977.0,12341.533032593252,-49.99,7
18:54,909676212.0,25.43253178761312,-6.99,9
18:55,527842638.0,139.0662426329834,-77.73,5
18:55,516051449.0,869.4797746508287,-119.34,5
18:56,534325901.0,6777.446005278434,-20.94,9
18:57,699313649.0,-2399.2633991419048,-63.77,5
19:02,570575024.0,-1131.479650000001,-44.03,5
19:04,280268430.0,4863.058692483257,-98.0,2
19:07,585133606.0,4878.564459392841,-253.11,5
19:07,893134725.0,986.0673376616674,-31.65,5
19:10,605116158.0,2412.1659000000036,-36.27,5
19:14,444371478.0,625.6662499999986,-43.03,5
19:18,796709231.0,-264.3276721037025,-48.02,5
19:19,817294757.0,-2567.7733,-50.57,5
19:20,352291960.0,1743.1280533035738,-84.36,5
19:21,762859681.0,1535.078599999999,-134.69,5
19:23,806358207.0,11321.43369858183,-12.08,2
19:24,706250160.0,12597.19121747887,-6.92,5
19:26,901432314.0,3333.2007201877313,-18.34,9
19:27,709608057.0,2322.0679384695286,-9.32,8
19:28,216286013.0,-131.31739334606013,-149.05,5
19:30,280268430.0,4793.058692483257,-70.0,2
19:30,999752672.0,913.7680435333348,-88.9,5
19:32,977899503.0,-748.5871064191473,-49.78,5
19:33,213930646.0,-1883.147063472563,-43.37,5
19:36,851181128.0,4510.069788170413,-38.39,9
19:37,786141370.0,-274.4318000000008,-48.77,5
19:38,213112754.0,5443.748244100596,-27.13,5
19:40,441274121.0,12357.278476424675,-7.88,5
19:42,373163757.0,11284.210169301214,-72.81,2
19:45,280268430.0,4667.058692483257,-126.0,2
19:46,383833857.0,25928.099002947893,-107.7,5
19:51,623156843.0,4487.950310366453,-13.89,8
19:58,819515373.0,2256.2878360637933,-65.56,5
19:58,199016328.0,4647.84903309074,-6.47,2
20:05,903953091.0,3066.1627901345732,-53.91,5
20:06,556992209.0,10683.92364921934,-33.01,5
20:07,641764023.0,-1167.8063037720044,-37.99,5
20:07,851181128.0,4496.047873717596,-14.02,8
20:13,785749304.0,8479.681448505,-7.69,5
20:15,165691047.0,-20.556700000001097,-74.36,5
20:19,412823730.0,45.10031585048972,-159.04,5
20:19,754141345.0,-3210.86283511576,-46.72,5
20:21,170637730.0,952.597015321238,-35.49,5
20:23,386729293.0,31550.82417520374,-83.58,5
20:29,681955876.0,-1561.4881000000005,-100.0,5
20:31,624500124.0,3059.9131062306187,-11.24,9
20:32,709632525.0,-1646.8323500000006,-66.42,5
20:34,836110591.0,2892.465695744881,-44.18,5
20:34,409971170.0,2603.7831899378184,-18.85,7
20:36,624563756.0,-539.4897712164436,-15.41,5
20:43,575652395.0,1175.7822366839414,-14.78,2
20:49,252701364.0,-4030.0611726779143,-60.56,5
20:56,660561861.0,319.02583163368945,-25.81,5
20:57,741269136.0,2489.055950000002,-97.23,5
20:57,433917275.0,7552.519693476074,-16.35,2
21:02,408057540.0,4715.950518572676,-46.49,5
21:03,282837512.0,13847.097580345133,-35.64,9
21:09,994214354.0,9889.4509289601,-51.28,5
21:15,668329719.0,8914.465888298704,-5.5,2
21:17,472995101.0,1105.904684099084,-0.3,2
21:43,310375875.0,1305.7196622627755,-3.49,2
02:19,113747882.0,11951.619174471409,-27.28,9
02:25,534325901.0,6765.466005278435,-11.98,9
02:27,918160369.0,-952.3736500000005,-36.09,9
02:37,383833857.0,25927.473832469568,-0.63,8
02:37,290818242.0,6987.153289012635,-1.35,2
02:41,779236304.0,1793.9875954795336,-27.53,9
02:50,147474476.0,2833.601537310334,-19.45,9
02:53,496395938.0,12318.579928616731,-5.26,2
03:02,575652395.0,1173.7867429162436,-2.0,2
03:02,700138124.0,4212.33153240676,-16.73,2
03:13,518474507.0,13551.26362991409,-26.35,9
03:18,519644021.0,2564.3639198096344,-7.12,7
03:23,461990622.0,7139.802951995812,-15.36,4
03:26,187111705.0,6803.251315959779,-61.8,2
03:30,718058208.0,1889.0564609790672,-10.77,5
03:36,779946617.0,16990.696366986394,-7.72,8
03:37,252760664.0,6681.473395889097,-11.04,5
03:39,547010927.0,24266.672004388507,-31.98,9
03:39,534325901.0,6760.98034762476,-4.49,5
03:40,187541224.0,1296.6322783028452,-31.2,9
03:42,113747882.0,11945.692736640543,-5.93,4
03:44,984783496.0,14307.010117845177,-15.2,9
03:44,749378808.0,1478.927608825056,-15.71,2
03:46,221868392.0,4613.487419998163,-32.14,9
03:48,873693307.0,10224.181218736836,-21.61,2
03:49,996042490.0,5870.903889366386,-16.45,4
03:53,506618547.0,14540.59514898927,-17.45,9
03:53,738958551.0,8841.28834371225,-30.95,9
03:54,143061865.0,6665.7965636042445,-27.61,5
03:55,414805878.0,12823.792686314546,-27.24,9
03:55,767447966.0,4803.039062706573,-38.04,9
03:55,554792076.0,29113.25908690415,-21.84,7
03:59,647472692.0,26459.424584613054,-23.55,9
04:00,809499628.0,17772.40506507589,-20.6,9
04:01,940569402.0,4133.942735019805,-14.45,9
04:03,120634201.0,4948.408433437468,-22.6,9
04:06,147474476.0,2822.781030555134,-10.82,2
04:10,730002588.0,13665.84453136924,-26.59,7
04:19,482513594.0,5397.320149662191,-25.71,7
04:20,480557476.0,11188.532315717908,-4.01,2
04:20,752362502.0,5938.024792957158,-14.27,5
04:22,719586818.0,18849.606684615064,-30.29,5
04:22,143003091.0,10383.162401271646,-30.69,5
04:32,511179916.0,7188.6438950360825,-44.58,2
04:33,973086490.0,10245.364400784558,-7.5,9
04:33,885259672.0,2861.215285963419,-33.21,2
04:36,986267641.0,4077.324575476885,-5.84,7
04:37,547010927.0,24248.144189959057,-18.53,7
04:38,949032480.0,3356.789865792496,-25.94,9
04:40,370521542.0,27220.332815642636,-14.49,2
04:41,348325817.0,8949.330713977864,-36.65,9
04:42,912705941.0,19074.8404737734,-14.97,7
04:45,259015404.0,766.0466088179295,-15.04,9
04:48,196289502.0,16101.876137017993,-17.15,9
04:49,383625050.0,2715.8640110714105,-16.89,5
04:53,678330503.0,863.6649460326629,-55.94,8
04:53,108931112.0,14384.750726981689,-37.79,9
04:54,216285378.0,24504.11459876362,-45.94,9
04:54,117308635.0,2205.003170706712,-19.08,9
04:55,951817450.0,9163.856665881603,-36.45,2
04:56,169006407.0,11617.243664807722,-6.43,7
04:57,678851253.0,3262.0355239249693,-74.88,2
05:00,795847804.0,24031.16846732532,-19.62,2
05:03,270374623.0,9494.830265312712,-44.83,2
05:03,264550521.0,5251.244417473195,-5.14,2
05:11,558119802.0,33925.765108127496,-1.18,7
05:12,687135796.0,28924.02795526996,-11.79,7
05:19,489964679.0,20414.7638924153,-51.53,9
05:22,994947671.0,1084.7557000000004,-28.33,9
05:23,690958123.0,20815.363195105016,-4.84,2
05:24,237684254.0,5800.969341777579,-6.48,2
05:25,867987292.0,1666.6322844552549,-27.35,7
05:27,282837512.0,13827.990252725258,-19.11,8
05:29,221868392.0,4557.9570815469015,-55.53,2
05:34,842682241.0,3477.9529151629663,-25.67,7
05:40,930277104.0,9463.492850636436,-0.39,7
05:41,809499628.0,17693.777072881843,-78.63,5
05:42,310375875.0,1273.2296622627755,-32.49,9
05:44,510101371.0,12439.990398193568,-33.78,9
05:44,633345190.0,5702.582622204952,-34.19,9
05:45,657139925.0,13504.899445543835,-14.9,9
05:47,572384506.0,6965.869265449724,-40.39,9
05:48,758160963.0,7196.921221723136,-6.44,2
05:51,601627384.0,3111.589435618333,-37.47,9
05:54,433917275.0,7540.319462863495,-12.2,5
05:55,550169791.0,22374.293543740467,-29.3,7
05:55,673025413.0,695.21292658072,-3.36,7
05:55,987163717.0,3726.520223888187,-39.93,9
05:56,259015404.0,764.1493859036228,-1.9,7
06:00,146909202.0,3196.808738739441,-15.58,5
06:00,659415300.0,1635.1128805359594,-35.13,9
06:02,287480331.0,7320.821903381768,-38.14,9
06:13,310375875.0,1270.3339433474505,-2.9,7
06:15,859603181.0,2895.9305991757924,-26.87,2
06:15,435984758.0,4010.627759009483,-11.29,7
06:16,987656636.0,3963.6710277625416,-2.37,2
06:16,108563213.0,23162.76273508981,-33.75,7
06:16,581655972.0,41525.80837385072,-65.1,7
06:20,305778936.0,10346.134948470062,-11.58,5
06:22,785210466.0,1835.452219997712,-19.7,9
06:29,256002321.0,6065.572575345056,-11.94,9
06:31,322221939.0,3318.127160338014,-4.93,5
06:31,532478725.0,4242.216084656701,-27.33,9
06:33,421881811.0,2134.6948774121133,-11.98,5
06:33,651756497.0,14418.642469844404,-4.76,7
06:35,399144202.0,1297.8920779873686,-28.3,9
06:43,667367404.0,9175.61259315385,-23.13,4
06:44,572384506.0,6953.461847441927,-12.41,2
06:44,709608057.0,2280.5379384695284,-41.53,9
06:44,985188462.0,-153.1936112887752,-31.83,9
06:48,364357875.0,7659.789336135645,-49.87,4
06:49,366550080.0,25707.60737837374,-4.48,2
06:50,613729471.0,7836.111226312143,-26.02,7
06:50,183888402.0,19180.802457140137,-32.03,9
06:51,949032480.0,3332.594526251796,-24.2,8
06:52,179173981.0,4491.3897739900885,-22.45,7
06:52,766941757.0,2266.6445636721055,-40.84,9
06:54,473820682.0,11321.731907591167,-17.4,5
06:56,905860285.0,10501.563326217762,-22.05,5
06:57,822135975.0,11278.605652910732,-73.88,7
06:58,285220959.0,12158.035763088885,-4.52,7
06:59,832564361.0,15576.34780665592,-22.62,5
07:00,587225252.0,5373.854573655331,-29.43,9
07:00,873701090.0,131.5880236924864,-29.6,5
07:05,910730524.0,7808.644167620731,-39.43,7
07:06,604288474.0,1359.2739176427394,-22.08,7
07:08,417850087.0,15449.348429355236,-14.7,7
07:10,960208650.0,14512.698975439129,-32.88,5
07:12,522188082.0,6850.758406578212,-32.68,7
07:16,264208990.0,571.2568999999985,-36.94,9
07:16,994214354.0,9857.0909289601,-32.36,9
07:16,899742927.0,12983.007680941728,-5.83,5
07:17,853907490.0,7592.516965900553,-23.53,5
07:18,145387690.0,4742.575716095913,-25.0,5
07:18,399144202.0,1273.425429583795,-24.47,2
07:20,506618547.0,14504.331280283624,-36.26,5
07:20,858989281.0,27063.14552406214,-1.11,5
07:26,897714622.0,9351.704653708824,-7.22,2
07:27,134461671.0,5224.37528518403,-58.77,5
07:29,549414742.0,7078.0081236665255,-21.26,7
07:30,887853850.0,10238.461766621558,-4.16,7
07:31,392270893.0,13300.370842434462,-21.45,5
07:37,324224854.0,4181.835629485641,-29.91,5
07:39,706250160.0,12569.847402344218,-27.34,5
07:40,541639148.0,4020.871130292558,-41.89,2
07:41,806358207.0,11291.868762419535,-29.56,7
07:44,815993333.0,6006.68424578926,-18.77,2
07:45,492215823.0,2411.801943815444,-30.29,9
07:46,532478725.0,4220.556341081781,-21.66,2
07:46,639549973.0,4948.277011338312,-11.86,4
07:47,151968462.0,6753.211027037544,-34.26,8
07:49,639409800.0,36657.376911358784,-8.58,2
07:51,587225252.0,5365.959504829651,-7.9,2
07:54,705848712.0,27716.507481799435,-16.19,9
07:56,200080192.0,9500.002809974188,-7.91,5
07:57,315078351.0,8165.352334272875,-11.89,8
07:59,675806859.0,7274.777012174984,-4.92,2
08:08,395284483.0,1142.914340211308,-7.15,9
08:08,824916823.0,8233.365128432251,-36.38,9
08:08,764450279.0,21427.15226821457,-21.83,5
08:09,399538448.0,7491.475926398817,-6.1,9
08:09,836110591.0,2863.681215148597,-28.78,2
08:15,500043411.0,13678.1189209146,-49.95,2
08:17,919185264.0,3944.081604367725,-24.95,7
08:18,992204045.0,7062.1163260758085,-67.91,7
08:19,237493332.0,14737.47039562168,-11.87,7
08:19,120634201.0,4922.226893137191,-26.18,2
08:20,885259672.0,2853.615285963419,-7.6,9
08:21,987390838.0,-3093.1337412103776,-17.32,5
08:21,874431242.0,8922.578555264168,-51.59,2
08:23,948558249.0,8197.665956046183,-5.35,9
08:28,149684419.0,272.9325499999979,-19.91,5
08:29,901432314.0,3327.0507201877313,-6.15,9
08:31,449387287.0,72.71769383510139,-93.62,5
08:32,954263768.0,-367.28820000000024,-60.08,5
08:32,482513594.0,5347.970149662191,-49.35,5
08:32,173317688.0,-2496.788734884284,-31.3,5
08:32,256002321.0,6045.54492751135,-20.03,2
08:33,821971408.0,968.8851102355432,-40.29,5
08:35,621652856.0,-256.09603038946,-157.96,5
08:36,331684336.0,-1627.2838699513215,-42.51,5
08:37,775790822.0,-3359.2734192160674,-44.35,5
08:39,890196840.0,-3123.03131667513,-42.33,5
08:40,815993333.0,5925.72924578926,-80.95,5
08:40,679662108.0,16441.288142331836,-1.58,5
08:41,213112754.0,5411.5826964097005,-32.17,7
08:41,868014990.0,-3609.208599999996,-36.42,5
08:44,782013626.0,638.8401993116287,-121.74,5
08:45,421881811.0,2086.4158774121133,-48.28,5
08:45,409370545.0,540.4042755455207,-82.17,5
08:46,960208650.0,14443.482975439128,-69.22,5
08:48,950234174.0,-104.20560434594094,-43.1,7
08:48,993663752.0,-632.7013575896036,-75.33,5
08:48,581655972.0,41449.69037385072,-76.12,5
08:48,336171116.0,-368.2657500000006,-164.65,5
08:49,683319988.0,6665.668081381764,-5.28,2
08:49,925659248.0,-861.4220892295712,-137.06,5
08:50,815385232.0,10345.256905116466,-3.9,2
08:52,993039226.0,-4508.666999999995,-52.43,5
08:52,331450202.0,7548.957751072179,-14.83,5
08:53,806358207.0,11254.992762419535,-36.88,5
08:54,822718326.0,11570.708797697163,-12.59,5
08:58,867679563.0,-96.38844629828418,-71.73,5
08:58,308897841.0,1152.0075999999988,-24.7,5
08:58,166019891.0,8214.162975464924,-34.82,4
08:58,761272540.0,-54.95915000000125,-38.48,5
09:01,824218857.0,-3881.668660845428,-93.34,5
09:03,558875206.0,3050.16053939978,-5.9,9
09:04,506618547.0,14497.881280283622,-6.45,9
09:06,575652395.0,936.7387429162436,-237.05,5
09:06,214339619.0,298.0866785105091,-5.9,9
09:06,683078800.0,1573.78944157638,-7.3,9
09:06,581655972.0,41444.44037385072,-5.25,9
09:07,131388684.0,21898.08537015158,-5.95,9
09:07,169006407.0,11610.743664807722,-6.5,9
09:10,441274121.0,12301.70440255932,-5.5,9
09:10,124102251.0,1727.0644806529046,-5.4,9
09:11,586315521.0,12419.407741093732,-6.5,9
09:12,970298834.0,2188.1176638483425,-21.03,2
09:12,659415300.0,1503.9615805359597,-131.15,5
09:13,383833857.0,25922.17383246957,-5.3,9
09:13,613729471.0,7830.311226312143,-5.8,9
09:13,828750680.0,906.23239521368,-57.97,4
09:15,999752672.0,908.1680435333348,-5.6,9
09:17,718058208.0,1881.5239309790672,-7.53,4
09:18,690958123.0,20807.863195105016,-7.5,9
09:18,417850087.0,15442.198429355236,-7.15,9
09:19,117273481.0,8986.796118264998,-5.05,9
09:19,992204045.0,6977.717326075808,-84.4,5
09:19,324046160.0,-935.0848832130712,-138.25,5
09:20,865748375.0,2131.882247066176,-8.77,2
09:21,776431321.0,2993.269004870256,-34.95,7
09:22,575652395.0,904.5725329162436,-32.17,4
09:22,403383649.0,685.0111252948917,-16.99,1
09:22,618138606.0,1363.1105215212997,-5.5,9
09:23,259015404.0,729.7793859036228,-34.37,7
09:23,540159353.0,11084.584196122263,-5.8,9
09:23,992204045.0,6972.967326075808,-4.75,9
09:27,762859681.0,1503.088599999999,-31.99,7
09:27,403902116.0,262.5331999999992,-182.38,5
09:27,310171581.0,-2290.146204340919,-24.43,5
09:28,601627384.0,3050.8951489673555,-60.69,5
09:30,822250278.0,6322.309303628213,-34.33,7
09:30,903953091.0,3061.1727901345735,-4.99,7
09:32,258201793.0,-683.7248000000002,-113.49,5
09:35,461029994.0,7809.382239540952,-10.17,5
09:36,588565416.0,5748.633389475904,-46.97,4
09:37,225210798.0,882.4569351225794,-20.98,4
09:40,195895574.0,7281.128370476063,-8.39,5
09:43,534204159.0,5497.624620473015,-224.0,2
09:44,280990953.0,866.3096999999983,-16.98,4
09:45,762859681.0,1486.568599999999,-16.52,4
09:46,903953091.0,2981.1927901345734,-79.98,2
09:46,987656636.0,3921.3410277625417,-42.33,7
09:48,187111705.0,6790.091315959779,-13.16,7
09:48,514362267.0,-32.93268089293971,-17.97,4
09:49,348525881.0,884.4716245949359,-15.98,7
09:54,237684254.0,5740.799341777579,-60.17,2
09:54,766941757.0,2201.1345636721053,-65.51,7
09:58,815993333.0,5911.67924578926,-14.05,1
10:01,711045550.0,2091.9943500000036,-81.54,5
10:03,941285623.0,668.1913990667704,-31.95,7
10:08,245198540.0,55.461398801779495,-29.97,1
10:11,472995101.0,1088.4246840990838,-17.48,4
10:11,593378953.0,355.8396500000049,-89.0,2
10:12,308505160.0,13360.833306683087,-0.66,8
10:13,609939116.0,7131.197128380763,-303.68,5
10:19,534204159.0,5330.324620473015,-167.3,2
10:20,287480331.0,7315.721903381767,-5.1,9
10:20,973086490.0,10221.550651307396,-23.81,2
10:20,534204159.0,5304.499948822642,-25.82,5
10:24,570269025.0,3202.0930363986845,-18.71,7
10:28,520447032.0,7926.330054575379,-11.94,5
10:32,548907062.0,440.8665387682884,-10.97,4
10:33,364357875.0,7652.6193361356445,-7.17,7
10:45,687135796.0,28908.27795526996,-15.75,4
10:52,280990953.0,814.3196999999983,-51.99,2
10:53,661295096.0,3282.269311666083,-18.0,4
11:02,593378953.0,260.8396500000049,-95.0,2
11:32,333054026.0,94.97089402319013,-10.04,2
11:41,280990953.0,796.3496999999983,-17.97,1
11:49,145387690.0,4475.105716095913,-267.47,2
11:57,593378953.0,190.8396500000049,-70.0,2
12:08,618514666.0,21450.69747271649,-71.48,4
12:16,766941757.0,2184.9501487213447,-16.18,5
12:24,421881811.0,2022.3158774121137,-64.1,2
12:24,494789005.0,2432.0636956144413,-49.78,5
12:31,593378953.0,1.3396500000048943,-189.5,2
12:43,348325817.0,8943.473355608843,-5.86,2
12:51,496865819.0,-173.82843184268242,-30.07,5
12:54,549414742.0,6937.308123666526,-140.7,2
13:00,588565416.0,5733.286152284324,-15.35,2
13:04,570323670.0,3150.07301907084,-213.61,2
13:04,762785862.0,566.4448999999993,-136.94,5
13:06,225210798.0,809.6849351225794,-72.77,2
13:08,688712152.0,6788.1807181372,-6.85,9
13:11,345514953.0,-977.3953000000006,-45.06,5
13:17,604288474.0,1318.2959176427394,-40.98,5
13:21,749378808.0,1474.577608825056,-4.35,9
13:21,945054126.0,-510.5119,-55.08,5
13:22,187111705.0,6784.69131595978,-5.4,9
13:23,849096144.0,1137.089020751343,-6.35,9
13:30,549414742.0,6796.608123666526,-140.7,2
13:33,570323670.0,3148.57452687926,-1.5,7
13:41,448004226.0,1503.3423686648796,-29.99,2
13:46,299871610.0,147.31065305876675,-58.22,5
13:56,737537711.0,-558.3569663984644,-41.36,5
13:59,448004226.0,1481.3723686648796,-21.97,7
14:11,586041848.0,2030.1426999999992,-29.99,2
14:18,659008214.0,-3545.7351022904227,-25.48,5
14:29,490868147.0,-501.0842208786984,-100.88,5
14:44,147341222.0,-2077.7932253207955,-140.57,5
14:48,494789005.0,2430.031585614441,-2.03,4
14:53,854895960.0,3256.127780390718,-13.24,8
15:13,421881811.0,2020.7583374121136,-1.56,4
15:25,108481285.0,8905.36009502111,-38.48,8
16:03,409971170.0,2576.728488485479,-27.05,2
16:25,391559884.0,-201.35770000000068,-32.94,9
16:37,785210466.0,1829.462219997712,-5.99,1
16:44,618514666.0,21380.71747271649,-69.98,2
16:45,613427466.0,6527.100455264377,-188.99,2
16:47,151916463.0,-322.4924444008311,-89.98,5
16:50,286484726.0,442.2436391525708,-146.09,5
16:54,392270893.0,13163.618842434462,-136.75,5
17:01,452974357.0,-3050.4364499999942,-4.72,5
17:01,613427466.0,6364.742455264377,-162.36,2
17:02,376271050.0,1455.4802261784878,-58.99,2
17:03,519935524.0,-149.80967026248118,-35.14,5
17:04,738958551.0,8815.304327987082,-25.98,5
17:04,670102069.0,-11.97616194910389,-30.43,9
17:07,887853850.0,10211.021766621558,-27.44,9
17:10,433917275.0,7500.589462863495,-39.73,9
17:10,785749304.0,8451.769353416881,-27.91,2
17:15,851649498.0,8220.23474662872,-0.04,2
17:19,510101371.0,12396.960398193569,-43.03,4
17:20,807714284.0,695.0940607359996,-105.93,5
17:23,449871732.0,7678.558783966989,-99.98,2
17:25,534097839.0,-4393.583549999997,-14.61,5
17:25,858989281.0,26913.78552406214,-149.36,2
17:25,690523499.0,119.73120000000016,-15.98,4
17:27,795847804.0,23975.07846732532,-56.09,2
17:27,558875206.0,3043.1705393997804,-6.99,7
17:29,315546581.0,29539.778706111058,-31.18,5
17:29,124102251.0,1691.9524806529046,-35.11,5
17:30,419550103.0,19003.301968192445,-30.79,9
17:31,639409800.0,36653.82523135879,-3.55,4
17:31,466649401.0,134.93014355208746,-36.89,5
17:31,833499132.0,677.3519000000022,-31.96,7
17:32,143061865.0,6657.816563604245,-7.98,4
17:33,414805878.0,12801.711176314546,-22.08,4
17:36,564744955.0,-183.57994141115813,-93.05,5
17:37,316793091.0,479.39311005495085,-84.93,5
17:38,285428103.0,10106.449808161064,-88.0,2
17:40,147474476.0,2788.831030555134,-33.95,7
17:42,556992209.0,10671.91364921934,-12.01,7
17:42,237493332.0,14672.58039562168,-64.89,2
17:42,138609932.0,2195.070003294586,-7.96,4
17:43,510101371.0,12368.165111513385,-28.8,8
17:45,741269136.0,2373.195950000002,-115.86,2
17:46,540159353.0,10956.594196122263,-127.99,2
17:47,245690309.0,9732.791646699608,-3.59,7
17:48,187541224.0,1276.1622783028452,-20.47,7
17:50,414805878.0,12732.371176314546,-69.34,2
17:51,887853850.0,10193.121766621558,-17.9,7
17:56,971010829.0,174.03505644424513,-10.98,7
17:57,886921642.0,3031.0310202973715,-55.13,7
17:58,516051449.0,838.5297746508287,-30.95,7
17:58,851181128.0,4472.467873717596,-23.58,9
18:01,690958123.0,20654.248195105018,-153.62,5
18:03,713641917.0,939.1483729031096,-28.7,9
18:04,627936697.0,-311.39414999999985,-135.48,5
18:05,836110591.0,2824.891215148597,-38.79,9
18:08,873693307.0,10213.201218736836,-10.98,9
18:12,984783496.0,14287.126878571573,-19.88,8
18:12,496674181.0,-2187.5254723307226,-111.38,5
18:20,433917275.0,7325.589462863495,-175.0,2
18:21,450896297.0,13237.780104178008,-33.49,9
18:22,475117511.0,6866.436921993651,-31.2,9
18:22,270374623.0,9483.560265312712,-11.27,7
18:23,128033695.0,1853.49548919891,-31.92,2
18:24,518466565.0,732.9254499999993,-39.2,9
18:25,769311479.0,6153.858571719505,-15.44,7
18:27,503575533.0,8038.078122931,-23.06,7
18:31,609939116.0,7093.679267278395,-37.52,4
18:32,270374623.0,9470.560265312712,-13.0,9
18:34,256045540.0,-3761.9613999999992,-11.82,5
18:34,675231808.0,18368.798099424563,-1.5,7
18:34,344219145.0,8232.417242229134,-50.22,5
18:35,344219145.0,8219.757645759402,-12.66,2
18:40,660561861.0,242.24983163368944,-76.78,5
18:41,558119802.0,33902.5651081275,-23.2,9
18:42,220183538.0,252.0214499999993,-14.97,7
18:47,196289502.0,16098.376640824528,-3.5,8
18:48,858989281.0,26903.48552406214,-10.3,9
18:50,245690309.0,9698.393646699607,-34.4,5
18:51,426474982.0,-3941.17975,-16.72,5
18:52,690958123.0,20652.256205105015,-1.99,7
18:52,709151315.0,-288.8797816258401,-45.74,5
18:56,779620857.0,-943.873196385176,-55.38,5
18:57,433917275.0,7081.289462863495,-244.3,2
18:57,493855007.0,-2770.8666315743917,-14.07,5
18:58,383833857.0,25906.883832469568,-15.29,9
18:58,844835978.0,10297.016778489342,-40.63,5
18:58,124102251.0,1682.784954665083,-9.17,7
19:00,345582855.0,368.43955282054935,-18.61,5
19:00,890567652.0,124.96649967960062,-103.88,5
19:01,145553416.0,-2814.608149999998,-24.79,5
19:01,705848712.0,27714.05216906713,-2.46,2
19:04,235881534.0,12756.57768885062,-6.37,7
19:07,282837512.0,13795.310252725258,-32.68,9
19:07,683319988.0,6642.838081381764,-22.83,9
19:09,698955014.0,115.08163020319672,-86.86,5
19:11,551196328.0,4350.087890225607,-116.66,5
19:12,873701090.0,43.262023692486395,-88.33,5
19:13,195895574.0,7247.188370476063,-33.94,9
19:13,350921975.0,-330.2938289261258,-130.95,5
19:15,662610817.0,-1547.136831324928,-157.83,5
19:16,833899961.0,1132.1298457180096,-47.84,5
19:17,274818272.0,185.67612856713137,-63.02,5
19:20,815385232.0,10333.306905116466,-11.95,9
19:20,885259672.0,2796.327285963419,-57.29,5
19:23,837876918.0,-10.872791465420107,-50.11,5
19:24,500843551.0,115.20049999999964,-126.0,5
19:26,679911053.0,2360.5225207819535,-0.15,4
19:32,785749304.0,8397.827353416882,-53.94,5
19:38,340680761.0,-3304.488099999997,-23.68,5
19:38,871866387.0,144.86669999999913,-49.69,5
19:40,441274121.0,12220.96640255932,-80.74,5
19:41,624563756.0,-562.0731712164436,-22.58,5
19:41,478651121.0,-651.2891704015303,-105.83,5
19:42,675806859.0,7134.959012174984,-139.82,5
19:43,246753533.0,171.07889999999836,-25.91,5
19:45,807098817.0,-19.933850000000973,-120.96,5
19:45,802697323.0,16116.252927774627,-33.64,9
19:46,226703987.0,1329.6581365470745,-117.64,5
19:47,491392945.0,5425.03750000001,-31.21,5
19:47,703478110.0,1934.277749908584,-68.0,5
19:48,361955473.0,-92.33505475591562,-43.05,5
19:50,696333897.0,-23.429600000001187,-123.35,5
19:51,719586818.0,18733.812684615063,-115.79,5
19:59,628470485.0,311.1840299001231,-163.4,5
20:01,586315521.0,12393.707741093733,-25.7,9
20:04,229205098.0,7384.639954191267,-27.22,7
20:07,736340277.0,8684.576661515526,-28.39,5
20:10,705848712.0,27608.43616906713,-105.62,5
20:10,216285378.0,24463.22759876362,-40.89,5
20:10,500043411.0,13634.6209209146,-43.5,5
20:13,471897866.0,6837.708447836221,-29.05,5
20:16,106601471.0,10599.713646330993,-33.17,5
20:16,605116158.0,2394.9159000000036,-17.25,9
20:18,639420537.0,-1526.64395,-38.6,5
20:21,736340277.0,8671.386661515526,-13.19,9
20:22,680773155.0,253.0536833310914,-47.99,5
20:22,183186021.0,-235.69754999999884,-50.21,5
20:23,287480331.0,7307.957220199439,-7.76,5
20:24,409971170.0,2550.708488485479,-26.02,9
20:42,586315521.0,12381.792590557749,-11.92,2
20:45,668329719.0,8891.701888298705,-22.76,5
20:50,138969884.0,543.5651999999994,-99.33,5
20:54,531186970.0,4841.523941587625,-38.75,5
20:55,535744551.0,226.40281599562584,-67.17,5
20:56,200080192.0,9407.140809974188,-92.86,5
21:06,851181128.0,4469.8363893337955,-2.63,4
21:09,930277104.0,9430.712850636435,-32.78,9
21:14,520447032.0,7884.440054575379,-41.89,9
22:04,331450202.0,7534.757751072179,-14.2,9
00:43,815993333.0,5901.9923526036955,-9.69,7
01:12,687135796.0,28882.32323980937,-25.95,2
01:13,421881811.0,1996.6448048939733,-24.11,8
01:23,779946617.0,16963.296366986393,-27.4,9
01:33,547010927.0,24247.049090146367,-1.1,7
01:41,370521542.0,27207.79822716023,-12.53,5
01:58,687135796.0,28871.37323980937,-10.95,9
02:18,639549973.0,4938.898537487544,-9.38,8
02:18,120634201.0,4900.336893137191,-21.89,9
02:28,858989281.0,26892.53552406214,-10.95,9
02:33,987656636.0,3913.571901121321,-7.77,2
02:38,433917275.0,7053.249462863495,-28.04,9
02:39,885259672.0,2764.359207306309,-31.97,5
02:40,799453072.0,-434.99545000000114,-29.65,9
02:53,522188082.0,6835.285613634337,-15.47,5
02:56,667367404.0,9172.593270382364,-3.02,2
02:56,145387690.0,4442.5157160959125,-32.59,9
02:57,441274121.0,12209.02640255932,-11.94,9
02:59,806358207.0,11227.08293559839,-27.91,5
03:00,809499628.0,17679.077072881842,-14.7,9
03:02,719586818.0,18715.625848919208,-18.19,8
03:07,718058208.0,1866.6644922486607,-14.86,7
03:11,417850087.0,15406.018516041417,-36.18,5
03:13,120634201.0,4883.506349057869,-16.83,2
03:20,414805878.0,12699.471176314546,-32.9,9
03:26,558119802.0,33902.08902916487,-0.48,7
03:26,815385232.0,10326.799691580904,-6.51,7
03:30,738958551.0,8780.414327987082,-34.89,9
03:30,237684254.0,5730.983515470141,-9.82,2
03:31,108481285.0,8902.926215009802,-2.43,8
03:36,809499628.0,17678.82758009372,-0.25,2
03:36,709608057.0,2249.717938469528,-30.82,9
03:37,776431321.0,2978.6156022977384,-14.65,2
03:38,519644021.0,2558.579329902401,-5.78,2
03:42,145387690.0,4397.232372026211,-45.28,7
03:43,678851253.0,3260.321436915001,-1.71,4
03:47,473820682.0,11320.437417446545,-1.29,2
03:50,213112754.0,5390.6926964097,-20.89,9
03:52,348325817.0,8897.383355608843,-46.09,9
03:53,683319988.0,6617.138081381764,-25.7,9
03:54,196289502.0,16080.476640824529,-17.9,9
03:55,290751280.0,19.712246674825565,-34.09,9
03:59,433917275.0,7024.020519696212,-29.23,5
04:02,613729471.0,7810.611895647455,-19.7,5
04:04,609939116.0,7089.554639976606,-4.12,8
04:05,704517789.0,18297.747426869537,-23.87,2
04:08,736340277.0,8657.406661515526,-13.98,9
04:08,824916823.0,8212.125128432252,-21.24,9
04:15,842682241.0,3458.5629151629664,-19.39,9
04:20,187541224.0,1242.532278302845,-33.63,9
04:21,647936800.0,2234.5837927880684,-1.53,7
04:26,195895574.0,7228.680424629081,-18.51,2
04:27,383833857.0,25830.303378222532,-76.58,7
04:31,518474507.0,13512.81362991409,-38.45,9
04:33,675806859.0,7123.505465369945,-11.45,8
04:35,480557476.0,11161.744760205656,-26.79,8
04:35,858989281.0,26889.27867960559,-3.26,7
04:38,970298834.0,2165.6961720860477,-22.42,4
04:38,534325901.0,6744.64034762476,-16.34,9
04:41,166019891.0,8204.529244382647,-9.63,7
04:43,419550103.0,18985.130064815698,-18.17,5
04:44,738958551.0,8748.732835468994,-31.68,2
04:46,994214354.0,9830.4009289601,-26.69,9
04:46,124102251.0,1660.3983575802977,-22.39,5
04:47,554792076.0,29044.90667816206,-68.35,8
04:48,256002321.0,6031.7049275113495,-13.84,9
04:50,308505160.0,13307.740134515658,-53.09,5
04:50,108931112.0,14350.370726981688,-34.38,9
04:52,930277104.0,9423.75812518998,-6.95,7
04:54,802697323.0,16073.712927774626,-42.54,9
04:55,572384506.0,6917.421847441927,-36.04,9
04:55,587225252.0,5338.469504829652,-27.49,9
04:56,290818242.0,6976.385164321461,-10.77,7
05:01,824916823.0,8160.727018830212,-51.4,7
05:03,500043411.0,13629.965531290847,-4.66,5
05:05,237493332.0,14661.88039562168,-10.7,9
05:07,383625050.0,2713.8647732641343,-2.0,8
05:12,534325901.0,6681.406895165414,-63.23,5
05:15,285220959.0,12140.592585419308,-17.44,2
05:19,229205098.0,7342.969484657355,-41.67,5
05:22,532478725.0,4187.166341081781,-33.39,9
05:22,832564361.0,15566.150209655863,-10.2,8
05:24,705848712.0,27589.24616906713,-19.19,9
05:26,992204045.0,6969.641091137284,-3.33,8
05:28,899742927.0,12975.837568498562,-7.17,4
05:28,113747882.0,11910.462736640544,-35.23,9
05:32,169006407.0,11593.429231126507,-17.31,5
05:38,853907490.0,7585.5269659005535,-6.99,9
05:39,901037631.0,-174.77867690359358,-41.46,9
05:39,581655972.0,41388.15562373714,-56.28,7
05:40,679911053.0,2285.6116899750223,-74.91,2
05:42,549414742.0,6768.0081236665255,-28.6,9
05:43,510101371.0,12339.385111513382,-28.78,9
05:45,651756497.0,14418.579071305216,-0.06,5
05:46,435984758.0,3995.935395427974,-14.69,7
05:47,550169791.0,22368.096086258865,-6.2,5
05:53,255814263.0,1434.8352534884616,-4.97,4
05:55,657139925.0,13491.159445543835,-13.74,9
05:57,752362502.0,5935.460676702758,-2.56,2
05:59,844835978.0,10287.793711405828,-9.22,7
06:00,482513594.0,5313.270865305085,-34.7,4
06:00,897714622.0,9347.209371058889,-4.5,8
06:00,456246119.0,21475.072712281093,-38.0,2
06:02,822135975.0,11276.99306154208,-1.61,2
06:06,766941757.0,2149.100148721345,-35.85,9
06:06,213112754.0,5379.37222562698,-11.32,5
06:08,534204159.0,5301.510410931339,-2.99,2
06:08,633345190.0,5666.9426222049515,-35.64,9
06:08,170637730.0,936.1162792728736,-1.25,7
06:09,853907490.0,7574.297177681509,-11.23,7
06:10,673025413.0,659.0016943343396,-36.21,7
06:12,331450202.0,7519.868885712225,-14.89,8
06:14,510101371.0,12323.64995101388,-15.74,7
06:15,108563213.0,23156.922035566335,-5.84,2
06:15,749378808.0,1415.7659435041137,-58.81,2
06:16,511179916.0,7173.26519356738,-15.38,2
06:21,285873880.0,12749.627810797085,-42.57,4
06:23,822250278.0,6275.591836108717,-46.72,2
06:27,461990622.0,7127.144915713904,-12.66,2
06:27,520447032.0,7864.560054575379,-19.88,9
06:27,918160369.0,-990.2636500000004,-37.89,9
06:28,986267641.0,4076.862082148434,-0.46,7
06:31,216285378.0,24422.72759876362,-40.5,9
06:36,842682241.0,3455.940117147414,-2.62,7
06:36,270374623.0,9442.197699858334,-28.36,8
06:37,960208650.0,14403.22414393872,-40.26,7
06:39,540159353.0,10954.862066814358,-1.73,2
06:42,179173981.0,4467.689773990089,-23.7,9
06:43,912705941.0,19059.109485433615,-15.73,8
06:44,623156843.0,4467.277078549516,-20.67,2
06:44,541639148.0,3995.585545201967,-25.29,2
06:47,322221939.0,3311.616013761352,-6.51,2
06:48,949032480.0,3309.6045262517964,-22.99,9
06:50,973086490.0,10215.550651307396,-6.0,9
06:51,874431242.0,8891.138555264168,-31.44,9
06:51,409971170.0,2548.514555743085,-2.19,7
06:52,985188462.0,-184.4236112887752,-31.23,9
06:52,601627384.0,3011.2051489673554,-39.69,9
06:54,187111705.0,6754.431518803845,-30.26,5
06:56,836110591.0,2818.5342149245807,-6.36,8
06:58,758160963.0,7186.155439868621,-10.77,7
06:58,324224854.0,4180.21951010926,-1.62,5
06:59,259015404.0,161.03938590362282,-38.74,9
07:00,366550080.0,25674.036713318103,-33.57,7
07:02,785749304.0,8384.69418259708,-13.13,2
07:02,146909202.0,3196.0053582210026,-0.8,5
07:06,709608057.0,2239.768762384688,-9.95,5
07:06,183888402.0,19144.682457140138,-36.12,9
07:07,588565416.0,5723.095873541664,-10.19,7
07:10,987163717.0,3685.630223888187,-40.89,9
07:10,769311479.0,6150.882068978519,-2.98,7
07:12,264550521.0,5208.322658250819,-42.92,7
07:12,679662108.0,16432.329109663006,-8.96,7
07:13,496395938.0,12308.351064135588,-10.23,7
07:13,282837512.0,13763.980252725258,-31.33,9
07:15,489964679.0,20365.6438924153,-49.12,9
07:19,297823329.0,606.9261499999992,-35.85,9
07:20,873693307.0,10197.271218736836,-15.93,9
07:20,298000165.0,26629.17005738366,-6.39,2
07:25,587225252.0,5324.350893445685,-14.12,8
07:26,237493332.0,14606.19665553139,-55.68,7
07:27,520447032.0,7861.427620919595,-3.13,2
07:28,494789005.0,2421.1340005748575,-8.9,7
07:30,887853850.0,10175.128922581853,-17.99,2
07:31,259015404.0,105.85908648632604,-55.18,2
07:38,305778936.0,10341.171071179724,-4.96,2
07:38,910730524.0,7780.148756525069,-28.5,8
07:39,905860285.0,10483.931705993971,-17.63,5
07:42,802697323.0,16020.74717470944,-52.97,4
07:52,639409800.0,36619.34786428822,-34.48,2
07:55,873693307.0,10162.022476292108,-35.25,7
07:57,795847804.0,23974.886365272432,-0.19,7
07:59,624500124.0,3042.695927625809,-17.22,2
08:04,766941757.0,2148.076308884677,-1.02,5
08:05,395284483.0,1137.564340211308,-5.35,9
08:05,280200287.0,176.01204661305104,-6.5,9
08:09,399538448.0,7484.675926398817,-6.8,9
08:11,668329719.0,8859.67212319917,-32.03,4
08:16,948558249.0,8191.865956046183,-5.8,9
08:18,254853117.0,2793.629311955678,-14.59,8
08:21,559995067.0,2140.3911800695646,-3.34,5
08:21,949032480.0,3289.6500278389844,-19.95,5
08:24,696758548.0,-3634.115396320137,-16.5,5
08:25,851181128.0,4445.881336158436,-23.96,7
08:26,262767079.0,-1456.9031000000004,-64.2,5
08:29,158766229.0,-792.64893589347,-46.06,5
08:30,822718326.0,11532.236797697164,-38.47,5
08:32,532525712.0,-857.9018000000003,-25.24,5
08:34,534908754.0,-1170.3572500000002,-50.59,5
08:35,950234174.0,-107.14180246962393,-2.94,7
08:36,873701090.0,22.688745821761337,-20.57,2
08:41,851649498.0,8124.992746628719,-95.24,5
08:41,473820682.0,11233.161417446545,-87.28,5
08:43,293609137.0,-207.03950742550185,-151.89,5
08:44,730002588.0,13640.437246545043,-25.41,2
08:44,550169791.0,22315.498086258864,-52.6,5
08:45,683078800.0,1526.76729157638,-47.02,5
08:49,407323346.0,-2721.505432555312,-75.9,5
08:51,337771621.0,-3084.757649999998,-79.64,5
08:55,851649498.0,8112.803533700336,-12.19,8
08:56,194023154.0,-2763.434671784733,-54.39,5
08:59,364357875.0,7648.034005168063,-4.59,5
09:02,956717493.0,1070.0307504359832,-81.94,5
09:04,179173981.0,4466.182255205995,-1.51,2
09:04,690958123.0,20646.256205105015,-6.0,9
09:09,383833857.0,25824.953378222537,-5.35,9
09:09,540159353.0,10948.762066814355,-6.1,9
09:09,598793068.0,57.77639999999798,-226.63,5
09:10,999752672.0,903.4180435333348,-4.75,9
09:12,473820682.0,11195.727417446546,-37.43,4
09:14,425964226.0,3969.090764114708,-6.5,9
09:14,667367404.0,9167.593270382364,-5.0,9
09:15,762896656.0,-1182.7775018481416,-29.13,5
09:16,856147482.0,-845.4631985986248,-122.59,5
09:17,355733816.0,5403.667023100917,-28.96,7
09:17,117273481.0,8981.296118264998,-5.5,9
09:18,865748375.0,2098.8922470661764,-32.99,1
09:19,506618547.0,14490.581280283624,-7.3,9
09:21,613729471.0,7804.811895647455,-5.8,9
09:21,169006407.0,11587.729231126508,-5.7,9
09:22,941285623.0,630.2113990667704,-37.98,2
09:22,214339619.0,293.0866785105091,-5.0,9
09:22,138609932.0,2189.670003294586,-5.4,9
09:23,916270283.0,2212.5442500000004,-28.96,1
09:23,305778936.0,10181.130071179725,-160.04,5
09:26,170637730.0,920.9457992728736,-15.17,4
09:26,979135922.0,754.655300590451,-219.8,2
09:27,979892433.0,-1511.355200000001,-20.99,5
09:28,215311171.0,6095.693734342205,-21.97,7
09:29,287480331.0,7262.389703103202,-45.57,7
09:30,179173981.0,4146.282255205995,-319.9,2
09:33,822250278.0,6266.617396108717,-8.97,4
09:41,904154012.0,319.1874581204316,-81.99,2
09:45,809499628.0,17639.09758009372,-39.73,2
09:48,475277431.0,1076.288136943619,-17.98,4
09:48,497809732.0,3215.7538695525955,-123.19,2
09:51,549414742.0,6765.809443666525,-2.2,4
09:56,538003940.0,1976.6700000000103,-99.97,6
09:56,245198540.0,-164.5086011982205,-219.97,2
09:57,348325817.0,8870.617204350881,-26.77,2
09:57,398429109.0,406.2970500000009,-32.99,2
09:59,165045150.0,386.1035614028557,-95.25,2
10:00,254853117.0,2781.6393119556783,-11.99,7
10:04,711045550.0,2082.004350000004,-9.99,2
10:05,700138124.0,4209.958018854531,-2.37,7
10:06,179173981.0,3967.782255205995,-178.5,2
10:08,479366718.0,2096.7013481400413,-29.99,4
10:09,215426302.0,25.240404025691916,-51.73,5
10:10,497809732.0,3036.5958695525956,-179.16,2
10:11,398429109.0,354.2970500000009,-52.0,2
10:12,570323670.0,3128.46437687926,-20.11,4
10:13,979135922.0,625.155300590451,-129.5,2
10:14,639549973.0,4927.868537487544,-11.03,4
10:14,298000165.0,26573.20005738366,-55.97,6
10:15,165045150.0,304.7285614028557,-81.38,2
10:20,919185264.0,3924.0916043677257,-19.99,2
10:22,143003091.0,10365.192401271646,-17.97,4
10:27,497809732.0,2965.9098695525954,-70.69,2
10:30,987229118.0,608.7345800724163,-83.96,2
10:31,779236304.0,1623.8875954795335,-170.1,2
10:36,930277104.0,9313.90012518998,-109.86,2
10:37,179173981.0,3751.482255205995,-216.3,2
10:40,618514666.0,21354.14547271649,-26.57,5
10:41,895331556.0,-607.4174000000008,-47.15,5
10:41,497809732.0,2913.4098695525954,-52.5,2
10:43,409370545.0,442.4042755455207,-98.0,2
10:48,165045150.0,180.9785614028557,-123.75,2
10:50,979135922.0,381.555300590451,-243.6,2
10:54,821971408.0,746.2851102355432,-222.6,2
10:55,973086490.0,10214.805556480089,-0.75,7
11:03,179173981.0,3670.982255205995,-80.5,2
11:03,930277104.0,9250.91412518998,-62.99,2
11:05,821971408.0,536.9851102355433,-209.3,2
11:06,657139925.0,13467.692885969996,-23.47,8
11:13,441142605.0,1877.0021422757293,-5.97,4
11:14,979135922.0,311.555300590451,-70.0,2
11:16,497809732.0,2810.5658695525954,-102.84,2
11:17,570269025.0,3147.9130363986847,-54.18,5
11:24,143003091.0,10352.529862827903,-12.66,5
11:25,549414742.0,6683.573748815932,-82.24,2
11:25,541639148.0,3964.605545201967,-30.98,1
11:27,237684254.0,5674.893515470141,-56.09,1
11:28,930277104.0,9077.32812518998,-173.59,2
11:33,668175891.0,405.6330231584989,-28.0,2
11:36,409370545.0,274.4042755455207,-49.0,2
11:40,930277104.0,8932.44212518998,-144.89,2
11:46,979135922.0,101.555300590451,-210.0,2
11:48,497809732.0,2679.6938695525955,-130.87,2
11:49,652048867.0,-123.25425000000106,-49.99,2
11:50,454356905.0,1198.128281183157,-64.59,8
12:01,155867488.0,-249.99730000000156,-22.15,9
12:03,121113546.0,94.57215606986968,-20.63,9
12:03,987229118.0,436.5625800724163,-172.17,2
12:04,979135922.0,-65.044699409549,-166.6,2
12:05,570269025.0,3125.943036398685,-21.97,7
12:06,586041848.0,2007.4526999999991,-22.69,9
12:09,996042490.0,5848.923889366386,-21.98,4
12:10,779946617.0,16945.869619102534,-17.43,7
12:16,497809732.0,2608.3078695525955,-71.39,2
12:16,391688371.0,44.11924120504477,-131.59,2
12:17,987229118.0,336.4765800724163,-100.09,2
12:18,979135922.0,-258.24469940954896,-193.2,2
12:19,355733816.0,5385.562383850865,-18.1,7
12:21,779236304.0,1478.2875954795338,-145.6,2
12:21,821971408.0,307.38511023554327,-229.6,2
12:21,497772347.0,575.7384999999978,-59.98,2
12:22,779236304.0,1454.3075954795338,-23.98,9
12:31,760704118.0,342.56831271748916,-18.23,9
12:32,480557476.0,11149.414760205656,-12.33,7
12:34,287480331.0,7229.089703103202,-33.3,9
12:36,979135922.0,-411.5446994095489,-153.3,2
12:38,727417797.0,5640.814204234198,-10.04,2
12:39,391688371.0,-88.86675879495525,-132.99,2
12:40,722971557.0,-1074.4382791569244,-28.83,5
12:41,941285623.0,575.8423990667703,-54.37,5
12:43,497809732.0,2445.2638695525957,-163.04,2
12:50,979135922.0,-478.0446994095489,-66.5,2
12:51,250895529.0,868.6925324692882,-109.96,5
12:52,202320275.0,-992.2480000000006,-73.93,5
13:04,187111705.0,6748.331518803845,-6.1,9
13:05,903468956.0,593.0411999999993,-56.07,5
13:06,480557476.0,11144.014760205657,-5.4,9
13:09,280098744.0,2281.4873778716665,-19.98,4
13:10,688712152.0,6780.6807181372,-7.5,9
13:10,678851253.0,3178.904436915001,-81.42,5
13:12,572333122.0,-4004.627549999995,-120.39,5
13:13,224215364.0,-1874.3550920882788,-26.45,5
13:18,165045150.0,40.72856140285569,-140.25,2
13:18,499244466.0,-667.3201312834224,-96.6,5
13:19,340321732.0,1531.5987500000035,-6.5,9
13:20,322221939.0,3306.216013761352,-5.4,9
13:20,910730524.0,7774.348756525069,-5.8,9
13:20,407574996.0,-633.5803906190631,-133.01,5
13:21,409370545.0,211.4042755455207,-63.0,2
13:23,779236304.0,1156.8075954795338,-297.5,2
13:34,409370545.0,184.1042755455207,-27.3,2
13:38,165045150.0,-101.02143859714432,-141.75,2
13:57,280268430.0,4615.47795278871,-51.58,7
14:05,409370545.0,103.6042755455207,-80.5,2
14:10,605711527.0,-497.1294861674163,-170.23,5
14:18,828750680.0,806.2423952136801,-99.99,2
14:23,518466565.0,602.3127999999992,-130.61,5
14:37,409370545.0,-132.9957244544793,-236.6,2
14:45,996042490.0,5823.923889366386,-25.0,2
14:56,547010927.0,24219.209090146367,-27.84,9
14:59,462962606.0,770.3100499999987,-45.08,2
15:09,165045150.0,-216.5214385971443,-115.5,2
15:11,979135922.0,-705.5446994095489,-227.5,2
15:11,108481285.0,8883.986215009802,-18.94,9
15:27,678330503.0,840.2564373377706,-23.41,8
15:36,687135796.0,28851.41323980937,-19.96,1
15:37,578131296.0,639.7115194440437,-49.84,5
15:42,979135922.0,-893.8446994095489,-188.3,2
15:43,575652395.0,883.1915572710884,-21.38,4
15:55,979135922.0,-1116.4446994095488,-222.6,2
16:07,609939116.0,7000.874639976606,-88.68,2
16:15,670102069.0,-85.85107997418558,-73.87,7
16:24,252760664.0,6666.164035703303,-15.31,5
16:25,605116158.0,2391.925900000004,-2.99,4
16:30,776108637.0,612.3873536574953,-75.38,5
16:31,165045150.0,-401.0214385971443,-184.5,2
16:31,478412511.0,12378.96107019746,-85.16,2
16:37,901432314.0,3268.572720187731,-58.48,5
16:41,310375875.0,1023.2339433474503,-247.1,2
16:41,165045150.0,-533.7714385971443,-132.75,2
16:41,409370545.0,-160.29572445447928,-27.3,2
16:43,979135922.0,-1332.044699409549,-215.6,2
16:43,892354433.0,-907.8399606343388,-13.07,5
16:48,867987292.0,1599.572284455255,-67.06,2
16:53,198051483.0,-1121.3669104088572,-42.26,5
16:55,395284483.0,1113.792340211308,-23.77,2
16:55,885259672.0,2738.3231973063093,-26.04,4
16:57,666952234.0,-433.4986518755133,-106.01,5
17:06,252760664.0,6583.564035703303,-82.6,2
17:06,948558249.0,8116.979956046182,-74.89,5
17:07,631111289.0,-498.29150000000095,-12.39,5
17:07,128033695.0,1836.5313125398372,-16.96,2
17:07,901432314.0,3241.252720187731,-27.32,7
17:08,874431242.0,8883.873324171083,-7.27,2
17:15,409370545.0,-282.0957244544793,-121.8,2
17:16,449871732.0,7660.713505793859,-17.85,5
17:18,979135922.0,-1619.044699409549,-287.0,2
17:18,670102069.0,-108.74107997418558,-22.89,9
17:19,668175891.0,394.80541607326205,-10.83,5
17:19,706250160.0,12546.897402344215,-22.95,9
17:20,467207141.0,-14.131832951736328,-128.38,5
17:22,433917275.0,7012.110459696212,-11.91,4
17:23,690523499.0,116.74120000000016,-2.99,4
17:23,423208402.0,3954.0201000000034,-18.0,4
17:23,558119802.0,33871.79902916487,-30.29,9
17:24,858560423.0,12294.031253018788,-51.48,4
17:24,992204045.0,6888.581091137284,-81.06,2
17:26,370757362.0,1231.376023603617,-19.99,2
17:27,482513594.0,5263.7508653050845,-49.52,2
17:27,489964679.0,20338.1567222767,-27.49,7
17:28,690958123.0,20623.266205105017,-22.99,7
17:28,130154096.0,603.3111481961066,-22.97,7
17:28,647472692.0,26390.486684613057,-68.94,4
17:29,690958123.0,20614.054012105134,-9.21,2
17:30,252760664.0,6391.764035703302,-191.8,2
17:31,802697323.0,16013.377174709438,-7.37,7
17:31,979135922.0,-1744.3446994095486,-125.3,2
17:32,395284483.0,1001.106340211308,-112.69,2
17:32,832564361.0,15517.123969655866,-49.03,4
17:33,130154096.0,578.1211481961066,-25.19,9
17:37,433917275.0,6993.350459696212,-18.76,4
17:37,423208402.0,3927.4866000000034,-26.53,5
17:37,771125520.0,51.25909999999908,-72.0,2
17:37,200080192.0,9382.870809974189,-24.27,7
17:37,586315521.0,12358.732590557747,-23.06,4
17:41,859603181.0,2890.7192378489917,-5.21,2
17:42,618138606.0,1341.1105215212997,-22.0,2
17:42,409370545.0,-358.3957244544793,-76.3,2
17:43,858560423.0,12274.041253018788,-19.99,2
17:43,874431242.0,8727.193324171083,-156.68,2
17:43,540159353.0,10911.282066814358,-37.48,4
17:45,854513972.0,1630.8477000000005,-49.99,2
17:45,703478110.0,1917.307749908584,-16.97,7
17:45,486495235.0,1631.2704142021826,-62.5,2
17:46,951817450.0,9092.680665881606,-71.18,5
17:46,395284483.0,832.448340211308,-168.66,2
17:47,951817450.0,9031.64487660853,-61.04,7
17:47,667367404.0,9134.642440382364,-32.95,4
17:49,471897866.0,6732.904447836221,-104.8,5
17:49,836110591.0,2783.894214924581,-34.64,9
17:49,955035930.0,1481.6084791714782,-1.99,4
17:52,151968462.0,6739.304366784843,-13.91,8
17:54,570323670.0,3120.8800485105257,-7.58,7
17:56,435984758.0,3893.1458754279743,-102.79,4
17:57,237493332.0,14533.96665553139,-72.23,2
17:58,143061865.0,6656.969619786792,-0.85,8
18:01,252964502.0,-922.5550224913006,-26.7,9
18:02,409370545.0,-440.9957244544793,-82.6,2
18:02,200080192.0,9336.684451923513,-46.19,7
18:02,536924114.0,-1018.9820055930962,-94.64,5
18:03,780859359.0,-865.7500000000002,-25.25,9
18:04,887853850.0,10150.928922581852,-24.2,9
18:04,310375875.0,1017.3799690898172,-5.85,5
18:06,834581602.0,20.399699999999157,-35.14,9
18:08,486495235.0,1606.2704142021826,-25.0,2
18:10,593191200.0,293.86909999999904,-11.99,9
18:10,352899149.0,258.7727411773412,-63.9,7
18:12,435984758.0,3870.633875427974,-22.51,5
18:12,298007503.0,1609.3381036256335,-28.9,9
18:15,832564361.0,15501.833969655863,-15.29,9
18:16,957821152.0,-1687.4854535715497,-22.34,5
18:16,450896297.0,13201.160104178009,-36.62,9
18:17,235881534.0,12695.132769291224,-61.44,2
18:18,815385232.0,10304.469691580904,-22.33,7
18:18,518474507.0,13498.199253117584,-14.61,5
18:19,241459011.0,462.6301132723467,-64.6,5
18:22,409370545.0,-550.8957244544793,-109.9,2
18:22,329840194.0,132.38129014314796,-55.19,5
18:24,486495235.0,1508.7904142021823,-97.48,2
18:27,551755686.0,6908.017926654151,-14.97,7
18:27,197865285.0,-398.64668826877966,-31.34,9
18:33,131388684.0,21896.12081169944,-1.96,2
18:33,675806859.0,7111.405465369945,-12.1,9
18:34,221868392.0,4516.567081546901,-41.39,9
18:36,886921642.0,3019.765043833609,-11.27,5
18:46,321372947.0,-505.4887507890994,-14.62,5
18:49,795847804.0,23906.510365272432,-68.38,5
18:50,675806859.0,7097.405465369945,-14.0,9
18:51,535804582.0,677.0310499999987,-21.98,4
18:52,706250160.0,12543.219359741395,-3.68,2
18:52,324224854.0,4152.62951010926,-27.59,9
18:53,479456865.0,1714.8194995833055,-18.0,7
18:54,409370545.0,-627.1957244544792,-76.3,2
18:54,887156614.0,-720.4886210407738,-39.17,9
18:55,612304466.0,-2285.323249999999,-11.62,5
18:56,697140785.0,-215.5913832638968,-123.14,5
19:00,975345315.0,36481.812960273586,-82.47,5
19:05,829914501.0,863.0348065709745,-56.43,5
19:13,191161970.0,-4102.734999999994,-39.44,5
19:17,169006407.0,11408.991231126509,-178.74,5
19:17,768271776.0,-839.6585967665796,-72.58,5
19:18,279149837.0,46.248049999999495,-87.07,5
19:19,683319988.0,6605.064950225967,-12.07,7
19:20,213096759.0,-1581.2691082144393,-91.83,5
19:21,879091637.0,-661.688476262023,-152.08,5
19:22,532478725.0,4119.860819463434,-67.31,8
19:24,990894155.0,-353.91279132115847,-42.61,5
19:27,409370545.0,-662.1957244544792,-35.0,2
19:36,835736339.0,2047.287599690938,-26.59,9
19:39,290818242.0,6943.373164321461,-33.01,5
19:42,117273481.0,8878.046118264998,-103.25,5
19:46,409370545.0,-802.1957244544792,-140.0,2
19:46,198946608.0,4160.05566002046,-17.12,8
19:48,345582855.0,330.44145282054933,-38.0,5
19:50,358846516.0,168.9539225272174,-28.47,5
19:52,310375875.0,982.1599690898172,-35.22,9
20:02,106601471.0,10567.34944044318,-32.36,5
20:02,982949451.0,-3990.269167052508,-54.99,5
20:09,785210466.0,1753.4822969465592,-75.98,8
20:19,975345315.0,36392.83775530997,-88.98,8
20:20,305778936.0,10152.140071179723,-28.99,9
20:28,270374623.0,9386.995699858337,-55.2,5
20:28,500051919.0,812.3609966505901,-43.45,5
20:33,241459011.0,439.7401132723467,-22.89,9
20:33,912584712.0,-622.4493804552669,-117.24,5
20:34,195895574.0,7209.740424629082,-18.94,9
20:36,540159353.0,10848.758066814358,-62.52,5
20:38,503575533.0,7903.342122931001,-134.74,5
20:40,531186970.0,4808.820385298425,-32.7,7
20:41,940569402.0,4127.550426417519,-6.39,5
20:47,940569402.0,4111.100426417519,-16.45,9
20:50,180616589.0,875.8708282361094,-57.48,5
20:54,131388684.0,21878.62081169944,-17.5,5
20:58,331450202.0,7507.618885712225,-12.25,9
20:59,653640811.0,17684.956325791165,-14.49,4
21:28,479456865.0,1669.9778118641743,-44.84,5
22:18,672913754.0,11800.720134385365,-22.27,5
01:14,421881811.0,1987.6419690195432,-9.0,5
01:18,547010927.0,24202.16932856227,-17.04,4
01:27,679662108.0,16407.746437604135,-24.58,8
01:30,985188462.0,-218.0636112887752,-33.64,9
01:31,639549973.0,4916.22788344103,-11.64,4
01:33,718058208.0,1863.5207615522015,-3.14,7
01:39,370521542.0,27205.888433616456,-1.91,2
01:49,647472692.0,26363.056684613057,-27.43,9
02:14,547010927.0,24183.21932856227,-18.95,9
02:22,950234174.0,-133.93253362551104,-26.79,2
02:29,259015404.0,70.01908648632605,-35.84,9
02:31,187541224.0,1201.832278302845,-40.7,9
02:35,534325901.0,6668.956895165415,-12.45,9
02:39,287480331.0,7202.099703103202,-26.99,9
02:40,949032480.0,3265.2700278389843,-24.38,9
02:41,970298834.0,2106.7873383513097,-58.91,2
02:42,853907490.0,7560.947177681509,-13.35,9
02:44,169006407.0,11338.730141444816,-70.26,2
02:45,802697323.0,15981.807174709438,-31.57,9
02:49,779946617.0,16912.52838957217,-33.34,2
02:52,316793091.0,450.4831100549509,-28.91,9
02:52,633345190.0,5643.612622204952,-23.33,9
02:56,601627384.0,2985.175148967355,-26.03,9
02:57,795847804.0,23891.69656765116,-14.81,7
02:59,860360312.0,-177.2144911173196,-40.4,9
03:03,108931112.0,14317.940726981687,-32.43,9
03:09,653640811.0,17657.545815844845,-27.41,5
03:18,305778936.0,10147.290652519468,-4.85,2
03:23,851649498.0,8099.688140887616,-13.12,7
03:28,905860285.0,10448.585894569154,-35.35,5
03:30,435984758.0,3838.8614318594086,-31.77,7
03:32,475117511.0,6861.306362956872,-5.13,5
03:33,287480331.0,7155.550770428586,-46.55,4
03:33,541639148.0,3927.6805716350113,-36.92,5
03:34,128033695.0,1811.0513125398372,-25.48,9
03:34,986267641.0,4042.339244204493,-34.52,7
03:34,996042490.0,5813.5868509047,-10.34,2
03:40,853907490.0,7559.16282948802,-1.78,7
03:43,874431242.0,8701.963324171084,-25.23,9
03:43,738958551.0,8714.802835468994,-33.93,9
03:46,736340277.0,8641.966661515526,-15.44,9
03:50,496395938.0,12303.884131244196,-4.47,5
03:51,399144202.0,1253.685429583795,-19.74,9
03:52,414805878.0,12665.341176314549,-34.13,9
03:54,678851253.0,3172.1454564721475,-6.76,7
03:54,383833857.0,25804.67025559795,-20.28,5
03:56,766941757.0,2112.746308884677,-35.33,9
03:58,108481285.0,8852.349808395187,-31.64,2
04:00,549414742.0,6645.983748815932,-37.59,9
04:01,473820682.0,11180.325301111248,-15.4,8
04:01,858989281.0,26885.66848383005,-3.61,5
04:03,973086490.0,10204.855556480088,-9.95,9
04:05,322221939.0,3281.3061424658113,-24.91,7
04:05,187111705.0,6664.897351717071,-83.43,2
04:10,987163717.0,3650.690223888187,-34.94,9
04:19,520447032.0,7838.237620919595,-23.19,9
04:20,534325901.0,6668.450451540622,-0.51,7
04:20,673025413.0,639.6274293652552,-19.37,8
04:22,949032480.0,3262.2620045110107,-3.01,7
04:23,237684254.0,5666.966336674464,-7.93,2
04:25,842682241.0,3436.55064654551,-19.39,7
04:31,113747882.0,11883.332736640545,-27.13,9
04:32,940569402.0,4098.850426417519,-12.25,9
04:34,128030172.0,-715.2733774498499,-26.94,9
04:35,270374623.0,9382.958636046116,-4.04,2
04:40,802697323.0,15947.168313397053,-34.64,5
04:42,441274121.0,12199.076402559318,-9.95,9
04:42,282837512.0,13730.790252725255,-33.19,9
04:43,510101371.0,12284.79995101388,-38.85,9
04:44,815993333.0,5859.811658444638,-42.18,2
04:44,120634201.0,4868.906349057868,-14.6,9
04:48,960208650.0,14387.22616551923,-16.0,7
04:48,324224854.0,4151.503204597319,-1.13,5
04:49,264550521.0,5173.796709373682,-34.53,8
04:50,128033695.0,1804.7764228065416,-6.27,2
04:52,450896297.0,13170.880104178006,-30.28,9
04:55,433917275.0,6976.900459696212,-16.45,9
05:01,752362502.0,5907.544090969774,-27.92,2
05:02,235881534.0,12663.739950446909,-31.39,2
05:02,749378808.0,1414.2143565179736,-1.55,7
05:05,256002321.0,5995.85543202175,-35.85,2
05:05,769311479.0,6148.541032636154,-2.34,2
05:05,399538448.0,7464.574755487446,-20.1,2
05:06,489964679.0,20305.6167222767,-32.54,9
05:06,310375875.0,954.0199690898172,-28.14,9
05:09,824916823.0,8131.947018830212,-28.78,9
05:09,987229118.0,329.75471503478866,-6.72,7
05:19,709608057.0,2200.468762384688,-39.3,9
05:26,471897866.0,6731.3112292184605,-1.59,5
05:26,910730524.0,7723.562524631511,-50.79,7
05:27,670102069.0,-147.67107997418557,-38.93,9
05:29,844835978.0,10216.71962306578,-71.07,2
05:32,534204159.0,5284.797515033805,-16.71,7
05:33,113747882.0,11861.135264171176,-22.2,4
05:34,518474507.0,13466.059253117584,-32.14,9
05:36,348325817.0,8834.467204350882,-36.15,9
05:38,994214354.0,9808.6509289601,-21.75,9
05:41,719586818.0,18709.33007079872,-6.3,7
05:42,409971170.0,2547.1318312674916,-1.38,8
05:45,310375875.0,952.4669501786638,-1.55,2
05:46,399144202.0,1215.4781912749893,-38.21,8
05:49,657139925.0,13446.542885969997,-21.15,9
05:49,522188082.0,6831.970335928259,-3.32,7
05:50,675806859.0,7067.839424865026,-29.57,7
05:53,633345190.0,5601.61165692561,-42.0,5
05:54,867987292.0,1580.049796602583,-19.52,7
05:55,308505160.0,13242.746400387552,-64.99,2
05:56,108563213.0,23148.458643428778,-8.46,8
05:59,519644021.0,2513.893708776778,-44.69,4
05:59,587225252.0,5282.360893445685,-41.99,9
05:59,285220959.0,12103.491326033343,-37.1,5
06:04,897714622.0,9307.994256165412,-39.22,2
06:04,213112754.0,5359.222225626981,-20.15,9
06:10,822250278.0,6239.377396108717,-27.24,9
06:11,581655972.0,41326.18090376552,-61.97,5
06:13,348325817.0,8749.644069377715,-84.82,7
06:14,532478725.0,4080.589463811229,-39.27,2
06:14,815385232.0,10263.053905109626,-41.42,2
06:15,984783496.0,14276.126878571573,-11.0,9
06:16,518474507.0,13445.744155974122,-20.32,7
06:17,824916823.0,8127.486753391037,-4.46,5
06:17,511179916.0,7173.055725264849,-0.21,2
06:18,221868392.0,4483.737081546901,-32.83,9
06:20,667367404.0,9086.767424261949,-47.88,2
06:20,196289502.0,16068.49664082453,-11.98,9
06:20,588565416.0,5677.0013404502815,-46.09,8
06:21,809499628.0,17623.66758009372,-15.43,9
06:27,851181128.0,4409.041336158436,-36.84,9
06:30,506618547.0,14485.233700680164,-5.35,7
06:32,832564361.0,15500.741331464244,-1.09,2
06:34,575652395.0,850.164629140423,-33.03,7
06:34,183888402.0,19112.51245714014,-32.17,9
06:34,609939116.0,6990.105493579741,-10.77,4
06:37,623156843.0,4446.15750191053,-21.12,5
06:40,550169791.0,22310.045621679274,-5.45,2
06:44,683319988.0,6595.887058785548,-9.18,5
06:44,216285378.0,24383.83759876362,-38.89,9
06:45,613729471.0,7803.366248550792,-1.45,5
06:45,678330503.0,818.5419051083485,-21.71,2
06:48,822135975.0,11256.522422090253,-20.47,2
06:49,221868392.0,4476.218428099725,-7.52,4
06:51,480557476.0,11132.673376065655,-11.34,8
06:51,854895960.0,3231.6647724857016,-24.46,2
06:51,785749304.0,8371.74418259708,-12.95,9
06:54,572384506.0,6883.621847441927,-33.8,9
06:55,873693307.0,10158.036837408055,-3.99,2
06:55,124102251.0,1660.0307259807716,-0.37,5
06:57,705848712.0,27570.04616906713,-19.2,9
07:03,461990622.0,7124.136231445387,-3.01,2
07:03,930277104.0,8901.60212518998,-30.84,9
07:04,587225252.0,5235.740102665044,-46.62,4
07:11,315546581.0,29473.274436480264,-66.5,2
07:11,822250278.0,6198.720775774296,-40.66,7
07:13,973086490.0,10134.360473750903,-70.5,5
07:25,940569402.0,4096.724820306094,-2.13,5
07:26,454356905.0,1165.628281183157,-32.5,9
07:26,290818242.0,6896.268265774462,-47.1,4
07:33,558119802.0,33858.86791726164,-12.93,5
07:39,705848712.0,27542.667389476577,-27.38,7
07:44,245690309.0,9689.886800498103,-8.51,5
07:44,433917275.0,6957.554347501093,-19.35,2
07:44,624500124.0,2999.643074374259,-43.05,5
07:52,736340277.0,8612.080447390532,-29.89,5
07:54,899742927.0,12967.841920363566,-8.0,2
07:55,572384506.0,6846.68059240621,-36.94,7
08:05,179173981.0,3658.733593565505,-12.25,8
08:05,758160963.0,7146.507480854671,-39.65,8
08:07,510101371.0,12268.93699133331,-15.86,5
08:10,651756497.0,14413.96593107042,-4.61,4
08:12,336557504.0,1011.1690758737816,-5.4,9
08:15,280200287.0,170.71204661305103,-5.3,9
08:18,399538448.0,7457.074755487446,-7.5,9
08:20,785749304.0,8369.019152909852,-2.73,7
08:21,395284483.0,826.5483402113081,-5.9,9
08:25,554792076.0,28995.12267816206,-49.78,5
08:26,482513594.0,5217.112679278215,-46.64,7
08:26,930277104.0,8897.562430036072,-4.04,5
08:27,346874167.0,-73.07505000000097,-46.0,5
08:29,237493332.0,14513.94665553139,-20.02,5
08:29,907987693.0,-2673.631999999998,-8.83,5
08:32,504055745.0,-392.1322386582331,-74.55,5
08:35,639409800.0,36588.180575968574,-31.17,7
08:35,149684419.0,259.9650499999979,-12.97,5
08:36,180719578.0,-4638.3702499999945,-29.9,5
08:38,948069469.0,-935.5857000000012,-23.26,5
08:39,229502829.0,-4012.055424186247,-155.89,5
08:39,967989787.0,333.92923264072726,-63.62,5
08:40,570323670.0,3066.8175103778335,-54.06,7
08:41,390747457.0,446.9085999999979,-36.93,5
08:46,691843653.0,-3279.4258999999925,-27.66,5
08:46,213112754.0,5344.380638306479,-14.84,7
08:47,969697937.0,-5072.812765670551,-15.07,5
08:49,124102251.0,1630.9107259807718,-29.12,5
08:50,221356538.0,706.8593999999996,-146.55,5
08:52,229205098.0,7262.287484657355,-80.68,5
08:54,248142083.0,-136.95856529748323,-31.04,5
08:55,700138124.0,4201.36092624916,-8.6,7
08:57,820686957.0,-1167.776066311196,-68.93,5
08:59,364357875.0,7598.983232175797,-49.05,7
09:00,138351025.0,-1122.9263500000004,-95.46,5
09:01,581655972.0,41318.28090376552,-7.9,9
09:01,441274121.0,12192.576402559318,-6.5,9
09:03,383833857.0,25796.87025559795,-7.8,9
09:04,214339619.0,286.5866785105091,-6.5,9
09:05,138609932.0,2184.270003294586,-5.4,9
09:05,558875206.0,3037.4705393997806,-5.7,9
09:06,402438092.0,119.34149999999894,-99.99,5
09:06,141521177.0,6407.791900000016,-42.92,5
09:10,855129444.0,-209.59669543737215,-93.31,5
09:13,506618547.0,14478.133700680164,-7.1,9
09:16,613729471.0,7797.266248550792,-6.1,9
09:17,999752672.0,896.9680435333347,-6.45,9
09:17,851649498.0,8094.338140887616,-5.35,9
09:17,117273481.0,8872.246118264999,-5.8,9
09:18,195895574.0,7206.412403918936,-3.33,5
09:18,586315521.0,12351.232590557747,-7.5,9
09:19,575652395.0,743.8646291404231,-106.3,2
09:19,284905540.0,8181.665445891465,-53.01,6
09:20,540159353.0,10843.758066814358,-5.0,9
09:21,618138606.0,1333.5105215212998,-7.6,9
09:22,417850087.0,15400.218516041416,-5.8,9
09:23,352291960.0,1693.0880533035738,-50.04,2
09:24,108931112.0,14284.813206981687,-33.13,4
09:24,919185264.0,3918.1016043677255,-5.99,7
09:25,264208990.0,564.1568999999985,-7.1,9
09:32,270374623.0,9327.618636046116,-55.34,2
09:34,119993184.0,-2207.7994029108618,-23.84,5
09:35,706361191.0,95.02099849407792,-75.95,5
09:37,933491926.0,3241.2112700000043,-25.11,7
09:37,585133606.0,4863.574459392841,-14.99,4
09:38,819515373.0,2249.2978360637935,-6.99,4
09:39,366550080.0,25639.956354262216,-34.08,7
09:42,554792076.0,28945.40266064898,-49.72,2
09:43,282837512.0,13718.340252725257,-12.45,1
09:44,117308635.0,2175.923170706712,-29.08,1
09:45,503575533.0,7863.64659214172,-39.7,7
09:52,456246119.0,21472.572712281093,-2.5,4
09:52,264550521.0,4942.796709373682,-231.0,2
09:53,549414742.0,6643.759054959903,-2.22,5
10:00,639549973.0,4894.13788344103,-22.09,2
10:02,987656636.0,3900.766195447101,-12.81,7
10:03,764450279.0,21389.162268214564,-37.99,2
10:04,570410059.0,1281.9639467763116,-84.99,2
10:06,195895574.0,7054.512403918936,-151.9,2
10:08,647472692.0,26279.161684613056,-83.89,5
10:09,117308635.0,2153.833170706712,-22.09,2
10:11,398429109.0,309.3670500000009,-44.93,7
10:11,280098744.0,2221.5173778716667,-59.97,4
10:11,187111705.0,6614.41335171707,-50.48,5
10:12,384497904.0,570.3134999999991,-15.52,5
10:14,280990953.0,732.3696999999983,-63.98,2
10:15,264550521.0,4783.896709373682,-158.9,2
10:21,441142605.0,1750.0203922757294,-126.98,5
10:25,137822385.0,3469.2135271943143,-6.15,9
10:26,462962606.0,734.2900499999987,-36.02,1
10:26,134461671.0,5199.794769363704,-24.58,8
10:29,259015404.0,45.09919398959653,-24.92,2
10:31,221356538.0,680.8893999999996,-25.97,7
10:34,639549973.0,4862.01788344103,-32.12,2
10:37,909676212.0,-57.335468212386864,-82.77,5
10:37,195895574.0,6866.226403918936,-188.29,2
11:00,145387690.0,4383.564717460244,-13.67,2
11:03,764450279.0,21344.182268214565,-44.98,2
11:07,655368335.0,3814.756381226444,-19.43,7
11:19,298000165.0,26571.210057383654,-1.99,4
11:31,919185264.0,3859.522701697937,-58.58,5
11:42,316793091.0,427.51311005495086,-22.97,7
11:52,534204159.0,5207.397515033806,-77.4,4
12:02,902798190.0,-755.0136344310265,-32.99,9
12:07,179173981.0,3633.433593565505,-25.3,9
12:13,793781222.0,555.020878947406,-32.95,1
12:15,421475159.0,-455.24973732558743,-22.93,9
12:17,215404070.0,117.71458917984964,-53.99,2
12:19,401293808.0,-213.96400000000085,-25.89,9
12:28,603375739.0,800.9390630232672,-24.5,9
12:30,364396689.0,-590.51325,-46.13,9
12:34,699139822.0,-816.0159242230529,-27.4,9
12:41,145387690.0,4358.314717460244,-25.25,9
12:44,631744379.0,-2318.801259491066,-27.2,5
12:45,737547541.0,-545.4854004322256,-36.92,5
12:46,767447966.0,4692.663062706572,-110.38,5
12:56,380911501.0,-295.52780000000087,-52.23,5
13:00,585625048.0,1791.6639749993576,-5.5,9
13:01,480557476.0,11126.523376065656,-6.15,9
13:07,688712152.0,6774.9807181372,-5.7,9
13:08,322221939.0,3274.156142465811,-7.15,9
13:09,895750759.0,-406.21528807566585,-5.99,7
13:14,424927189.0,-131.32811725589482,-130.89,5
13:19,849096144.0,1131.439020751343,-5.65,9
13:22,812692024.0,3627.519590521821,-5.1,9
13:44,497772347.0,465.76849999999774,-109.97,4
14:00,761272540.0,-93.00380000000126,-38.04,5
14:06,987390838.0,-3117.7862412103777,-24.65,5
14:31,792845450.0,603.0711500000008,-16.98,1
14:47,223207876.0,-1772.2528999999995,-41.79,5
15:04,280268430.0,4607.579675011809,-7.9,5
15:32,497772347.0,225.0717499999977,-240.7,5
15:34,724537117.0,-1347.0542500000004,-81.52,5
15:54,679911053.0,2279.6056899750224,-6.01,4
16:01,857997794.0,587.5336651508866,-85.97,4
16:06,885259672.0,2732.178212024955,-6.14,7
16:10,354894456.0,-52.34000000000043,-22.44,9
16:12,886921642.0,2994.268690010024,-25.5,2
16:16,297823329.0,580.9661499999992,-25.96,7
16:17,527842638.0,117.0862426329834,-21.98,4
16:19,670102069.0,-164.32345192390787,-16.65,5
16:26,605116158.0,2384.935900000004,-6.99,4
16:28,146909202.0,3187.962426965716,-8.04,7
16:28,941285623.0,560.8523990667703,-14.99,4
16:30,228136274.0,1123.2718399999997,-18.52,7
16:34,126929801.0,1369.1507015783834,-42.97,2
16:37,370757362.0,1200.4160236036173,-30.96,7
16:43,939972497.0,782.2191086000105,-35.98,4
16:43,444428189.0,2526.414200000002,-72.8,2
16:53,628470485.0,99.08402990012311,-212.1,7
16:53,116598243.0,2055.0412217774506,-35.16,2
16:54,198946608.0,4078.265127592683,-81.79,4
16:57,452974357.0,-3078.996449999994,-28.56,5
17:01,198630866.0,-555.8175735612685,-98.83,5
17:05,444428189.0,2416.528200000002,-109.89,2
17:07,738958551.0,8693.687231277121,-21.12,2
17:07,807714284.0,672.1140607359996,-22.98,2
17:08,892354433.0,-954.0999606343388,-46.26,5
17:09,992204045.0,6885.926831377815,-2.65,5
17:09,672913754.0,11776.626413511342,-24.09,8
17:11,683319988.0,6579.497058785548,-16.39,9
17:12,628470485.0,-59.073970099876874,-158.16,4
17:13,556992209.0,10653.273649219342,-18.64,9
17:19,706250160.0,12535.770488092032,-7.45,5
17:22,198946608.0,4050.185127592683,-28.08,2
17:22,858989281.0,26849.91848383005,-35.75,1
17:22,766812921.0,-547.980700000001,-160.22,5
17:23,698076160.0,6304.6526975888155,-149.74,2
17:23,858989281.0,26826.98848383005,-22.93,9
17:23,229205098.0,7246.857504869277,-15.43,5
17:23,444428189.0,2301.742200000002,-114.79,2
17:24,117273481.0,8864.158698798241,-8.09,7
17:25,846550094.0,1718.4792671741443,-19.97,1
17:28,897592348.0,15728.79632329499,-9.99,7
17:29,383625050.0,2709.7488597519755,-4.12,5
17:30,964913066.0,-2445.904699999998,-30.95,5
17:30,690523499.0,114.75120000000015,-1.99,4
17:32,627917561.0,3927.455050000006,-29.96,7
17:34,596463612.0,-943.512604725138,-41.17,5
17:37,500043411.0,13515.879531290848,-114.09,2
17:41,704517789.0,18255.106299404983,-42.64,2
17:41,252760664.0,6389.781875841881,-1.98,5
17:44,806358207.0,11211.57293559839,-15.51,4
17:46,581655972.0,41301.31090376552,-16.97,7
17:47,532478725.0,4043.8694638112297,-36.72,9
17:48,500043411.0,13505.115471290848,-10.76,4
17:49,994214354.0,9478.9649289601,-329.69,2
17:49,876890798.0,2995.1778706999335,-181.96,2
17:50,994214354.0,9472.941913986086,-6.02,5
17:50,196289502.0,16050.10664082453,-18.39,4
17:51,975345315.0,36385.34775530997,-7.49,4
17:52,423208402.0,3872.0655000000033,-55.42,5
17:55,897714622.0,9162.408256165412,-145.59,2
17:56,322720763.0,6601.560592500611,-39.46,5
17:58,987163717.0,3577.440223888187,-73.25,2
18:00,143061865.0,6636.999619786791,-19.97,7
18:00,859603181.0,2660.289237848992,-230.43,2
18:01,137913631.0,426.3964499999996,-111.02,5
18:01,414454079.0,1.828850000001495,-36.78,9
18:03,736310094.0,-931.345124027426,-15.48,9
18:03,912705941.0,18982.774485433616,-76.34,5
18:04,627723633.0,-2432.161328003762,-50.37,5
18:04,175452235.0,-1777.6607499999996,-28.85,9
18:05,705848712.0,27430.667389476577,-112.0,2
18:07,331450202.0,7472.954885712225,-34.66,5
18:08,687135796.0,28839.16323980937,-12.25,9
18:11,836110591.0,2747.494214924581,-36.4,9
18:12,887853850.0,10124.088922581852,-26.84,9
18:15,237493332.0,14493.242158002333,-20.7,2
18:16,893134725.0,927.6138376616674,-58.45,5
18:23,558119802.0,33833.27791726164,-25.59,9
18:24,618138606.0,1187.7159215212998,-145.79,5
18:26,215311171.0,6090.491335553916,-5.2,7
18:29,701070224.0,-1286.2221499999998,-38.78,9
18:29,984783496.0,14245.02154653219,-31.11,5
18:37,845648250.0,-64.72560000000063,-76.91,5
18:37,824916823.0,8121.776753391037,-5.71,7
18:41,675231808.0,18324.95009942456,-43.85,5
18:43,534325901.0,6660.974631540623,-7.48,7
18:43,152488934.0,1828.839207313731,-54.62,5
18:46,936813994.0,1.3651108327880763,-85.94,5
18:47,433837402.0,-172.9658684641881,-45.7,9
18:47,901432314.0,3228.320835135803,-12.93,7
18:49,220183538.0,167.53319999999928,-84.49,5
18:49,344522228.0,-3019.704488208393,-14.29,5
18:51,489964679.0,20241.993360005366,-63.62,7
18:51,668329719.0,8850.679922633231,-8.99,7
18:53,809499628.0,17594.44599598443,-29.22,7
18:54,235881534.0,12560.041950446908,-103.7,5
18:55,610645022.0,-742.8444626449184,-102.74,5
18:55,534097839.0,-4400.168549999997,-6.58,5
18:57,158414827.0,-1551.4900000000018,-11.48,5
18:58,679911053.0,2262.1496863479674,-17.46,7
18:59,492215823.0,2367.8842238154443,-43.92,7
19:01,965038148.0,-91.97251436767225,-53.36,5
19:02,305778936.0,10114.890652519469,-32.4,9
19:03,383625050.0,2628.5418597519756,-81.21,5
19:07,166019891.0,8179.889244382647,-24.64,9
19:09,143061865.0,6626.063010250521,-10.94,7
19:11,386729293.0,31539.21998439763,-11.6,2
19:13,170637730.0,904.594627957988,-16.35,7
19:14,859603181.0,2627.741587044663,-32.55,2
19:15,321372947.0,-521.1561507890995,-15.67,5
19:15,203466392.0,606.7256960955241,-74.35,5
19:17,613729471.0,7730.759248550792,-66.51,5
19:17,642924505.0,66.29512018352602,-64.76,5
19:19,116598243.0,2018.3122217774503,-36.73,5
19:21,426474982.0,-4001.07475,-59.89,5
19:23,256002321.0,5977.70543202175,-18.15,9
19:27,444371478.0,578.6241499999986,-47.04,5
19:29,370521542.0,27193.688433616455,-12.2,9
19:33,445240363.0,-1226.8535059632736,-86.08,5
19:33,867987292.0,1440.189796602583,-139.86,5
19:37,834581602.0,-70.45260000000086,-90.85,5
19:44,556992209.0,10598.015649219342,-55.26,5
19:44,742223719.0,39.57435730480262,-138.39,5
19:45,556992209.0,10593.338260854003,-4.68,7
19:56,143061865.0,6557.407010250521,-68.66,5
19:56,886921642.0,2984.4686900100237,-9.8,5
19:59,874431242.0,8674.543362523682,-27.42,2
20:00,851181128.0,4378.984628715788,-30.06,8
20:01,414805878.0,12657.86760656766,-7.47,2
20:05,912705941.0,18973.50129150879,-9.27,7
20:05,586315521.0,12335.409767173374,-15.82,2
20:10,865748375.0,2091.2549229560263,-7.64,7
20:14,806358207.0,11182.58293559839,-28.99,9
20:25,851649498.0,8083.898140887616,-10.44,9
20:26,718058208.0,1760.5157615522016,-103.0,5
20:34,624563756.0,-591.6922712164436,-29.62,5
20:34,361201224.0,3060.6394746538026,-33.0,9
20:41,698076160.0,6269.378917364548,-35.27,7
20:43,348525881.0,820.5116245949358,-63.96,5
20:54,668329719.0,8761.86392263323,-88.82,5
20:54,126929801.0,1363.1938192125629,-5.96,7
20:56,668692488.0,340.8227285738098,-144.62,5
21:09,779236304.0,1120.0075954795338,-36.8,9
21:12,700138124.0,4191.32092624916,-10.04,9
21:51,520447032.0,7823.8904103549885,-14.35,7
22:47,668692488.0,338.39424105758434,-2.43,7
00:41,270374623.0,9327.50016241019,-0.12,2
01:58,678851253.0,3136.321084832888,-35.82,7
02:37,518474507.0,13398.654155974122,-47.09,9
02:41,308505160.0,13223.182030620586,-19.56,5
02:47,851181128.0,4350.644628715788,-28.34,9
02:49,815385232.0,10255.663905109626,-7.39,9
02:58,893134725.0,925.1415007761188,-2.47,5
02:59,766941757.0,2077.446308884677,-35.3,9
03:00,973086490.0,10116.460473750903,-17.9,9
03:03,984783496.0,14233.281546532193,-11.74,9
03:09,216285378.0,24339.09759876362,-44.74,9
03:13,489964679.0,20209.47336000537,-32.52,9
03:24,949032480.0,3225.7220045110107,-36.54,9
03:28,287480331.0,7132.580770428585,-22.97,9
03:34,417850087.0,15319.481888569637,-38.12,5
03:35,706250160.0,12508.691144326536,-27.08,7
03:38,187111705.0,6605.261326022203,-9.15,7
03:41,679662108.0,16366.902854284228,-40.84,2
03:46,264550521.0,4767.394322771492,-16.5,5
03:49,510101371.0,12236.41699133331,-32.52,9
03:49,704517789.0,18251.99472148628,-3.11,2
03:50,187541224.0,1161.002278302845,-40.83,9
03:51,554792076.0,28933.12919418241,-12.27,7
03:51,912705941.0,18950.868308999503,-22.63,7
03:53,651756497.0,14412.848485168524,-1.12,5
03:54,887853850.0,10093.408922581852,-30.68,9
03:54,285220959.0,12098.11315127794,-5.38,4
03:58,506618547.0,14459.022395257858,-19.11,2
03:59,595800644.0,-1163.3077000000003,-37.19,9
04:08,482513594.0,5213.343616612691,-3.77,8
04:09,668329719.0,8682.607673328495,-79.26,5
04:10,348325817.0,8731.444069377714,-18.2,9
04:11,433917275.0,6931.574347501093,-25.98,9
04:13,718058208.0,1691.8024376923202,-68.71,7
04:17,461990622.0,7107.640817769453,-16.5,5
04:19,910730524.0,7721.016096743204,-2.55,2
04:20,930277104.0,8860.162430036073,-37.4,9
04:31,905860285.0,10397.02239265836,-51.56,4
04:31,709608057.0,2168.038762384688,-32.43,9
04:39,822135975.0,11239.604040667738,-16.92,2
04:40,933491926.0,3238.997598448768,-2.21,2
04:40,221868392.0,4446.718428099725,-29.5,9
04:40,430910686.0,-338.7624999999996,-17.9,9
04:47,604288474.0,1266.9893072516438,-51.31,2
04:51,639549973.0,4845.671306327227,-16.35,2
04:51,450896297.0,13135.240104178009,-35.64,9
04:54,601627384.0,2940.0751489673553,-45.1,9
04:54,822718326.0,11481.276840313833,-50.96,7
04:57,858989281.0,26801.057533295545,-25.93,7
04:57,492215823.0,2335.4542238154445,-32.43,9
04:57,471897866.0,6677.465722180911,-53.85,8
05:01,324224854.0,4141.0754986545435,-10.43,2
05:07,940569402.0,4073.8248203060944,-22.9,9
05:09,719586818.0,18693.15207184565,-16.18,5
05:10,336557504.0,992.0210833178852,-19.15,4
05:12,237684254.0,5666.074529297168,-0.89,5
05:12,519644021.0,2484.4775880979196,-29.42,8
05:19,146909202.0,3177.330884226864,-10.63,8
05:22,949032480.0,3180.630328329115,-45.09,2
05:22,496395938.0,12287.607415032871,-16.28,2
05:23,709608057.0,2135.9467655025187,-32.09,8
05:23,310375875.0,941.313986946868,-11.15,7
05:24,795847804.0,23878.254794800458,-13.44,2
05:25,522188082.0,6778.464930937596,-53.51,8
05:25,647936800.0,2224.04117152595,-10.54,5
05:28,383625050.0,2589.605692915743,-38.94,5
05:30,259015404.0,11.80919398959653,-33.29,9
05:30,809499628.0,17584.15599598443,-10.29,9
05:31,683319988.0,6546.007058785548,-33.49,9
05:34,806358207.0,11141.837806148556,-40.75,2
05:35,973086490.0,10089.345838880556,-27.11,7
05:36,581655972.0,41269.03164624257,-32.28,7
05:38,613729471.0,7721.333783837311,-9.43,2
05:39,822250278.0,6192.130861449708,-6.59,4
05:39,113747882.0,11834.958867858471,-26.18,7
05:39,815385232.0,10250.524120704327,-5.14,7
05:39,853907490.0,7546.21282948802,-12.95,9
05:40,730002588.0,13599.280687560386,-41.16,2
05:40,198946608.0,4010.364945979047,-39.82,8
05:40,290818242.0,6888.238006653337,-8.03,4
05:41,305778936.0,10079.211514763983,-35.68,7
05:45,776431321.0,2906.8372956715334,-71.78,4
05:46,985188462.0,-242.44361128877517,-24.38,9
05:46,930277104.0,8833.114908531708,-27.05,2
05:50,166019891.0,8152.086984712451,-27.8,5
05:51,873693307.0,10140.106837408057,-17.93,9
05:52,624500124.0,2961.326333758101,-38.32,2
05:53,414805878.0,12623.03760656766,-34.83,9
05:54,824916823.0,8120.847498363472,-0.93,7
05:54,169006407.0,11326.480141444816,-12.25,9
05:58,500043411.0,13488.165471290848,-16.95,9
06:01,131388684.0,21842.89907186465,-35.72,4
06:03,873701090.0,13.966749770208397,-8.72,2
06:03,738958551.0,8683.485186826229,-10.2,5
06:04,195895574.0,6817.821469798766,-48.4,2
06:06,851649498.0,8072.343156164611,-11.55,5
06:07,639409800.0,36535.51840325272,-52.66,4
06:10,853907490.0,7525.951718598241,-20.26,2
06:10,117308635.0,2111.546355669448,-42.29,7
06:14,802697323.0,15904.698313397052,-42.47,9
06:20,383833857.0,25779.87025559795,-17.0,9
06:20,541639148.0,3927.661910893336,-0.02,5
06:25,820686957.0,-1197.706066311196,-29.93,9
06:25,169006407.0,11310.361779937108,-16.12,5
06:26,216285378.0,24329.541113528416,-9.56,2
06:27,785749304.0,8365.26166386293,-3.76,5
06:27,511179916.0,7148.177911379403,-24.88,2
06:29,480557476.0,11078.01923070521,-48.5,5
06:29,885259672.0,2727.4811645023374,-4.7,7
06:30,851181128.0,4345.635633256564,-5.01,2
06:30,609939116.0,6952.1619455932105,-37.94,2
06:32,842682241.0,3422.46230124788,-14.09,7
06:35,873693307.0,10116.771953347536,-23.33,7
06:37,836110591.0,2709.7142149245806,-37.78,9
06:40,348325817.0,8710.364425876665,-21.08,5
06:40,414805878.0,12617.852235126116,-5.19,2
06:41,700138124.0,4172.877986915363,-18.44,7
06:41,550169791.0,22308.18514800541,-1.86,7
06:43,633345190.0,5569.06165692561,-32.55,9
06:45,196289502.0,16028.80664082453,-21.3,9
06:47,673025413.0,638.6011090334484,-1.03,7
06:49,752362502.0,5907.12558159811,-0.42,7
06:49,366550080.0,25605.73886099047,-34.22,7
06:50,255814263.0,1406.9152534884615,-27.92,9
06:51,572384506.0,6812.56059240621,-34.12,9
06:52,670102069.0,-200.66345192390787,-36.34,9
06:52,575652395.0,716.9086551224666,-26.96,7
06:53,683319988.0,6510.469212353086,-35.54,8
06:53,108931112.0,14247.143206981687,-37.67,9
06:54,532478725.0,4033.952438934851,-9.92,2
06:55,657139925.0,13435.902885969996,-10.64,9
07:00,558119802.0,33829.71914648773,-3.56,5
07:03,298000165.0,26559.044462688755,-12.17,7
07:04,986267641.0,4020.3093947616217,-22.03,7
07:05,221868392.0,4439.095183036252,-7.62,2
07:09,779946617.0,16907.039384275315,-5.49,5
07:10,886921642.0,2951.5377375676776,-32.93,2
07:10,679911053.0,2215.3614155173714,-46.79,2
07:11,749378808.0,1406.316854846962,-7.9,2
07:13,520447032.0,7788.38722228947,-35.5,5
07:16,183888402.0,19072.32245714014,-40.19,9
07:17,994214354.0,9441.051913986086,-31.89,9
07:18,170637730.0,874.7596396332116,-29.83,7
07:19,383833857.0,25778.709531262382,-1.16,5
07:20,586315521.0,12305.223496985876,-30.19,7
07:22,769311479.0,6140.613317718409,-7.93,7
07:22,200080192.0,9320.748973294849,-15.94,7
07:22,987163717.0,3543.350223888187,-34.09,9
07:26,899742927.0,12940.07572578883,-27.77,5
07:32,859603181.0,2615.313453873411,-12.43,5
07:36,315546581.0,29435.2955662892,-37.98,5
07:37,151968462.0,6730.522301883049,-8.78,7
07:37,556992209.0,10589.300340095346,-4.04,5
07:38,940569402.0,4060.84268532059,-12.98,2
07:39,120634201.0,4850.9563490578685,-17.95,9
07:39,285873880.0,12718.1745078172,-31.45,8
07:42,143003091.0,10349.49561353962,-3.03,8
07:44,655368335.0,3780.584441032311,-34.17,2
07:47,687135796.0,28802.074332230382,-37.09,2
07:50,108481285.0,8851.83676478423,-0.51,7
07:52,688712152.0,6701.034893890441,-73.95,5
07:56,549414742.0,6607.589054959903,-36.17,9
07:59,527842638.0,111.6862426329834,-5.4,9
08:03,994214354.0,9437.379081936882,-3.67,7
08:07,280200287.0,164.61204661305104,-6.1,9
08:07,145387690.0,4339.429107335295,-18.89,2
08:07,399538448.0,7451.374755487446,-5.7,9
08:09,970298834.0,2079.085442136821,-27.7,2
08:10,421881811.0,1949.7036871097011,-37.94,8
08:14,534204159.0,5158.794297156285,-48.6,7
08:23,124102251.0,1606.3904474591618,-24.52,2
08:24,331450202.0,7460.263154393408,-12.69,4
08:25,546760202.0,-2005.753027675968,-18.57,5
08:26,245690309.0,9679.680800498105,-10.21,5
08:27,549414742.0,6577.276579465571,-30.31,5
08:28,446720287.0,-2028.9775591815944,-26.51,5
08:31,291128777.0,-2846.2714405263687,-33.57,5
08:33,424397946.0,-1181.9302163945997,-114.74,5
08:34,331048953.0,-235.51363202150637,-77.03,5
08:37,204855464.0,-1170.4082386396162,-177.22,5
08:40,494156986.0,-672.2709543276653,-85.8,5
08:43,496395938.0,12169.853415032872,-117.75,5
08:44,364357875.0,7598.001705608457,-0.98,8
08:45,986267641.0,3952.9413947616217,-67.37,5
08:45,256045540.0,-3804.2163999999993,-42.26,5
08:45,370521542.0,27189.316929365967,-4.37,5
08:46,478412511.0,12208.60907019746,-170.35,5
08:47,482513594.0,5188.171616612692,-25.17,5
08:48,766692943.0,-2152.25675,-48.54,5
08:51,924045955.0,-154.94855734133512,-46.35,5
08:56,806358207.0,11077.031806148556,-64.81,5
08:56,786879739.0,-2513.5507941205565,-49.23,5
08:56,124125096.0,-120.48740561219802,-162.29,5
08:57,282837512.0,13708.827367071355,-9.51,7
08:57,832564361.0,15452.049331464244,-48.69,5
08:57,534325901.0,6644.534631540623,-16.44,9
08:58,832564361.0,15423.554155367174,-28.5,7
08:58,494156462.0,-1321.7829864817602,-55.4,5
09:01,478986718.0,-1214.7108000000014,-61.02,5
09:04,920031185.0,-193.18617051629224,-124.99,5
09:06,491392945.0,5372.4535000000105,-52.58,5
09:07,395284483.0,717.222340211308,-109.33,5
09:07,163470640.0,800.3585999999995,-82.94,5
09:08,493855007.0,-2804.5866315743915,-33.72,5
09:08,668175891.0,363.8829160732621,-30.92,5
09:10,678330503.0,795.7980399041003,-22.74,5
09:11,259015404.0,7.624825496342821,-4.18,2
09:12,815993333.0,5832.4012771008765,-27.41,7
09:13,195895574.0,6732.519469798766,-85.3,5
09:14,108563213.0,23111.502527844452,-36.96,5
09:14,613729471.0,7713.533783837311,-7.8,9
09:14,383833857.0,25773.00953126238,-5.7,9
09:15,286484726.0,429.2536391525708,-12.99,2
09:16,975345315.0,36185.36775530997,-199.98,2
09:17,960208650.0,14373.960001737538,-13.27,5
09:17,500051919.0,794.3909966505901,-17.97,7
09:18,200080192.0,9219.478973294848,-101.27,2
09:20,538003940.0,1946.7100000000105,-29.96,7
09:21,644751433.0,-1683.3106584655384,-22.56,5
09:21,943829984.0,-544.604190886543,-57.08,5
09:22,886837068.0,861.4755999999993,-44.98,4
09:23,138609932.0,2167.770003294586,-16.5,4
09:23,188263947.0,-94.37599999999938,-22.0,2
09:25,601627384.0,2912.4639594430446,-27.61,2
09:25,421881811.0,1925.303687109701,-24.4,4
09:26,215311171.0,6042.501335553916,-47.99,2
09:30,214339619.0,221.1107785105091,-65.48,5
09:31,971010829.0,140.07505644424512,-33.96,7
09:31,435984758.0,3836.791791300509,-2.07,2
09:31,229205098.0,7229.457504869278,-17.4,7
09:34,876890798.0,2973.2078706999337,-21.97,1
09:35,264550521.0,4746.254322771491,-21.14,7
09:35,534325901.0,6641.342088638517,-3.19,4
09:35,122884111.0,-813.8360830729687,-26.68,5
09:35,824916823.0,8115.137498363471,-5.71,7
09:37,574548998.0,-630.164950000001,-118.74,5
09:38,518474507.0,13339.111528072825,-59.54,5
09:39,994214354.0,9396.688371936883,-40.69,4
09:39,703588001.0,-435.75870000000054,-90.87,5
09:40,923322792.0,-1022.8643317536375,-37.78,5
09:42,450896297.0,13124.057779829756,-11.18,5
09:42,506618547.0,14402.372395257858,-56.65,2
09:43,698955014.0,95.09163020319671,-19.99,4
09:44,131388684.0,21784.189071864646,-58.71,2
09:44,108481285.0,8716.716764784229,-135.12,2
09:45,672913754.0,11710.860603809038,-65.77,5
09:45,951817450.0,9018.038707498976,-13.61,7
09:48,836110591.0,2701.8442149245807,-7.87,4
09:50,221868392.0,4427.665183036252,-11.43,4
09:50,588565416.0,5653.916258483269,-23.09,8
09:51,235881534.0,12553.644859989156,-6.4,8
09:51,663479159.0,4745.871541827712,-9.99,1
09:52,949032480.0,3118.420328329115,-62.21,2
09:53,979892433.0,-1565.965000000001,-54.61,5
09:54,857754342.0,263.2118880227201,-34.99,2
09:58,833899961.0,1115.1922957180095,-16.94,5
09:59,113747882.0,11809.038867858471,-25.92,4
09:59,480198977.0,12294.603032593252,-46.93,7
10:04,836110591.0,2694.0341429904342,-7.81,7
10:05,688712152.0,6691.044893890441,-9.99,1
10:05,534325901.0,6481.042088638517,-160.3,2
10:05,237493332.0,14463.156158002334,-30.09,5
10:05,986267641.0,3869.3713947616216,-83.57,2
10:07,531186970.0,4720.850385298425,-87.97,2
10:09,558875206.0,3005.480539399781,-31.99,2
10:09,237493332.0,14457.38906480242,-5.77,8
10:09,280990953.0,695.3996999999982,-36.97,4
10:10,806358207.0,11070.598246148556,-6.43,4
10:12,131388684.0,21746.431071864645,-37.76,5
10:15,586315521.0,12253.605496985874,-51.62,5
10:15,587202562.0,-64.95510058293156,-145.08,5
10:17,891716230.0,-21.780073298135733,-249.97,2
10:18,425964226.0,3964.090764114708,-5.0,7
10:18,949032480.0,3091.630328329115,-26.79,7
10:19,762859681.0,1465.6185999999989,-20.95,4
10:20,713641917.0,895.9388459567871,-43.21,7
10:21,690523499.0,110.76120000000016,-3.99,7
10:21,897714622.0,9060.894701100042,-59.53,2
10:22,322720763.0,6586.580592500612,-14.98,4
10:22,690958123.0,20579.02401210514,-35.03,2
10:22,130154096.0,551.1411481961065,-26.98,4
10:23,187111705.0,6581.961326022203,-23.3,7
10:24,242218612.0,-145.2511999999994,-34.99,2
10:27,586315521.0,12222.185496985874,-31.42,7
10:28,297823329.0,512.4861499999992,-68.48,2
10:28,940569402.0,4031.27268532059,-29.57,1
10:29,703537476.0,750.4502499999992,-66.07,2
10:29,833899961.0,1015.6922957180096,-99.5,2
10:30,331450202.0,7420.303154393408,-39.96,7
10:30,987656636.0,3899.428162229085,-1.34,4
10:33,503575533.0,7756.56059214172,-107.09,2
10:34,245690309.0,9652.017455990574,-27.66,4
10:34,767447966.0,4681.130042706573,-11.53,4
10:35,534325901.0,6178.642088638518,-302.4,2
10:35,549414742.0,6549.9765794655705,-27.3,4
10:35,844835978.0,10170.67362306578,-46.05,5
10:36,466649401.0,96.43014355208746,-38.5,4
10:37,667367404.0,9029.577827855235,-57.19,2
10:37,653640811.0,17633.555815844844,-23.99,1
10:39,822135975.0,11233.984040667738,-5.62,4
10:40,551196328.0,4329.117890225607,-20.97,7
10:40,355733816.0,5288.976383850865,-96.59,2
10:42,874431242.0,8668.40111159522,-6.14,2
10:44,405945930.0,2934.330813675409,-9.99,7
10:47,503575533.0,7633.38859214172,-123.17,2
10:50,143061865.0,6523.936413139575,-33.47,8
10:50,558875206.0,2994.500539399781,-10.98,1
10:51,348525881.0,815.5216245949358,-4.99,1
10:52,668692488.0,278.4142410575843,-59.98,4
10:54,449871732.0,7546.743505793859,-113.97,2
10:54,767447966.0,4605.980042706573,-75.15,2
10:56,315078351.0,8113.749694272875,-51.6,4
10:58,833899961.0,909.1922957180096,-106.5,2
11:00,162162212.0,-392.674256672691,-82.07,5
11:01,549414742.0,6500.9765794655705,-49.0,7
11:01,500051919.0,634.41099665059,-159.98,2
11:02,388862238.0,1460.0642088728068,-9.99,4
11:03,117273481.0,8839.188698798242,-24.97,7
11:04,408057540.0,4684.069332092719,-31.88,7
11:05,322720763.0,6581.131842574031,-5.45,7
11:06,973086490.0,9953.805838880557,-135.54,2
11:10,449871732.0,7539.753505793859,-6.99,1
11:12,454356905.0,1094.523961183157,-71.1,4
11:18,355733816.0,5235.104383850865,-53.87,2
11:18,549414742.0,6328.790579465571,-172.19,2
11:28,833899961.0,671.6922957180095,-237.5,2
11:34,308897841.0,1104.8324999999988,-47.18,5
11:36,355733816.0,5086.732383850865,-148.37,2
11:38,851181128.0,4338.099753256563,-7.54,4
11:42,627917561.0,3871.485050000006,-55.97,2
11:44,429556122.0,4416.331942175412,-50.45,2
11:45,405945930.0,2896.350813675409,-37.98,2
11:47,736340277.0,8521.780447390533,-90.3,2
11:48,506618547.0,14322.422395257858,-79.95,2
11:48,489964679.0,20152.308540005368,-57.16,4
11:50,833899961.0,553.6922957180095,-118.0,2
11:50,315546581.0,29411.2155662892,-24.08,4
11:54,503575533.0,7480.80259214172,-152.59,2
11:55,549414742.0,6199.304579465571,-129.49,2
12:01,386729293.0,31489.229984397633,-49.99,2
12:03,261793952.0,-856.505739796185,-30.48,9
12:04,215426302.0,10.250404025691916,-14.99,9
12:05,187541224.0,1130.302278302845,-30.7,7
12:06,749378808.0,1379.3768548469618,-26.94,9
12:06,792845450.0,583.0811500000008,-19.99,4
12:08,348325817.0,8677.236905876665,-33.13,4
12:10,903953091.0,2815.6707901345735,-165.52,5
12:12,555393405.0,-920.8528000000002,-26.63,9
12:13,121858569.0,231.40115000000236,-39.3,9
12:13,785210466.0,1736.5022969465592,-16.98,1
12:21,520447032.0,7748.957222289469,-39.43,9
12:21,704517789.0,18240.86472148628,-11.13,1
12:21,270374623.0,9314.01016241019,-13.49,9
12:22,549414742.0,6147.518579465571,-51.79,2
12:23,409971170.0,2546.0311548340796,-1.1,4
12:23,503575533.0,7299.54459214172,-181.26,2
12:27,874431242.0,8651.383431595219,-17.02,4
12:34,538003940.0,1911.7800000000104,-34.93,4
12:37,925659248.0,-894.3420892295711,-32.92,9
12:39,213112754.0,5336.723079189582,-7.66,5
12:41,503575533.0,7114.086592141721,-185.46,2
12:41,297823329.0,388.9861499999992,-123.5,2
12:43,355733816.0,4935.560383850865,-151.17,2
12:44,696758548.0,-3656.0678963201367,-21.95,5
12:45,310375875.0,917.353986946868,-23.96,9
12:47,711045550.0,2053.8143500000037,-28.19,9
12:48,647936800.0,2202.3911715259505,-21.65,9
12:50,878989510.0,4893.211467815367,-20.62,2
12:50,285428103.0,10070.343808161066,-36.11,5
12:51,704517789.0,18129.56472148628,-111.3,2
12:52,532478725.0,3999.862438934851,-34.09,9
12:53,626989363.0,459.6217633173751,-84.98,2
12:54,549414742.0,6139.13257946557,-8.39,2
12:54,134847904.0,4839.57198347907,-74.85,4
12:57,815993333.0,5601.4012771008765,-231.0,4
13:01,386277162.0,167.80999999999935,-44.99,2
13:02,990461108.0,40.316518620611035,-27.73,9
13:03,506618547.0,14305.242395257856,-17.18,7
13:03,833899961.0,384.1922957180095,-169.5,4
13:03,355733816.0,4850.8883838508655,-84.67,2
13:04,503575533.0,7013.300592141721,-100.79,2
13:06,469561218.0,-304.6543500000009,-98.23,5
13:08,950234174.0,-169.52916249188155,-35.6,7
13:09,585625048.0,1783.3639749993577,-8.3,9
13:10,704517789.0,18049.06472148628,-80.5,2
13:10,187111705.0,6576.3113260222035,-5.65,9
13:10,246753533.0,143.84049999999834,-27.24,5
13:11,564214408.0,-245.354215274274,-38.26,5
13:12,993663752.0,-727.5835575896036,-94.88,5
13:12,535804582.0,622.0410499999987,-54.99,2
13:13,853907490.0,7475.495718598241,-50.46,5
13:13,297823329.0,290.00614999999914,-98.98,2
13:19,503575533.0,6862.842592141721,-150.46,2
13:19,704517789.0,17870.56472148628,-178.5,2
13:20,297823329.0,262.5261499999991,-27.48,2
13:21,833899961.0,274.6922957180095,-109.5,7
13:22,340321732.0,1526.5987500000035,-5.0,9
13:22,549414742.0,6061.446579465571,-77.69,2
13:23,166019891.0,8145.832344712451,-6.25,4
13:23,349107386.0,-3743.940973194561,-45.4,5
13:25,291580432.0,-256.60804999999965,-135.54,5
13:28,570323670.0,3006.9764915689693,-59.84,2
13:28,229205098.0,7182.5836114445465,-46.87,2
13:30,315078351.0,8099.087430410292,-14.66,7
13:33,887853850.0,10091.439522739882,-1.97,2
13:35,833899961.0,214.69229571800952,-60.0,7
13:35,534325901.0,6098.142088638518,-80.5,2
13:37,297823329.0,190.5361499999991,-71.99,2
13:37,625281433.0,-1046.8700073707569,-126.14,5
13:37,108563213.0,23034.684527844453,-76.82,5
13:37,558119802.0,33813.729146487734,-15.99,9
13:40,704517789.0,17590.56472148628,-280.0,2
13:48,421475159.0,-574.4247373255874,-119.17,5
13:54,355733816.0,4632.488383850866,-218.4,2
13:58,653640811.0,17604.824432581812,-28.73,2
13:59,683078800.0,1425.30159157638,-101.47,5
14:00,549414742.0,5990.046579465571,-71.4,2
14:00,254853117.0,2777.8485523361187,-3.79,8
14:02,155317149.0,169.99479999999903,-41.86,5
14:04,534325901.0,5909.842088638517,-188.3,2
14:05,736340277.0,8445.508447390532,-76.27,2
14:05,833899961.0,61.19229571800952,-153.5,4
14:12,500051919.0,571.43099665059,-62.98,2
14:17,833899961.0,-87.30770428199048,-148.5,7
14:25,736340277.0,8386.708447390532,-58.8,2
14:28,344219145.0,8113.903645759402,-105.85,5
14:30,512989907.0,-2061.9944039753655,-26.68,5
14:31,978951113.0,-948.5531425904192,-173.56,5
14:31,435984758.0,3741.829791300509,-94.96,5
14:32,785749304.0,8315.311663862929,-49.95,2
14:33,549414742.0,5953.646579465571,-36.4,2
14:44,489964679.0,20112.388433404107,-39.92,5
14:45,699997811.0,721.2490000000038,-77.11,5
14:54,903953091.0,2797.7007901345737,-17.97,7
15:08,287480331.0,7076.660038049705,-55.92,2
15:10,871866387.0,112.57429999999913,-32.29,5
15:33,548907062.0,434.8765387682884,-5.99,2
15:36,454356905.0,1083.8242496697662,-10.7,5
15:45,548907062.0,393.8865387682884,-40.99,2
15:56,736340277.0,8294.322447390532,-92.39,2
15:57,199016328.0,4584.1410350990745,-63.71,2
16:16,233981231.0,2107.210722724169,-38.34,2
16:18,376271050.0,1443.9902261784878,-11.49,4
16:21,736340277.0,8211.722447390532,-82.6,2
16:21,373163757.0,11263.43109058372,-20.78,7
16:23,180616589.0,861.3808282361094,-14.49,9
16:23,587225252.0,5203.900102665044,-31.84,9
16:24,941285623.0,506.7563990667703,-54.1,5
16:30,736340277.0,8191.822447390532,-19.9,9
16:38,738958551.0,8644.35518682623,-39.13,9
16:43,851649498.0,8030.203156164611,-42.14,7
16:45,444428189.0,2262.792200000002,-38.95,7
16:46,376271050.0,1442.485681627471,-1.5,2
16:49,769311479.0,6134.523317718409,-6.09,1
16:49,486495235.0,1497.869910076207,-10.92,7
16:55,964702094.0,336.81091865159385,-9.99,2
16:59,444428189.0,2192.8022000000024,-69.99,2
17:06,475277431.0,1059.318136943619,-16.97,7
17:07,180616589.0,809.3908282361094,-51.99,2
17:19,256002321.0,5967.2154320217505,-10.49,9
17:28,373163757.0,11249.44109058372,-13.99,1
17:29,984783496.0,14224.11195692549,-9.17,8
17:40,308505160.0,13198.772030620588,-24.41,4
17:44,736340277.0,8026.622447390532,-165.2,2
17:48,475117511.0,6819.826362956873,-41.48,7
17:51,198946608.0,3996.344945979047,-14.02,7
17:58,919185264.0,3830.562701697937,-28.96,7
18:00,462962606.0,684.1900499999987,-50.1,6
18:01,925037906.0,1401.6968000000013,-56.25,2
18:07,809499628.0,17517.401023182716,-66.75,2
18:09,736340277.0,7846.050447390532,-180.57,2
18:09,474951915.0,-2704.8560952340113,-23.92,5
18:14,399144202.0,1211.2236109982562,-4.25,8
18:19,925037906.0,1367.9468000000013,-33.75,2
18:20,867987292.0,1419.8676820604471,-20.32,8
18:20,399144202.0,1179.783610998256,-31.44,9
18:24,252760664.0,6376.890662629467,-12.89,2
18:25,736340277.0,7832.813804982734,-13.24,8
18:26,675806859.0,7059.298976284563,-8.54,8
18:27,687135796.0,28795.754332230383,-6.32,7
18:29,886921642.0,2909.7197375676774,-41.82,5
18:31,925037906.0,1291.4468000000013,-76.5,2
18:40,520418719.0,441.1863500000036,-41.75,9
18:41,461029994.0,7794.392239540953,-14.99,7
18:42,713910252.0,-1428.949674271459,-55.0,5
18:44,932820758.0,-2717.0840667755538,-12.21,5
18:48,583558311.0,-983.8272152486676,-132.55,5
18:53,901432314.0,3226.5199821993215,-1.8,8
18:54,296770890.0,247.72301037908312,-55.59,5
18:57,120634201.0,4834.856349057868,-16.1,7
18:58,610450243.0,-750.1195999999998,-39.48,5
18:58,120634201.0,4826.787997814722,-8.07,5
18:59,964702094.0,317.1617425992495,-19.65,8
19:02,551755686.0,6838.969926654151,-69.05,5
19:06,925037906.0,1257.6968000000013,-33.75,2
19:13,547010927.0,24161.81932856227,-21.4,9
19:17,170637730.0,821.1816396332116,-53.58,5
19:26,215311171.0,6026.471335553916,-16.03,9
19:40,654329190.0,-792.8252990514808,-55.16,5
19:47,687135796.0,28785.054332230386,-10.7,9
19:55,336557504.0,902.9443333178853,-89.08,5
20:21,865748375.0,2082.0689072030823,-9.19,7
20:23,137822385.0,3454.037253161884,-15.18,5
20:40,280268430.0,4591.626962685003,-15.95,5
20:47,518474507.0,13252.486528072825,-86.62,5
20:48,370521542.0,27181.816929365967,-7.5,9
20:48,996042490.0,5809.359212641911,-4.23,8
21:18,284905540.0,8134.222701943602,-47.44,2
21:46,392270893.0,13156.279016145652,-7.34,5
00:13,414454079.0,-28.961149999998504,-30.79,9
00:23,873693307.0,10100.831953347535,-15.94,9
00:34,853907490.0,7473.617733184357,-1.88,2
00:40,113747882.0,11767.898867858472,-41.14,9
00:43,719586818.0,18685.894210419476,-7.26,5
00:44,940569402.0,4011.53268532059,-19.74,9
00:51,887853850.0,10078.301861630256,-13.14,7
00:51,324224854.0,4111.263471408905,-29.81,7
00:52,806358207.0,11054.256601087867,-16.34,2
00:54,534204159.0,5134.314297156286,-24.48,9
00:55,858989281.0,26788.07753329554,-6.99,9
01:01,885259672.0,2714.448353965992,-13.03,8
01:02,264550521.0,4745.294005415559,-0.96,8
01:04,802697323.0,15873.968313397054,-30.73,9
01:11,473820682.0,11166.86261776507,-7.07,5
01:11,910730524.0,7700.188951730442,-20.83,2
01:12,601627384.0,2873.1139594430447,-39.35,9
01:18,873693307.0,10096.04116995355,-4.79,7
01:20,541639148.0,3903.331910893336,-24.33,9
01:21,169006407.0,11274.383822944406,-35.98,8
01:32,905860285.0,10389.129693579474,-7.89,8
01:33,282837512.0,13708.231371041698,-0.6,5
01:37,534325901.0,5892.392088638518,-17.45,9
01:38,815385232.0,10247.439352811069,-3.08,5
01:39,282837512.0,13678.151371041698,-30.08,9
01:46,704517789.0,17567.029648817694,-23.54,7
01:53,987163717.0,3511.710223888187,-31.64,9
01:58,506618547.0,14303.659013131188,-1.58,5
02:00,435984758.0,3696.6723390638144,-45.16,5
02:19,541639148.0,3900.560083577112,-2.77,4
02:21,970298834.0,2030.610693579846,-48.47,5
02:21,145387690.0,4308.037031097134,-31.39,2
02:23,290818242.0,6827.329671125003,-60.91,7
02:23,858989281.0,26743.563742568364,-44.51,5
02:28,134461671.0,5188.663128613624,-11.13,5
02:33,113747882.0,11755.55364372864,-12.35,7
02:33,705848712.0,27415.437389476578,-15.23,9
02:36,187541224.0,1084.712278302845,-45.59,9
02:36,822135975.0,11176.582610530224,-57.4,7
02:38,270374623.0,9284.14483654399,-29.87,2
02:43,131388684.0,21737.152758983582,-9.28,8
02:46,575652395.0,714.110883894376,-2.8,8
02:52,471897866.0,6650.758919122986,-26.71,2
02:53,832564361.0,15404.750901148347,-18.8,2
02:53,510101371.0,12193.84699133331,-42.57,9
02:54,554792076.0,28907.052785132702,-26.08,7
03:00,940569402.0,4009.8725065223352,-1.66,2
03:03,146909202.0,3158.7590300385355,-18.57,7
03:03,417850087.0,15285.190712299012,-34.29,2
03:04,613729471.0,7687.899737842735,-25.63,2
03:04,738958551.0,8606.44518682623,-37.91,9
03:07,949032480.0,3084.1763945191365,-7.45,7
03:09,851181128.0,4311.859753256564,-26.24,9
03:12,836110591.0,2656.3041429904342,-37.73,9
03:13,183888402.0,19031.02245714014,-41.3,9
03:14,992204045.0,6881.419010549831,-4.51,2
03:16,511179916.0,7135.153258804467,-13.02,8
03:23,214339619.0,218.88766416988753,-2.22,8
03:25,534204159.0,5062.888115621908,-71.43,7
03:28,604288474.0,1255.3285937263606,-11.66,2
03:28,730002588.0,13595.034773195186,-4.25,2
03:30,657139925.0,13419.902885969996,-16.0,9
03:30,108931112.0,14206.053206981687,-41.09,9
03:32,532478725.0,3962.022438934851,-37.84,9
03:35,200080192.0,9217.95899716734,-1.52,2
03:38,305778936.0,10053.325898880805,-25.89,2
03:38,433917275.0,6895.684347501093,-35.89,9
03:39,129018172.0,9676.10946802586,-16.23,5
03:43,647936800.0,2194.026077380845,-8.37,2
03:43,587225252.0,5173.670102665044,-30.23,9
03:45,522188082.0,6763.180540824913,-15.28,4
03:45,809499628.0,17500.501023182715,-16.9,9
03:47,586315521.0,12218.472773928464,-3.71,2
03:47,987229118.0,302.02974770089605,-27.72,7
03:49,795847804.0,23852.625581946497,-25.63,8
03:49,678851253.0,3096.650971089477,-39.67,2
03:52,179173981.0,3600.003593565505,-33.43,9
03:53,187111705.0,6561.931326022203,-14.38,9
03:57,874431242.0,8624.24343159522,-27.14,9
04:00,124102251.0,1591.61127931773,-14.78,8
04:03,216285378.0,24299.201113528416,-30.34,9
04:04,496395938.0,12142.37892936801,-27.47,2
04:06,887853850.0,10044.811861630256,-33.49,9
04:07,414805878.0,12580.622235126117,-37.23,9
04:07,461990622.0,7106.474826080365,-1.17,2
04:07,482513594.0,5183.631924699128,-4.54,7
04:10,196289502.0,16007.10664082453,-21.7,9
04:13,322221939.0,3202.6323478088493,-68.48,5
04:13,581655972.0,41235.25792083927,-33.77,7
04:14,618138606.0,1132.1933032642874,-55.52,5
04:15,229205098.0,7166.825331011941,-15.76,2
04:28,221868392.0,4375.794126718636,-51.87,5
04:28,547010927.0,24142.62932856227,-19.19,9
04:29,187111705.0,6536.481524842555,-25.45,2
04:29,480557476.0,11075.0700373232,-2.95,7
04:30,179173981.0,3572.270377368542,-27.73,7
04:34,256002321.0,5948.36543202175,-18.85,9
04:34,667367404.0,9006.036107491029,-23.54,7
04:38,639409800.0,36534.090131919744,-1.43,5
04:40,709608057.0,2096.826765502519,-39.12,9
04:43,510101371.0,12153.269265770225,-40.58,2
04:44,950234174.0,-236.9241807628404,-67.4,4
04:44,532478725.0,3944.2007983140734,-17.82,5
04:47,348325817.0,8639.036905876665,-38.2,9
04:47,987656636.0,3883.577275450066,-15.85,7
04:47,588565416.0,5651.486772050563,-2.43,7
04:48,700138124.0,4153.186646820614,-19.69,7
04:51,237684254.0,5657.144819130804,-8.93,5
04:52,859603181.0,2586.533453873411,-28.78,9
04:53,550169791.0,22295.93514800541,-12.25,9
04:58,687135796.0,28767.15433223038,-17.9,9
04:59,973086490.0,9943.105838880554,-10.7,9
05:00,985188462.0,-271.9136112887752,-29.47,9
05:01,441274121.0,12150.250588475978,-14.99,9
05:04,718058208.0,1684.494390377968,-7.31,4
05:04,678330503.0,780.3774119909469,-15.42,7
05:08,623156843.0,4442.624763710315,-3.53,5
05:08,310375875.0,887.853986946868,-29.5,9
05:09,836110591.0,2646.114194593359,-10.19,8
05:09,519644021.0,2470.632126744185,-13.85,7
05:11,824916823.0,8093.130768214593,-22.01,5
05:11,540159353.0,10768.080644432086,-75.68,5
05:13,670102069.0,-237.34345192390788,-36.68,9
05:24,651756497.0,14397.972731026051,-14.88,2
05:31,120634201.0,4802.8479978147225,-23.94,9
05:37,259015404.0,-19.60517450365718,-27.23,9
05:41,698955014.0,61.29163020319672,-33.8,9
05:41,851649498.0,8026.375428588091,-3.83,7
05:46,679662108.0,16295.464321205887,-71.44,7
05:47,383833857.0,25763.539503794585,-9.47,5
05:47,779946617.0,16845.589757429443,-61.45,4
05:49,727417797.0,5634.967166576052,-5.85,7
05:51,331450202.0,7380.652131660724,-39.65,5
05:52,198946608.0,3977.749733716661,-18.6,2
05:53,419550103.0,18966.95432756233,-18.18,2
05:54,518474507.0,13236.811359570254,-15.68,2
05:55,108563213.0,23020.84592416136,-13.84,5
05:55,572384506.0,6780.00059240621,-32.56,9
06:02,960208650.0,14367.383008618755,-6.58,5
06:04,170637730.0,820.2703050965463,-0.91,5
06:05,687135796.0,28748.108510675254,-19.05,5
06:05,280268430.0,4577.308280713835,-14.32,7
06:08,259015404.0,-94.4750077284472,-74.87,7
06:11,973086490.0,9902.3014654786,-40.8,5
06:12,308505160.0,13178.087265622247,-20.68,7
06:13,366550080.0,25600.458020256898,-5.28,7
06:17,766941757.0,2049.016308884677,-28.43,9
06:18,151968462.0,6726.608393190115,-3.91,2
06:21,256002321.0,5889.468698715715,-58.9,2
06:21,558119802.0,33763.59285876453,-50.14,2
06:22,128033695.0,1760.9185980169746,-43.86,7
06:26,901432314.0,3213.7333063330516,-12.79,5
06:30,815993333.0,5568.7870836257,-32.61,2
06:32,520447032.0,7689.958158115403,-59.0,2
06:34,912705941.0,18919.31522988358,-31.55,7
06:36,897592348.0,15709.83100613928,-18.97,4
06:37,752362502.0,5865.2067339540945,-41.92,2
06:38,213112754.0,5319.823079189582,-16.9,9
06:42,779236304.0,1100.5575954795338,-19.45,9
06:43,769311479.0,6086.9617299369975,-47.56,8
06:51,986267641.0,3814.60024549982,-54.77,5
06:55,683319988.0,6466.5566400783255,-43.91,7
06:57,706250160.0,12501.030201188709,-7.66,4
06:59,994214354.0,9354.208371936884,-42.48,9
07:01,245690309.0,9631.770491429605,-20.25,4
07:03,287480331.0,7060.663615493616,-16.0,8
07:04,601627384.0,2811.8821962266466,-61.23,7
07:05,785749304.0,8242.733400256415,-72.58,2
07:05,550169791.0,22295.423614934694,-0.51,2
07:05,809499628.0,17493.809464698395,-6.69,5
07:07,749378808.0,1378.8491626497278,-0.53,2
07:14,399538448.0,7446.342173250001,-5.03,7
07:14,899742927.0,12915.472209034886,-24.6,7
07:16,421881811.0,1923.6525862389456,-1.65,8
07:17,548907062.0,388.8874864260272,-5.0,7
07:17,668329719.0,8676.037476469292,-6.57,2
07:22,252760664.0,6329.261808049666,-47.63,8
07:27,851181128.0,4310.237774890442,-1.62,2
07:31,489964679.0,20073.148433404105,-39.24,9
07:40,310375875.0,886.5935460123892,-1.26,5
07:42,450896297.0,13121.425039093676,-2.63,5
07:43,609939116.0,6948.564024633522,-3.6,7
07:52,322720763.0,6580.01757170804,-1.11,7
07:57,738958551.0,8585.430409991961,-21.01,4
07:57,215311171.0,6011.502060937451,-14.97,4
07:58,930277104.0,8816.365238350036,-16.75,4
08:01,213112754.0,5259.775257246753,-60.05,4
08:03,842682241.0,3380.0168944526995,-42.45,5
08:07,383625050.0,2583.6075909762235,-6.0,2
08:10,675806859.0,7002.314911524416,-56.98,4
08:21,433917275.0,6887.9617248295945,-7.72,5
08:22,822250278.0,6171.984700540702,-20.15,8
08:34,235881534.0,12529.44859826786,-24.2,8
08:34,373163757.0,11214.222782079334,-35.22,2
08:37,547010927.0,24097.631139145957,-45.0,2
08:42,633345190.0,5527.110075949659,-41.95,5
08:42,549414742.0,5908.5294052896625,-45.12,7
08:47,117273481.0,8799.301038702899,-39.89,2
08:49,570323670.0,2975.0788273877074,-31.9,8
08:50,108481285.0,8712.865693143738,-3.85,2
08:57,897714622.0,9015.679033797373,-45.22,5
09:17,873701090.0,13.25834680371824,-0.71,7
09:17,361201224.0,3054.6294746538024,-6.01,7
09:18,819515373.0,2236.3178360637935,-12.98,7
09:28,429556122.0,4340.199042155833,-76.13,7
09:28,727417797.0,5609.997166576051,-24.97,7
09:29,355733816.0,4599.528383850866,-32.96,7
09:29,758160963.0,7126.32748085467,-20.18,1
09:31,909676212.0,-93.29546821238688,-35.96,1
09:31,540159353.0,10754.100644432086,-13.98,1
09:31,835736339.0,1995.7060696909384,-51.58,4
09:32,449871732.0,7478.2095057938595,-61.54,2
09:38,200080192.0,9145.90099716734,-72.06,7
09:42,496395938.0,12131.32892936801,-11.05,7
09:44,280098744.0,2078.7313778716666,-142.79,2
09:45,752362502.0,5855.136733954095,-10.07,7
09:46,891716230.0,-36.770073298135735,-14.99,4
09:48,472995101.0,1076.4446840990838,-11.98,4
09:56,532478725.0,3916.3407983140737,-27.86,1
09:58,225210798.0,279.6949351225794,-19.99,4
10:00,237493332.0,14435.299992960538,-22.09,2
10:03,280098744.0,1977.9453778716663,-100.79,2
10:04,435984758.0,3695.1562990638145,-1.52,4
10:04,134847904.0,4807.6019834790695,-31.97,4
10:05,215311171.0,5893.90206093745,-117.6,2
10:05,449871732.0,7252.837505793859,-225.37,2
10:12,939972497.0,775.2291086000105,-6.99,4
10:15,492215823.0,2302.5742238154444,-32.88,1
10:15,416060965.0,44.18225470058025,-5.99,2
10:16,280098744.0,1967.9553778716663,-9.99,4
10:16,535804582.0,613.0610499999987,-8.98,4
10:18,131388684.0,21627.992758983582,-109.16,2
10:18,134461671.0,5090.483128613624,-98.18,2
10:19,403765849.0,-2588.4454999999966,-14.46,5
10:20,373163757.0,11032.222782079334,-182.0,2
10:20,321372947.0,-548.5275507890995,-27.37,5
10:21,500043411.0,13479.222971777845,-8.94,2
10:21,215311171.0,5804.30206093745,-89.6,2
10:22,358846516.0,101.9817725272174,-66.97,5
10:23,138609932.0,2147.770003294586,-20.0,4
10:24,915666111.0,-4556.649574772037,-23.91,5
10:26,824916823.0,8090.530768214593,-2.6,4
10:27,744968736.0,-1646.056826569424,-18.14,5
10:28,352899149.0,104.79274117734118,-153.98,2
10:28,867987292.0,1369.299566788884,-50.57,7
10:28,461029994.0,7737.594239540953,-56.8,5
10:28,155867488.0,-303.88330000000155,-53.89,5
10:29,282837512.0,13676.0006410417,-2.15,4
10:29,449871732.0,7156.237505793859,-96.6,2
10:29,425730826.0,1146.09690938872,-16.04,5
10:30,296972867.0,-1128.0463000000009,-51.38,5
10:30,361201224.0,3043.8713848320917,-10.76,4
10:30,572136270.0,-1121.3378884119766,-52.73,5
10:30,510101371.0,12088.442265770223,-64.83,5
10:31,531186970.0,4643.870385298425,-76.98,2
10:32,355940285.0,7856.375978189683,-60.63,5
10:32,290751280.0,-111.26775332517444,-130.98,2
10:35,873701090.0,-6.791653196281761,-20.05,2
10:36,409971170.0,2523.125680567951,-22.91,7
10:37,948069469.0,-1021.7963000000012,-86.21,5
10:37,355602925.0,1305.6602265753274,-112.98,2
10:39,769319491.0,-153.4030000000008,-11.84,5
10:39,656812046.0,885.2587537325189,-82.24,2
10:39,212560376.0,-326.33287422089785,-43.24,5
10:39,603375739.0,717.8630630232672,-83.08,5
10:40,785210466.0,1704.5122969465592,-31.99,2
10:41,117308635.0,2086.496355669448,-25.05,7
10:43,499410772.0,-2975.789362905162,-52.97,5
10:43,705848712.0,27330.97738947658,-84.46,2
10:44,518746136.0,-1178.692228236917,-57.64,5
10:44,494404688.0,-2872.8832653362074,-54.41,5
10:44,673025413.0,627.9560409249739,-10.65,2
10:45,749371623.0,-2750.0941535173424,-45.11,5
10:46,940569402.0,3988.722506522335,-21.15,2
10:47,611143859.0,675.4274000000123,-218.59,5
10:47,846550094.0,1686.4892671741443,-31.99,2
10:47,391688371.0,-164.21475879495523,-75.35,5
10:47,449871732.0,6950.451505793859,-205.79,2
10:47,224112146.0,760.4648999999997,-31.99,2
10:49,639409800.0,36505.840131919744,-28.25,2
10:52,913127700.0,1533.737138011116,-111.6,5
10:52,578131296.0,569.1284194440436,-70.58,5
10:52,727417797.0,5477.039166576052,-132.96,2
10:54,878989510.0,4793.221467815367,-99.99,2
10:55,373163757.0,10824.322782079336,-207.9,2
10:56,126929801.0,1191.2138192125628,-171.98,2
10:56,242218612.0,-287.3761999999994,-142.12,2
10:56,195895574.0,6510.647469798766,-221.87,2
10:56,822135975.0,11164.352610530224,-12.23,4
10:56,659008214.0,-3586.0476022904227,-40.31,5
10:57,195895574.0,6449.140841752899,-61.51,2
10:57,835829467.0,-988.994749999998,-19.7,5
10:58,994214354.0,9316.39265369369,-37.82,7
10:58,540159353.0,10712.120644432089,-41.98,2
10:59,263882093.0,-1394.5738000000006,-87.82,5
10:59,280098744.0,1846.1553778716664,-121.8,2
11:00,819515373.0,2167.3278360637937,-68.99,2
11:00,475277431.0,1042.818136943619,-16.5,4
11:00,962295212.0,-2346.480149999996,-105.71,5
11:02,836110591.0,2640.8741945933593,-5.24,7
11:03,214339619.0,173.39766416988755,-45.49,2
11:03,196289502.0,16000.96664082453,-6.14,4
11:04,429235692.0,-1232.8470000000002,-109.66,5
11:04,510101371.0,12045.292265770224,-43.15,7
11:05,713057426.0,-406.7992500000004,-26.89,5
11:05,651756497.0,14252.211731026053,-145.76,5
11:05,127809299.0,658.260496724463,-75.93,5
11:06,873701090.0,-21.81165319628176,-15.02,1
11:07,639549973.0,4816.417278032942,-29.25,8
11:07,441274121.0,12055.130588475977,-95.12,2
11:08,417850087.0,15277.640712299011,-7.55,4
11:09,822135975.0,11153.132610530223,-11.22,7
11:10,124102251.0,1496.5312793177302,-95.08,2
11:11,303843160.0,-416.41319999999854,-76.95,5
11:11,315546581.0,29388.163119740784,-23.05,7
11:13,992204045.0,6833.379010549831,-48.04,2
11:14,264208990.0,562.6568999999985,-1.5,4
11:14,383625050.0,2538.0475909762235,-45.56,2
11:15,651756497.0,14226.841731026052,-25.37,7
11:15,675231808.0,18115.65009942456,-209.3,7
11:15,421881811.0,1889.4885062389455,-34.16,4
11:16,695607232.0,-526.81350538944,-134.63,5
11:18,235881534.0,12428.46619826786,-100.98,4
11:18,188263947.0,-173.6772499999994,-79.3,5
11:18,661295096.0,3147.2793116660832,-134.99,2
11:20,688712152.0,6618.064893890441,-72.98,2
11:20,340680761.0,-3317.5830999999966,-13.1,5
11:21,441142605.0,1733.5203922757294,-16.5,4
11:22,322221939.0,3116.6163478088492,-86.02,5
11:24,690523499.0,54.941100000000176,-55.82,5
11:25,489964679.0,20065.748433404104,-7.4,1
11:26,672913754.0,11687.89060380904,-22.97,7
11:28,494789005.0,2396.2420005748577,-24.89,5
11:31,373163757.0,10691.322782079336,-133.0,2
11:31,214339619.0,124.90766416988754,-48.49,2
11:33,280098744.0,1729.9833778716666,-116.17,2
11:33,117273481.0,8795.8110387029,-3.49,4
11:35,496395938.0,11961.95692936801,-169.37,2
11:35,600585971.0,30.009149999999536,-102.64,5
11:36,786141370.0,-346.3183000000008,-71.89,5
11:39,111137699.0,-395.7845499999994,-124.71,5
11:44,675231808.0,17998.050099424563,-117.6,4
11:49,449871732.0,6891.679505793859,-58.77,2
11:50,828750680.0,781.2623952136801,-24.98,4
11:51,126929801.0,1138.2438192125628,-52.97,2
11:52,758160963.0,7098.0474808546705,-28.28,2
11:53,280098744.0,1593.5113778716666,-136.47,2
11:54,887853850.0,9944.591861630255,-100.22,2
11:55,603721739.0,-111.23910051681612,-43.2,5
11:56,675231808.0,17774.750099424564,-223.3,4
12:01,999752672.0,822.8138935333347,-74.15,5
12:02,189335192.0,-1437.1039517578606,-18.98,9
12:03,235881534.0,12375.20619826786,-53.26,2
12:03,588565416.0,5612.536772050563,-38.95,1
12:03,679943657.0,1564.5488891801374,-182.95,5
12:05,423208402.0,3802.0855000000033,-69.98,2
12:05,895750759.0,-512.2052880756659,-105.99,2
12:05,519644021.0,2440.432126744185,-30.2,2
12:08,653640811.0,17588.615879328063,-16.21,5
12:12,897592348.0,15703.84100613928,-5.99,1
12:12,298000165.0,26429.544462688755,-129.5,2
12:13,519644021.0,2399.152126744185,-41.28,2
12:16,373163757.0,10433.722782079334,-257.6,2
12:16,280098744.0,1503.2113778716666,-90.3,2
12:17,518474507.0,13200.221359570254,-36.59,9
12:18,215311171.0,5480.90206093745,-323.4,2
12:18,766941757.0,1752.9163088846772,-296.1,2
12:20,298000165.0,26192.244462688755,-237.3,2
12:20,743630833.0,-1055.7886367152987,-43.61,5
12:21,364357875.0,7590.880384262869,-7.12,2
12:25,675231808.0,17648.750099424564,-126.0,7
12:25,909676212.0,-163.27546821238687,-69.98,4
12:26,657139925.0,13326.634885969996,-93.27,5
12:28,497809732.0,2285.293869552596,-159.97,2
12:31,331450202.0,7359.352131660724,-21.3,9
12:32,348460748.0,-438.994850000001,-25.19,9
12:33,587202562.0,-104.30510058293156,-39.35,9
12:35,373163757.0,10270.622782079334,-163.1,2
12:36,766941757.0,1522.6163088846772,-230.3,2
12:39,245690309.0,9600.970491429603,-30.8,5
12:42,629078930.0,37.07381326707177,-74.99,2
12:42,605116158.0,2353.973500000004,-30.96,5
12:43,200080192.0,8998.214997167339,-147.69,7
12:46,478986718.0,-1241.6008000000015,-26.89,9
12:46,971010829.0,130.09505644424513,-9.98,7
12:47,280098744.0,1205.0113778716666,-298.2,2
12:47,657139925.0,13202.464885969996,-124.17,2
12:47,785749304.0,8220.333400256415,-22.4,9
12:49,245690309.0,9563.536491429604,-37.43,4
12:49,298000165.0,25914.34446268875,-277.9,2
12:52,480557476.0,11038.5860373232,-36.48,5
12:54,951817450.0,8992.874720922591,-25.16,2
12:54,736310094.0,-985.954924027426,-54.61,5
13:00,200080192.0,8870.84299716734,-127.37,4
13:01,136770968.0,-361.0108000000005,-52.61,5
13:02,718058208.0,1612.284390377968,-72.21,4
13:03,187111705.0,6531.081524842555,-5.4,9
13:04,570269025.0,3102.2114421446404,-23.73,7
13:05,480557476.0,11032.0860373232,-6.5,9
13:05,722971557.0,-1100.3102791569245,-25.87,5
13:06,844835978.0,10169.17362306578,-1.5,4
13:07,812692024.0,3620.719590521821,-6.8,9
13:07,290818242.0,6819.829671125003,-7.5,9
13:08,486495235.0,1407.815610076207,-90.05,5
13:09,555804115.0,-1495.276047558703,-28.67,5
13:09,348325817.0,8633.136905876665,-5.9,9
13:10,221868392.0,4354.594126718636,-21.2,9
13:10,793781222.0,513.050878947406,-41.97,4
13:12,280098744.0,960.7533778716668,-244.26,2
13:12,916225911.0,-2432.76925,-37.99,5
13:12,600585971.0,-11.11085000000046,-41.12,9
13:14,215311171.0,5298.20206093745,-182.7,2
13:15,200080192.0,8641.25699716734,-229.59,4
13:15,781554833.0,911.8202255639663,-87.5,5
13:15,242218612.0,277.3738000000006,-125.25,2
13:16,635679314.0,-3150.113329119518,-41.96,5
13:16,370757362.0,1170.8260236036174,-29.59,9
13:17,534325901.0,5867.834588638518,-24.56,4
13:17,409370545.0,-872.9027244544792,-70.71,5
13:17,843174694.0,-5398.623499999998,-56.13,5
13:17,637649383.0,308.19279999999833,-115.01,5
13:19,585625048.0,1777.9639749993576,-5.4,9
13:20,854513972.0,1601.8977000000002,-28.95,7
13:20,441274121.0,12041.927147480728,-13.2,2
13:22,145387690.0,4288.807031097134,-19.23,1
13:22,874431242.0,8610.819602201494,-13.42,2
13:22,214339619.0,30.42766416988755,-94.48,2
13:22,618138606.0,1094.2033032642871,-37.99,6
13:26,970298834.0,2010.590693579846,-20.02,2
13:27,969697937.0,-5117.955265670551,-45.14,5
13:28,727417797.0,5393.753166576052,-83.29,2
13:31,215311171.0,5116.20206093745,-182.0,2
13:31,750094757.0,-1869.4893000000009,-68.04,5
13:32,280098744.0,920.8953778716668,-39.86,2
13:34,124102251.0,1406.6932793177302,-89.84,5
13:36,200080192.0,8445.97099716734,-195.29,7
13:39,391688371.0,-186.23475879495524,-22.02,2
13:39,822718326.0,11451.436001111882,-29.84,2
13:41,472995101.0,974.7395840990838,-101.71,5
13:42,760704118.0,287.7023127174892,-54.87,5
13:42,957821152.0,-1706.2729535715496,-18.79,5
13:44,621181115.0,-361.7252495707711,-76.17,5
13:47,835736339.0,1965.6860696909384,-30.02,2
13:53,224112146.0,740.4748999999997,-19.99,2
13:54,461029994.0,7622.614239540953,-114.98,2
13:54,441142605.0,1728.5303922757294,-4.99,7
13:54,727417797.0,5348.967166576052,-44.79,2
13:57,430910686.0,-444.3777999999996,-105.62,5
14:01,575652395.0,698.534293894376,-15.58,4
14:05,423208402.0,3792.095500000003,-9.99,2
14:09,706250160.0,12433.670201188708,-67.36,7
14:10,165098840.0,-611.7156263623731,-45.92,5
14:15,215311171.0,4850.90206093745,-265.3,2
14:21,117308635.0,2017.216355669448,-69.28,2
14:21,675231808.0,17547.250099424564,-101.5,7
14:25,876890798.0,2914.1957706999337,-59.01,5
14:27,727417797.0,5165.595166576051,-183.37,2
14:28,214339619.0,-105.55233583011248,-135.98,2
14:29,449871732.0,6785.993505793859,-105.69,7
14:30,802697323.0,15707.368313397052,-166.6,2
14:30,195895574.0,6301.482841752899,-147.66,2
14:31,941285623.0,473.7863990667703,-32.97,7
14:31,776431321.0,2900.8472956715336,-5.99,4
14:38,280098744.0,790.0093778716667,-130.89,2
14:39,680773155.0,234.3139833310914,-18.74,5
14:40,450896297.0,13089.731799093675,-31.69,4
14:43,538003940.0,1896.7900000000104,-14.99,4
14:47,705848712.0,27296.25698139273,-34.72,7
14:47,408057540.0,4641.82933209272,-42.24,9
14:48,679911053.0,2189.3714155173716,-25.99,1
14:50,214339619.0,-315.0423358301125,-209.49,2
14:51,675231808.0,17174.850099424562,-372.4,4
14:52,200080192.0,8347.99899716734,-97.97,7
14:53,762859681.0,1458.6185999999989,-7.0,7
14:54,727417797.0,4977.323166576051,-188.27,2
14:55,758160963.0,7018.2266803804,-79.82,2
14:57,214339619.0,-406.5223358301125,-91.48,2
14:59,975345315.0,36155.90348145652,-29.46,5
15:00,449871732.0,6731.407505793859,-54.59,4
15:02,195895574.0,6197.196841752899,-104.29,2
15:08,769311479.0,6066.661729936997,-20.3,7
15:08,893134725.0,790.1615007761188,-134.98,2
15:09,492215823.0,2272.8942238154445,-29.68,9
15:11,657528784.0,-266.6330999999993,-96.5,5
15:13,280098744.0,625.5373778716668,-164.47,2
15:13,417850087.0,15214.451712299013,-63.19,5
15:20,730002588.0,13457.260773195188,-137.77,5
15:21,727417797.0,4890.551166576051,-86.77,2
15:22,685959099.0,1752.6098660992434,-50.0,2
15:22,214339619.0,-541.4823358301126,-134.96,2
15:28,856957948.0,10797.759154533907,-12.98,4
15:32,699139822.0,-835.005924223053,-18.99,9
15:32,242218612.0,189.9988000000006,-87.38,2
15:32,450896297.0,13073.311799093675,-16.42,7
15:33,187541224.0,1073.6388873742358,-11.07,7
15:41,633345190.0,5501.91007594966,-25.2,9
15:43,280098744.0,465.93737787166674,-159.6,2
15:49,449871732.0,6661.435505793859,-69.97,4
15:50,727417797.0,4723.265166576051,-167.29,2
15:52,819515373.0,2057.7624360637938,-109.57,5
15:56,679911053.0,2176.6548815046954,-12.72,7
16:03,971010829.0,70.11505644424514,-59.98,2
16:05,280098744.0,315.4933778716668,-150.44,2
16:10,698955014.0,8.291630203196718,-53.0,2
16:16,280098744.0,267.2073778716668,-48.29,2
16:18,675231808.0,16886.45009942456,-288.4,7
16:26,449871732.0,6382.877505793859,-278.56,7
16:35,280098744.0,139.1493778716668,-128.06,2
16:46,198946608.0,3697.777733716661,-279.97,4
16:51,736340277.0,7817.383804982734,-15.43,7
16:54,886921642.0,2879.73679823973,-29.98,7
16:54,333054026.0,15.590894023190115,-79.38,2
16:55,373163757.0,10137.622782079334,-133.0,2
16:57,386729293.0,31474.74582976568,-14.48,4
17:05,696333897.0,-50.70960000000119,-27.28,9
17:10,891716230.0,-61.51967018989863,-24.75,4
17:16,242218612.0,40.748800000000585,-149.25,2
17:20,198946608.0,3583.7057337166607,-114.07,7
17:26,678851253.0,3073.460971089477,-23.19,9
17:28,280268430.0,4470.338280713835,-106.97,4
17:29,846550094.0,1635.5192671741445,-50.97,4
17:36,214339619.0,-704.4723358301126,-162.99,2
17:37,308505160.0,13145.797265622246,-32.29,9
17:38,956717493.0,906.0307504359832,-164.0,2
17:41,242218612.0,-101.7511999999994,-142.5,2
17:43,984783496.0,14169.406386693756,-54.71,5
17:48,522188082.0,6737.010540824913,-26.17,1
17:52,198946608.0,3424.833733716661,-158.87,7
17:53,628470485.0,-136.04397009987687,-76.97,4
18:00,984783496.0,14145.719226693756,-23.69,4
18:01,984783496.0,14118.829226693755,-26.89,9
18:07,242218612.0,-251.7511999999994,-150.0,2
18:08,263882093.0,-1435.7638000000006,-41.19,9
18:10,675231808.0,16714.25009942456,-172.2,2
18:12,214339619.0,-750.9623358301126,-46.49,2
18:13,624500124.0,2936.5863337581013,-24.74,9
18:23,675231808.0,16590.35009942456,-123.9,2
18:28,198946608.0,3330.333733716661,-94.5,4
18:38,195895574.0,6171.5168417528985,-25.68,9
18:40,683319988.0,6429.626640078325,-36.93,9
18:43,120634201.0,4801.0849618611865,-1.76,2
18:44,383833857.0,25757.549503794584,-5.99,9
18:45,556992209.0,10550.383084801782,-38.92,2
18:52,558119802.0,33742.94285876453,-20.65,9
19:25,285220959.0,12033.254197413298,-64.86,2
19:32,106601471.0,10518.455797678516,-48.89,7
19:38,287480331.0,7035.473615493616,-25.19,9
19:40,305778936.0,10020.845898880803,-32.48,9
19:47,450896297.0,13036.931799093676,-36.38,9
19:50,624500124.0,2933.015083004978,-3.57,5
19:53,370521542.0,27163.966929365968,-17.85,9
20:18,764450279.0,21314.699137873664,-29.48,7
20:49,399144202.0,1158.253610998256,-21.53,9
00:16,310620484.0,-154.20880490780172,-41.17,9
00:18,705848712.0,27276.81698139273,-19.44,9
00:18,858989281.0,26727.697069975748,-15.87,2
00:19,421881811.0,1814.0388003224916,-75.45,8
00:21,124102251.0,1387.9500037579342,-18.74,7
00:23,667367404.0,8973.066736218232,-32.97,5
00:27,785749304.0,8200.283400256416,-20.05,9
00:34,441274121.0,12041.787713881526,-0.14,7
00:38,237493332.0,14383.05416871697,-52.25,7
00:39,960208650.0,14311.77746096047,-55.61,2
00:40,541639148.0,3840.169738976461,-60.39,2
00:40,569687509.0,-2332.4328999999993,-31.35,9
00:42,836110591.0,2616.0841945933594,-24.79,9
00:43,519644021.0,2383.6535766003144,-15.5,2
00:48,179173981.0,3536.730377368542,-35.54,9
00:49,987163717.0,3485.130223888187,-26.58,9
00:50,108481285.0,8710.230947033748,-2.63,2
00:52,433917275.0,6828.44562575204,-59.52,2
00:56,992204045.0,6809.199431394842,-24.18,7
00:57,657139925.0,13192.224885969998,-10.24,9
00:57,704517789.0,17519.27790772455,-47.75,2
01:01,581655972.0,41223.69870971774,-11.56,2
01:02,824916823.0,8056.500768214593,-34.03,9
01:05,647936800.0,2183.7089194692508,-10.32,2
01:08,822135975.0,11111.688287982546,-41.44,8
01:09,802697323.0,15675.538313397054,-31.83,9
01:28,282837512.0,13637.0606410417,-38.94,9
01:34,518474507.0,13155.821359570256,-44.4,9
01:38,985188462.0,-310.8636112887752,-38.95,9
01:43,785749304.0,8198.50738212425,-1.78,7
01:43,897714622.0,9007.533833201807,-8.15,5
01:50,417850087.0,15177.802383908072,-36.65,7
01:52,690958123.0,20574.03405592685,-4.99,2
01:57,586315521.0,12218.171777505757,-0.3,2
01:58,235881534.0,12355.125652853778,-20.08,8
01:58,799861885.0,559.7830999999987,-46.45,9
02:00,949032480.0,3057.2263945191366,-26.95,9
02:18,221868392.0,4321.324126718636,-33.27,9
02:22,815385232.0,10245.81059970068,-1.63,2
02:22,853907490.0,7466.227733184357,-7.39,9
02:24,795847804.0,23844.858523738338,-7.77,7
02:28,851649498.0,7977.059874735915,-49.32,5
02:36,216285378.0,24259.511113528417,-39.69,9
02:44,809499628.0,17474.559464698395,-19.25,9
02:47,522188082.0,6697.381278217368,-39.63,2
02:47,996042490.0,5808.882198403352,-0.48,2
02:49,586315521.0,12182.541777505756,-35.63,9
02:50,705848712.0,27241.733940142534,-35.08,2
02:54,383625050.0,2535.9626700393605,-2.08,5
02:55,853907490.0,7442.793109352968,-23.43,7
02:57,403902116.0,225.09319999999923,-37.44,9
02:57,473820682.0,11141.130189495772,-25.73,8
02:59,749378808.0,1328.4506847884977,-21.68,5
03:03,213112754.0,5237.061693119757,-22.71,7
03:04,344219145.0,8035.963113232297,-77.94,2
03:07,769311479.0,6034.873967770641,-31.79,7
03:20,113747882.0,11716.21364372864,-39.34,9
03:29,874431242.0,8592.819828142927,-18.0,2
03:29,624500124.0,2888.401852791638,-44.61,2
03:31,237684254.0,5651.772405384467,-5.37,5
03:38,179173981.0,3520.208721021879,-16.52,2
03:40,147508204.0,-318.02528221811343,-25.9,9
03:43,824916823.0,8012.849977243108,-43.65,5
03:46,456246119.0,21461.749398845648,-10.82,7
03:46,912705941.0,18918.80541131987,-0.51,2
03:49,196289502.0,15982.57664082453,-18.39,9
03:50,551196328.0,4322.847465435382,-6.27,5
03:50,511179916.0,7114.1024541786355,-21.05,7
03:51,970298834.0,1984.1820136207184,-26.41,5
03:52,221868392.0,4293.417870687221,-27.91,5
03:54,628470485.0,-158.33150243258538,-22.29,2
03:57,651756497.0,14219.912821674836,-6.93,8
03:57,639409800.0,36504.5330917164,-1.31,4
04:00,655368335.0,3766.698129096231,-13.89,2
04:03,806358207.0,10991.769154545727,-62.49,8
04:04,766941757.0,1494.6763088846772,-27.94,9
04:08,500043411.0,13438.258633810745,-40.96,2
04:09,195895574.0,6150.326841752899,-21.19,9
04:11,298007503.0,1571.5181036256338,-37.82,9
04:33,752362502.0,5852.715772687644,-2.42,5
04:40,489964679.0,20036.308433404105,-29.44,9
04:42,229205098.0,7156.960755597025,-9.86,2
04:45,910730524.0,7661.457817660659,-38.73,4
04:46,601627384.0,2767.032196226646,-44.85,9
04:46,532478725.0,3874.0507983140737,-42.29,9
04:49,370521542.0,27143.02692936597,-20.94,9
04:51,668329719.0,8627.026840533264,-49.01,5
04:52,454356905.0,1080.0212843613451,-3.8,5
04:53,399144202.0,1131.513610998256,-26.74,9
04:54,331450202.0,7351.852131660724,-7.5,9
04:59,719586818.0,18678.176861820688,-7.72,4
04:59,940569402.0,3932.0469364040505,-56.68,5
05:00,842682241.0,2685.6191004827674,-4.4,2
05:02,264550521.0,4730.940906572157,-14.35,7
05:03,779946617.0,16819.010369096624,-26.58,7
05:06,549414742.0,5895.394775544888,-13.13,8
05:11,489964679.0,20019.35746236988,-16.95,5
05:13,128033695.0,1739.407306966171,-21.51,2
05:14,633345190.0,5469.47007594966,-32.44,9
05:14,450896297.0,13007.191799093676,-29.74,9
05:15,496395938.0,11947.89035200335,-14.07,2
05:16,558119802.0,33689.80295518229,-53.14,2
05:17,987656636.0,3873.844775958082,-9.73,7
05:22,203466392.0,593.2356960955241,-13.49,9
05:23,535744551.0,188.8128159956258,-37.59,9
05:28,143061865.0,6494.788101787972,-29.15,7
05:31,822250278.0,6147.784700540702,-24.2,9
05:33,256002321.0,5866.268698715715,-23.2,9
05:38,809499628.0,17453.33368703457,-21.23,8
05:39,994214354.0,9283.992653693693,-32.4,9
05:43,510101371.0,12005.792265770224,-39.5,9
05:44,670102069.0,637.4165480760921,-35.24,9
05:45,885259672.0,2696.612568522443,-17.84,2
05:47,414805878.0,12542.222235126115,-38.4,9
05:48,145387690.0,4284.274596376896,-4.53,2
05:49,738958551.0,8548.940409991961,-36.49,9
05:51,899742927.0,12914.614967056788,-0.86,8
05:51,383833857.0,25727.85678942595,-29.69,5
05:55,252760664.0,6319.281692854478,-9.98,5
05:57,287480331.0,7001.293615493616,-34.18,9
05:58,683319988.0,6394.276640078325,-35.35,9
05:58,461990622.0,7074.534751347721,-31.94,4
06:05,409971170.0,2479.4961306661503,-43.63,8
06:08,370521542.0,27135.073168911964,-7.95,4
06:08,930277104.0,8793.425238350035,-22.94,9
06:08,718058208.0,1590.8735549812536,-21.41,5
06:14,587225252.0,5127.570102665044,-46.1,9
06:15,700138124.0,4113.118930458054,-40.07,4
06:15,736340277.0,7801.933804982734,-15.45,9
06:19,575652395.0,693.785460112429,-4.75,7
06:20,887853850.0,9910.627745139587,-33.96,7
06:21,550169791.0,22292.709566117635,-2.71,7
06:21,520447032.0,7653.458158115403,-36.5,9
06:22,675806859.0,7000.9004945655915,-1.41,2
06:23,738958551.0,8486.05799582451,-62.88,8
06:23,315546581.0,29386.793197195908,-1.37,7
06:25,183888402.0,19001.242457140143,-29.78,9
06:29,683319988.0,6317.475589035769,-76.8,7
06:29,822250278.0,6108.199060415725,-39.59,5
06:29,547010927.0,24061.991139145957,-35.64,9
06:30,482513594.0,5166.431924699128,-17.2,9
06:31,324224854.0,4095.4109200621906,-15.85,7
06:32,873693307.0,10083.84116995355,-12.2,9
06:33,143003091.0,10318.687328961109,-2.18,5
06:33,730002588.0,13451.822061973027,-5.44,7
06:36,198946608.0,3295.987926829229,-34.35,2
06:39,348325817.0,8606.846905876664,-26.29,9
06:39,930277104.0,8781.539123876559,-11.89,2
06:42,435984758.0,3628.7765541226145,-66.38,7
06:46,408057540.0,4609.3525744498365,-32.48,5
06:47,687135796.0,28727.918510675256,-20.19,9
06:51,554792076.0,28895.438238534414,-11.61,7
06:52,678851253.0,3071.610729793774,-1.85,2
06:54,572384506.0,6754.610592406209,-25.39,9
06:57,832564361.0,15394.050901148346,-10.7,9
06:57,673025413.0,601.4389647987813,-26.52,8
07:01,305778936.0,9985.505898880803,-35.34,9
07:01,482513594.0,5147.801693880493,-18.63,7
07:02,709608057.0,2058.3867655025188,-38.44,9
07:03,108563213.0,23015.23098711715,-5.61,8
07:04,779236304.0,1061.5075954795338,-39.05,9
07:06,310375875.0,849.9535460123892,-36.64,9
07:08,661295096.0,3124.321949818632,-22.96,5
07:09,706250160.0,12394.960320399314,-38.71,2
07:12,556992209.0,10518.009766670775,-32.37,5
07:19,609939116.0,6944.442896060738,-4.12,7
07:24,670102069.0,610.1621927731381,-27.25,4
07:26,604288474.0,1225.224972996379,-30.1,7
07:30,570323670.0,2915.586609085731,-59.49,2
07:37,873693307.0,10069.137740177512,-14.7,8
07:37,623156843.0,4438.223982628593,-4.4,5
07:38,213112754.0,5221.071693119758,-15.99,9
07:39,949032480.0,3033.130541364279,-24.1,2
07:47,290818242.0,6774.465710731867,-45.36,5
07:56,873701090.0,-23.993086195598423,-2.18,2
07:56,187541224.0,1040.6188873742358,-33.02,9
07:57,815993333.0,5555.273494542933,-13.51,5
08:00,865748375.0,2072.5627804811957,-9.51,4
08:03,687135796.0,28706.482945654556,-21.44,5
08:09,986267641.0,3749.2182062354914,-65.38,2
08:11,429556122.0,4322.299160778195,-17.9,5
08:12,336557504.0,897.2443333178851,-5.7,9
08:14,187111705.0,6492.42912495785,-38.65,2
08:17,285220959.0,11992.75007509345,-40.5,2
08:18,170637730.0,790.6074209653565,-29.66,5
08:18,679662108.0,14530.785201706878,-34.68,2
08:23,639549973.0,4815.579767554566,-0.84,2
08:24,885259672.0,2689.512568522443,-7.1,9
08:25,506618547.0,14287.000322536878,-16.66,5
08:25,259015404.0,-116.28055382556455,-21.81,7
08:26,851181128.0,4304.411548734847,-5.83,8
08:26,613729471.0,7679.142582926347,-8.76,7
08:26,322221939.0,3105.071502708284,-11.54,2
08:26,829914501.0,857.7348065709746,-5.3,9
08:27,907987693.0,-2705.716999999998,-32.09,5
08:29,954263768.0,-390.93560000000025,-23.65,5
08:30,235310449.0,5.301184830309992,-90.07,5
08:33,873701090.0,-66.53908619559843,-42.55,5
08:35,895750759.0,-636.9725880756658,-124.77,5
08:36,593191200.0,208.80229999999904,-85.07,5
08:37,886921642.0,2868.1977931916285,-11.54,7
08:38,559995067.0,2086.7151800695647,-53.68,5
08:40,737547541.0,-638.8094004322255,-93.32,5
08:41,290818242.0,6715.175710731867,-59.29,5
08:41,891513205.0,483.2911796590689,-92.83,5
08:41,788740658.0,292.4614690169987,-144.61,5
08:42,979122276.0,-891.3430377056713,-129.86,5
08:42,925037906.0,1132.032800000001,-125.66,5
08:43,535744551.0,80.98306599562582,-107.83,5
08:43,844206657.0,958.8710051465696,-57.56,5
08:45,768271776.0,-941.9422467665796,-102.28,5
08:45,101531259.0,-137.0779000000004,-149.09,5
08:46,493640090.0,-2810.5084499999984,-19.31,5
08:46,119943495.0,-1641.082562112858,-14.67,5
08:47,596328017.0,-2661.6478499999976,-87.33,5
08:47,521611005.0,-302.2132858510465,-64.38,5
08:51,760753808.0,-179.1445000000006,-128.54,5
08:55,753525749.0,-2491.330899999999,-32.53,5
08:57,822718326.0,11306.564001111885,-52.89,5
08:58,242218612.0,-267.35119999999944,-15.6,5
08:59,613427466.0,6299.117455264377,-65.62,5
09:01,425964226.0,3958.940764114708,-5.15,9
09:01,506618547.0,14280.550322536878,-6.45,9
09:03,305778936.0,9971.746514546478,-13.76,7
09:03,816685391.0,-858.6044037084264,-32.29,5
09:04,762700245.0,32.211700000002665,-52.04,5
09:04,116169597.0,398.8769499999996,-316.39,5
09:04,391559884.0,-430.7228500000007,-229.37,5
09:05,690958123.0,20568.88405592685,-5.15,9
09:07,169006407.0,11268.433822944406,-5.95,9
09:07,399144202.0,1116.5115347120786,-15.0,5
09:08,618138606.0,1089.2033032642871,-5.0,9
09:09,822135975.0,11067.770287982548,-43.92,5
09:09,151278285.0,1545.1874499999997,-95.84,5
09:10,899692478.0,-2154.5708435240076,-43.63,5
09:10,585596026.0,2479.845038381067,-111.58,5
09:11,667367404.0,8965.466736218232,-7.6,9
09:11,215404070.0,58.76758917984965,-58.95,5
09:12,842682241.0,2538.7451004827676,-146.87,5
09:13,116169597.0,329.96694999999966,-68.91,7
09:13,290818242.0,6709.375710731867,-5.8,9
09:14,535804582.0,554.7072999999987,-58.35,5
09:14,550169791.0,22234.665566117634,-58.04,5
09:14,475277431.0,928.284136943619,-114.53,5
09:16,417850087.0,15172.402383908073,-5.4,9
09:16,999752672.0,817.7638935333348,-5.05,9
09:17,727417797.0,4613.309166576051,-109.96,5
09:19,441274121.0,12034.987713881526,-6.8,9
09:19,240643705.0,-158.87992037943192,-79.9,5
09:19,851649498.0,7971.359874735915,-5.7,9
09:19,117273481.0,8790.1610387029,-5.65,9
09:19,280098744.0,5.2533778716668,-133.9,5
09:20,143003091.0,10311.697328961109,-6.99,4
09:22,361955473.0,-191.60625475591564,-99.27,5
09:22,998390769.0,-387.3932490594758,-181.66,5
09:24,540159353.0,10704.220644432087,-7.9,9
09:24,282837512.0,13587.200641041698,-49.86,2
09:26,866941383.0,1705.397680303673,-32.95,7
09:27,134461671.0,5020.287060725691,-70.2,7
09:28,191992682.0,-2986.121460292063,-47.36,5
09:29,448004226.0,1451.3823686648796,-29.99,2
09:30,129018172.0,9653.13946802586,-22.97,1
09:31,741903302.0,2400.4870679352607,-7.98,4
09:31,534204159.0,5038.371132700332,-24.52,7
09:32,541639148.0,3681.8297389764607,-158.34,2
09:32,522188082.0,6630.851278217368,-66.53,4
09:35,995615876.0,1452.137731580979,-25.14,5
09:36,961077907.0,224.03155,-72.34,5
09:36,106601471.0,10481.465797678517,-36.99,1
09:38,256002321.0,5799.078698715715,-67.19,2
09:38,711045550.0,2021.8243500000035,-31.99,2
09:40,661295096.0,3011.341949818632,-112.98,2
09:43,657139925.0,13174.876614451065,-17.35,2
09:44,601627384.0,2727.832196226647,-39.2,7
09:44,986774156.0,1511.5769316257692,-15.98,7
09:45,479366718.0,2045.7213481400413,-50.98,2
09:50,287480331.0,6992.789935493616,-8.5,4
09:50,849096144.0,1076.469020751343,-54.97,4
09:52,553734946.0,-67.87690000000173,-74.77,5
09:53,383345285.0,-938.5679235880762,-42.09,5
09:54,473820682.0,11036.830189495771,-104.3,2
09:58,282837512.0,13580.100641041698,-7.1,9
10:00,233981231.0,2047.230722724169,-59.98,4
10:01,987229118.0,298.4470049334381,-3.58,4
10:02,366550080.0,25576.039681107675,-24.42,2
10:02,866941383.0,1655.427680303673,-49.97,4
10:03,572384506.0,6618.91059240621,-135.7,2
10:10,933491926.0,3179.035598448768,-59.96,5
10:10,522188082.0,6590.228878217368,-40.62,4
10:11,639549973.0,4794.579767554566,-21.0,2
10:12,821971408.0,252.08511023554323,-55.3,5
10:12,642015139.0,-361.2336625343617,-189.0,2
10:14,473820682.0,10907.358189495772,-129.47,2
10:16,454356905.0,1060.748324361345,-19.27,4
10:17,849096144.0,1038.5190207513429,-37.95,7
10:17,727417797.0,4533.329166576052,-79.98,4
10:20,659415300.0,1479.6115805359595,-6.35,9
10:22,973086490.0,9874.360422797834,-27.94,5
10:23,913801979.0,83.0065299144938,-57.99,5
10:30,252760664.0,6225.747692854478,-93.53,5
10:34,456246119.0,21451.76939884565,-9.98,4
10:36,792845450.0,555.0811500000008,-28.0,2
10:37,473820682.0,10835.300189495774,-72.06,2
10:38,984783496.0,14098.069226693757,-20.76,1
10:38,364357875.0,7534.097038492248,-56.78,5
10:39,639549973.0,4643.379767554567,-151.2,2
10:40,642015139.0,-544.2336625343617,-183.0,2
10:51,550832673.0,3013.3460163955097,-29.99,4
10:56,399538448.0,7427.592260393225,-18.75,7
10:58,639549973.0,4531.379767554567,-112.0,2
11:03,709151315.0,-390.8347816258401,-101.95,5
11:04,473820682.0,10742.928189495777,-92.37,2
11:12,709608057.0,2047.9349526978883,-10.45,7
11:15,761272540.0,-238.95800000000128,-145.95,5
11:16,252760664.0,6187.417692854478,-38.33,2
11:16,480557476.0,11030.976694487736,-1.11,5
11:21,901432314.0,3095.759326333052,-117.97,4
11:26,280990953.0,688.4096999999982,-6.99,1
11:27,285873880.0,12530.5745078172,-187.6,2
11:28,364357875.0,7431.507038492248,-102.59,2
11:29,475277431.0,923.294136943619,-4.99,4
11:31,642015139.0,-649.2336625343617,-105.0,2
11:33,548907062.0,382.8974864260272,-5.99,4
11:34,639549973.0,4496.379767554567,-35.0,2
11:34,194745206.0,24.223372091243174,-45.67,5
11:36,767447966.0,4559.827922706573,-46.15,4
11:40,285873880.0,12485.1025078172,-45.47,2
11:41,857997794.0,517.5536651508866,-69.98,4
11:42,899742927.0,12748.974967056787,-165.64,2
11:45,648644594.0,128.67709999999911,-124.53,5
11:48,642015139.0,-719.2336625343617,-70.0,2
11:48,639549973.0,4377.379767554567,-119.0,2
11:58,587225252.0,5119.689084083154,-7.88,7
12:03,879091637.0,-694.4784762620229,-32.79,9
12:03,749378808.0,1305.1206847884978,-23.33,9
12:06,639549973.0,4300.379767554567,-77.0,2
12:07,254853117.0,2766.858552336119,-10.99,1
12:11,519644021.0,2372.5735766003145,-11.08,7
12:11,285873880.0,12427.7305078172,-57.37,2
12:11,419084831.0,-585.8402255261033,-19.75,9
12:12,960208650.0,14203.94246096047,-107.84,5
12:19,195895574.0,6139.152545415013,-11.17,5
12:19,984783496.0,14037.868353415766,-60.2,5
12:25,984783496.0,14020.968353415768,-16.9,9
12:35,550832673.0,2939.91601639551,-73.43,5
12:40,642015139.0,-831.2336625343617,-112.0,2
12:40,179173981.0,3518.584761021879,-1.62,4
12:46,663479159.0,4726.901541827711,-18.97,7
12:49,108812033.0,400.0263499999983,-104.04,5
12:51,901432314.0,3052.541326333052,-43.22,5
12:51,106601471.0,10478.679906156109,-2.79,5
12:52,551755686.0,6815.4899266541515,-23.48,4
12:53,588565416.0,5598.057134268144,-14.48,4
12:57,773633520.0,-400.8717890614886,-108.85,5
12:59,744211756.0,-4491.178249999992,-36.63,5
13:00,642015139.0,-950.7336625343617,-119.5,2
13:02,899983008.0,-3310.273649999996,-15.73,5
13:07,688712152.0,6612.664893890442,-5.4,9
13:08,849096144.0,1031.419020751343,-7.1,9
13:09,120634201.0,4787.484961861186,-13.6,9
13:10,175452235.0,-1810.5482499999996,-32.89,5
13:14,973086490.0,9864.380422797834,-9.98,9
13:14,405416860.0,2460.176506880905,-27.96,7
13:18,642015139.0,-1159.7336625343617,-209.0,2
13:19,910730524.0,7656.007817660659,-5.45,9
13:21,519935524.0,-165.99467026248118,-16.18,5
13:24,472213568.0,-738.1456942060533,-63.98,5
13:33,642015139.0,-1307.2336625343617,-147.5,2
13:42,857997794.0,464.63366515088654,-52.92,1
13:42,317161035.0,-3848.842599999996,-91.06,5
13:46,252419513.0,-2371.3111858134152,-37.07,5
13:46,480198977.0,12150.312032593252,-144.29,5
14:14,783650950.0,-1137.4406434110117,-136.81,5
14:18,520447032.0,7602.1281581154035,-51.33,2
14:20,901432314.0,2975.448439312908,-77.09,5
14:26,170637730.0,768.5174209653565,-22.09,7
14:28,366550080.0,25491.871681107674,-84.17,5
14:35,538003940.0,1796.8000000000102,-99.99,2
14:46,642015139.0,-1396.7336625343617,-89.5,2
14:47,285873880.0,12392.0445078172,-35.69,2
14:50,455052690.0,-287.4422600513724,-86.04,5
15:02,950234174.0,-333.6921807628404,-96.77,5
15:05,642015139.0,-1489.2336625343617,-92.5,2
15:09,284905540.0,8101.287533307072,-32.94,2
15:15,520447032.0,7556.031262724161,-46.1,5
15:20,642015139.0,-1724.2336625343617,-235.0,2
15:21,285873880.0,12287.0445078172,-105.0,2
15:29,285873880.0,12049.0725078172,-237.97,2
15:35,348325817.0,8598.573446166263,-8.27,8
15:43,642015139.0,-1813.7336625343617,-89.5,2
15:56,285873880.0,11979.1145078172,-69.96,2
15:57,556992209.0,10501.993766670776,-16.02,4
16:20,713641917.0,754.9588459567871,-140.98,2
16:20,556992209.0,10468.993766670776,-33.0,4
16:24,624500124.0,2867.481502791638,-20.92,4
16:25,310375875.0,821.8645901371343,-28.09,7
16:29,286484726.0,416.2636391525707,-12.99,2
16:32,298000165.0,25914.22282212372,-0.12,5
16:34,285873880.0,11871.3285078172,-107.79,2
16:34,329840194.0,84.94229014314797,-47.44,5
16:35,631111289.0,-525.9565000000009,-27.66,5
16:46,256002321.0,5774.624897201944,-24.45,7
16:48,409971170.0,2440.5261306661505,-38.97,7
16:51,198051483.0,-1232.1419104088573,-110.77,5
16:53,899742927.0,12643.574967056788,-105.4,2
16:54,297823329.0,157.0201499999991,-33.52,5
16:56,345582855.0,271.41605282054934,-59.03,5
17:03,285873880.0,11690.0565078172,-181.27,2
17:06,534325901.0,5855.095144156464,-12.74,2
17:09,433917275.0,6802.055625752039,-26.39,9
17:10,865748375.0,2040.5427804811957,-32.02,2
17:11,517934629.0,412.1276787084264,-35.0,2
17:13,395284483.0,573.7363402113081,-143.49,2
17:17,559995067.0,2058.285180069565,-28.43,9
17:20,858989281.0,26709.307069975748,-18.39,9
17:21,986267641.0,3735.039646235491,-14.18,4
17:25,627917561.0,3802.125050000006,-69.36,2
17:26,104832000.0,-3170.4748589058445,-49.85,5
17:26,361201224.0,3004.7613848320916,-39.11,7
17:28,868377987.0,2831.2437961778805,-57.99,2
17:28,429556122.0,4281.149160778195,-41.15,2
17:30,285873880.0,11582.2565078172,-107.8,2
17:31,491392945.0,5294.463500000011,-77.99,2
17:34,331450202.0,7351.673746739405,-0.18,2
17:34,131388684.0,21575.534758983584,-52.46,5
17:35,235881534.0,12244.565652853778,-110.56,7
17:36,518474507.0,13112.457964143769,-43.36,8
17:37,245690309.0,9548.246491429603,-15.29,7
17:37,876890798.0,2882.205770699934,-31.99,2
17:37,642015139.0,-1956.7336625343617,-143.0,2
17:39,874431242.0,8565.979828142927,-26.84,1
17:40,419550103.0,18960.95432756233,-6.0,7
17:41,905860285.0,10369.716410284174,-19.41,5
17:41,815385232.0,10205.532599700678,-40.28,5
17:41,822718326.0,11281.594001111884,-24.97,1
17:41,290818242.0,6645.245710731867,-64.13,2
17:42,836110591.0,2590.896362523865,-25.19,7
17:44,876890798.0,2840.215770699934,-41.99,2
17:45,280268430.0,4412.348280713835,-57.99,2
17:45,885259672.0,2602.740568522443,-86.77,2
17:45,854895960.0,3184.6847724857016,-46.98,2
17:46,656812046.0,849.4327537325189,-35.83,5
17:46,670102069.0,597.9221927731381,-12.24,7
17:46,851181128.0,4264.981548734847,-39.43,2
17:47,679911053.0,2161.6899063033034,-14.96,5
17:48,627917561.0,3709.507550000006,-92.62,2
17:49,200080192.0,8329.391929470956,-18.61,2
17:49,395284483.0,443.5503402113081,-130.19,2
17:52,166019891.0,8112.134344712451,-33.7,5
17:52,454129843.0,-249.14360483344,-131.11,5
17:52,581655972.0,41206.71870971774,-16.98,7
17:55,585596026.0,2466.7211185692563,-13.12,8
17:55,140893085.0,6473.257056365463,-198.07,2
17:56,651756497.0,14179.352821674836,-40.56,4
17:58,151968462.0,6716.518193190115,-10.09,4
17:58,834383043.0,5196.860579814327,-1.5,4
17:59,287230540.0,840.0509977638749,-44.0,2
17:59,151968462.0,6713.607334796313,-2.91,2
17:59,308505160.0,13141.30029980992,-4.5,8
18:02,844835978.0,10133.403623065778,-35.77,5
18:08,627917561.0,3667.5150500000063,-41.99,2
18:08,414454079.0,-71.10114999999851,-42.14,9
18:09,653640811.0,17533.44887932806,-55.17,5
18:09,285873880.0,11508.7985078172,-73.46,2
18:10,977899503.0,-960.7491064191472,-92.16,5
18:11,140893085.0,6217.771056365463,-255.49,2
18:13,780463728.0,3335.0808709422395,-92.03,5
18:15,224112146.0,695.8467499999997,-44.63,5
18:17,672913754.0,11651.71368710861,-36.18,7
18:18,340321732.0,1263.0592500000037,-263.54,5
18:20,245690309.0,9543.501513494615,-4.74,5
18:25,624563756.0,-604.9789712164436,-13.29,5
18:26,992204045.0,6807.697931394841,-1.5,7
18:28,802697323.0,15608.777913397054,-66.76,7
18:30,259015404.0,-144.01055382556456,-27.73,9
18:34,637433131.0,-17.22730000000103,-17.24,9
18:35,558119802.0,33672.86295518229,-16.94,9
18:36,886837068.0,829.9855999999993,-31.49,4
18:39,170233640.0,-644.5429600501027,-70.98,5
18:40,930271460.0,-28.731452464223665,-68.59,5
18:42,414805878.0,12536.916633381388,-5.31,5
18:45,270374623.0,9271.20483654399,-12.94,9
18:46,172084472.0,-468.9407215957186,-29.35,9
18:47,824916823.0,8009.739977243108,-3.11,7
18:51,358836279.0,-56.6343071924143,-150.5,5
18:51,146909202.0,3147.300127859603,-11.46,7
18:52,832564361.0,15361.373701148346,-32.68,7
18:53,868014990.0,-3620.286099999996,-11.08,5
18:54,285873880.0,11474.1485078172,-34.65,5
18:58,349614277.0,462.2750999999995,-143.68,5
19:00,163470640.0,773.3785999999994,-26.98,7
19:00,641764023.0,-1199.7938037720044,-31.99,5
19:00,730002588.0,13444.832061973028,-6.99,9
19:03,680773155.0,194.4671833310914,-39.85,5
19:03,618514666.0,21281.72347271649,-72.42,5
19:04,859603181.0,2457.509453873411,-129.02,5
19:07,169006407.0,11247.079412971165,-21.35,7
19:08,517190750.0,1324.8760899154126,-34.16,5
19:11,214765415.0,-549.5806488501354,-97.79,5
19:16,270374623.0,9265.380234374905,-5.82,2
19:19,224215364.0,-1896.3600920882789,-22.0,5
19:20,421881811.0,1783.7988003224916,-30.24,9
19:24,374994043.0,-2431.9880500000004,-25.18,5
19:26,155317149.0,129.11724999999905,-40.88,5
19:26,598586358.0,-3674.982449999995,-40.18,5
19:28,340295966.0,-1744.8019500000005,-29.38,5
19:29,829914501.0,681.2928065709746,-176.44,5
19:30,138969884.0,510.98519999999945,-32.58,9
19:31,466649401.0,95.43903079737434,-0.99,4
19:31,184430449.0,2527.48456682489,-70.36,5
19:32,720221651.0,-2645.2938665984343,-60.26,5
19:35,409971170.0,2282.9631306661504,-157.56,5
19:36,982286721.0,-3705.5155240177296,-43.04,5
19:37,479456865.0,539.4878118641743,-30.49,9
19:39,166019891.0,8071.708260281289,-40.43,7
19:41,871200314.0,-254.93487575736165,-115.95,5
19:46,994214354.0,9259.877800876384,-24.11,7
19:46,951817450.0,8991.573595445252,-1.3,2
19:50,871866387.0,27.29469999999911,-85.28,5
19:54,940569402.0,3841.4529364040504,-90.59,5
19:58,419550103.0,18903.91096114055,-57.04,2
20:06,624500124.0,2754.865502791638,-112.62,5
20:09,471897866.0,6629.324611599918,-21.43,5
20:09,832564361.0,15305.984210608282,-55.39,7
20:14,444428189.0,1028.3662000000024,-254.44,5
20:19,132400709.0,534.4070351539397,-90.67,5
20:21,322720763.0,6558.789992080467,-21.23,7
20:22,287480331.0,6988.244590957029,-4.55,5
20:31,872286364.0,-793.2525458130998,-28.47,5
20:33,532478725.0,3818.8170414402857,-55.23,4
20:50,586041848.0,1981.6646999999991,-25.79,5
20:59,151968462.0,6665.5383347963125,-48.07,5
21:10,776431321.0,2896.0320183352537,-4.82,2
21:19,867987292.0,1338.190655159993,-31.11,2
21:21,516051449.0,807.6321813984505,-30.9,7
21:23,653640811.0,17515.29139939478,-18.16,2
21:24,472995101.0,934.9995840990838,-39.74,9
21:26,166019891.0,8049.768260281289,-21.94,9
00:11,475117511.0,6819.295141140191,-0.53,2
00:18,738958551.0,8477.183874476434,-8.87,5
00:24,738958551.0,8442.483874476433,-34.7,9
00:24,973086490.0,9843.140422797836,-21.24,9
00:35,886921642.0,2866.680084533137,-1.52,7
00:37,348325817.0,8562.373446166263,-36.2,9
00:41,613729471.0,7632.231438697739,-46.91,7
01:06,899742927.0,12643.19608662295,-0.38,7
01:20,973086490.0,9842.917308865475,-0.22,2
01:35,697140785.0,-239.3313832638968,-23.74,9
01:36,984783496.0,14004.528353415766,-16.44,9
01:52,305778936.0,9951.848474347817,-19.9,7
02:10,399144202.0,1106.031810659464,-10.48,2
02:21,252760664.0,6129.528758102275,-57.89,2
02:36,858989281.0,26693.067069975747,-16.24,9
02:37,987163717.0,3449.590223888187,-35.54,9
02:39,287480331.0,6957.404590957029,-30.84,9
02:42,534325901.0,5818.055201328121,-37.04,5
02:46,124102251.0,1359.3823184627606,-28.57,2
02:46,601627384.0,2689.882196226647,-37.95,9
02:46,256002321.0,5763.874897201944,-10.75,9
02:48,433917275.0,6768.77562575204,-33.28,9
02:49,709608057.0,2004.2449526978885,-43.69,9
02:54,461990622.0,7045.735994278885,-28.8,5
02:57,480557476.0,11014.396973879037,-16.58,7
03:13,905860285.0,10362.385088972003,-7.33,2
03:14,588565416.0,5593.802014267637,-4.26,8
03:16,287480331.0,6929.414284340701,-27.99,2
03:17,256002321.0,5749.518316780856,-14.36,2
03:19,441274121.0,12019.687713881529,-15.3,9
03:20,912705941.0,18894.879301692898,-23.93,2
03:21,815385232.0,10195.332599700678,-10.2,9
03:29,655730067.0,-350.4718500000005,-38.89,9
03:30,679911053.0,2124.0797402210956,-37.61,8
03:34,836110591.0,2561.0563625238647,-29.84,9
03:37,450896297.0,12979.761799093676,-27.43,9
03:37,795847804.0,23814.68249375246,-30.18,5
03:41,532478725.0,3780.4270414402854,-38.39,9
03:43,549414742.0,5869.254775544888,-26.14,9
03:44,120634201.0,4768.194961861186,-19.29,9
03:46,282837512.0,13541.750641041695,-38.35,9
03:47,985188462.0,-342.0336112887752,-31.17,9
03:47,370521542.0,27102.08134645267,-32.99,7
03:49,221868392.0,4265.017870687221,-28.4,9
03:49,187111705.0,6490.889406711437,-1.54,7
03:49,237493332.0,14366.81416871697,-16.24,9
03:51,885259672.0,2571.07459257799,-31.67,2
03:59,196289502.0,15967.095215818335,-15.48,2
04:00,678851253.0,3063.116729137072,-8.49,5
04:02,489964679.0,19990.23746236988,-29.12,9
04:03,108563213.0,23007.7966621905,-7.43,5
04:07,822250278.0,6098.771988366479,-9.43,8
04:09,930277104.0,8748.609123876558,-32.93,9
04:11,151916463.0,-350.78244440083114,-28.29,9
04:12,473820682.0,10707.337427636689,-35.59,2
04:13,698076160.0,6258.367379080278,-11.01,7
04:20,169006407.0,11186.664628124856,-60.41,2
04:22,781554833.0,880.3302255639663,-31.49,9
04:28,933491926.0,3134.7233452882815,-44.31,5
04:34,679662108.0,14492.189862382387,-38.6,2
04:38,128033695.0,1700.144850301085,-39.26,7
04:39,704517789.0,17472.389183665215,-46.89,2
04:40,832564361.0,15298.994210608282,-6.99,9
04:43,298000165.0,25903.458919154644,-10.76,5
04:43,766941757.0,1481.6331215021394,-13.04,8
04:44,752362502.0,5847.889714094106,-4.83,5
04:48,858989281.0,26639.193633315193,-53.87,7
04:48,113747882.0,11659.972135924032,-56.24,2
04:55,657139925.0,13158.646614451063,-16.23,9
04:56,417850087.0,15169.663333231956,-2.74,5
04:56,532478725.0,3771.570857564939,-8.86,2
04:56,264550521.0,4728.2712376490035,-2.67,2
04:57,668329719.0,8578.298142166504,-48.73,8
04:58,647936800.0,2132.1220343851733,-51.59,7
05:00,441274121.0,11995.22474001242,-24.46,7
05:03,709608057.0,2002.032681468542,-2.21,2
05:07,117308635.0,1991.9602517860951,-25.26,2
05:07,108931112.0,14135.463206981687,-29.49,9
05:09,414805878.0,12500.536633381387,-36.38,9
05:10,683319988.0,6259.838964556634,-57.64,7
05:13,510101371.0,11971.742265770225,-34.05,9
05:15,145387690.0,4280.735263506156,-3.54,5
05:18,806358207.0,10980.681938270374,-11.09,4
05:19,348325817.0,8536.728302934393,-25.65,7
05:19,887853850.0,9900.94660443995,-9.68,8
05:30,809499628.0,17437.40368703457,-15.93,9
05:32,673025413.0,600.2311378491714,-1.21,7
05:35,678330503.0,751.2874119909469,-29.09,9
05:38,213112754.0,5206.871693119758,-14.2,9
05:41,940569402.0,3839.542300383149,-1.91,8
05:43,433917275.0,6758.521394986219,-10.25,7
05:43,534204159.0,5018.722754257618,-19.65,8
05:43,366550080.0,25474.57507487255,-17.3,8
05:47,749378808.0,1253.9794778732123,-51.14,7
05:50,216285378.0,24221.191113528417,-38.32,9
05:53,822135975.0,11065.708282375246,-2.06,5
05:59,897714622.0,8945.711637450024,-61.82,5
05:59,815385232.0,10189.483882604998,-5.85,2
06:03,520447032.0,7532.991262724161,-23.04,9
06:06,678330503.0,741.6770111354522,-9.61,2
06:08,331450202.0,7340.925492149376,-10.75,7
06:08,558119802.0,33659.90268920959,-12.96,2
06:08,478412511.0,12204.154292893065,-4.45,2
06:09,832564361.0,15265.101575670787,-33.89,2
06:09,736340277.0,7756.761615684275,-45.17,2
06:10,383625050.0,2465.143430794794,-70.82,2
06:12,587225252.0,5075.649084083154,-44.04,9
06:12,414805878.0,12450.692803014548,-49.84,8
06:15,575652395.0,651.811014197173,-41.97,4
06:19,769311479.0,6004.125711633757,-30.75,2
06:19,450896297.0,12926.746079877164,-53.02,5
06:20,851181128.0,4263.99550450152,-0.99,5
06:21,482513594.0,5143.898222590843,-3.9,2
06:26,824916823.0,8008.254907830061,-1.49,7
06:26,503575533.0,6858.435558034369,-4.41,2
06:26,315546581.0,29375.487962888677,-11.31,5
06:28,975345315.0,36132.05389051303,-23.85,4
06:35,581655972.0,41184.98893115024,-21.73,2
06:38,853907490.0,7433.843109352968,-8.95,9
06:38,213112754.0,5202.876835744515,-3.99,7
06:40,108481285.0,8700.241968008757,-9.99,2
06:40,254853117.0,2744.8085523361187,-22.05,9
06:41,506618547.0,14256.082811783508,-24.47,2
06:41,179173981.0,3488.004761021879,-30.58,9
06:42,572384506.0,6575.92059240621,-42.99,9
06:42,310375875.0,793.2245901371343,-28.64,9
06:42,987656636.0,3861.065064244265,-12.78,7
06:45,324224854.0,4092.5440700450936,-2.87,5
06:47,518474507.0,13104.37948296749,-8.08,5
06:48,633345190.0,5449.51007594966,-19.96,9
06:49,901432314.0,2931.299551743742,-44.15,8
06:49,802697323.0,15567.937913397054,-40.84,9
06:51,706250160.0,12383.030003880458,-11.93,4
06:57,290818242.0,6643.279692205897,-1.97,7
06:59,237684254.0,5626.957838883596,-24.81,2
07:03,705848712.0,27225.993940142533,-15.74,9
07:07,873693307.0,10047.737740177512,-21.4,9
07:09,237493332.0,14344.653062566436,-22.16,5
07:13,170637730.0,750.074391142719,-18.44,2
07:16,647472692.0,26218.57484028517,-60.59,8
07:17,670102069.0,562.4421927731381,-35.48,9
07:17,259015404.0,-176.80055382556455,-32.79,9
07:18,873701090.0,-131.95283048517962,-65.41,7
07:19,383833857.0,25696.13308150303,-8.0,7
07:21,829914501.0,675.9928065709746,-5.3,9
07:22,996042490.0,5782.940159846393,-25.94,2
07:23,166019891.0,7977.796020364515,-71.97,5
07:24,187541224.0,997.3188873742358,-43.3,9
07:32,143061865.0,6455.62984654668,-39.16,5
07:34,633345190.0,5448.597624869653,-0.91,2
07:36,836110591.0,2541.8030657338627,-19.25,2
07:37,587225252.0,5001.99079089366,-73.66,2
07:43,146909202.0,3120.6038223472538,-26.7,5
07:47,511179916.0,7079.718966695806,-34.38,2
07:49,541639148.0,3650.203186160172,-31.63,2
07:52,549414742.0,5859.959131837417,-9.3,5
07:52,540159353.0,10633.73613911443,-70.48,2
07:56,874431242.0,8554.24687283202,-11.73,2
07:59,675806859.0,6934.831558406704,-66.07,2
08:00,308505160.0,13133.230098790622,-8.07,2
08:09,683078800.0,1395.0850811472849,-30.22,2
08:09,766941757.0,1447.0331215021397,-34.6,9
08:09,687135796.0,28698.7586128096,-7.72,2
08:10,986267641.0,3732.520340826044,-2.52,2
08:13,270374623.0,9248.06656026848,-17.31,5
08:14,994214354.0,9235.47936294483,-24.4,4
08:15,429556122.0,4242.010131214204,-39.14,8
08:20,970298834.0,1967.7321997478891,-16.45,7
08:21,245690309.0,9525.329513494617,-18.17,5
08:22,984783496.0,14001.945815760082,-2.58,2
08:22,873693307.0,10017.499724197674,-30.24,8
08:25,550644516.0,-430.8163500000015,-41.46,5
08:25,815993333.0,5539.737423689321,-15.54,8
08:26,885259672.0,2565.17459257799,-5.9,9
08:27,623156843.0,4415.166878011584,-23.06,8
08:27,730002588.0,13381.694847420731,-63.14,8
08:27,536924114.0,-1089.724705593096,-70.74,5
08:33,675231808.0,16588.64413259353,-1.71,8
08:35,550169791.0,22229.191681154945,-5.47,8
08:36,586315521.0,12170.778262868282,-11.76,4
08:39,932820758.0,-2766.756566775554,-49.67,5
08:39,820686957.0,-1327.440916311196,-129.73,5
08:39,782013626.0,564.3111993116287,-74.53,5
08:41,718058208.0,1586.895412220709,-3.98,7
08:41,554792076.0,28854.058726681506,-41.38,2
08:41,401293808.0,-405.8431000000009,-191.88,5
08:42,701070224.0,-1402.1915,-115.97,5
08:42,737537711.0,-580.6844663984643,-22.33,5
08:43,403383649.0,602.9851252948918,-82.03,5
08:44,355602925.0,1251.5957265753275,-54.06,5
08:45,141521177.0,6340.675900000016,-67.12,5
08:45,682194230.0,-2470.5108499999988,-20.06,5
08:48,202320275.0,-1020.7166500000006,-28.47,5
08:50,137822385.0,3409.568703161884,-44.47,5
08:51,615144184.0,527.7638991255188,-138.07,5
08:52,246753533.0,95.74769999999836,-48.09,5
08:52,280200287.0,138.82704661305104,-25.79,5
08:53,315078351.0,8078.588246840607,-20.5,7
08:54,951817450.0,8991.266111181685,-0.31,2
08:56,298000165.0,25865.70091915464,-37.76,5
08:56,865748375.0,2013.683780481196,-26.86,5
08:57,647472692.0,26185.434840285172,-33.14,9
08:57,715068825.0,-541.5255000000002,-85.3,5
08:58,845648250.0,-212.21595000000065,-147.49,5
09:00,779946617.0,16798.440326065618,-20.57,2
09:03,999752672.0,811.2638935333348,-6.5,9
09:03,322221939.0,3068.0059173737927,-37.07,5
09:03,683078800.0,1387.285081147285,-7.8,9
09:03,290818242.0,6638.279692205897,-5.0,9
09:05,547010927.0,24007.877702433765,-54.11,7
09:06,558875206.0,2988.400539399781,-6.1,9
09:07,960208650.0,14198.280104822792,-5.66,5
09:07,285873880.0,11459.427877134804,-14.72,4
09:07,554792076.0,28794.4607266815,-59.6,5
09:08,417850087.0,15164.013333231956,-5.65,9
09:10,667367404.0,8960.366736218231,-5.1,9
09:11,455831435.0,-1972.212104801495,-41.74,5
09:11,425964226.0,3952.790764114707,-6.15,9
09:11,618138606.0,1083.5033032642873,-5.7,9
09:11,661295096.0,2861.590949818632,-149.75,5
09:13,930277104.0,8742.309146623624,-6.3,5
09:13,683319988.0,6253.688964556634,-6.15,9
09:14,183888402.0,18955.152457140142,-46.09,9
09:14,609939116.0,6904.351574120286,-40.09,4
09:16,954263768.0,-451.7831000000003,-60.85,5
09:16,500043411.0,13369.168633810745,-69.09,5
09:17,903953091.0,2769.7007901345737,-28.0,2
09:18,399144202.0,965.781810659464,-140.25,2
09:18,117273481.0,8785.211038702899,-4.95,9
09:18,169006407.0,11181.014628124856,-5.65,9
09:18,581655972.0,41178.18893115024,-6.8,9
09:18,308505160.0,13127.930098790624,-5.3,9
09:21,587225252.0,4784.12079089366,-217.87,2
09:21,690958123.0,20563.88405592685,-5.0,9
09:22,414454079.0,3328.7588500000015,-10.14,4
09:23,540159353.0,10628.23613911443,-5.5,9
09:25,331048953.0,-293.8936320215064,-58.38,5
09:26,588565416.0,5541.812014267637,-51.99,2
09:27,441274121.0,11990.22474001242,-5.0,9
09:29,955035930.0,1435.638479171478,-45.97,4
09:30,259015404.0,-176.9757711337782,-0.18,5
09:30,986774156.0,1440.5969316257692,-70.98,2
09:32,700138124.0,4073.67695240748,-39.44,5
09:39,890830949.0,802.4039999999976,-141.99,2
09:42,853907490.0,7407.874230869358,-25.97,5
09:42,546296727.0,162.33772730261845,-40.99,2
09:43,741903302.0,2300.497067935261,-99.99,2
09:43,414454079.0,3211.938850000002,-116.82,2
09:43,252760664.0,5921.708758102275,-207.82,2
09:46,550832673.0,2895.91601639551,-44.0,2
09:49,670102069.0,534.827763329875,-27.61,8
09:55,414454079.0,3198.7388500000015,-13.2,2
09:57,264550521.0,4677.488197649003,-50.78,4
09:57,890830949.0,762.9039999999976,-39.5,2
09:59,127809299.0,2146.270496724463,-31.99,2
10:00,348525881.0,757.5416245949358,-57.98,2
10:01,762859681.0,1436.6285999999989,-21.99,1
10:02,903468956.0,553.5411999999993,-39.5,7
10:03,215311171.0,4750.91206093745,-99.99,6
10:05,895331556.0,-652.4512000000009,-45.03,5
10:05,128030172.0,-759.32297744985,-44.05,5
10:06,441142605.0,1596.550392275729,-131.98,2
10:06,546296727.0,152.34772730261844,-9.99,1
10:09,659415300.0,1473.8115805359596,-5.8,9
10:11,890830949.0,629.9139999999976,-132.99,2
10:12,256002321.0,5707.538316780857,-41.98,1
10:12,679943657.0,1491.118889180137,-73.43,2
10:12,711045550.0,1914.871350000004,-106.95,5
10:17,399538448.0,7395.612260393225,-31.98,4
10:18,305778936.0,9925.398474347814,-26.45,2
10:21,348325817.0,8519.628532934392,-17.1,4
10:21,903468956.0,468.5411999999993,-85.0,4
10:23,604288474.0,1161.9869729963789,-63.24,5
10:24,364357875.0,7430.977400039646,-0.53,7
10:25,941285623.0,453.80639906677027,-19.98,4
10:29,769319491.0,-191.3530000000008,-37.95,1
10:30,792845450.0,553.0911500000008,-1.99,4
10:31,355733816.0,4589.076316440188,-10.45,7
10:35,399144202.0,933.4065706594644,-32.38,4
10:36,815993333.0,5510.637423689321,-29.1,1
10:40,812692024.0,3613.729590521821,-6.99,4
10:42,366550080.0,25385.03107487255,-89.54,2
10:42,285220959.0,11943.97785720292,-48.77,8
10:44,435313070.0,2629.073333033221,-131.98,2
10:46,703537476.0,582.9962499999992,-167.45,5
10:46,718058208.0,1333.523412220709,-253.37,2
10:48,910730524.0,7530.595817660659,-125.41,5
10:50,386277162.0,140.84999999999934,-26.96,7
10:52,890830949.0,571.9339999999976,-57.98,2
10:52,392270893.0,13119.157288908063,-37.12,7
10:55,282046994.0,-609.7876499999996,-33.18,5
10:56,305778936.0,9809.212474347814,-116.19,2
10:57,903468956.0,354.0411999999993,-114.5,2
11:00,546296727.0,139.35772730261843,-12.99,2
11:01,308897841.0,1049.722499999999,-55.11,2
11:05,272538745.0,16079.879900000024,-31.98,4
11:06,718058208.0,1306.251412220709,-27.27,2
11:07,865748375.0,1968.289814445187,-45.39,4
11:08,890830949.0,509.9539999999976,-61.98,2
11:09,703537476.0,512.9962499999992,-70.0,2
11:10,414454079.0,3182.4988500000018,-16.24,2
11:12,366550080.0,25313.64507487255,-71.39,2
11:14,782013626.0,429.33119931162867,-134.98,6
11:15,910730524.0,7514.948895315276,-15.65,7
11:15,546296727.0,94.37772730261844,-44.98,2
11:22,812692024.0,3591.729590521821,-22.0,2
11:25,425730826.0,1061.11690938872,-84.98,2
11:25,718058208.0,1175.407412220709,-130.84,2
11:27,366550080.0,25039.95907487255,-273.69,2
11:28,890830949.0,430.48399999999754,-79.47,2
11:29,604288474.0,1161.434873017406,-0.55,2
11:30,703537476.0,411.4962499999992,-101.5,2
11:31,762896656.0,-1213.6475018481417,-30.87,5
11:34,305778936.0,9767.240474347816,-41.97,2
11:35,519644021.0,2368.6729189411467,-3.9,5
11:42,180616589.0,800.4108282361094,-8.98,4
11:55,475277431.0,917.294136943619,-6.0,4
11:56,903468956.0,239.54119999999932,-114.5,7
12:01,890830949.0,359.0039999999975,-71.48,2
12:01,700138124.0,4058.03695240748,-15.64,9
12:07,779236304.0,1022.4175954795338,-39.09,9
12:09,250895529.0,847.9625324692881,-20.73,9
12:10,117308635.0,1948.5882517860953,-43.37,7
12:22,901432314.0,2904.989551743742,-26.31,1
12:23,198946608.0,3241.8379268292288,-54.15,2
12:27,548907062.0,315.1273364260272,-67.77,5
12:29,903468956.0,194.54119999999932,-45.0,4
12:33,146686559.0,-809.631411173478,-22.3,5
12:36,308897841.0,1042.035099999999,-7.69,5
12:37,792845450.0,407.49115000000074,-145.6,2
12:38,366550080.0,24944.07307487255,-95.89,2
12:40,479366718.0,1994.2413481400413,-51.48,4
12:42,479456865.0,530.4978118641743,-8.99,4
12:42,799861885.0,456.9009499999987,-102.88,5
12:43,520447032.0,7522.731262724161,-10.26,2
12:44,179173981.0,3439.8837350050617,-48.12,7
12:44,490868147.0,-601.3592208786985,-100.27,5
12:45,866941383.0,1595.427680303673,-60.0,2
12:45,696758548.0,-3697.265396320137,-41.2,5
12:47,433837402.0,-199.4458684641881,-26.48,9
12:51,366550080.0,24882.48707487255,-61.59,2
12:55,448004226.0,1422.4423686648795,-28.94,9
12:55,308897841.0,1030.800099999999,-11.23,2
12:58,191161970.0,-4176.381999999994,-73.65,5
13:05,366550080.0,24622.12907487255,-260.36,2
13:05,221356538.0,667.4393999999995,-13.45,9
13:08,892354433.0,-1008.4599606343388,-54.36,5
13:09,903468956.0,125.54119999999932,-69.0,2
13:11,792845450.0,215.69115000000076,-191.8,2
13:11,749378808.0,1231.5394778732125,-22.44,9
13:11,262767079.0,-1535.3465000000006,-78.44,5
13:11,849096144.0,1023.619020751343,-7.8,9
13:18,348325817.0,8484.998532934393,-34.63,1
13:19,688712152.0,6607.714893890442,-4.95,9
13:20,158766229.0,-860.99763589347,-68.35,5
13:35,305778936.0,9496.354474347814,-270.89,2
13:37,198946608.0,3192.2843911153113,-49.55,2
13:37,527842638.0,81.6962426329834,-29.99,2
13:41,903468956.0,2.0411999999993213,-123.5,2
13:41,228136274.0,1108.2618399999997,-15.01,4
13:43,366550080.0,24308.543074872552,-313.59,2
13:51,718058208.0,1125.021412220709,-50.39,2
13:56,366550080.0,24249.77107487255,-58.77,2
13:57,403383649.0,557.5648031531707,-45.42,2
13:59,225210798.0,210.0799351225794,-69.61,5
14:07,890830949.0,319.5039999999975,-39.5,2
14:11,792845450.0,3.5911500000007663,-212.1,2
14:14,165691047.0,-111.1829000000011,-90.63,5
14:16,903468956.0,-20.45880000000068,-22.5,2
14:17,546296727.0,-57.60227269738155,-151.98,2
14:18,718058208.0,763.121412220709,-361.9,2
14:24,890830949.0,209.5139999999975,-109.99,2
14:28,366550080.0,24146.19907487255,-103.57,2
14:32,792845450.0,-218.3088499999992,-221.9,2
14:37,718058208.0,668.621412220709,-94.5,2
14:48,812692024.0,3483.7615905218213,-107.97,5
14:51,399144202.0,911.5065706594644,-21.9,9
14:51,366550080.0,24017.42707487255,-128.77,2
14:52,890830949.0,155.5239999999975,-53.99,2
14:52,256002321.0,5634.672486780857,-72.87,4
15:03,305778936.0,9283.610474347814,-212.74,2
15:14,984783496.0,13979.295615760082,-22.65,4
15:20,280990953.0,682.4196999999982,-5.99,4
15:23,890830949.0,116.0239999999975,-39.5,2
15:27,305778936.0,9242.338474347813,-41.27,2
15:28,322221939.0,3047.775257373793,-20.23,4
15:32,274818272.0,117.26757856713138,-68.41,5
15:41,546296727.0,-107.58227269738154,-49.98,4
15:50,718058208.0,574.163412220709,-94.46,2
15:55,890830949.0,89.54399999999751,-26.48,2
15:56,305778936.0,9048.480474347813,-193.86,2
16:00,321372947.0,-593.4549507890995,-44.93,5
16:11,520447032.0,7480.037938427334,-42.69,2
16:12,158414827.0,-1568.075000000002,-16.59,5
16:18,117308635.0,1873.0162517860952,-75.57,2
16:26,126929801.0,1039.3338192125627,-98.91,4
16:28,890830949.0,20.57399999999751,-68.97,2
16:30,366550080.0,23854.38307487255,-163.04,2
16:31,117308635.0,1763.8442517860954,-109.17,2
16:33,305778936.0,8762.894474347813,-285.59,2
16:34,305778936.0,8723.644474347813,-39.25,9
16:38,310375875.0,756.8957377870831,-36.33,5
16:38,117308635.0,1603.5722517860954,-160.27,2
16:38,370757362.0,958.7260236036174,-212.1,2
16:49,208381936.0,-25.71557822174519,-79.98,2
16:50,456221621.0,-10.260632697372031,-66.05,5
16:53,366550080.0,23686.43907487255,-167.94,2
16:58,886921642.0,2846.328554533137,-20.35,4
16:59,117308635.0,1436.9862517860954,-166.59,2
17:01,628470485.0,-230.25150243258537,-71.92,4
17:03,370757362.0,882.4260236036174,-76.3,2
17:04,890830949.0,-60.92600000000249,-81.5,2
17:06,196289502.0,15941.595215818335,-25.5,9
17:07,719586818.0,18665.537459501604,-12.64,2
17:07,124102251.0,1338.4323184627606,-20.95,4
17:10,241459011.0,410.1210132723467,-29.62,5
17:16,134847904.0,1364.7619834790696,-32.84,9
17:17,842682241.0,2516.386536130075,-22.36,2
17:18,449871732.0,6380.887505793859,-1.99,4
17:19,486495235.0,937.8256100762068,-19.99,2
17:24,117308635.0,1283.7002517860954,-153.29,2
17:25,124102251.0,1278.3923184627606,-60.04,2
17:26,141521177.0,6290.685900000016,-49.99,2
17:28,984783496.0,13914.885615760082,-64.41,2
17:29,758160963.0,6950.9303803804,-67.3,4
17:31,987163717.0,3294.6602238881874,-154.93,2
17:32,854513972.0,1512.9177000000002,-88.98,2
17:32,874431242.0,8505.60687283202,-48.64,2
17:33,208381936.0,-53.71557822174519,-28.0,2
17:33,516051449.0,757.6621813984505,-49.97,4
17:36,890830949.0,-100.42600000000247,-39.5,2
17:36,425964226.0,3928.7807641147074,-24.01,7
17:38,705848712.0,27212.84063949334,-13.15,7
17:38,365608668.0,-184.26608952616735,-65.52,5
17:39,990461108.0,8.326518620611036,-31.99,2
17:39,534325901.0,5802.855201328121,-15.2,9
17:39,824916823.0,7997.8649078300605,-10.39,2
17:39,939972497.0,706.6809086000105,-68.55,5
17:41,627622066.0,3329.30907216963,-104.49,2
17:42,315546581.0,29345.086632888677,-30.4,4
17:43,366550080.0,23548.539074872548,-137.9,2
17:45,106601471.0,10454.606969606017,-24.07,5
17:46,683319988.0,6227.148964556634,-26.54,9
17:50,851649498.0,7921.893879870908,-49.47,8
17:51,169006407.0,11156.764628124856,-24.25,1
17:51,344219145.0,7948.973113232297,-86.99,2
17:52,703537476.0,243.49624999999924,-168.0,2
17:52,802697323.0,15552.458174823276,-15.48,2
17:55,517190750.0,1254.7585899154126,-70.12,2
17:55,690523499.0,-3.911399999999823,-58.85,5
17:58,752362502.0,5842.8597140941065,-5.03,7
17:58,138609932.0,2078.484003294586,-69.29,2
18:00,667367404.0,8935.161779262311,-25.2,8
18:02,556992209.0,10416.283766670776,-52.71,5
18:02,435984758.0,3626.0106803732942,-2.77,4
18:03,616924659.0,-709.5304201769147,-12.2,5
18:06,496395938.0,11933.981469457893,-13.91,5
18:06,482513594.0,5120.826222590843,-23.07,5
18:08,517190750.0,1106.2585899154126,-148.5,2
18:13,940569402.0,3819.652300383149,-19.89,9
18:15,581655972.0,41151.88293115024,-26.31,5
18:16,518474507.0,13073.12948296749,-31.25,9
18:19,423208402.0,3786.595500000003,-5.5,7
18:21,844835978.0,10129.67610558531,-3.73,8
18:22,627622066.0,3246.80907216963,-82.5,2
18:24,116169597.0,311.48694999999964,-18.48,7
18:26,758160963.0,6907.138380380399,-43.79,5
18:31,639420537.0,-1562.2239499999998,-35.58,5
18:34,187111705.0,6470.197406711437,-20.69,5
18:35,992204045.0,6790.618074221772,-17.08,5
18:37,229205098.0,7131.228755597025,-25.73,5
18:44,775790822.0,-3394.9584192160673,-35.69,5
18:45,478651121.0,-690.9298204015304,-39.64,5
18:47,996042490.0,5776.930159846393,-6.01,7
18:47,994214354.0,9211.02936294483,-24.45,9
18:47,433917275.0,6746.051394986219,-12.47,7
18:47,736340277.0,7735.355615684275,-21.41,5
18:49,143383029.0,-1617.3659193476612,-37.32,9
18:53,390747457.0,405.5588999999979,-41.35,5
18:56,858560423.0,12267.051253018788,-6.99,7
18:58,874431242.0,8473.17687283202,-32.43,9
18:58,266777719.0,-1431.2890662197603,-57.5,5
18:59,331450202.0,7327.919492149375,-13.01,5
18:59,176922958.0,1293.4005471976498,-24.07,9
19:00,280268430.0,4392.406605984273,-19.94,2
19:00,229205098.0,7122.6118944080345,-8.62,7
19:01,624563756.0,-622.9206712164436,-17.94,5
19:02,897592348.0,15692.013417711749,-11.83,7
19:03,494156462.0,-1423.1489364817603,-101.37,5
19:04,366477356.0,71.87179999999982,-74.03,5
19:04,308068836.0,-881.2684774318078,-71.15,5
19:11,873693307.0,9956.515724197674,-60.98,5
19:15,547010927.0,23982.477702433764,-25.4,9
19:16,868033067.0,-2534.130786451081,-20.62,5
19:18,824916823.0,7976.584907830061,-21.28,9
19:18,706301742.0,-3218.640649999996,-49.6,5
19:18,147474476.0,2525.890030555134,-262.94,5
19:21,522188082.0,6589.784009493322,-0.44,8
19:22,246753533.0,77.54769999999834,-18.2,9
19:22,651756497.0,14170.182230062888,-9.17,5
19:25,282837512.0,13537.726207856344,-4.02,7
19:36,213930646.0,-1918.584563472563,-35.44,5
19:37,120634201.0,4752.730461478469,-15.46,2
19:37,152488934.0,1738.8846573137312,-89.95,5
19:43,653640811.0,17469.421209104283,-45.87,7
19:45,720742759.0,138.32113088300724,-133.68,5
19:47,980500334.0,-1403.4819338929035,-12.73,5
19:47,119943495.0,-1674.0225621128582,-32.94,5
19:50,899742927.0,12385.820086622947,-257.38,5
19:50,471897866.0,6621.217930284307,-8.11,2
19:52,851181128.0,4169.5585045015205,-94.44,5
19:57,248658670.0,-990.66585,-17.69,5
19:58,736340277.0,7718.715615684275,-16.64,9
19:59,785749304.0,8156.1771219325,-9.98,9
20:00,550169791.0,22210.451681154944,-18.74,9
20:01,949032480.0,3004.250541364279,-28.88,9
20:04,896821055.0,-1062.3994407329176,-142.44,5
20:18,409971170.0,2251.999991164573,-30.96,2
20:22,601627384.0,2666.155725776922,-23.73,5
20:23,618138606.0,1056.8633032642872,-26.64,9
20:25,804317849.0,-4119.641633020518,-94.43,5
20:27,200080192.0,8294.184865638263,-35.21,5
20:27,859603181.0,2446.171645335317,-11.34,2
20:37,713910252.0,-1503.482874271459,-74.53,5
20:45,637433131.0,-106.90920000000104,-89.68,5
20:59,893134725.0,780.8515007761189,-9.31,5
20:59,315546581.0,29316.196632888677,-28.89,9
21:00,113747882.0,11628.182135924031,-31.79,9
21:23,143003091.0,10302.897026686323,-8.8,7
02:20,518474507.0,13042.23948296749,-30.89,9
02:25,749378808.0,1203.1994778732123,-28.34,9
02:28,688328251.0,-1021.2663753548272,-23.23,9
02:32,216285378.0,24188.361113528415,-32.83,9
02:37,996042490.0,5745.176754859272,-31.75,4
02:38,885259672.0,2558.3733321896148,-6.8,7
02:39,534325901.0,5787.915201328122,-14.94,9
02:42,461990622.0,7034.7177685368,-11.02,7
02:49,930277104.0,8707.729146623624,-34.58,9
02:49,887853850.0,9869.27660443995,-31.67,9
02:56,270374623.0,9240.385715048043,-7.68,2
02:56,705848712.0,27206.85063949334,-5.99,9
03:04,679662108.0,14465.043639958702,-27.15,8
03:08,738958551.0,8408.523874476434,-33.96,9
03:11,534204159.0,5008.56603638335,-10.16,7
03:13,683319988.0,6203.958964556635,-23.19,9
03:14,489964679.0,19952.19746236988,-38.04,9
03:18,324224854.0,4040.3624683394614,-52.18,7
03:21,822135975.0,11058.718282375246,-6.99,9
03:24,550169791.0,22206.73169844692,-3.72,2
03:24,675806859.0,6928.566123682562,-6.27,8
03:26,492215823.0,2245.4642238154447,-27.43,9
03:29,108481285.0,8696.74494583741,-3.5,7
03:35,973086490.0,9820.308548144338,-22.61,5
03:35,887853850.0,9868.705429852413,-0.57,5
03:38,558119802.0,33658.95615685317,-0.95,5
03:40,256002321.0,5623.772486780857,-10.9,9
03:41,700138124.0,4034.2342426536225,-23.8,7
03:41,510101371.0,11934.562265770224,-37.18,9
03:43,836110591.0,2504.313065733863,-37.49,9
03:46,554792076.0,28762.412644911452,-32.05,5
03:47,802697323.0,15522.968174823276,-29.49,9
03:48,473820682.0,10695.638097136502,-11.7,4
03:50,670102069.0,502.417763329875,-32.41,9
03:50,987163717.0,3255.5202238881875,-39.14,9
03:51,679911053.0,2100.6609505983383,-23.42,4
04:00,912705941.0,18891.842539736463,-3.04,2
04:00,785749304.0,8116.5240077993985,-39.65,7
04:01,816685391.0,-876.8044037084264,-18.2,9
04:02,145387690.0,4253.255263506157,-27.48,9
04:02,930277104.0,8662.673109379,-45.06,7
04:03,305778936.0,8666.253231480136,-57.39,7
04:04,518474507.0,12957.427217473787,-84.81,2
04:10,519644021.0,2321.610772794741,-47.06,5
04:12,749378808.0,1201.3041745044577,-1.9,5
04:13,196289502.0,15926.155215818337,-15.44,9
04:15,370521542.0,27089.08134645267,-13.0,9
04:17,865748375.0,1962.932461293732,-5.36,8
04:18,383833857.0,25674.88308150303,-21.25,9
04:20,899742927.0,12326.212652855798,-59.61,2
04:21,252760664.0,5899.290222038698,-22.42,7
04:22,355602925.0,1219.9957265753276,-31.6,9
04:23,348325817.0,8484.471517643395,-0.53,5
04:24,683319988.0,6192.17502470516,-11.78,2
04:24,450896297.0,12923.032233446109,-3.71,7
04:26,586315521.0,12095.61415587801,-75.16,2
04:37,793781222.0,483.900878947406,-29.15,9
04:38,832564361.0,15256.006878023793,-9.09,5
04:38,322221939.0,3019.796976213188,-27.98,2
04:38,120634201.0,4734.800461478469,-17.93,9
04:39,128033695.0,1691.751327340415,-8.39,8
04:46,897714622.0,8942.950286277222,-2.76,2
04:48,179173981.0,3395.1452208527417,-44.74,5
04:49,482513594.0,5105.649481143439,-15.18,5
04:51,355733816.0,4570.076316440188,-19.0,9
04:51,417850087.0,15134.769515347962,-29.24,5
04:56,511179916.0,7037.084208690281,-42.63,2
05:02,435984758.0,3613.3355567006665,-12.68,2
05:04,994214354.0,9178.87936294483,-32.15,9
05:08,370521542.0,27046.489373308763,-42.59,7
05:10,572384506.0,6544.19059240621,-31.73,9
05:12,169006407.0,11143.88284139402,-12.88,2
05:12,853907490.0,7364.05532495338,-43.82,7
05:17,986267641.0,3698.240340826044,-34.28,9
05:20,285220959.0,11902.40878717974,-41.57,5
05:23,383833857.0,25665.352818639076,-9.53,5
05:24,187541224.0,963.8288873742358,-33.49,9
05:25,992204045.0,6781.404203345351,-9.21,2
05:25,970298834.0,1934.035478613967,-33.7,7
05:26,414805878.0,12417.562803014547,-33.13,9
05:26,779946617.0,16790.147917987593,-8.29,2
05:27,842682241.0,2512.802729517414,-3.58,5
05:28,874431242.0,8455.39687283202,-17.78,9
05:41,187111705.0,6464.254495025158,-5.94,2
05:43,698076160.0,6255.818610146619,-2.55,8
05:44,668329719.0,8561.910003632136,-16.39,2
05:46,520447032.0,7407.498715259511,-72.54,2
05:46,985188462.0,-371.7736112887752,-29.74,9
05:49,709608057.0,1964.692681468542,-37.34,9
05:53,170637730.0,735.1336205222763,-14.94,2
05:59,496395938.0,11919.75993692274,-14.22,7
06:00,310375875.0,733.2847652598518,-23.61,5
06:00,601627384.0,2635.7757257769217,-30.38,9
06:02,949032480.0,2976.360541364279,-27.89,9
06:03,678851253.0,3053.1599833566615,-9.96,2
06:04,433917275.0,6723.901394986219,-22.15,9
06:04,308505160.0,13065.014677079927,-62.92,5
06:07,673025413.0,593.9058728046261,-6.33,7
06:08,108931112.0,14095.813206981687,-39.65,9
06:12,933491926.0,3131.625897981177,-3.1,2
06:13,480557476.0,11010.88162930783,-3.52,2
06:13,822135975.0,11047.984187925174,-10.73,2
06:14,315546581.0,29284.742829758565,-31.45,2
06:14,858989281.0,26622.293633315192,-16.9,9
06:17,587225252.0,4747.24079089366,-36.88,9
06:18,282837512.0,13504.226207856344,-33.5,9
06:19,809499628.0,17414.21368703457,-23.19,9
06:19,836110591.0,2503.763407774246,-0.55,7
06:23,532478725.0,3741.1408575649393,-30.43,9
06:23,769311479.0,5987.5126980553105,-16.61,5
06:23,287480331.0,6896.091834201883,-33.32,8
06:24,984783496.0,13904.18561576008,-10.7,9
06:25,815993333.0,5496.861996048702,-13.78,2
06:25,806358207.0,10966.65390915336,-14.03,7
06:29,633345190.0,5421.107624869654,-27.49,9
06:33,949032480.0,2969.075777072572,-7.28,2
06:34,303843160.0,-434.60319999999854,-18.19,9
06:34,588565416.0,5539.927367678118,-1.88,8
06:38,873693307.0,9942.875724197676,-13.64,9
06:40,237684254.0,5611.550854354138,-15.41,4
06:41,613729471.0,7562.237802412713,-69.99,7
06:43,718058208.0,573.8276191219226,-0.34,5
06:47,678726554.0,-562.1072476516102,-24.63,9
06:47,113747882.0,11584.222135924032,-43.96,9
06:47,639549973.0,4286.574561998214,-13.81,4
06:49,429556122.0,4212.573613134685,-29.44,4
06:53,391688371.0,-190.9250448121827,-4.69,8
06:53,657139925.0,13145.706614451065,-12.94,9
06:55,984783496.0,13848.268635726949,-55.92,2
06:59,905860285.0,10347.665361022528,-14.72,7
06:59,824916823.0,7966.537871208043,-10.05,5
07:05,719586818.0,18663.21402990871,-2.32,7
07:07,948558249.0,8092.592461815641,-24.39,8
07:09,873693307.0,9921.39827896594,-21.48,2
07:09,264550521.0,4651.5411549158525,-25.95,2
07:11,124102251.0,1251.002521809098,-27.39,7
07:13,575652395.0,614.963921118654,-36.85,5
07:15,647936800.0,2106.5076313032814,-25.61,5
07:18,994214354.0,9168.129528946483,-10.75,2
07:20,221868392.0,4262.652781209946,-2.37,5
07:23,815385232.0,10180.951927868427,-8.53,7
07:25,259015404.0,-181.0793576905384,-4.1,4
07:26,738958551.0,8371.598830490373,-36.93,7
07:27,581655972.0,41126.83850052174,-25.04,7
07:28,355602925.0,1147.2929924538068,-72.7,8
07:30,237493332.0,14294.153170415331,-50.5,7
07:30,541639148.0,3648.26511639389,-1.94,5
07:35,651756497.0,14170.16362029841,-0.02,2
07:39,704517789.0,17464.14218730267,-8.25,5
07:42,559995067.0,2052.585931608866,-5.7,7
07:42,540159353.0,10592.114785858346,-36.12,4
07:42,290818242.0,6609.427548013474,-28.85,7
07:45,500043411.0,13355.228633810744,-13.94,9
07:48,383625050.0,2451.3248180262567,-13.82,7
07:49,910730524.0,7449.002877145231,-65.95,5
07:53,572384506.0,6498.965320873538,-45.23,7
07:56,986267641.0,3627.861670368372,-70.38,7
07:56,609939116.0,6853.183733204111,-51.17,2
07:57,885259672.0,2551.5733321896146,-6.8,9
07:57,229205098.0,7104.182895645544,-18.43,7
08:07,331450202.0,7308.211585441041,-19.71,7
08:12,336557504.0,891.5943333178851,-5.65,9
08:12,280200287.0,134.52704661305103,-4.3,9
08:16,822250278.0,6069.619109674383,-29.15,2
08:18,604288474.0,1107.8798395752242,-53.56,2
08:20,399538448.0,7389.712260393226,-5.9,9
08:21,215311171.0,4742.072865502607,-8.84,2
08:23,166019891.0,7968.8060203645155,-8.99,9
08:25,108563213.0,22984.62620761174,-23.17,4
08:26,890830949.0,-138.3110500000025,-37.89,5
08:26,834383043.0,5157.49323618032,-39.37,8
08:26,644751433.0,-1698.8956584655384,-15.59,5
08:26,386729293.0,31469.164075349865,-5.58,2
08:31,425730826.0,1007.16190938872,-53.95,5
08:32,450896297.0,12850.015233446107,-73.02,5
08:33,138969884.0,420.4520999999994,-90.53,5
08:36,183888402.0,18922.562457140142,-32.59,9
08:40,867679563.0,-155.6532462982842,-59.26,5
08:40,296770890.0,93.73001037908313,-153.99,5
08:41,951817450.0,8951.436111181685,-39.83,5
08:43,366550080.0,23496.40040128616,-52.14,8
08:44,215426302.0,-32.54759597430808,-42.8,5
08:45,726913482.0,-1066.6305985264764,-50.03,5
08:47,134461671.0,4960.565897688849,-59.72,7
08:47,196289502.0,15908.018400894622,-18.14,2
08:47,250957494.0,670.2027499999986,-107.63,5
08:49,245198540.0,-194.6736011982205,-30.16,5
08:49,151968462.0,6637.203597117894,-28.33,5
08:50,621652856.0,-480.96403038945994,-224.87,5
08:50,534583529.0,740.8575880547653,-142.23,5
08:50,752362502.0,5816.215220895514,-26.64,7
08:53,685959099.0,1681.9028660992435,-70.71,5
08:53,138609932.0,2072.784003294586,-5.7,9
08:54,108563213.0,22933.21820761174,-51.41,5
08:54,990461108.0,-76.00213137938897,-84.33,5
08:55,549414742.0,5825.059131837417,-34.9,9
08:55,213112754.0,5128.9008357445155,-73.98,5
08:56,758160963.0,6882.400077676835,-24.74,2
08:56,688712152.0,6593.047900262114,-14.67,5
08:57,331684336.0,-1687.9138699513217,-60.63,5
08:57,856957948.0,10639.251154533908,-158.51,5
08:57,237493332.0,14246.049170415334,-48.1,5
08:58,547010927.0,23964.12252815823,-18.36,8
08:59,941285623.0,351.8093990667703,-102.0,5
08:59,308505160.0,12904.511677079929,-160.5,5
09:00,117273481.0,8778.361038702898,-6.85,9
09:02,540159353.0,10586.914785858346,-5.2,9
09:07,169006407.0,11136.08284139402,-7.8,9
09:08,960208650.0,14167.544450352292,-30.74,5
09:08,558875206.0,2982.250539399781,-6.15,9
09:08,494789005.0,2381.743707090131,-14.5,7
09:09,449871732.0,6316.0395057938595,-64.85,5
09:11,618138606.0,1051.5133032642873,-5.35,9
09:11,815385232.0,10113.121927868428,-67.83,5
09:13,613729471.0,7556.737802412713,-5.5,9
09:14,252701364.0,-4068.198672677914,-38.14,5
09:16,987656636.0,3780.3200642442657,-80.75,5
09:16,506618547.0,14248.282811783509,-7.8,9
09:18,856461967.0,-479.8656464705074,-108.67,5
09:18,679662108.0,14459.9536399587,-5.09,7
09:19,586315521.0,12089.914155878008,-5.7,9
09:22,930277104.0,8633.693109379,-28.98,2
09:23,667367404.0,8929.56177926231,-5.6,9
09:25,741903302.0,2295.4470679352607,-5.05,9
09:25,414454079.0,3176.4288500000016,-6.07,4
09:28,398429109.0,232.39705000000092,-76.97,2
09:29,403383649.0,546.5748031531707,-10.99,1
09:30,180719578.0,-4680.565249999994,-42.2,5
09:31,473820682.0,10685.244297136502,-10.39,4
09:33,170637730.0,728.0614405222763,-7.07,4
09:36,298007503.0,1544.158103625634,-27.36,7
09:37,679662108.0,14449.7536399587,-10.2,2
09:40,659415300.0,1447.8315805359596,-25.98,2
09:41,659415300.0,1403.0839962180737,-44.75,7
09:52,856147482.0,-1111.356798598625,-265.89,5
09:52,473820682.0,10661.8042971365,-23.44,2
09:55,176922958.0,1181.7705471976496,-111.63,2
10:02,514362267.0,-47.92268089293971,-14.99,4
10:04,497809732.0,2273.313869552596,-11.98,4
10:07,782013626.0,367.03119931162865,-62.3,2
10:08,779376323.0,3389.9658339813404,-59.98,2
10:09,282837512.0,13496.726207856344,-7.5,9
10:14,687135796.0,28689.287249117104,-9.47,4
10:15,421881811.0,1688.8909312131266,-47.58,2
10:16,916270283.0,2155.5442500000004,-57.0,2
10:18,903953091.0,2764.750790134574,-4.95,9
10:21,137822385.0,3404.518703161884,-5.05,9
10:24,519644021.0,2240.676772794741,-80.93,5
10:25,549414742.0,5824.165327397484,-0.89,7
10:37,706361191.0,-57.017951505922085,-152.04,5
10:40,370521542.0,26892.009373308763,-154.48,2
10:43,673025413.0,546.8868728046261,-47.02,5
10:53,652048867.0,-221.44815000000108,-98.19,5
10:55,588565416.0,5435.242367678117,-104.68,5
11:01,143003091.0,10224.293267568954,-78.6,2
11:02,782013626.0,168.23119931162867,-198.8,2
11:04,722358036.0,-77.5364093729171,-66.17,5
11:08,546296727.0,-135.58227269738154,-28.0,2
11:24,782013626.0,22.631199311628677,-145.6,2
11:31,767447966.0,4459.637922706574,-100.19,2
11:40,472995101.0,905.0095840990838,-29.99,4
11:46,656389634.0,-415.4318404219855,-48.98,5
11:50,987229118.0,218.4770049334381,-79.97,4
12:04,460463595.0,-531.8379454185789,-42.08,9
12:06,310620484.0,-168.1888049078017,-13.98,9
12:08,766941757.0,1423.1131215021394,-23.92,9
12:13,534204159.0,4972.97603638335,-35.59,9
12:18,854895960.0,3167.9672912903393,-16.72,7
12:19,348325817.0,8454.431517643394,-30.04,9
12:22,280098744.0,-29.726622128333197,-34.98,4
12:24,221356538.0,452.5533999999995,-214.89,2
12:34,782013626.0,-88.66880068837132,-111.3,2
12:40,779946617.0,16723.647917987593,-66.5,2
12:43,822250278.0,6047.279109674383,-22.34,9
12:45,936813994.0,-46.67448916721193,-48.04,5
12:52,687135796.0,28677.037249117104,-12.25,9
12:55,221356538.0,193.58139999999952,-258.97,2
13:00,782013626.0,-176.1688006883713,-87.5,2
13:02,441142605.0,1589.050392275729,-7.5,4
13:06,187111705.0,6458.254495025158,-6.0,9
13:07,322221939.0,3014.146976213188,-5.65,9
13:10,699313649.0,-2420.6758991419047,-21.41,5
13:11,910730524.0,7442.102877145231,-6.9,9
13:14,585625048.0,1770.1639749993576,-7.8,9
13:15,340321732.0,1257.3592500000036,-5.7,9
13:19,849096144.0,1018.219020751343,-5.4,9
13:20,688712152.0,6585.8979002621145,-7.15,9
13:23,812692024.0,3478.0615905218215,-5.7,9
13:24,993039226.0,-4554.379499999995,-45.71,5
13:30,189757473.0,-2374.9236499999993,-41.87,5
13:36,916270283.0,2099.9152500000005,-55.63,5
13:42,639549973.0,4251.434561998214,-35.14,2
13:59,828750680.0,718.29239521368,-62.97,2
14:18,147341222.0,-2247.5078753207954,-169.71,5
15:09,867987292.0,1318.5704620688227,-19.62,7
15:21,828750680.0,574.75214521368,-143.54,5
15:22,987656636.0,3762.550129493502,-17.77,5
15:48,618514666.0,21259.74347271649,-21.98,4
15:48,546296727.0,-335.55227269738157,-199.97,2
15:50,744968736.0,-1659.591826569424,-13.54,5
15:53,173335108.0,2378.814000000001,-275.1,2
15:55,857997794.0,389.9156651508865,-74.72,5
16:14,333054026.0,-17.519105976809882,-33.11,1
16:15,948558249.0,8073.622461815641,-18.97,7
16:17,632065391.0,-1079.3186499999997,-79.21,5
16:18,228136274.0,1063.2068299999996,-45.06,7
16:19,173335108.0,2246.514000000001,-132.3,2
16:23,532478725.0,3725.945572766492,-15.2,8
16:25,215404070.0,8.777589179849649,-49.99,2
16:27,527842638.0,65.7162426329834,-15.98,4
16:28,828750680.0,492.77214521368,-81.98,2
16:30,570575024.0,-1155.9196500000007,-24.44,9
16:45,670102069.0,458.6392004021052,-43.78,5
16:49,817294757.0,-2609.5708,-41.8,5
16:54,392270893.0,13112.578853350557,-6.58,4
16:55,388862238.0,1457.3742278976383,-2.69,7
16:55,948558249.0,8058.922461815641,-14.7,5
16:56,519935524.0,-188.5246702624812,-22.53,5
16:58,605116158.0,2325.013500000004,-28.96,7
16:59,885259672.0,2544.0658321896144,-7.51,4
17:03,939972497.0,648.6909086000105,-57.99,2
17:03,880546403.0,-1584.159500000002,-78.39,5
17:07,492215823.0,2118.778223815445,-126.69,2
17:10,106601471.0,10446.615671464826,-7.99,8
17:11,874431242.0,8397.297701426029,-58.1,5
17:11,605116158.0,2293.0435000000043,-31.97,4
17:12,344219145.0,7930.743113232297,-18.23,9
17:17,433917275.0,6691.711576147399,-32.19,5
17:17,128033695.0,1653.8513273404149,-37.9,9
17:18,475117511.0,6789.307141140191,-29.99,5
17:18,130154096.0,524.1611481961065,-26.98,4
17:20,121858569.0,11.43115000000236,-219.97,2
17:21,939972497.0,574.2009086000105,-74.49,2
17:23,221868392.0,4240.252781209946,-22.4,9
17:23,450896297.0,12819.075233446109,-30.94,9
17:24,117273481.0,8771.371038702899,-6.99,7
17:24,807714284.0,622.1326607359996,-49.98,5
17:25,779946617.0,16532.547917987595,-191.1,2
17:25,551196328.0,4180.005465435383,-142.84,5
17:27,992204045.0,6754.424203345351,-26.98,7
17:28,613729471.0,7546.567802412713,-10.17,7
17:30,585596026.0,2416.7211185692563,-50.0,2
17:30,500043411.0,13316.654713685406,-38.57,2
17:31,836110591.0,2464.9634077742458,-38.8,7
17:32,245690309.0,9523.515088829492,-1.81,2
17:32,500843551.0,54.63229999999964,-60.57,5
17:32,550832673.0,2855.96601639551,-39.95,1
17:33,730002588.0,13345.881234213695,-35.81,2
17:34,795847804.0,23780.98249375246,-33.7,4
17:34,939972497.0,487.2009086000105,-87.0,2
17:34,229205098.0,7078.592895645544,-25.59,7
17:36,940569402.0,3815.4097757107265,-4.24,8
17:39,200080192.0,8249.133773478567,-20.24,2
17:40,874431242.0,8273.397701426029,-123.9,2
17:41,878989510.0,4618.221467815367,-175.0,2
17:42,471897866.0,6607.71802500453,-13.5,7
17:44,489964679.0,19876.62546236988,-75.57,7
17:45,492215823.0,2064.8922238154446,-53.89,2
17:48,441274121.0,11977.27474001242,-12.95,9
17:49,208381936.0,-58.70557822174519,-4.99,7
17:54,887853850.0,9840.265429852412,-28.44,7
17:54,802697323.0,15497.638174823276,-25.33,7
17:56,624500124.0,2753.136601842349,-1.73,5
17:56,478412511.0,11985.754292893063,-218.4,2
17:56,558875206.0,2949.300539399781,-32.95,7
17:58,878989510.0,4353.6214678153665,-264.6,2
18:00,639409800.0,36466.7470917164,-37.79,2
18:01,413557825.0,-119.1748000000006,-288.28,5
18:06,939972497.0,400.7109086000105,-86.49,2
18:07,409971170.0,2229.809991164573,-22.19,9
18:07,373875019.0,17556.706900423345,-16.1,2
18:08,824916823.0,7950.237871208043,-16.3,9
18:08,414454079.0,3142.2588500000015,-34.17,9
18:09,570323670.0,2907.961177370599,-7.63,7
18:17,678330503.0,730.4174903505708,-11.26,2
18:19,489964679.0,19735.92546236988,-140.7,4
18:19,138609932.0,2045.284003294586,-27.5,7
18:20,550832673.0,2754.50801639551,-101.46,2
18:23,213112754.0,5097.024755444617,-31.88,5
18:24,270374623.0,9222.485715048044,-17.9,9
18:24,868377987.0,2746.7156461778804,-84.53,5
18:24,408057540.0,4579.052574449836,-30.3,9
18:26,898104045.0,-1891.3980500000025,-82.29,5
18:29,448004226.0,1376.4723686648797,-45.97,7
18:29,878989510.0,4189.1214678153665,-164.5,2
18:33,512989907.0,-2113.5119039753654,-51.52,5
18:33,698076160.0,6116.084610146619,-139.73,5
18:34,639409800.0,36195.16109171639,-271.59,2
18:36,297823329.0,29.93864999999909,-127.08,5
18:39,939972497.0,369.2309086000105,-31.48,2
18:40,833899961.0,-131.15780428199048,-43.85,5
18:41,868377987.0,2713.4856461778804,-33.23,9
18:44,358846516.0,48.6155225272174,-53.37,5
18:45,489964679.0,19710.03946236988,-25.89,2
18:47,535273662.0,34.87739999999949,-25.19,9
18:51,506618547.0,14215.002969786094,-33.28,4
18:55,627622066.0,3097.86237216963,-148.95,5
18:55,550832673.0,2674.0360163955097,-80.47,2
18:57,873701090.0,-169.88874328552777,-37.94,8
19:03,176922958.0,1138.5705471976496,-43.2,9
19:03,264208990.0,500.2931999999985,-62.36,5
19:03,690941877.0,-150.9950384825081,-29.33,9
19:03,639549973.0,4213.0255619982145,-38.41,5
19:03,822718326.0,11255.708001111883,-25.89,5
19:04,706250160.0,12382.732418494275,-0.3,2
19:10,656317661.0,-438.2446584585973,-197.23,5
19:11,868014990.0,-3645.081099999996,-24.8,5
19:12,893134725.0,746.4577007761188,-34.39,5
19:12,143606916.0,-325.1646459708104,-316.47,5
19:15,564744955.0,-253.95024141115812,-70.37,5
19:16,785210466.0,1625.1777969465593,-79.33,5
19:17,858989281.0,26568.142703039324,-54.15,7
19:22,180616589.0,763.6188282361094,-36.79,5
19:22,331450202.0,7295.211585441041,-13.0,9
19:27,897592348.0,15559.04141771175,-132.97,5
19:28,336557504.0,880.5807123661109,-11.01,7
19:29,851649498.0,7863.415879870908,-58.48,5
19:30,957821152.0,-1765.6504535715496,-59.38,5
19:30,373163757.0,10041.127782079331,-96.5,5
19:32,399144202.0,876.7865706594642,-34.72,9
19:39,166019891.0,7931.780997221068,-37.03,2
19:44,235881534.0,12230.861797170322,-13.7,2
19:47,226703987.0,1234.8221365470745,-94.84,5
19:52,478412511.0,11972.839041290454,-12.92,7
19:54,149684419.0,194.58889999999792,-65.38,5
19:54,691789577.0,-1420.4430500000003,-269.05,5
19:55,872286364.0,-929.1718958130998,-135.92,5
19:59,886921642.0,2818.010789043211,-28.32,8
19:59,659415300.0,1291.2442962180735,-111.84,5
20:05,298007503.0,1489.684103625634,-54.47,5
20:06,534325901.0,5726.283051379087,-61.63,2
20:08,256002321.0,5592.137792557939,-31.63,2
20:09,555393405.0,-966.8974000000004,-46.04,5
20:14,621181115.0,-453.1802495707711,-91.45,5
20:26,473820682.0,10565.5262971365,-96.28,5
20:30,858560423.0,12179.817253018788,-87.23,5
20:35,145553416.0,-2860.913149999998,-46.3,5
20:37,119993184.0,-2236.261902910862,-28.46,5
20:37,601627384.0,2633.1614832727173,-2.61,2
20:40,387957305.0,-2864.9336059800785,-56.81,5
20:41,388862238.0,1305.2554778976382,-152.12,5
20:47,605116158.0,2262.719500000004,-30.32,5
20:47,624563756.0,-660.2537712164435,-37.33,5
20:50,762859681.0,1381.0415999999989,-55.59,5
20:55,461029994.0,7566.110239540953,-56.5,5
21:09,951817450.0,8877.136963930092,-74.3,2
21:10,179173981.0,3362.405220852742,-32.74,9
21:18,853907490.0,7349.85532495338,-14.2,9
21:42,111137699.0,-424.9045499999994,-29.12,9
00:31,570323670.0,4332.93127902046,-5.03,8
01:09,421881811.0,3825.058801466341,-13.83,2
01:09,815993333.0,6608.5971680432185,-38.26,2
01:12,809499628.0,21144.273687034573,-19.94,9
01:21,216286013.0,471.0749765451335,-67.61,7
01:52,639549973.0,7494.873001183843,-3.15,2
01:54,575652395.0,2212.9280979729338,-12.04,7
01:56,532478725.0,3718.428228941877,-7.52,2
02:30,534325901.0,8315.583051379086,-10.7,9
02:36,198946608.0,3182.120124598254,-10.16,2
02:45,683319988.0,8449.93502470516,-36.24,9
03:06,308505160.0,16622.911880601307,-31.6,7
03:07,216285378.0,24152.991113528416,-35.37,9
03:14,518474507.0,16672.507217473787,-33.92,9
03:19,806358207.0,10962.334795762372,-4.32,2
03:19,556992209.0,13724.012710219338,-25.27,8
03:20,435984758.0,5805.025707077037,-58.31,4
03:22,449871732.0,9180.679130852795,-5.36,5
03:23,613729471.0,10877.42245691986,-2.15,5
03:23,718058208.0,1999.996922431323,-73.83,5
03:24,675806859.0,9695.573105282614,-12.99,8
03:25,196289502.0,19262.528400894626,-21.49,9
03:38,779946617.0,20878.39604221943,-29.15,7
03:38,348325817.0,12588.041517643394,-33.39,9
03:40,547010927.0,28335.055826228418,-4.07,2
03:40,970298834.0,1871.746110827443,-62.29,7
03:44,887853850.0,9782.123691993933,-58.14,2
03:46,815385232.0,13105.32207722965,-6.8,8
03:49,454356905.0,1037.108324361345,-23.64,9
03:50,985188462.0,422.7863887112248,-35.44,9
03:52,310375875.0,2366.894765259852,-41.39,9
04:00,169006407.0,11125.42578493364,-10.66,2
04:02,705848712.0,27187.66063949334,-19.19,9
04:05,270374623.0,12338.505715048044,-9.98,9
04:05,370521542.0,31609.983146154955,-61.03,5
04:08,824916823.0,10842.207871208042,-25.03,9
04:09,996042490.0,7951.135781867768,-44.04,7
04:10,874431242.0,11995.807701426029,-26.59,9
04:12,433917275.0,6665.061576147399,-26.65,9
04:13,769311479.0,8759.361442950056,-11.15,7
04:15,461990622.0,10574.33699523383,-2.38,8
04:17,736340277.0,7699.425615684275,-19.29,9
04:17,785749304.0,10973.574007799398,-12.95,9
04:20,322720763.0,6536.945803671502,-21.84,5
04:29,405945930.0,4520.376219465057,-0.97,4
04:30,128033695.0,1629.2878188047273,-24.56,7
04:31,779236304.0,2675.177595479534,-22.24,9
04:33,851181128.0,4147.559859848635,-22.0,7
04:35,940569402.0,3792.6597757107265,-22.75,9
04:39,899742927.0,12312.773977628283,-13.44,8
04:40,647472692.0,30941.473856210858,-22.96,8
04:45,678330503.0,1384.917368040375,-5.5,2
04:50,604288474.0,1049.6953096997047,-58.18,5
04:51,706250160.0,15908.47688046728,-16.26,2
04:52,558119802.0,39449.66283098784,-42.29,7
04:53,195895574.0,8131.762545415013,-28.39,9
04:54,290818242.0,9207.786388103865,-1.64,5
04:54,450896297.0,15942.335233446109,-39.74,9
04:55,657139925.0,16621.30661445106,-9.4,9
04:58,897714622.0,11751.529658692172,-0.42,4
04:59,480557476.0,14659.88768891818,-6.99,5
04:59,587225252.0,7511.31079089366,-35.93,9
05:03,730002588.0,17299.20408940187,-3.68,5
05:04,383833857.0,30396.6699014012,-47.68,7
05:04,824916823.0,10804.186125017091,-38.02,8
05:05,364357875.0,8235.277400039646,-35.7,9
05:05,108563213.0,26665.44640477053,-16.77,7
05:05,166019891.0,10841.98658722748,-6.79,5
05:07,698076160.0,6109.962227948762,-6.12,7
05:07,511179916.0,9298.888183540475,-15.2,2
05:07,822135975.0,11024.766047161334,-23.22,2
05:10,700138124.0,6902.063702068644,-50.17,5
05:12,987163717.0,5519.650223888188,-27.87,9
05:12,822250278.0,6033.2991096743835,-13.98,9
05:15,836110591.0,2429.3334077742456,-35.63,9
05:16,510101371.0,14670.922265770225,-43.64,9
05:18,414805878.0,12376.362803014548,-41.2,9
05:19,331450202.0,10372.469072364527,-10.49,2
05:22,940569402.0,3775.2906977283983,-17.37,8
05:28,633345190.0,5389.2276248696535,-31.88,9
05:30,587225252.0,7463.847698566697,-47.46,7
05:32,184430449.0,4463.766332391089,-13.72,7
05:34,229205098.0,7064.618670452108,-13.97,2
05:35,183888402.0,18877.922457140143,-44.64,9
05:35,912705941.0,18891.784657600143,-0.06,2
05:36,364357875.0,8174.778485331397,-60.5,2
05:38,534325901.0,8272.350160573458,-43.23,5
05:40,473820682.0,13665.682245248534,-25.84,4
05:43,534204159.0,6943.00603638335,-29.97,9
05:43,752362502.0,10171.69635043632,-19.52,2
05:44,832564361.0,15227.942082293392,-28.06,7
05:48,252760664.0,5892.333599683385,-6.96,7
05:49,572384506.0,8145.885320873538,-36.08,9
05:49,738958551.0,10607.008830490371,-37.59,9
05:50,679662108.0,19225.229026487348,-3.52,2
05:50,282837512.0,16375.476207856344,-39.25,9
05:50,348325817.0,12536.220980263168,-51.82,7
05:52,482513594.0,7845.235054250669,-50.41,7
05:53,709608057.0,1933.3226814685424,-31.37,9
05:54,143061865.0,8953.804826403766,-10.83,7
05:55,647936800.0,2095.9703799851345,-10.54,5
05:56,583558311.0,-1012.1672152486676,-28.34,9
06:00,108931112.0,17899.863206981685,-34.95,9
06:03,802697323.0,18998.788174823276,-40.85,9
06:04,518474507.0,16671.177027579513,-1.33,2
06:06,213112754.0,5063.814320994548,-33.21,4
06:07,324046160.0,-960.5648832130712,-25.48,9
06:08,492215823.0,5072.792223815444,-27.1,9
06:08,399144202.0,834.3465706594643,-42.44,9
06:10,285220959.0,14719.175037241055,-52.23,5
06:11,984783496.0,17154.07863572695,-27.19,9
06:14,324224854.0,6996.9575500535175,-13.4,8
06:16,145387690.0,4839.432329695629,-3.82,5
06:16,842682241.0,5265.070774877891,-27.73,5
06:16,429556122.0,6444.861472972949,-31.71,7
06:17,992204045.0,10164.168108346255,-23.26,7
06:17,905860285.0,10290.35680294388,-57.31,2
06:19,195895574.0,8089.242982446124,-42.52,7
06:19,520447032.0,7377.358715259511,-30.14,9
06:19,776431321.0,2890.4963828386235,-5.54,5
06:20,960208650.0,15260.471154964189,-67.07,2
06:22,719586818.0,22561.65868747271,-3.56,5
06:25,668329719.0,11282.103109515208,-59.81,8
06:29,120634201.0,7320.450461478468,-15.35,9
06:29,237684254.0,7255.050854354138,-31.5,9
06:34,623156843.0,7268.258454994649,-64.91,5
06:35,858989281.0,26561.152703039323,-6.99,9
06:37,873693307.0,13861.20827896594,-17.19,9
06:40,282837512.0,16373.470896580217,-2.01,5
06:44,851649498.0,7810.439684171039,-52.98,5
06:51,809499628.0,21109.78579158873,-34.49,8
06:52,419550103.0,18868.90693612308,-35.0,7
06:52,113747882.0,14032.842135924033,-26.38,9
06:56,910730524.0,7404.723859640793,-37.38,2
06:57,399538448.0,7372.359771568456,-17.35,7
06:57,973086490.0,9808.368548144335,-11.94,9
06:58,601627384.0,4192.331483272717,-36.83,9
07:00,670102069.0,2102.2492004021055,-41.39,9
07:02,785749304.0,10947.535057902474,-26.04,2
07:03,550169791.0,26970.73169844692,-15.0,9
07:04,270374623.0,12336.189407686545,-2.32,5
07:04,586315521.0,12077.011788954344,-12.9,7
07:05,170637730.0,667.160273337066,-60.9,7
07:06,766941757.0,3057.7331215021395,-40.38,9
07:07,627622066.0,3063.43237216963,-34.43,9
07:10,987163717.0,5500.806078176684,-18.84,7
07:10,678851253.0,5335.277509533381,-10.88,7
07:11,506618547.0,19397.111648917205,-19.89,5
07:13,179173981.0,5157.765220852742,-29.64,9
07:14,221868392.0,6390.072781209946,-30.18,9
07:18,522188082.0,6586.563772831141,-3.22,4
07:21,554792076.0,33094.56740687216,-42.85,2
07:22,749378808.0,1146.899434750245,-54.4,7
07:24,383625050.0,2443.8585010811607,-7.47,5
07:25,673025413.0,3845.913435616786,-0.97,7
07:31,399144202.0,829.1826066835055,-5.16,2
07:33,639409800.0,41741.283409543306,-79.88,8
07:35,653640811.0,17456.164105493455,-13.26,5
07:37,245690309.0,9521.57093991542,-1.94,5
07:37,146909202.0,3037.2207593056396,-83.38,2
07:37,844835978.0,10112.739631562928,-16.94,8
07:44,973086490.0,9801.87013905696,-6.5,2
07:52,549414742.0,5788.285327397484,-35.88,9
07:57,858989281.0,26553.489331937435,-7.66,7
07:58,885259672.0,2539.0658321896144,-5.0,9
07:59,433917275.0,6605.816473170386,-59.25,7
08:05,758160963.0,9668.023756711154,-4.38,8
08:11,187111705.0,9774.399736314695,-17.18,8
08:14,315546581.0,33236.963516416596,-36.78,8
08:16,399538448.0,7367.059771568455,-5.3,9
08:18,280200287.0,127.42704661305105,-7.1,9
08:18,519644021.0,2211.7808139037093,-28.9,2
08:20,930277104.0,11244.071339838005,-18.62,5
08:23,899983008.0,-3334.941149999996,-24.67,5
08:23,395284483.0,2092.950340211308,-5.6,9
08:23,564214408.0,-298.647315274274,-53.29,5
08:23,929044080.0,969.8938915056284,-22.77,5
08:24,741903302.0,4073.397067935261,-20.05,9
08:26,124102251.0,1195.0872895961854,-55.92,4
08:27,336171116.0,1184.3683999999996,-117.37,5
08:27,308897841.0,2971.787999999999,-59.01,5
08:28,570269025.0,3027.87144214464,-74.34,5
08:29,687135796.0,33450.75033788611,-5.29,7
08:30,348525881.0,727.8566245949359,-29.68,5
08:30,121113546.0,-64.58684393013033,-159.16,5
08:31,151968462.0,6569.037597117894,-68.17,5
08:33,576188756.0,-4293.531499999998,-33.43,5
08:33,414805878.0,12363.049239226288,-13.31,5
08:34,993663752.0,-179.55785758960366,-121.97,5
08:34,489964679.0,19671.49946236988,-38.54,9
08:36,874506295.0,-1180.7517562455723,-23.83,5
08:37,113747882.0,14018.401829568573,-14.44,7
08:38,866941383.0,4014.648480303673,-84.11,5
08:41,220183538.0,2337.5235999999995,-60.01,5
08:42,667367404.0,12046.425711836157,-9.14,2
08:43,250895529.0,780.0128324692881,-67.95,5
08:43,971129830.0,-1221.0506499999992,-47.19,5
08:45,315546581.0,33116.2975164166,-120.67,5
08:47,822250278.0,6010.37545467593,-22.92,8
08:51,683319988.0,8416.89963499065,-33.04,2
08:51,480557476.0,14592.72968891818,-67.16,5
08:53,588565416.0,8126.857151735635,-2.39,5
08:55,667367404.0,12040.725711836156,-5.7,9
08:55,647472692.0,30886.74785621086,-54.73,5
08:55,237493332.0,17994.79381815354,-0.26,8
08:57,162370388.0,-1208.850399999999,-19.48,5
08:57,609939116.0,7706.308109076563,-6.88,2
09:02,999752672.0,2832.3638935333347,-6.9,9
09:02,235663459.0,439.5589298120151,-45.25,5
09:04,218795010.0,546.8384499999994,-47.06,5
09:05,581655972.0,41084.37483683589,-6.2,9
09:05,624563756.0,1154.6962287835563,-6.05,9
09:07,718058208.0,1888.8439224313229,-111.15,5
09:07,613729471.0,10871.372456919862,-6.05,9
09:09,586315521.0,12071.311788954345,-5.7,9
09:09,391688371.0,1329.9449551878172,-21.63,5
09:09,752362502.0,10125.93735043632,-45.76,5
09:10,131388684.0,21569.384758983582,-6.15,9
09:11,383833857.0,30391.2699014012,-5.4,9
09:11,540159353.0,10579.764785858346,-7.15,9
09:11,169006407.0,11119.72578493364,-5.7,9
09:11,520447032.0,7334.436592652729,-42.92,7
09:11,478986718.0,748.0902999999985,-52.31,5
09:12,491392945.0,8328.089500000011,-54.12,5
09:15,700138124.0,6808.529702068644,-93.53,5
09:15,290818242.0,9201.986388103864,-5.8,9
09:16,248142083.0,383.0514347025168,-29.99,2
09:18,494156986.0,1124.2590456723349,-45.97,2
09:19,117273481.0,12139.8710387029,-7.5,9
09:19,417850087.0,18251.96951534796,-7.8,9
09:20,246753533.0,1718.5576999999982,-64.99,2
09:20,155867488.0,703.1466999999984,-82.97,2
09:20,690958123.0,24017.53405592685,-5.35,9
09:20,973388795.0,959.1056761636216,-82.06,2
09:20,506618547.0,19389.961648917204,-7.15,9
09:21,709935470.0,850.9707376997723,-49.98,2
09:21,385685918.0,192.01994084155265,-99.99,2
09:21,348525881.0,685.9066245949358,-41.95,7
09:21,553734946.0,1865.1530999999984,-16.97,7
09:21,101531259.0,1397.9320999999995,-7.49,4
09:22,558875206.0,6069.050539399781,-5.25,9
09:23,256002321.0,8818.98979255794,-106.15,5
09:23,843537309.0,305.06423220836814,-51.98,2
09:23,310740977.0,791.3704359296809,-19.99,2
09:23,409370545.0,1013.9672755455208,-23.13,7
09:23,108812033.0,1142.0463499999985,-87.98,2
09:24,282046994.0,-36.920649999999625,-77.13,5
09:25,799286313.0,353.93838712413844,-5.99,2
09:25,970298834.0,1736.496110827443,-135.25,2
09:25,857455726.0,185.06473587568416,-6.99,7
09:26,904154012.0,982.1974581204316,-6.99,7
09:26,245198540.0,1463.3563988017795,-16.97,1
09:27,762785862.0,1701.4448999999993,-35.0,2
09:27,355733816.0,6388.106316440188,-21.97,7
09:27,683078800.0,3257.7850811472854,-5.5,9
09:29,570410059.0,1031.3121467763117,-250.65,5
09:30,310620484.0,431.4711950921983,-50.34,2
09:30,943329213.0,1420.6886193497576,-15.04,7
09:30,279149837.0,1570.2580499999997,-19.99,2
09:30,137913631.0,2346.40645,-31.99,2
09:31,799861885.0,1306.9109499999988,-9.99,7
09:31,769319491.0,-241.3430000000008,-49.99,2
09:31,822250278.0,5975.37605467593,-35.0,4
09:32,494156986.0,1111.2690456723346,-12.99,2
09:32,687135796.0,33422.350337886106,-28.4,1
09:32,799286313.0,312.9583871241384,-40.98,2
09:34,726913482.0,-349.61059852647645,-22.98,2
09:34,552980092.0,332.9207191193376,-159.99,2
09:34,570323670.0,4331.42677902046,-1.5,4
09:34,879091637.0,293.2015237379771,-132.32,2
09:35,519649533.0,648.7118163706621,-124.99,2
09:37,282837512.0,16357.293666580215,-16.18,4
09:37,108812033.0,1020.0563499999982,-121.99,2
09:37,524425303.0,635.4203999999988,-9.0,4
09:37,293609137.0,222.97049257449817,-29.99,2
09:38,163470640.0,2981.1285999999996,-56.25,2
09:38,254018059.0,125.9495,-30.95,7
09:39,382862215.0,261.87899999999985,-5.99,2
09:39,257633312.0,694.083699999999,-49.99,4
09:40,987656636.0,6422.470129493502,-10.08,2
09:40,304455868.0,1528.385879897875,-57.33,2
09:40,248625662.0,363.6580842848524,-18.98,2
09:40,246753533.0,1688.5676999999982,-29.99,4
09:41,216286013.0,411.0849765451335,-59.99,6
09:42,555804115.0,13.283952441296664,-33.94,7
09:42,895750759.0,312.04741192433414,-10.98,7
09:43,627936697.0,1284.62585,-97.98,2
09:43,553734946.0,1852.1630999999984,-12.99,6
09:43,101531259.0,1355.9420999999995,-41.99,6
09:44,799453072.0,798.0045499999987,-22.0,2
09:44,818552503.0,2111.538099999999,-22.98,6
09:44,279149837.0,1541.2980499999994,-28.96,1
09:45,757115616.0,2435.400000000004,-4.99,7
09:46,760753808.0,1710.8654999999994,-9.99,2
09:46,586041848.0,2908.6746999999996,-162.99,2
09:46,402438092.0,1762.3514999999989,-31.99,2
09:47,155317149.0,729.1272499999991,-19.99,2
09:47,280990953.0,1260.469699999998,-41.95,1
09:47,555393405.0,341.1125999999997,-4.99,1
09:47,843537309.0,282.0942322083681,-22.97,1
09:48,444371478.0,1071.6441499999987,-16.98,1
09:48,293609137.0,202.98049257449816,-19.99,2
09:48,449387287.0,902.7476938351014,-89.97,2
09:48,448004226.0,1341.5323686648794,-34.94,1
09:48,890567652.0,524.9764996796006,-19.99,4
09:48,258201793.0,-163.7148000000002,-49.99,2
09:49,519649533.0,618.721816370662,-29.99,4
09:49,212560376.0,118.50712577910215,-65.16,2
09:49,345514953.0,1592.6346999999994,-31.97,2
09:50,132400709.0,863.4170351539397,-40.99,2
09:52,479456865.0,2417.5778118641742,-6.0,4
09:53,896821055.0,634.6205592670824,-14.98,1
09:54,722971557.0,-1146.3282791569245,-46.02,5
09:54,799861885.0,1241.9309499999988,-64.98,2
09:54,621181115.0,154.84975042922892,-21.97,1
09:55,797184978.0,158.3000865730194,-94.97,2
09:55,163470640.0,2913.6285999999996,-67.5,2
09:55,456246119.0,21380.83139884565,-48.96,7
09:55,799286313.0,212.9683871241384,-99.99,2
09:56,108812033.0,990.0663499999982,-29.99,2
09:56,987656636.0,6373.23064530641,-49.24,4
09:57,919185264.0,6207.208701697936,-123.35,5
09:57,895750759.0,280.05741192433413,-31.99,2
09:57,257633312.0,662.093699999999,-31.99,2
09:58,414454079.0,4784.638850000002,-7.62,4
09:59,216286013.0,344.0949765451335,-66.99,2
09:59,382862215.0,231.88899999999984,-29.99,4
10:00,345514953.0,1572.6446999999994,-19.99,2
10:02,550169791.0,26951.188112942713,-19.54,7
10:03,904154012.0,937.2174581204316,-44.98,2
10:03,757115616.0,2400.400000000004,-35.0,2
10:03,760753808.0,1680.8954999999994,-29.97,1
10:04,433837402.0,738.5641315358118,-101.99,2
10:04,534204159.0,6940.91503638335,-2.09,4
10:05,534204159.0,6933.155426726898,-7.76,2
10:06,637649383.0,2068.2127999999984,-49.98,2
10:06,762785862.0,1597.4648999999993,-103.98,2
10:06,879091637.0,261.6515237379771,-31.55,2
10:06,834383043.0,5114.513236180321,-42.98,2
10:06,403902116.0,1750.1431999999993,-36.95,7
10:06,293609137.0,175.02049257449815,-27.96,1
10:07,449387287.0,864.7676938351013,-37.98,2
10:08,572136270.0,581.6321115880235,-35.95,1
10:10,136770968.0,179.01919999999953,-79.97,2
10:10,402438092.0,1742.3614999999988,-19.99,2
10:10,248142083.0,364.08143470251673,-18.97,1
10:11,257633312.0,645.593699999999,-16.5,4
10:11,519933553.0,-34.14899584927155,-41.52,5
10:11,497809732.0,2205.987869552596,-67.33,5
10:12,456246119.0,21179.94539884565,-200.89,4
10:12,855129444.0,-372.7876954373722,-163.19,5
10:12,433837402.0,712.0641315358118,-26.5,2
10:12,132400709.0,835.4170351539397,-28.0,2
10:13,761272540.0,466.0519999999987,-34.99,2
10:13,282837512.0,16351.593666580216,-5.7,9
10:14,843537309.0,225.1042322083681,-56.99,2
10:16,726913482.0,-469.5805985264765,-119.97,2
10:17,552980092.0,269.9307191193376,-62.99,2
10:17,402438092.0,1690.3714999999988,-51.99,2
10:17,212560376.0,55.33712577910215,-63.17,2
10:18,254018059.0,55.95949999999999,-69.99,2
10:18,143003091.0,13136.890366269252,-5.4,5
10:19,385685918.0,182.02994084155264,-9.99,2
10:19,248625662.0,327.6880842848524,-35.97,2
10:20,444371478.0,986.6541499999988,-84.99,2
10:20,799861885.0,1219.9309499999988,-22.0,2
10:22,293609137.0,145.03049257449814,-29.99,4
10:22,170637730.0,588.284273337066,-78.88,5
10:22,627936697.0,1255.66585,-28.96,1
10:23,304455868.0,1414.7258798978748,-113.66,2
10:24,843537309.0,202.1242322083681,-22.98,2
10:25,403902116.0,1709.1531999999993,-40.99,2
10:26,497772347.0,1221.0717499999978,-24.0,4
10:27,760753808.0,1617.9154999999994,-62.98,2
10:27,449387287.0,854.7876938351013,-9.98,7
10:28,929044080.0,919.9138915056284,-49.98,2
10:28,700138124.0,6612.529702068644,-196.0,2
10:29,433837402.0,679.4741315358118,-32.59,1
10:29,444371478.0,908.6641499999988,-77.99,2
10:29,345514953.0,1515.6546999999994,-56.99,2
10:31,985188462.0,393.2563887112248,-29.53,7
10:32,552980092.0,263.96071911933757,-5.97,4
10:32,541639148.0,3638.05151191149,-10.21,2
10:34,823208989.0,1414.5117038695316,-159.6,2
10:34,179173981.0,5143.215220852741,-14.55,7
10:34,598793068.0,1716.276399999998,-16.5,4
10:36,310620484.0,387.2111950921983,-44.26,7
10:36,762785862.0,1437.4848999999992,-159.98,2
10:36,585625048.0,1702.1839749993576,-67.98,2
10:37,941285623.0,326.8593990667703,-24.95,7
10:38,669503912.0,25.350550348817237,-75.99,2
10:39,454356905.0,966.0040043613452,-71.1,4
10:39,555804115.0,-131.69604755870333,-144.98,2
10:40,688328251.0,190.75362464517275,-69.98,2
10:41,823208989.0,1302.5117038695316,-112.0,2
10:42,700138124.0,6529.929702068644,-82.6,2
10:43,879091637.0,248.43152373797707,-13.22,2
10:44,386277162.0,1967.8799999999992,-64.97,4
10:45,280268430.0,6654.10900606806,-31.3,7
10:46,987229118.0,-9.50299506656188,-227.98,2
10:48,945054126.0,1118.0281,-46.46,5
10:50,857455726.0,0.4274858756841695,-184.64,5
10:50,688328251.0,155.75362464517275,-35.0,2
10:51,726913482.0,-502.5605985264765,-32.98,2
10:52,508518911.0,789.6147502790103,-12.99,2
10:53,853907490.0,10817.696784821112,-17.16,2
10:54,637649383.0,2000.2327999999984,-67.98,2
10:54,216286013.0,325.12497654513345,-18.97,7
10:54,155867488.0,503.1666999999984,-199.98,2
10:56,197050303.0,487.259432563495,-22.98,2
10:56,570269025.0,2996.9214421446404,-30.95,1
11:00,163470640.0,2850.2535999999996,-63.38,2
11:01,405416860.0,2261.115406880905,-199.06,5
11:01,929044080.0,898.9438915056282,-20.97,7
11:02,904154012.0,922.2174581204316,-15.0,4
11:02,444371478.0,878.6741499999987,-29.99,2
11:03,524425303.0,601.9403999999988,-33.48,4
11:05,138351025.0,-17.87635000000041,-19.95,4
11:05,585625048.0,1642.4599749993577,-59.72,5
11:05,688328251.0,20.76362464517274,-134.99,2
11:07,248625662.0,275.69808428485237,-51.99,2
11:08,923322792.0,-112.85433175363768,-49.99,2
11:08,152616936.0,1508.6050078630649,-28.0,2
11:08,538003940.0,1756.8300000000102,-39.97,4
11:09,762785862.0,1365.4948999999992,-71.99,2
11:10,137913631.0,2289.40645,-57.0,2
11:10,250957494.0,1408.2327499999983,-41.97,4
11:10,709935470.0,803.0307376997723,-47.94,4
11:10,895331556.0,1012.5587999999992,-9.99,7
11:11,155867488.0,496.1766999999984,-6.99,1
11:12,799453072.0,782.0245499999987,-15.98,2
11:13,879091637.0,95.76152373797709,-152.67,2
11:13,637649383.0,1969.2427999999984,-30.99,2
11:13,136770968.0,153.03919999999954,-25.98,2
11:14,943329213.0,1401.6286193497576,-19.06,2
11:15,706361191.0,827.0020484940779,-55.98,2
11:16,524425303.0,523.9603999999988,-77.98,2
11:17,979892433.0,74.48499999999895,-39.55,5
11:19,761272540.0,386.08199999999874,-79.97,2
11:21,552980092.0,218.97071911933756,-44.99,2
11:24,163470640.0,2790.2535999999996,-60.0,2
11:25,923322792.0,-137.81433175363767,-24.96,7
11:30,895331556.0,987.5787999999992,-24.98,4
11:31,627936697.0,1214.67585,-40.99,2
11:31,496865819.0,466.18156815731754,-9.99,4
11:32,373875019.0,20053.769900423344,-104.94,5
11:34,637649383.0,1936.2927999999984,-32.95,7
11:35,524425303.0,518.9703999999988,-4.99,1
11:36,538003940.0,1677.3300000000102,-79.5,2
11:37,657139925.0,16612.76371949208,-8.54,7
11:38,259015404.0,-422.5793576905384,-241.5,2
11:42,246753533.0,1531.5876999999982,-156.98,2
11:42,152616936.0,1488.6450078630646,-19.96,4
11:42,105375973.0,679.5796528189405,-110.32,2
11:43,709935470.0,743.0307376997723,-60.0,2
11:44,441142605.0,2688.0803922757295,-20.97,1
11:44,382862215.0,101.91899999999984,-129.97,2
11:47,970298834.0,1710.486110827443,-26.01,1
11:47,919185264.0,6204.845859740335,-2.36,5
11:48,762785862.0,1272.5248999999992,-92.97,2
11:49,700138124.0,6412.329702068643,-117.6,2
11:49,627936697.0,1156.68585,-57.99,2
11:49,250957494.0,1321.2527499999983,-86.98,2
11:49,812839908.0,-687.1048500000003,-43.01,5
11:50,385685918.0,119.0399408415526,-62.99,2
11:52,163470640.0,2773.3785999999996,-16.88,2
11:52,382862215.0,-24.05100000000016,-125.97,2
11:54,136770968.0,62.059199999999535,-90.98,2
11:56,127809299.0,2716.2804967244633,-9.99,2
11:57,259015404.0,-665.4793576905383,-242.9,2
11:57,155867488.0,464.1866999999984,-31.99,2
11:59,246753533.0,1449.5976999999982,-81.99,2
12:00,250957494.0,1215.2727499999985,-105.98,2
12:00,857455726.0,-68.54251412431583,-68.97,2
12:01,508518911.0,754.6647502790103,-34.95,1
12:03,216286013.0,199.15497654513345,-125.97,6
12:06,136770968.0,-12.910800000000464,-74.97,4
12:06,538003940.0,1654.8300000000102,-22.5,2
12:06,280990953.0,1240.479699999998,-19.99,4
12:08,155867488.0,453.7066999999984,-10.48,4
12:09,105375973.0,640.5196528189406,-39.06,1
12:10,700138124.0,6380.829702068643,-31.5,2
12:13,769319491.0,-261.3330000000008,-19.99,2
12:13,163470640.0,2754.6285999999996,-18.75,2
12:17,688328251.0,-41.21637535482726,-61.98,2
12:26,197050303.0,459.259432563495,-28.0,2
12:27,979892433.0,24.484999999998948,-50.0,2
12:32,211493028.0,1618.711449999999,-35.0,6
12:33,433837402.0,669.2841315358118,-10.19,2
12:35,237684254.0,7243.226631337016,-11.82,5
12:36,727417797.0,6045.1355130453185,-30.69,8
12:36,132400709.0,750.4270351539396,-84.99,2
12:37,749378808.0,1115.459434750245,-31.44,9
12:38,647472692.0,30856.06785621086,-30.68,9
12:38,298000165.0,25857.829833530133,-7.87,2
12:40,969804197.0,-561.8487500000008,-24.21,5
12:42,259015404.0,-704.6493576905383,-39.17,9
12:43,538003940.0,1500.3300000000102,-154.5,2
12:46,105375973.0,618.4496528189405,-22.07,2
12:47,163470640.0,2670.6285999999996,-84.0,2
12:47,754141345.0,-3234.76283511576,-23.9,9
12:54,555393405.0,328.1225999999997,-12.99,2
12:55,414454079.0,4748.748850000002,-35.89,9
12:56,903468956.0,1586.278999999999,-76.26,5
12:57,823208989.0,1177.2117038695317,-125.3,2
13:00,979892433.0,-3.475000000001053,-27.96,1
13:01,684284526.0,-3394.946366745756,-35.3,5
13:03,340321732.0,3275.9592500000035,-5.4,9
13:04,287480331.0,8475.074154201882,-17.02,4
13:05,585625048.0,1637.0599749993576,-5.4,9
13:07,348325817.0,12529.620980263167,-6.6,9
13:07,923322792.0,-143.80433175363768,-5.99,2
13:08,637649383.0,1906.3027999999983,-29.99,6
13:12,298000165.0,25769.853833530135,-87.98,5
13:13,494156986.0,1105.1190456723346,-6.15,9
13:14,155867488.0,303.72669999999835,-149.98,2
13:16,639549973.0,7484.853001183843,-10.02,4
13:17,187111705.0,9766.599736314698,-7.8,9
13:18,956717493.0,3359.0607504359837,-46.97,4
13:21,322221939.0,3009.8469762131876,-4.3,9
13:22,849096144.0,1012.169020751343,-6.05,9
13:22,538003940.0,1391.3300000000102,-109.0,2
13:23,854895960.0,5571.853291290339,-198.11,5
13:24,496865819.0,408.2115681573175,-57.97,2
13:25,688712152.0,6579.3979002621145,-6.5,9
13:27,480557476.0,14587.62968891818,-5.1,9
13:30,163470640.0,2636.8785999999996,-33.75,2
13:30,637649383.0,1851.3127999999983,-54.99,2
13:34,896821055.0,609.6205592670824,-25.0,2
13:35,370521542.0,31590.083146154953,-19.9,9
13:35,923322792.0,-185.78433175363767,-41.98,2
13:37,346874167.0,-188.50575000000097,-115.43,5
13:40,538003940.0,1341.3300000000102,-50.0,2
13:45,688328251.0,-49.20637535482726,-7.99,4
13:47,807098817.0,-90.27755000000096,-70.34,5
13:48,605711527.0,-549.7764861674164,-52.65,5
13:53,538003940.0,1246.3300000000102,-95.0,2
13:59,163470640.0,2607.2535999999996,-29.62,2
13:59,688328251.0,-65.69637535482725,-16.49,4
14:01,815993333.0,6588.4067180432185,-20.19,4
14:13,155317149.0,707.1572499999991,-21.97,7
14:16,688328251.0,-95.68637535482723,-29.99,2
14:21,779946617.0,20829.786042219428,-48.61,2
14:21,345514953.0,1503.6021999999994,-12.05,5
14:22,538003940.0,1211.8300000000102,-34.5,2
14:23,293609137.0,139.04049257449813,-5.99,2
14:28,223207876.0,-247.7003999999995,-55.45,5
14:39,538003940.0,1073.3300000000102,-138.5,2
14:44,444371478.0,833.6841499999987,-44.99,2
14:44,779946617.0,20765.976042219427,-63.81,2
14:46,293609137.0,67.05049257449814,-71.99,2
14:49,258201793.0,-253.6948000000002,-89.98,2
14:50,985188462.0,336.15638871122474,-57.1,2
14:51,496865819.0,386.25156815731754,-21.96,1
14:57,508518911.0,726.6647502790103,-28.0,2
15:00,823208989.0,944.1117038695318,-178.5,2
15:05,538003940.0,998.8300000000102,-74.5,2
15:07,212560376.0,-73.03287422089785,-128.37,2
15:10,687135796.0,33411.350337886106,-11.0,9
15:14,444371478.0,783.6941499999987,-49.99,2
15:28,173335108.0,2211.514000000001,-35.0,2
15:28,496865819.0,239.26156815731753,-146.99,2
15:29,823208989.0,849.6117038695318,-94.5,2
15:31,776108637.0,2265.3973536574954,-40.99,2
15:32,444371478.0,778.1941499999987,-5.5,4
15:34,896821055.0,481.6405592670824,-127.98,2
15:39,929044080.0,876.9438915056282,-22.0,2
15:40,990894155.0,768.0972086788415,-31.99,2
15:44,352899149.0,1269.8227411773412,-18.97,7
15:44,492058070.0,-434.8340312595294,-25.0,2
15:46,163470640.0,2577.6285999999996,-29.62,2
15:47,444371478.0,646.2141499999987,-131.98,2
15:59,538003940.0,899.3300000000102,-99.5,2
16:01,823208989.0,762.1117038695318,-87.5,2
16:03,163470640.0,2489.8785999999996,-87.75,2
16:06,532478725.0,3685.2882289418767,-33.14,9
16:06,497772347.0,1165.0917499999978,-55.98,4
16:08,583579399.0,1541.0161000000007,-19.88,9
16:11,885259672.0,2520.790114099697,-18.28,7
16:13,631111289.0,1147.543499999999,-1.5,7
16:14,923322792.0,-330.75433175363764,-144.97,2
16:20,538003940.0,879.8300000000102,-19.5,2
16:20,494789005.0,2264.120007090131,-67.43,4
16:20,941285623.0,286.8793990667703,-39.98,4
16:21,679911053.0,1999.5459505983383,-101.11,5
16:22,990894155.0,730.1072086788415,-37.99,2
16:22,169689461.0,1806.603149999999,-15.98,7
16:26,158414827.0,207.94499999999812,-4.99,1
16:27,631111289.0,1142.553499999999,-4.99,7
16:28,823208989.0,671.8117038695318,-90.3,2
16:30,163470640.0,2434.0035999999996,-55.88,2
16:31,624500124.0,2712.332796117887,-40.8,5
16:35,610450243.0,883.8904000000002,-40.99,2
16:39,776108637.0,2148.5302536574955,-116.87,5
16:39,796709231.0,1524.6823278962977,-29.99,2
16:39,838830098.0,1334.4076920877844,-12.98,7
16:40,564744955.0,1367.059758588842,-53.99,2
16:42,492058070.0,-475.7640312595294,-40.93,1
16:42,538003940.0,730.3300000000102,-149.5,2
16:42,350921975.0,-400.6774289261258,-70.38,5
16:45,666952234.0,-474.9547518755133,-41.46,5
16:46,929044080.0,834.9638915056282,-41.98,2
16:47,241459011.0,388.2026132723467,-21.92,5
16:47,208381936.0,-138.67557822174518,-79.97,2
16:48,899742927.0,12280.693977628283,-32.08,7
16:49,948558249.0,7970.953461815641,-87.97,5
16:52,736310094.0,-1033.928024027426,-47.97,5
16:54,376271050.0,1420.505681627471,-21.98,7
16:55,538003940.0,690.8300000000102,-39.5,2
16:56,796709231.0,1513.1923278962977,-11.49,4
16:56,860360312.0,-294.7997911173196,-117.59,5
16:57,152616936.0,1450.6550078630646,-37.99,2
16:58,477216513.0,1273.0078000000003,-17.98,4
16:58,604334058.0,1479.8886999999993,-49.99,4
16:59,163470640.0,2333.5035999999996,-100.5,2
16:59,155317149.0,566.177249999999,-140.98,2
17:00,494789005.0,2208.9740166093716,-55.15,2
17:00,508518911.0,713.6747502790103,-12.99,2
17:01,880546403.0,112.45049999999787,-49.99,2
17:02,901037631.0,1549.9713230964064,-94.25,2
17:05,766812921.0,1063.049299999999,-22.0,2
17:05,534097839.0,-4414.696049999997,-14.53,5
17:05,158414827.0,-24.02500000000188,-231.97,2
17:05,583579399.0,1519.0561000000007,-21.96,7
17:07,914806976.0,1200.1932501854865,-18.97,7
17:11,823208989.0,446.41170386953183,-225.4,2
17:13,256045540.0,-3853.813899999999,-49.6,5
17:14,212560376.0,-84.04287422089786,-11.01,1
17:14,296972867.0,494.9636999999991,-51.99,2
17:15,641764023.0,49.70619622799563,-5.5,4
17:15,538003940.0,626.3300000000102,-64.5,2
17:19,466649401.0,2010.4390307973745,-35.0,6
17:20,696333897.0,1302.8303999999987,-28.96,1
17:21,151968462.0,6551.290237886337,-17.75,7
17:21,824916823.0,10798.986125017092,-5.2,4
17:21,354894456.0,691.6799999999996,-199.98,2
17:22,766812921.0,1033.089299999999,-29.96,1
17:23,518474507.0,16637.557027579514,-33.62,7
17:26,366477356.0,2136.8918,-157.98,2
17:26,779620857.0,248.136803614824,-62.99,2
17:27,482513594.0,7821.449054250669,-23.79,5
17:27,198630866.0,-679.8267735612685,-124.01,5
17:28,771125520.0,5.793049999999077,-45.47,5
17:28,796709231.0,1502.2123278962974,-10.98,1
17:28,556992209.0,13653.96271021934,-70.05,2
17:29,874431242.0,11985.869047153272,-9.94,8
17:29,795847804.0,27282.79277809937,-40.19,4
17:30,815993333.0,6550.226718043218,-38.18,2
17:30,163470640.0,2270.5035999999996,-63.0,2
17:30,508518911.0,693.6947502790102,-19.98,4
17:31,151916463.0,1242.147555599169,-82.07,2
17:33,361201224.0,5225.243384832092,-28.52,5
17:34,169006407.0,11060.98578493364,-58.74,2
17:34,690523499.0,1734.1186,-8.97,7
17:34,166019891.0,10778.57658722748,-63.41,2
17:35,833899961.0,-161.9578042819905,-30.8,9
17:35,452974357.0,-2138.573949999994,-12.58,5
17:36,255814263.0,1372.9552534884615,-33.96,1
17:36,187541224.0,941.3088873742358,-22.52,7
17:37,886921642.0,2807.118789043211,-10.89,5
17:37,901037631.0,1424.6113230964063,-125.36,2
17:39,336171116.0,1148.4183999999996,-35.95,1
17:39,417850087.0,18238.132249727467,-13.84,7
17:40,859264768.0,962.8511837819384,-19.99,2
17:41,294474095.0,-2621.768786499238,-45.34,5
17:42,613729471.0,10861.202456919862,-10.17,6
17:42,500843551.0,2188.6522999999997,-15.98,7
17:42,851181128.0,4126.679859848635,-20.88,9
17:43,555393405.0,303.1225999999997,-25.0,2
17:44,656317661.0,446.77534154140267,-129.98,2
17:44,478986718.0,689.1202999999985,-58.97,4
17:45,538003940.0,516.3300000000102,-110.0,2
17:46,245690309.0,9485.08693991542,-36.48,5
17:47,365608668.0,1646.7439104738326,-1.99,4
17:47,496395938.0,11824.20993692274,-95.55,2
17:48,823208989.0,243.41170386953183,-203.0,2
17:49,880546403.0,36.46049999999788,-75.99,2
17:49,901037631.0,1371.4813230964064,-53.13,2
17:49,668329719.0,11069.317109515208,-212.79,2
17:50,581655972.0,41067.39483683588,-16.98,7
17:50,769311479.0,8748.191442950056,-11.17,1
17:50,287480331.0,8454.205932165338,-20.87,7
17:50,876890798.0,3466.235770699934,-53.98,2
17:51,287230540.0,3105.080997763875,-26.97,1
17:51,421881811.0,3817.81064146634,-7.25,4
17:52,496395938.0,11799.058381453571,-25.15,5
17:52,838830098.0,1314.4176920877844,-19.99,2
17:53,788740658.0,1953.4714690169988,-13.99,7
17:53,335698481.0,-2514.710496694939,-31.83,5
17:53,631111289.0,1082.573499999999,-59.98,6
17:54,687135796.0,33399.770337886104,-11.58,4
17:55,641764023.0,-26.26380377200437,-75.97,2
17:55,859264768.0,850.9911837819383,-111.86,4
17:56,752362502.0,10102.797350436322,-23.14,7
17:58,656317661.0,436.78534154140266,-9.99,1
17:59,822718326.0,14445.936001111882,-142.77,2
18:00,857754342.0,142.25503802272007,-120.96,5
18:10,699997811.0,3122.2118500000033,-41.04,5
18:11,305778936.0,11560.413231480135,-23.84,9
18:12,184430449.0,4373.466332391089,-90.3,2
18:12,668329719.0,10860.017109515207,-209.3,2
18:16,538003940.0,456.83000000001016,-59.5,2
18:16,878989510.0,4022.8434678153662,-166.28,5
18:16,949032480.0,2946.1457770725724,-22.93,9
18:17,704517789.0,17430.422195831663,-33.72,8
18:17,603721739.0,-230.7921005168161,-119.55,5
18:17,365608668.0,1639.2439104738326,-7.5,7
18:23,670102069.0,2050.587612115047,-51.66,5
18:25,108481285.0,10230.28894899539,-50.46,8
18:26,256002321.0,8805.749792557941,-13.24,9
18:27,198946608.0,3101.6061245982532,-80.51,5
18:29,361201224.0,5199.603384832091,-25.64,9
18:30,538003940.0,377.33000000001016,-79.5,2
18:31,834581602.0,1416.5773999999992,-44.97,7
18:31,540159353.0,10550.238785858346,-29.53,5
18:33,448279144.0,892.5788999999991,-19.49,9
18:33,383833857.0,30383.8799014012,-7.39,9
18:33,613427466.0,7972.127455264377,-1.99,7
18:33,493855007.0,-2831.1766315743916,-26.59,9
18:34,433837402.0,640.9641315358117,-28.32,9
18:35,558119802.0,39358.27083098784,-91.39,5
18:35,627936697.0,1148.70585,-7.98,7
18:36,287480331.0,8425.575932165339,-28.63,9
18:39,604334058.0,1416.0752999999993,-63.81,5
18:40,493571342.0,-2689.433380907047,-21.97,5
18:40,558119802.0,39330.870830987835,-27.4,9
18:41,475117511.0,6787.317141140191,-1.99,7
18:41,429556122.0,6301.977472972949,-142.88,5
18:42,984783496.0,17147.223277976256,-6.86,2
18:44,417850087.0,18211.789129727465,-26.34,7
18:45,903953091.0,4410.770790134575,-59.98,7
18:48,901432314.0,2841.933551743742,-63.06,5
18:48,916225911.0,-2489.10925,-56.34,5
18:50,500043411.0,13286.15328013106,-30.5,4
18:52,187541224.0,899.7688873742359,-41.54,9
18:52,183186021.0,-262.9750499999988,-27.28,5
18:55,475117511.0,6766.758141140191,-20.56,5
18:57,986267641.0,7373.831099705963,-4.03,7
18:58,696333897.0,1292.840399999999,-9.99,7
18:59,200080192.0,8187.428771755341,-61.71,2
19:00,345582855.0,256.13435282054934,-15.28,5
19:04,390747457.0,364.2623999999979,-41.3,5
19:06,248658670.0,-67.22584999999998,-16.56,5
19:15,779816907.0,-3155.14608292291,-59.24,5
19:15,979135922.0,-1793.1096994095487,-48.77,5
19:17,527842638.0,1667.3800426329835,-73.34,5
19:21,616924659.0,-729.6154201769148,-20.09,5
19:22,466649401.0,1906.0007807973743,-104.44,5
19:23,471897866.0,6552.911134195606,-54.81,7
19:26,213112754.0,5056.424320994548,-7.39,9
19:31,383833857.0,30309.4699014012,-74.41,5
19:32,487051121.0,1044.410620870394,-67.17,5
19:33,510101371.0,14643.23863577762,-27.68,7
19:36,667367404.0,12017.285711836155,-23.44,9
19:45,146909202.0,3005.48075930564,-31.74,9
19:47,310375875.0,2365.5923376907663,-1.3,2
19:48,859264768.0,821.5050837819383,-29.49,5
19:50,865748375.0,1961.508765646476,-1.42,2
19:50,999752672.0,2689.8410935333345,-142.52,5
19:54,679911053.0,1979.3079976196584,-20.24,2
20:00,736340277.0,7653.064609588025,-46.36,7
20:00,887853850.0,9755.223691993931,-26.9,9
20:11,131388684.0,21556.37875898358,-13.01,5
20:13,709632525.0,-395.6373500000006,-98.81,5
20:15,581655972.0,40971.158836835886,-96.24,5
20:18,261894284.0,-2690.6037999999967,-62.78,5
20:21,450896297.0,15941.67689821693,-0.66,2
20:33,995615876.0,3181.698461877259,-3.44,2
20:33,126929801.0,2747.118819212563,-134.72,5
20:35,409971170.0,3901.6625302754505,-34.15,7
20:38,203466392.0,481.78169609552407,-111.45,5
20:38,949032480.0,2893.8156900204904,-52.33,2
20:39,414805878.0,12269.683239226288,-93.37,5
20:40,873693307.0,13861.070487857683,-0.14,2
20:42,994214354.0,9128.039528946483,-40.09,9
20:42,678726554.0,-670.1312476516102,-108.02,5
20:50,534325901.0,8252.764160573459,-19.59,5
20:56,200080192.0,8116.952771755341,-70.48,5
20:57,472213568.0,-871.8904942060534,-133.74,5
20:59,214339619.0,-831.3608358301126,-80.4,5
21:10,120634201.0,7295.15869192003,-25.29,4
21:24,951817450.0,8872.870892354871,-4.27,7
00:00,652048867.0,878.5518499999989,-575.0,0
00:00,838415080.0,-3455.1764999999987,-928.0,0
00:00,169006407.0,13410.98578493364,-520.0,0
00:00,624500124.0,3883.332796117887,-654.0,0
00:00,134461671.0,6570.565897688848,-530.0,0
00:00,228136274.0,1579.7068299999996,-1026.0,0
00:00,478651121.0,-355.9298204015304,-1340.0,0
00:00,833899961.0,978.0421957180096,-530.0,0
00:00,766692943.0,-2099.25675,-952.0,0
00:00,551196328.0,5438.005465435383,-567.0,0
00:00,919185264.0,5521.845859740335,-683.0,0
00:00,822250278.0,7868.3760546759295,-801.0,0
00:00,287230540.0,1722.080997763875,-1383.0,0
00:00,987163717.0,4981.806078176684,-519.0,0
00:00,871866387.0,1033.294699999999,-706.0,0
00:00,758160963.0,9093.023756711154,-575.0,0
00:00,909676212.0,956.7245317876132,-780.0,0
00:00,135937041.0,-489.930348268412,-517.0,0
00:00,314980178.0,5585.266850000006,-1285.0,0
00:00,834581602.0,701.5773999999992,-715.0,0
00:00,487051121.0,1897.4106208703945,-759.0,0
00:00,743630833.0,-305.7886367152987,-925.0,0
00:00,625281433.0,-377.87000737075687,-700.0,0
00:00,471897866.0,8525.911134195605,-499.0,0
00:00,516051449.0,1928.6621813984505,-504.0,0
00:00,754141345.0,-3252.76283511576,-1181.0,0
00:00,414805878.0,14892.433239226288,-465.0,0
00:00,703588001.0,518.2412999999997,-1004.0,0
00:00,618138606.0,2141.513303264287,-570.0,0
00:00,688328251.0,-1030.6863753548273,-935.0,0
00:00,385685918.0,-358.9600591584474,-478.0,0
00:00,741269136.0,2135.195950000002,-1268.0,0
00:00,472213568.0,-301.8904942060535,-600.0,0
00:00,572136270.0,-252.36788841197657,-834.0,0
00:00,656812046.0,2223.432753732519,-926.0,0
00:00,874431242.0,11533.869047153272,-452.0,0
00:00,654329190.0,-273.82529905148067,-1144.0,0
00:00,448279144.0,1440.578899999999,-496.0,0
00:00,270374623.0,11795.189407686545,-541.0,0
00:00,500843551.0,1519.6522999999995,-669.0,0
00:00,684988568.0,15.79752657279846,-457.0,0
00:00,196289502.0,18735.581189086646,-512.0,0
00:00,785749304.0,10160.535057902474,-787.0,0
00:00,915666111.0,-4855.549574772038,-1269.0,0
00:00,122884111.0,-1786.836083072969,-973.0,0
00:00,482513594.0,7171.449054250669,-650.0,0
00:00,233981231.0,3031.730722724169,-858.0,0
00:00,691789577.0,-1092.4430500000003,-883.0,0
00:00,598793068.0,1053.276399999998,-663.0,0
00:00,750094757.0,-1415.4893000000006,-1226.0,0
00:00,506618547.0,18246.961648917204,-1143.0,0
00:00,858560423.0,14304.817253018788,-745.0,0
00:00,943829984.0,535.3958091134568,-595.0,0
00:00,885259672.0,3742.290114099696,-621.0,0
00:00,424397946.0,857.0697836054003,-1041.0,0
00:00,656781737.0,-5595.909999999994,-917.0,0
00:00,500043411.0,15685.15328013106,-839.0,0
00:00,996042490.0,7450.135781867768,-501.0,0
00:00,221356538.0,1139.5813999999996,-729.0,0
00:00,188263947.0,911.3227500000008,-1310.0,0
00:00,163470640.0,1176.5035999999996,-1094.0,0
00:00,903663593.0,807.069380043554,-578.0,0
00:00,949032480.0,4540.81569002049,-645.0,0
00:00,844206657.0,1326.8710051465696,-1307.0,0
00:00,170637730.0,1976.2842733370665,-633.0,0
00:00,237493332.0,17409.79381815354,-585.0,0
00:00,452974357.0,-3460.573949999994,-1322.0,0
00:00,857754342.0,1192.00503802272,-1268.0,0
00:00,373163757.0,12254.127782079331,-554.0,0
00:00,872286364.0,-208.1718958130998,-991.0,0
00:00,913127700.0,2855.7371380111163,-621.0,0
00:00,386277162.0,900.8799999999994,-1067.0,0
00:00,610645022.0,-86.8444626449184,-988.0,0
00:00,130522384.0,-184.14381562086032,-847.0,0
00:00,429556122.0,5798.977472972949,-503.0,0
00:00,855129444.0,-8.687695437372213,-846.0,0
00:00,138351025.0,-587.8763500000005,-570.0,0
00:00,744968736.0,-1369.591826569424,-1294.0,0
00:00,534908754.0,-1037.3572500000002,-1143.0,0
00:00,760704118.0,1732.0023127174895,-639.0,0
00:00,736310094.0,-602.9280240274259,-856.0,0
00:00,340321732.0,2814.9592500000035,-461.0,0
00:00,534097839.0,-5105.696049999997,-691.0,0
00:00,867679563.0,268.3467537017159,-1201.0,0
00:00,142791593.0,236.84459999999967,-475.0,0
00:00,994214354.0,11533.039528946483,-594.0,0
00:00,913801979.0,500.00652991449374,-641.0,0
00:00,776108637.0,1582.5302536574957,-566.0,0
00:00,137913631.0,1813.40645,-476.0,0
00:00,204855464.0,-539.8082386396163,-646.0,0
00:00,639409800.0,40864.283409543306,-877.0,0
00:00,631111289.0,131.57349999999906,-951.0,0
00:00,124102251.0,2635.687289596185,-476.0,0
00:00,361955473.0,707.3937452440841,-711.0,0
00:00,673025413.0,2956.913435616786,-889.0,0
00:00,982949451.0,-4125.269167052507,-1130.0,0
00:00,948069469.0,-554.7963000000011,-1239.0,0
00:00,809499628.0,20464.78579158873,-645.0,0
00:00,349614277.0,1884.2750999999992,-661.0,0
00:00,119993184.0,-2177.261902910862,-1223.0,0
00:00,555804115.0,-1172.6960475587034,-1041.0,0
00:00,519933553.0,628.3510041507284,-880.0,0
00:00,492058070.0,-1831.7640312595297,-1356.0,0
00:00,623156843.0,6200.258454994649,-1068.0,0
00:00,769311479.0,7838.191442950056,-910.0,0
00:00,630691258.0,19.36654487484134,-617.0,0
00:00,656317661.0,-55.21465845859734,-492.0,0
00:00,366477356.0,1016.8918,-1120.0,0
00:00,522188082.0,8826.563772831141,-540.0,0
00:00,833499132.0,1708.3519000000024,-837.0,0
00:00,208381936.0,-682.6755782217451,-544.0,0
00:00,308897841.0,1752.787999999999,-1219.0,0
00:00,461990622.0,9258.33699523383,-1316.0,0
00:00,252760664.0,8059.933599683385,-749.0,0
00:00,581655972.0,46184.158836835886,-620.0,0
00:00,402438092.0,916.3714999999988,-774.0,0
00:00,812839908.0,-1691.1048500000002,-1004.0,0
00:00,724537117.0,-1434.0542500000004,-1176.0,0
00:00,994947671.0,1682.7557000000006,-590.0,0
00:00,291580432.0,439.3919500000002,-1156.0,0
00:00,553734946.0,1033.1630999999982,-819.0,0
00:00,264208990.0,1422.2931999999985,-1266.0,0
00:00,285428103.0,12120.443808161066,-598.0,0
00:00,744398361.0,317.70299999999963,-608.0,0
00:00,819515373.0,3357.7624360637938,-491.0,0
00:00,892354433.0,-286.4599606343386,-1324.0,0
00:00,450896297.0,15456.67689821693,-485.0,0
00:00,336171116.0,63.418399999999565,-1085.0,0
00:00,999752672.0,2037.8410935333343,-652.0,0
00:00,668329719.0,10365.017109515207,-495.0,0
00:00,736340277.0,9373.064609588026,-752.0,0
00:00,298000165.0,29461.853833530135,-475.0,0
00:00,956717493.0,2118.0607504359837,-1241.0,0
00:00,486495235.0,2456.8256100762064,-631.0,0
00:00,641764023.0,-896.2638037720044,-870.0,0
00:00,769319491.0,-1125.3330000000008,-864.0,0
00:00,585596026.0,3038.721118569256,-938.0,0
00:00,828532554.0,-129.11969048271033,-995.0,0
00:00,213112754.0,6791.424320994548,-1135.0,0
00:00,490790931.0,762.4789499999986,-701.0,0
00:00,627936697.0,418.70585000000005,-730.0,0
00:00,245690309.0,11714.08693991542,-479.0,0
00:00,964702094.0,1403.6617425992497,-456.0,0
00:00,554792076.0,32578.567406872156,-516.0,0
00:00,564214408.0,25.35268472572602,-1351.0,0
00:00,151968462.0,9151.290237886336,-776.0,0
00:00,383625050.0,4161.958501081161,-930.0,0
00:00,854513972.0,2816.9177,-571.0,0
00:00,435313070.0,3527.0733330332205,-1148.0,0
00:00,424927189.0,263.67188274410523,-890.0,0
00:00,930271460.0,565.2685475357762,-1116.0,0
00:00,574548998.0,287.835049999999,-662.0,0
00:00,741903302.0,3389.397067935261,-684.0,0
00:00,945054126.0,531.0281,-587.0,0
00:00,467207141.0,952.8681670482638,-693.0,0
00:00,494789005.0,3462.8940166093716,-485.0,0
00:00,534325901.0,7643.764160573459,-609.0,0
00:00,596328017.0,-2436.6478499999976,-1090.0,0
00:00,173335108.0,1372.514000000001,-839.0,0
00:00,220183538.0,1068.5235999999995,-1269.0,0
00:00,962295212.0,-3107.480149999996,-761.0,0
00:00,605116158.0,3293.819500000004,-589.0,0
00:00,889916166.0,559.5034014132266,-613.0,0
00:00,479456865.0,1782.5778118641742,-635.0,0
00:00,780463728.0,5216.08087094224,-508.0,0
00:00,986267641.0,6101.831099705963,-1272.0,0
00:00,779620857.0,-365.863196385176,-614.0,0
00:00,517190750.0,3207.3585899154123,-547.0,0
00:00,647472692.0,29989.06785621086,-867.0,0
00:00,183888402.0,22197.922457140143,-847.0,0
00:00,194745206.0,856.2233720912432,-508.0,0
00:00,667367404.0,11532.285711836155,-485.0,0
00:00,403902116.0,849.1531999999993,-860.0,0
00:00,705848712.0,31137.46063949334,-1343.0,0
00:00,183186021.0,-1071.9750499999989,-809.0,0
00:00,499244466.0,-318.22013128342246,-621.0,0
00:00,979892433.0,-1212.475000000001,-1209.0,0
00:00,435984758.0,5111.025707077037,-694.0,0
00:00,570575024.0,-870.9196500000007,-730.0,0
00:00,509627909.0,105.80464999999911,-961.0,0
00:00,365608668.0,970.2439104738326,-669.0,0
00:00,184430449.0,3681.466332391089,-692.0,0
00:00,796709231.0,554.2123278962974,-948.0,0
00:00,229205098.0,9109.618670452108,-464.0,0
00:00,627622066.0,4384.43237216963,-989.0,0
00:00,990894155.0,109.10720867884152,-621.0,0
00:00,187111705.0,8379.599736314698,-1387.0,0
00:00,865748375.0,3559.5087656464757,-485.0,0
00:00,266777719.0,282.71093378023966,-806.0,0
00:00,851181128.0,6448.679859848635,-448.0,0
00:00,520418719.0,2770.1863500000036,-588.0,0
00:00,101531259.0,496.9420999999995,-859.0,0
00:00,593378953.0,1572.6696500000048,-932.0,0
00:00,534583529.0,1787.857588054765,-628.0,0
00:00,366550080.0,27027.40040128616,-636.0,0
00:00,152488934.0,2730.984657313731,-826.0,0
00:00,308068836.0,736.7315225681923,-854.0,0
00:00,639549973.0,6773.853001183843,-711.0,0
00:00,133755851.0,776.109248138252,-1109.0,0
00:00,442070890.0,1938.302412444371,-1351.0,0
00:00,336557504.0,2045.2407123661103,-967.0,0
00:00,971129830.0,-1790.0506499999992,-569.0,0
00:00,147474476.0,3927.890030555134,-473.0,0
00:00,807714284.0,1485.6326607359997,-679.0,0
00:00,558119802.0,38296.870830987835,-1034.0,0
00:00,143061865.0,8252.804826403766,-701.0,0
00:00,886921642.0,4262.118789043211,-591.0,0
00:00,189335192.0,-984.6039517578606,-650.0,0
00:00,898104045.0,-1505.2980500000024,-584.0,0
00:00,691012931.0,-1604.532250000001,-1335.0,0
00:00,709608057.0,3380.322681468542,-553.0,0
00:00,984783496.0,16505.223277976256,-642.0,0
00:00,129018172.0,11787.73946802586,-782.0,0
00:00,544961962.0,-206.2256769943906,-553.0,0
00:00,480198977.0,14337.312032593252,-731.0,0
00:00,225210798.0,1203.5799351225796,-849.0,0
00:00,376271050.0,2354.1056816274704,-813.0,0
00:00,696333897.0,764.8403999999987,-528.0,0
00:00,462962606.0,-364.8099500000013,-1049.0,0
00:00,154246234.0,-851.2951078978956,-702.0,0
00:00,215426302.0,1217.952404025692,-592.0,0
00:00,719586818.0,22009.65868747271,-552.0,0
00:00,570269025.0,4508.92144214464,-488.0,0
00:00,556992209.0,12662.96271021934,-991.0,0
00:00,444428189.0,2156.366200000002,-918.0,0
00:00,752362502.0,8996.797350436322,-1106.0,0
00:00,433917275.0,8773.816473170387,-912.0,0
00:00,165691047.0,1076.3170999999988,-655.0,0
00:00,700138124.0,5486.829702068643,-894.0,0
00:00,169689461.0,1221.603149999999,-585.0,0
00:00,901432314.0,4216.433551743742,-468.0,0
00:00,496395938.0,14079.718381453573,-561.0,0
00:00,822718326.0,13246.936001111882,-1199.0,0
00:00,644751433.0,-1450.8956584655384,-952.0,0
00:00,637649383.0,1221.3127999999983,-630.0,0
00:00,403383649.0,1755.5748031531707,-471.0,0
00:00,998390769.0,224.6067509405243,-1013.0,0
00:00,711045550.0,2158.971350000003,-1376.0,0
00:00,183546640.0,391.29069734773384,-883.0,0
00:00,954263768.0,36.21689999999967,-1057.0,0
00:00,479366718.0,2770.2413481400417,-997.0,0
00:00,454129843.0,1270.85639516656,-790.0,0
00:00,683078800.0,2639.7850811472854,-618.0,0
00:00,215832575.0,-1106.7694637442198,-877.0,0
00:00,576188756.0,-4890.531499999998,-597.0,0
00:00,280200287.0,-337.57295338694894,-465.0,0
00:00,355733816.0,5724.106316440188,-664.0,0
00:00,846550094.0,2757.5192671741443,-1170.0,0
00:00,975345315.0,41193.05389051303,-772.0,0
00:00,524425303.0,-398.0296000000012,-917.0,0
00:00,618514666.0,24514.74347271649,-495.0,0
00:00,737547541.0,491.1905995677744,-545.0,0
00:00,709632525.0,-1438.6373500000009,-1043.0,0
00:00,853907490.0,9707.696784821112,-1110.0,0
00:00,297823329.0,1027.9386499999991,-677.0,0
00:00,426466211.0,-3529.4657499999994,-1248.0,0
00:00,816685391.0,-585.8044037084264,-1384.0,0
00:00,137822385.0,4530.518703161884,-957.0,0
00:00,166019891.0,9872.57658722748,-906.0,0
00:00,977899503.0,179.25089358085268,-469.0,0
00:00,108931112.0,16963.863206981685,-936.0,0
00:00,226703987.0,2509.8221365470745,-1017.0,0
00:00,200080192.0,10095.95277175534,-821.0,0
00:00,176922958.0,2506.57054719765,-653.0,0
00:00,474301748.0,-2605.3390056839676,-553.0,0
00:00,675231808.0,19248.64413259353,-578.0,0
00:00,565175333.0,-4212.568522729825,-1204.0,0
00:00,925659248.0,-564.3420892295711,-1270.0,0
00:00,668692488.0,1615.414241057584,-543.0,0
00:00,588565416.0,7625.857151735635,-501.0,0
00:00,688712152.0,8067.397900262115,-887.0,0
00:00,655368335.0,4709.69812909623,-682.0,0
00:00,629078930.0,879.0738132670717,-531.0,0
00:00,398429109.0,1973.397050000001,-1032.0,0
00:00,345582855.0,1259.634352820549,-539.0,0
00:00,441274121.0,14916.27474001242,-520.0,0
00:00,151278285.0,1526.1874499999994,-1009.0,0
00:00,642924505.0,671.295120183526,-460.0,0
00:00,550832673.0,4289.03601639551,-986.0,0
00:00,699997811.0,1782.211850000003,-1340.0,0
00:00,713641917.0,1590.9588459567872,-451.0,0
00:00,218795010.0,32.8384499999994,-514.0,0
00:00,818552503.0,1446.5380999999988,-665.0,0
00:00,564744955.0,795.059758588842,-572.0,0
00:00,627917561.0,4659.515050000006,-856.0,0
00:00,221868392.0,5796.072781209946,-594.0,0
00:00,713910252.0,-566.482874271459,-1213.0,0
00:00,567499591.0,-1557.3899000000004,-1000.0,0
00:00,555393405.0,-370.8774000000003,-674.0,0
00:00,344219145.0,9982.743113232296,-728.0,0
00:00,416060965.0,960.1822547005804,-458.0,0
00:00,604288474.0,2220.995309699705,-912.0,0
00:00,799286313.0,-563.0316128758616,-776.0,0
00:00,240643705.0,801.120079620568,-998.0,0
00:00,842682241.0,4753.070774877891,-512.0,0
00:00,499410772.0,-2861.789362905162,-1168.0,0
00:00,480557476.0,13640.62968891818,-947.0,0
00:00,586315521.0,14388.311788954345,-653.0,0
00:00,324224854.0,6528.9575500535175,-468.0,0
00:00,581618317.0,-5227.721701873204,-1204.0,0
00:00,104832000.0,-3026.4748589058445,-861.0,0
00:00,535804582.0,830.7072999999987,-1164.0,0
00:00,290751280.0,899.7322466748255,-614.0,0
00:00,199016328.0,6521.1410350990745,-863.0,0
00:00,868377987.0,3913.48564617788,-650.0,0
00:00,779946617.0,19465.976042219427,-1300.0,0
00:00,131388684.0,25210.37875898358,-721.0,0
00:00,491392945.0,7090.089500000011,-1238.0,0
00:00,308505160.0,16013.911880601308,-609.0,0
00:00,722358036.0,293.4635906270828,-1304.0,0
00:00,681955876.0,-1225.4881000000005,-1004.0,0
00:00,246753533.0,773.5976999999982,-676.0,0
00:00,722971557.0,-381.3282791569245,-910.0,0
00:00,607629901.0,-4687.0383199081425,-1193.0,0
00:00,303843160.0,612.3968000000013,-778.0,0
00:00,866941383.0,3264.648480303673,-750.0,0
00:00,158414827.0,-1320.025000000002,-1296.0,0
00:00,834383043.0,6352.513236180321,-783.0,0
00:00,390747457.0,1011.8623999999976,-1269.0,0
00:00,670427480.0,1131.8097000000012,-1247.0,0
00:00,821971408.0,1463.0851102355432,-464.0,0
00:00,475277431.0,1910.294136943619,-632.0,0
00:00,895331556.0,159.5787999999991,-828.0,0
00:00,679662108.0,18677.229026487348,-548.0,0
00:00,494156986.0,105.11904567233456,-1000.0,0
00:00,370521542.0,30784.083146154953,-806.0,0
00:00,878989510.0,5712.843467815366,-782.0,0
00:00,835829467.0,-1479.994749999998,-491.0,0
00:00,285220959.0,13601.175037241055,-1118.0,0
00:00,660874296.0,332.5474499608499,-611.0,0
00:00,162162212.0,-112.67425667269094,-1395.0,0
00:00,455052690.0,398.5577399486276,-594.0,0
00:00,316793091.0,1327.5131100549506,-475.0,0
00:00,930277104.0,10772.071339838005,-472.0,0
00:00,348325817.0,11320.620980263167,-1209.0,0
00:00,357651163.0,-715.2200000000007,-1008.0,0
00:00,812692024.0,4831.561590521822,-489.0,0
00:00,687135796.0,32884.770337886104,-515.0,0
00:00,550644516.0,-155.7163500000015,-1065.0,0
00:00,286484726.0,1346.2636391525707,-745.0,0
00:00,245198540.0,615.3563988017795,-848.0,0
00:00,430910686.0,754.6222000000005,-476.0,0
00:00,624563756.0,332.69622878355653,-822.0,0
00:00,893134725.0,1750.457700776119,-1296.0,0
00:00,134847904.0,3318.7619834790694,-515.0,0
00:00,760753808.0,546.9154999999994,-1071.0,0
00:00,138969884.0,757.4520999999995,-619.0,0
00:00,995615876.0,2544.698461877259,-637.0,0
00:00,647936800.0,2154.630379985134,-1393.0,0
00:00,277562576.0,389.2421699762572,-856.0,0
00:00,986774156.0,2176.5969316257692,-939.0,0
00:00,859603181.0,4218.1716453353165,-700.0,0
00:00,768271776.0,-403.9422467665798,-632.0,0
00:00,672913754.0,13686.71368710861,-745.0,0
00:00,713057426.0,-1053.7992500000005,-647.0,0
00:00,422955974.0,448.1319349990499,-1089.0,0
00:00,672994751.0,471.19629078601,-520.0,0
00:00,592961759.0,-1741.3848000000005,-1194.0,0
00:00,843174694.0,-5742.623499999998,-1300.0,0
00:00,256045540.0,-3937.7138999999993,-1294.0,0
00:00,680773155.0,1154.4671833310913,-746.0,0
00:00,354894456.0,-61.32000000000039,-753.0,0
00:00,824916823.0,10003.986125017092,-795.0,0
00:00,130154096.0,1376.1611481961063,-996.0,0
00:00,477216513.0,-77.99219999999946,-1351.0,0
00:00,876890798.0,2891.235770699934,-575.0,0
00:00,673818591.0,1763.6821753758404,-469.0,0
00:00,120634201.0,6356.15869192003,-939.0,0
00:00,197865285.0,475.3533117312204,-1276.0,0
00:00,639420537.0,-1241.2239499999998,-684.0,0
00:00,293191074.0,1226.558149999999,-796.0,0
00:00,659415300.0,2770.244296218074,-1331.0,0
00:00,274818272.0,689.2675785671313,-517.0,0
00:00,920830317.0,-41.77577936251873,-1361.0,0
00:00,880546403.0,-1244.539500000002,-1281.0,0
00:00,832564361.0,18169.94208229339,-600.0,0
00:00,531186970.0,3890.8703852984254,-753.0,0
00:00,345514953.0,256.60219999999936,-1247.0,0
00:00,903468956.0,957.2789999999992,-629.0,0
00:00,781554833.0,1590.3302255639665,-985.0,0
00:00,282102606.0,1097.7613624228266,-812.0,0
00:00,587202562.0,761.6948994170684,-1214.0,0
00:00,461029994.0,9478.110239540954,-861.0,0
00:00,843537309.0,-464.8757677916319,-667.0,0
00:00,897714622.0,10794.529658692172,-957.0,0
00:00,540159353.0,12754.128785858346,-921.0,0
00:00,358846516.0,1101.6155225272173,-1257.0,0
00:00,690523499.0,1156.1186,-578.0,0
00:00,111137699.0,-79.90454999999929,-660.0,0
00:00,613729471.0,10383.202456919862,-478.0,0
00:00,971010829.0,708.115056444245,-815.0,0
00:00,340295966.0,-1380.8019500000005,-850.0,0
00:00,886837068.0,1030.9855999999993,-802.0,0
00:00,331450202.0,9741.469072364527,-631.0,0
00:00,241459011.0,1277.302613272347,-731.0,0
00:00,472995101.0,2021.3395840990831,-887.0,0
00:00,503575533.0,9643.435558034367,-965.0,0
00:00,338022396.0,111.78453937573909,-881.0,0
00:00,730002588.0,16126.204089401868,-1173.0,0
00:00,657139925.0,15743.76371949208,-869.0,0
00:00,558875206.0,4713.050539399781,-1356.0,0
00:00,514362267.0,1233.0773191070602,-829.0,0
00:00,386729293.0,35795.164075349865,-650.0,0
00:00,261894284.0,-3248.6037999999967,-558.0,0
00:00,799453072.0,188.02454999999873,-594.0,0
00:00,550169791.0,25787.188112942713,-1164.0,0
00:00,456221621.0,1000.739367302628,-664.0,0
00:00,860360312.0,390.7002088826803,-477.0,0
00:00,489964679.0,23741.29946236988,-613.0,0
00:00,380228542.0,-424.0520081844342,-623.0,0
00:00,887853850.0,12063.883691993931,-533.0,0
00:00,626989363.0,1490.721763317375,-577.0,0
00:00,203466392.0,2651.441696095524,-672.0,0
00:00,786141370.0,359.6816999999992,-1237.0,0
00:00,698955014.0,1287.0416302031967,-539.0,0
00:00,504055745.0,711.8677613417669,-608.0,0
00:00,172084472.0,-1121.9407215957183,-1296.0,0
00:00,473820682.0,13208.682245248534,-457.0,0
00:00,651372390.0,-3772.9757499999982,-1222.0,0
00:00,939972497.0,1071.2309086000105,-557.0,0
00:00,255814263.0,2376.9552534884615,-795.0,0
00:00,776431321.0,3888.496382838623,-502.0,0
00:00,844835978.0,11947.839631562929,-813.0,0
00:00,322221939.0,4900.846976213188,-803.0,0
00:00,519649533.0,-280.27818362933795,-899.0,0
00:00,604334058.0,914.0752999999992,-502.0,0
00:00,585133606.0,6301.574459392841,-882.0,0
00:00,835736339.0,3280.5760696909383,-500.0,0
00:00,141521177.0,8200.685900000015,-1090.0,0
00:00,785210466.0,2772.1777969465593,-678.0,0
00:00,973086490.0,12119.87013905696,-850.0,0
00:00,703478110.0,3633.307749908584,-1201.0,0
00:00,180616589.0,1760.6188282361095,-736.0,0
00:00,388862238.0,2228.2554778976382,-446.0,0
00:00,940569402.0,5751.290697728398,-1149.0,0
00:00,520447032.0,9137.436592652728,-891.0,0
00:00,350921975.0,316.8225710738743,-665.0,0
00:00,815385232.0,12562.32207722965,-543.0,0
00:00,951817450.0,10566.870892354871,-1014.0,0
00:00,851649498.0,10136.43968417104,-673.0,0
00:00,315078351.0,10450.588246840607,-959.0,0
00:00,425964226.0,5109.780764114707,-799.0,0
00:00,661295096.0,3890.590949818632,-646.0,0
00:00,478412511.0,13088.839041290454,-559.0,0
00:00,214339619.0,100.23916416988732,-985.0,0
00:00,331684336.0,-1507.9138699513217,-990.0,0
00:00,478986718.0,-588.8797000000015,-1278.0,0
00:00,146686559.0,-435.631411173478,-1301.0,0
00:00,455831435.0,-1676.1121048014948,-674.0,0
00:00,355940285.0,8726.705978189682,-1233.0,0
00:00,817294757.0,-2366.0708,-1359.0,0
00:00,257633312.0,59.59369999999899,-586.0,0
00:00,663479159.0,5432.901541827711,-1044.0,0
00:00,633345190.0,7135.227624869654,-1334.0,0
00:00,859264768.0,252.5050837819383,-569.0,0
00:00,987229118.0,1326.497004933438,-489.0,0
00:00,290818242.0,8570.986388103865,-631.0,0
00:00,896821055.0,-407.3594407329176,-889.0,0
00:00,321372947.0,-161.45495078909948,-1262.0,0
00:00,854895960.0,4565.853291290339,-1006.0,0
00:00,858989281.0,30847.28933193743,-999.0,0
00:00,873693307.0,12894.070487857683,-967.0,0
00:00,637433131.0,617.090799999999,-982.0,0
00:00,706250160.0,14910.47688046728,-998.0,0
00:00,766812921.0,187.08929999999896,-846.0,0
00:00,758885184.0,1398.667182274345,-561.0,0
00:00,496674181.0,-2751.5254723307226,-564.0,0
00:00,535744551.0,1358.9830659956258,-472.0,0
00:00,610450243.0,-197.10959999999977,-1081.0,0
00:00,596463612.0,-1955.512604725138,-1012.0,0
00:00,979135922.0,-124.10969940954874,-551.0,0
00:00,235663459.0,1134.558929812015,-901.0,0
00:00,405416860.0,3221.6154068809046,-882.0,0
00:00,742223719.0,1144.5743573048026,-479.0,0
00:00,361201224.0,4534.603384832091,-665.0,0
00:00,162370388.0,-2494.8503999999984,-1286.0,0
00:00,957821152.0,-1331.6504535715496,-951.0,0
00:00,121858569.0,2045.4311500000024,-776.0,0
00:00,117273481.0,11242.8710387029,-897.0,0
00:00,992204045.0,9656.168108346255,-508.0,0
00:00,648644594.0,1187.677099999999,-452.0,0
00:00,250895529.0,2475.012832469288,-525.0,0
00:00,521611005.0,46.28671414895348,-1194.0,0
00:00,925037906.0,2378.0328000000013,-587.0,0
00:00,284905540.0,10349.287533307071,-446.0,0
00:00,933491926.0,4567.625897981177,-585.0,0
00:00,466649401.0,1202.0007807973743,-704.0,0
00:00,955035930.0,2689.638479171478,-1347.0,0
00:00,198051483.0,-703.6419104088573,-624.0,0
00:00,950234174.0,1660.3078192371595,-596.0,0
00:00,822135975.0,13516.516047161334,-596.0,0
00:00,675806859.0,9047.573105282614,-648.0,0
00:00,734161378.0,-2858.792669434212,-1043.0,0
00:00,383833857.0,29639.4699014012,-670.0,0
00:00,352899149.0,799.8227411773412,-470.0,0
00:00,256002321.0,7877.749792557941,-928.0,0
00:00,497809732.0,2573.987869552596,-1327.0,0
00:00,449871732.0,8475.679130852795,-705.0,0
00:00,559995067.0,3874.3359316088663,-1266.0,0
00:00,370757362.0,1913.4260236036175,-644.0,0
23:59,652048867.0,870.5618499999989,-7.99,7
23:59,652048867.0,770.5618499999989,-100.0,6
23:59,652048867.0,751.5718499999989,-18.99,6
23:59,838415080.0,-3474.1664999999985,-18.99,6
23:59,838415080.0,-3574.1664999999985,-100.0,6
23:59,169006407.0,13394.99578493364,-15.99,1
23:59,169006407.0,13376.00578493364,-18.99,6
23:59,624500124.0,3875.342796117888,-7.99,7
23:59,624500124.0,3860.352796117888,-14.99,1
23:59,624500124.0,3845.362796117888,-14.99,1
23:59,624500124.0,3830.372796117888,-14.99,1
23:59,624500124.0,3811.3827961178886,-18.99,6
23:59,738958551.0,10599.018830490371,-7.99,7
23:59,738958551.0,10593.028830490372,-5.99,1
23:59,738958551.0,10580.038830490374,-12.99,1
23:59,738958551.0,10573.038830490374,-7.0,1
23:59,738958551.0,10567.048830490374,-5.99,1
23:59,738958551.0,10548.058830490374,-18.99,6
23:59,738958551.0,10448.058830490374,-100.0,6
23:59,134461671.0,6562.575897688848,-7.99,7
23:59,134461671.0,6543.5858976888485,-18.99,6
23:59,134461671.0,6537.595897688849,-5.99,1
23:59,134461671.0,6522.605897688849,-14.99,1
23:59,134461671.0,6422.605897688849,-100.0,6
23:59,228136274.0,1571.7168299999996,-7.99,7
23:59,228136274.0,1563.7268299999996,-7.99,1
23:59,228136274.0,1463.7268299999996,-100.0,6
23:59,478651121.0,-371.9198204015304,-15.99,1
23:59,478651121.0,-379.9098204015304,-7.99,7
23:59,478651121.0,-398.8998204015304,-18.99,6
23:59,344843570.0,-314.72181750933385,-15.99,1
23:59,833899961.0,972.0521957180096,-5.99,1
23:59,833899961.0,965.0521957180096,-7.0,1
23:59,975200042.0,-3248.6751999999965,-7.99,7
23:59,975200042.0,-3267.6651999999963,-18.99,6
23:59,344522228.0,-3035.6944882083926,-15.99,1
23:59,344522228.0,-3041.6844882083924,-5.99,1
23:59,344522228.0,-3056.674488208392,-14.99,1
23:59,938992364.0,853.9151237313995,-18.99,6
23:59,938992364.0,753.9151237313995,-100.0,6
23:59,938992364.0,745.9251237313995,-7.99,1
23:59,938992364.0,730.9351237313995,-14.99,1
23:59,938992364.0,717.9451237313995,-12.99,1
23:59,938992364.0,704.9551237313995,-12.99,1
23:59,938992364.0,697.9551237313995,-7.0,1
23:59,412823730.0,809.1103158504898,-15.99,1
23:59,412823730.0,801.1203158504898,-7.99,1
23:59,412823730.0,701.1203158504898,-100.0,6
23:59,551196328.0,5419.015465435383,-18.99,6
23:59,551196328.0,5411.025465435383,-7.99,7
23:59,551196328.0,5395.035465435383,-15.99,1
23:59,551196328.0,5380.045465435383,-14.99,1
23:59,229502829.0,-4028.0454241862462,-15.99,1
23:59,229502829.0,-4036.0354241862465,-7.99,1
23:59,229502829.0,-4055.0254241862463,-18.99,6
23:59,229502829.0,-4068.015424186246,-12.99,1
23:59,299871610.0,898.3206530587668,-18.99,6
23:59,299871610.0,882.3306530587668,-15.99,1
23:59,299871610.0,869.3406530587667,-12.99,1
23:59,299871610.0,854.3506530587667,-14.99,1
23:59,492215823.0,5056.802223815444,-15.99,1
23:59,492215823.0,5037.812223815445,-18.99,6
23:59,492215823.0,5022.822223815445,-14.99,1
23:59,492215823.0,5016.832223815445,-5.99,1
23:59,492215823.0,5001.842223815445,-14.99,1
23:59,919185264.0,5502.855859740335,-18.99,6
23:59,919185264.0,5496.8658597403355,-5.99,1
23:59,919185264.0,5483.875859740336,-12.99,1
23:59,919185264.0,5470.885859740336,-12.99,1
23:59,919185264.0,5454.895859740336,-15.99,1
23:59,919185264.0,5446.905859740336,-7.99,7
23:59,248658670.0,-83.21584999999997,-15.99,1
23:59,248658670.0,-91.20584999999996,-7.99,7
23:59,248658670.0,-110.19584999999996,-18.99,6
23:59,690958123.0,24001.54405592685,-15.99,1
23:59,690958123.0,23993.55405592685,-7.99,1
23:59,690958123.0,23978.564055926847,-14.99,1
23:59,690958123.0,23963.574055926845,-14.99,1
23:59,690958123.0,23950.584055926844,-12.99,1
23:59,690958123.0,23935.59405592684,-14.99,1
23:59,690958123.0,23916.60405592684,-18.99,6
23:59,822250278.0,7852.38605467593,-15.99,1
23:59,822250278.0,7844.39605467593,-7.99,1
23:59,287230540.0,1714.090997763875,-7.99,1
23:59,287230540.0,1698.100997763875,-15.99,1
23:59,287230540.0,1679.110997763875,-18.99,6
23:59,287230540.0,1672.110997763875,-7.0,1
23:59,287230540.0,1657.120997763875,-14.99,1
23:59,987163717.0,4881.806078176684,-100.0,6
23:59,987163717.0,4865.816078176685,-15.99,1
23:59,287480331.0,9349.58593216534,-15.99,1
23:59,287480331.0,9330.59593216534,-18.99,6
23:59,871866387.0,1020.304699999999,-12.99,1
23:59,871866387.0,1005.314699999999,-14.99,1
23:59,871866387.0,989.324699999999,-15.99,1
23:59,871866387.0,981.334699999999,-7.99,1
23:59,758160963.0,9087.033756711156,-5.99,1
23:59,758160963.0,9072.043756711157,-14.99,1
23:59,758160963.0,9053.053756711157,-18.99,6
23:59,758160963.0,9045.063756711155,-7.99,7
23:59,758160963.0,9029.073756711156,-15.99,1
23:59,758160963.0,8929.073756711156,-100.0,6
23:59,909676212.0,948.7345317876132,-7.99,7
23:59,909676212.0,929.7445317876133,-18.99,6
23:59,909676212.0,829.7445317876131,-100.0,6
23:59,909676212.0,823.7545317876131,-5.99,1
23:59,909676212.0,808.7645317876131,-14.99,1
23:59,909676212.0,802.7745317876131,-5.99,1
23:59,135937041.0,-505.920348268412,-15.99,1
23:59,135937041.0,-513.910348268412,-7.99,7
23:59,135937041.0,-520.910348268412,-7.0,1
23:59,834581602.0,694.5773999999992,-7.0,1
23:59,834581602.0,688.5873999999992,-5.99,1
23:59,834581602.0,669.5973999999992,-18.99,6
23:59,834581602.0,653.6073999999992,-15.99,1
23:59,834581602.0,645.6173999999992,-7.99,1
23:59,834581602.0,545.6173999999992,-100.0,6
23:59,425730826.0,2910.16190938872,-7.0,1
23:59,425730826.0,2904.17190938872,-5.99,1
23:59,425730826.0,2885.18190938872,-18.99,6
23:59,409370545.0,1000.9772755455208,-12.99,1
23:59,409370545.0,993.9772755455208,-7.0,1
23:59,487051121.0,1881.4206208703945,-15.99,1
23:59,487051121.0,1873.4306208703945,-7.99,7
23:59,497772347.0,1149.1017499999978,-15.99,1
23:59,497772347.0,1130.1117499999978,-18.99,6
23:59,497772347.0,1115.1217499999975,-14.99,1
23:59,497772347.0,1108.1217499999975,-7.0,1
23:59,497772347.0,1008.1217499999976,-100.0,6
23:59,743630833.0,-321.7786367152987,-15.99,1
23:59,743630833.0,-340.7686367152987,-18.99,6
23:59,743630833.0,-346.75863671529873,-5.99,1
23:59,743630833.0,-353.75863671529873,-7.0,1
23:59,108812033.0,983.0663499999982,-7.0,1
23:59,108812033.0,970.0763499999982,-12.99,1
23:59,108812033.0,955.0863499999982,-14.99,1
23:59,108812033.0,939.0963499999982,-15.99,1
23:59,108812033.0,920.1063499999982,-18.99,6
23:59,108812033.0,820.1063499999982,-100.0,6
23:59,600185455.0,47.38000224748148,-15.99,1
23:59,600185455.0,39.39000224748147,-7.99,7
23:59,625281433.0,-393.8600073707569,-15.99,1
23:59,625281433.0,-401.8500073707569,-7.99,1
23:59,625281433.0,-420.8400073707569,-18.99,6
23:59,625281433.0,-427.8400073707569,-7.0,1
23:59,625281433.0,-442.8300073707569,-14.99,1
23:59,625281433.0,-455.8200073707569,-12.99,1
23:59,625281433.0,-470.8100073707569,-14.99,1
23:59,625281433.0,-570.8100073707569,-100.0,6
23:59,471897866.0,8519.921134195605,-5.99,1
23:59,471897866.0,8512.921134195605,-7.0,1
23:59,471897866.0,8497.931134195605,-14.99,1
23:59,471897866.0,8490.931134195605,-7.0,1
23:59,471897866.0,8482.941134195606,-7.99,7
23:59,471897866.0,8466.951134195606,-15.99,1
23:59,471897866.0,8447.961134195606,-18.99,6
23:59,516051449.0,1913.6721813984504,-14.99,1
23:59,516051449.0,1900.6821813984504,-12.99,1
23:59,516051449.0,1893.6821813984504,-7.0,1
23:59,516051449.0,1887.6921813984504,-5.99,1
23:59,516051449.0,1868.7021813984504,-18.99,6
23:59,516051449.0,1860.7121813984504,-7.99,1
23:59,516051449.0,1844.7221813984504,-15.99,1
23:59,754141345.0,-3268.75283511576,-15.99,1
23:59,754141345.0,-3276.7428351157596,-7.99,7
23:59,754141345.0,-3291.7328351157594,-14.99,1
23:59,754141345.0,-3304.722835115759,-12.99,1
23:59,754141345.0,-3323.712835115759,-18.99,6
23:59,754141345.0,-3423.712835115759,-100.0,6
23:59,414805878.0,14876.443239226288,-15.99,1
23:59,414805878.0,14868.453239226288,-7.99,1
23:59,414805878.0,14849.463239226288,-18.99,6
23:59,703588001.0,510.2512999999997,-7.99,1
23:59,703588001.0,491.26129999999966,-18.99,6
23:59,618138606.0,2125.5233032642873,-15.99,1
23:59,618138606.0,2118.5233032642873,-7.0,1
23:59,618138606.0,2103.5333032642875,-14.99,1
23:59,618138606.0,2097.5433032642877,-5.99,1
23:59,618138606.0,2084.553303264288,-12.99,1
23:59,618138606.0,2065.563303264288,-18.99,6
23:59,618138606.0,1965.563303264288,-100.0,6
23:59,849096144.0,2629.179020751343,-7.99,1
23:59,849096144.0,2613.1890207513434,-15.99,1
23:59,849096144.0,2594.1990207513436,-18.99,6
23:59,849096144.0,2579.209020751344,-14.99,1
23:59,849096144.0,2573.219020751344,-5.99,1
23:59,849096144.0,2558.2290207513443,-14.99,1
23:59,849096144.0,2458.2290207513443,-100.0,6
23:59,688328251.0,-1049.676375354827,-18.99,6
23:59,688328251.0,-1057.666375354827,-7.99,1
23:59,688328251.0,-1157.666375354827,-100.0,6
23:59,688328251.0,-1164.666375354827,-7.0,1
23:59,688328251.0,-1170.656375354827,-5.99,1
23:59,688328251.0,-1177.656375354827,-7.0,1
23:59,385685918.0,-374.9500591584474,-15.99,1
23:59,385685918.0,-382.9400591584474,-7.99,7
23:59,385685918.0,-401.9300591584474,-18.99,6
23:59,385685918.0,-414.92005915844743,-12.99,1
23:59,385685918.0,-429.91005915844744,-14.99,1
23:59,385685918.0,-435.90005915844745,-5.99,1
23:59,385685918.0,-448.89005915844746,-12.99,1
23:59,941285623.0,1421.8893990667702,-14.99,1
23:59,941285623.0,1415.8993990667702,-5.99,1
23:59,941285623.0,1396.9093990667702,-18.99,6
23:59,941285623.0,1388.9193990667702,-7.99,1
23:59,941285623.0,1380.9293990667702,-7.99,7
23:59,741269136.0,2119.2059500000023,-15.99,1
23:59,741269136.0,2111.2159500000025,-7.99,7
23:59,741269136.0,2092.2259500000027,-18.99,6
23:59,741269136.0,2086.235950000003,-5.99,1
23:59,472213568.0,-309.8804942060535,-7.99,1
23:59,472213568.0,-325.87049420605354,-15.99,1
23:59,472213568.0,-332.87049420605354,-7.0,1
23:59,472213568.0,-339.87049420605354,-7.0,1
23:59,472213568.0,-439.87049420605354,-100.0,6
23:59,669503912.0,10.360550348817236,-14.99,1
23:59,669503912.0,4.370550348817236,-5.99,1
23:59,669503912.0,-3.619449651182764,-7.99,1
23:59,669503912.0,-11.609449651182764,-7.99,7
23:59,669503912.0,-30.599449651182763,-18.99,6
23:59,669503912.0,-130.59944965118277,-100.0,6
23:59,920031185.0,-212.17617051629225,-18.99,6
23:59,920031185.0,-228.16617051629223,-15.99,1
23:59,572136270.0,-268.35788841197655,-15.99,1
23:59,572136270.0,-283.34788841197656,-14.99,1
23:59,192202372.0,754.9157349805995,-5.99,1
23:59,192202372.0,747.9157349805995,-7.0,1
23:59,192202372.0,732.9257349805995,-14.99,1
23:59,192202372.0,717.9357349805995,-14.99,1
23:59,192202372.0,709.9457349805995,-7.99,7
23:59,192202372.0,690.9557349805995,-18.99,6
23:59,195895574.0,8073.252982446124,-15.99,1
23:59,195895574.0,8065.262982446125,-7.99,7
23:59,195895574.0,8058.262982446125,-7.0,1
23:59,195895574.0,8045.272982446125,-12.99,1
23:59,195895574.0,8030.282982446125,-14.99,1
23:59,195895574.0,8011.292982446125,-18.99,6
23:59,682194230.0,-2489.5008499999985,-18.99,6
23:59,682194230.0,-2497.4908499999983,-7.99,1
23:59,682194230.0,-2504.4908499999983,-7.0,1
23:59,682194230.0,-2517.480849999998,-12.99,1
23:59,656812046.0,2204.442753732519,-18.99,6
23:59,867987292.0,2883.580462068823,-18.99,6
23:59,867987292.0,2867.5904620688234,-15.99,1
23:59,874431242.0,11525.879047153272,-7.99,7
23:59,874431242.0,11510.889047153272,-14.99,1
23:59,874431242.0,11503.889047153272,-7.0,1
23:59,874431242.0,11484.899047153272,-18.99,6
23:59,654329190.0,-289.8152990514807,-15.99,1
23:59,973388795.0,943.1156761636216,-15.99,1
23:59,973388795.0,935.1256761636216,-7.99,1
23:59,973388795.0,916.1356761636216,-18.99,6
23:59,973388795.0,910.1456761636216,-5.99,1
23:59,448279144.0,1421.588899999999,-18.99,6
23:59,448279144.0,1405.598899999999,-15.99,1
23:59,448279144.0,1397.608899999999,-7.99,7
23:59,448279144.0,1384.618899999999,-12.99,1
23:59,448279144.0,1377.618899999999,-7.0,1
23:59,448279144.0,1364.628899999999,-12.99,1
23:59,494156462.0,-1439.1389364817603,-15.99,1
23:59,494156462.0,-1447.1289364817603,-7.99,7
23:59,494156462.0,-1466.1189364817603,-18.99,6
23:59,978410962.0,-2922.315839548972,-15.99,1
23:59,978410962.0,-2928.3058395489716,-5.99,1
23:59,978410962.0,-2934.2958395489713,-5.99,1
23:59,978410962.0,-2940.285839548971,-5.99,1
23:59,978410962.0,-2955.275839548971,-14.99,1
23:59,978410962.0,-2974.2658395489707,-18.99,6
23:59,214765415.0,-557.5706488501354,-7.99,1
23:59,214765415.0,-573.5606488501354,-15.99,1
23:59,572384506.0,9519.895320873538,-15.99,1
23:59,572384506.0,9511.90532087354,-7.99,7
23:59,572384506.0,9492.91532087354,-18.99,6
23:59,572384506.0,9479.92532087354,-12.99,1
23:59,572384506.0,9464.93532087354,-14.99,1
23:59,572384506.0,9458.94532087354,-5.99,1
23:59,572384506.0,9443.95532087354,-14.99,1
23:59,460463595.0,171.1620545814211,-7.0,1
23:59,460463595.0,158.1720545814211,-12.99,1
23:59,460463595.0,145.18205458142108,-12.99,1
23:59,460463595.0,132.19205458142108,-12.99,1
23:59,270374623.0,11787.199407686545,-7.99,1
23:59,270374623.0,11781.209407686543,-5.99,1
23:59,270374623.0,11681.209407686543,-100.0,6
23:59,270374623.0,11662.219407686543,-18.99,6
23:59,500843551.0,1419.6522999999995,-100.0,6
23:59,500843551.0,1403.6622999999995,-15.99,1
23:59,500843551.0,1396.6622999999995,-7.0,1
23:59,500843551.0,1383.6722999999995,-12.99,1
23:59,500843551.0,1376.6722999999995,-7.0,1
23:59,500843551.0,1361.6822999999995,-14.99,1
23:59,500843551.0,1342.6922999999997,-18.99,6
23:59,684988568.0,-0.1924734272015396,-15.99,1
23:59,684988568.0,-8.18247342720154,-7.99,7
23:59,684988568.0,-21.17247342720154,-12.99,1
23:59,684988568.0,-27.16247342720154,-5.99,1
23:59,684988568.0,-42.15247342720154,-14.99,1
23:59,684988568.0,-49.15247342720154,-7.0,1
23:59,684988568.0,-68.14247342720154,-18.99,6
23:59,196289502.0,18719.591189086645,-15.99,1
23:59,196289502.0,18700.601189086643,-18.99,6
23:59,196289502.0,18693.601189086643,-7.0,1
23:59,196289502.0,18678.61118908664,-14.99,1
23:59,196289502.0,18671.61118908664,-7.0,1
23:59,196289502.0,18656.62118908664,-14.99,1
23:59,857997794.0,1483.9256651508863,-15.99,1
23:59,857997794.0,1475.9356651508865,-7.99,7
23:59,857997794.0,1456.9456651508865,-18.99,6
23:59,857997794.0,1441.9556651508865,-14.99,1
23:59,857997794.0,1434.9556651508865,-7.0,1
23:59,785749304.0,10152.545057902476,-7.99,1
23:59,785749304.0,10136.555057902477,-15.99,1
23:59,785749304.0,10130.565057902477,-5.99,1
23:59,785749304.0,10117.575057902475,-12.99,1
23:59,785749304.0,10102.585057902475,-14.99,1
23:59,890567652.0,516.9864996796006,-7.99,1
23:59,122884111.0,-1805.826083072969,-18.99,6
23:59,122884111.0,-1905.826083072969,-100.0,6
23:59,122884111.0,-1913.8160830729687,-7.99,1
23:59,122884111.0,-1929.8060830729687,-15.99,1
23:59,671824917.0,-1162.8832000000004,-100.0,6
23:59,671824917.0,-1168.8732000000005,-5.99,1
23:59,252419513.0,-2387.301185813415,-15.99,1
23:59,252419513.0,-2395.291185813415,-7.99,7
23:59,252419513.0,-2414.2811858134146,-18.99,6
23:59,482513594.0,7163.459054250669,-7.99,1
23:59,482513594.0,7144.46905425067,-18.99,6
23:59,233981231.0,3012.7407227241692,-18.99,6
23:59,233981231.0,2996.7507227241695,-15.99,1
23:59,691789577.0,-1111.4330500000003,-18.99,6
23:59,598793068.0,1045.286399999998,-7.99,7
23:59,598793068.0,1037.296399999998,-7.99,1
23:59,598793068.0,1018.306399999998,-18.99,6
23:59,750094757.0,-1434.4793000000006,-18.99,6
23:59,750094757.0,-1450.4693000000009,-15.99,1
23:59,750094757.0,-1550.4693000000009,-100.0,6
23:59,786879739.0,-2529.5407941205563,-15.99,1
23:59,786879739.0,-2537.530794120556,-7.99,1
23:59,786879739.0,-2556.520794120556,-18.99,6
23:59,506618547.0,18238.9716489172,-7.99,1
23:59,506618547.0,18230.9816489172,-7.99,7
23:59,506618547.0,18211.9916489172,-18.99,6
23:59,506618547.0,18111.9916489172,-100.0,6
23:59,858560423.0,14297.817253018788,-7.0,1
23:59,858560423.0,14282.827253018788,-14.99,1
23:59,858560423.0,14263.837253018788,-18.99,6
23:59,858560423.0,14247.847253018788,-15.99,1
23:59,858560423.0,14147.847253018788,-100.0,6
23:59,943829984.0,516.4058091134568,-18.99,6
23:59,943829984.0,416.4058091134568,-100.0,6
23:59,943829984.0,400.4158091134568,-15.99,1
23:59,885259672.0,3734.3001140996967,-7.99,7
23:59,885259672.0,3715.310114099697,-18.99,6
23:59,701070224.0,-1408.1815,-5.99,1
23:59,701070224.0,-1414.1715,-5.99,1
23:59,701070224.0,-1433.1615,-18.99,6
23:59,424397946.0,838.0797836054003,-18.99,6
23:59,424397946.0,825.0897836054003,-12.99,1
23:59,424397946.0,810.0997836054003,-14.99,1
23:59,424397946.0,795.1097836054003,-14.99,1
23:59,424397946.0,780.1197836054002,-14.99,1
23:59,656781737.0,-5614.899999999994,-18.99,6
23:59,656781737.0,-5630.889999999994,-15.99,1
23:59,656781737.0,-5638.879999999994,-7.99,7
23:59,570323670.0,4315.436779020461,-15.99,1
23:59,570323670.0,4307.446779020461,-7.99,1
23:59,570323670.0,4292.456779020461,-14.99,1
23:59,570323670.0,4273.476779020461,-12.99,1
23:59,570323670.0,4254.486779020462,-18.99,6
23:59,216286013.0,186.16497654513344,-12.99,1
23:59,216286013.0,173.17497654513343,-12.99,1
23:59,216286013.0,158.18497654513342,-14.99,1
23:59,216286013.0,58.18497654513342,-100.0,6
23:59,216286013.0,42.19497654513342,-15.99,1
23:59,216286013.0,34.20497654513342,-7.99,7
23:59,500043411.0,15677.16328013106,-7.99,7
23:59,500043411.0,15661.17328013106,-15.99,1
23:59,500043411.0,15642.18328013106,-18.99,6
23:59,500043411.0,15542.18328013106,-100.0,6
23:59,541639148.0,5215.06151191149,-18.99,6
23:59,541639148.0,5208.06151191149,-7.0,1
23:59,541639148.0,5193.07151191149,-14.99,1
23:59,541639148.0,5186.07151191149,-7.0,1
23:59,541639148.0,5170.08151191149,-15.99,1
23:59,119943495.0,-1280.0125621128582,-5.99,1
23:59,119943495.0,-1286.0025621128582,-5.99,1
23:59,119943495.0,-1293.9925621128582,-7.99,1
23:59,119943495.0,-1301.9825621128582,-7.99,7
23:59,996042490.0,7434.145781867768,-15.99,1
23:59,996042490.0,7415.155781867768,-18.99,6
23:59,221356538.0,1123.5913999999996,-15.99,1
23:59,221356538.0,1115.6013999999996,-7.99,7
23:59,221356538.0,1015.6013999999996,-100.0,6
23:59,419084831.0,-257.84022552610327,-7.0,1
23:59,419084831.0,-270.8302255261033,-12.99,1
23:59,419084831.0,-278.8202255261033,-7.99,1
23:59,419084831.0,-297.8102255261033,-18.99,6
23:59,188263947.0,892.3327500000007,-18.99,6
23:59,163470640.0,1160.5135999999995,-15.99,1
23:59,163470640.0,1152.5235999999995,-7.99,7
23:59,163470640.0,1133.5335999999995,-18.99,6
23:59,163470640.0,1126.5335999999995,-7.0,1
23:59,163470640.0,1119.5335999999995,-7.0,1
23:59,163470640.0,1106.5435999999995,-12.99,1
23:59,163470640.0,1091.5535999999995,-14.99,1
23:59,163470640.0,991.5535999999996,-100.0,6
23:59,903663593.0,792.079380043554,-14.99,1
23:59,903663593.0,786.089380043554,-5.99,1
23:59,903663593.0,771.099380043554,-14.99,1
23:59,903663593.0,756.109380043554,-14.99,1
23:59,903663593.0,737.119380043554,-18.99,6
23:59,324046160.0,-576.5548832130712,-15.99,1
23:59,324046160.0,-595.5448832130712,-18.99,6
23:59,493640090.0,-2826.4984499999982,-15.99,1
23:59,493640090.0,-2834.488449999998,-7.99,7
23:59,493640090.0,-2840.478449999998,-5.99,1
23:59,493640090.0,-2940.478449999998,-100.0,6
23:59,315546581.0,33100.3075164166,-15.99,1
23:59,315546581.0,33092.3175164166,-7.99,1
23:59,315546581.0,33073.327516416604,-18.99,6
23:59,315546581.0,33060.33751641661,-12.99,1
23:59,315546581.0,33054.34751641661,-5.99,1
23:59,949032480.0,4525.825690020491,-14.99,1
23:59,949032480.0,4519.835690020491,-5.99,1
23:59,949032480.0,4513.845690020491,-5.99,1
23:59,949032480.0,4494.855690020491,-18.99,6
23:59,949032480.0,4478.8656900204915,-15.99,1
23:59,844206657.0,1307.8810051465696,-18.99,6
23:59,844206657.0,1207.8810051465696,-100.0,6
23:59,844206657.0,1199.8910051465696,-7.99,7
23:59,844206657.0,1183.9010051465696,-15.99,1
23:59,213930646.0,-1931.574563472563,-12.99,1
23:59,213930646.0,-1944.5645634725631,-12.99,1
23:59,213930646.0,-1957.5545634725631,-12.99,1
23:59,213930646.0,-1973.5445634725631,-15.99,1
23:59,213930646.0,-1992.5345634725631,-18.99,6
23:59,929044080.0,826.9738915056282,-7.99,1
23:59,929044080.0,807.9838915056282,-18.99,6
23:59,108563213.0,26658.44640477053,-7.0,1
23:59,108563213.0,26645.456404770528,-12.99,1
23:59,108563213.0,26637.466404770526,-7.99,7
23:59,108563213.0,26621.476404770525,-15.99,1
23:59,108563213.0,26602.486404770523,-18.99,6
23:59,170637730.0,1960.2942733370664,-15.99,1
23:59,170637730.0,1952.3042733370664,-7.99,1
23:59,978951113.0,-316.54314259041917,-7.99,1
23:59,978951113.0,-324.5331425904192,-7.99,7
23:59,978951113.0,-343.5231425904192,-18.99,6
23:59,124377686.0,-2950.807399999997,-18.99,6
23:59,124377686.0,-2958.7973999999967,-7.99,1
23:59,124377686.0,-2974.7873999999965,-15.99,1
23:59,124377686.0,-3074.7873999999965,-100.0,6
23:59,242218612.0,-286.34119999999945,-18.99,6
23:59,242218612.0,-294.33119999999946,-7.99,1
23:59,242218612.0,-302.32119999999946,-7.99,7
23:59,187541224.0,3184.778887374236,-14.99,1
23:59,187541224.0,3177.778887374236,-7.0,1
23:59,187541224.0,3162.7888873742363,-14.99,1
23:59,187541224.0,3147.7988873742365,-14.99,1
23:59,187541224.0,3139.8088873742367,-7.99,1
23:59,128030172.0,-487.31297744985,-7.99,7
23:59,128030172.0,-503.30297744985,-15.99,1
23:59,235310449.0,1589.31118483031,-15.99,1
23:59,635679314.0,-3158.1033291195176,-7.99,7
23:59,635679314.0,-3166.0933291195174,-7.99,1
23:59,635679314.0,-3266.0933291195174,-100.0,6
23:59,872874909.0,-2139.741897899587,-7.99,1
23:59,211493028.0,1602.721449999999,-15.99,1
23:59,211493028.0,1502.721449999999,-100.0,6
23:59,211493028.0,1489.731449999999,-12.99,1
23:59,211493028.0,1482.731449999999,-7.0,1
23:59,237493332.0,17401.803818153538,-7.99,1
23:59,237493332.0,17382.813818153536,-18.99,6
23:59,237493332.0,17376.823818153534,-5.99,1
23:59,237493332.0,17363.833818153533,-12.99,1
23:59,237493332.0,17357.84381815353,-5.99,1
23:59,237493332.0,17257.84381815353,-100.0,6
23:59,452974357.0,-3476.563949999994,-15.99,1
23:59,452974357.0,-3495.5539499999936,-18.99,6
23:59,452974357.0,-3595.5539499999936,-100.0,6
23:59,857754342.0,1173.01503802272,-18.99,6
23:59,857754342.0,1166.01503802272,-7.0,1
23:59,857754342.0,1153.02503802272,-12.99,1
23:59,857754342.0,1147.0350380227198,-5.99,1
23:59,373163757.0,12238.137782079331,-15.99,1
23:59,373163757.0,12230.147782079332,-7.99,1
23:59,285873880.0,13401.437877134806,-7.99,1
23:59,285873880.0,13395.447877134806,-5.99,1
23:59,285873880.0,13389.457877134806,-5.99,1
23:59,285873880.0,13374.467877134806,-14.99,1
23:59,872286364.0,-224.16189581309985,-15.99,1
23:59,872286364.0,-239.15189581309983,-14.99,1
23:59,872286364.0,-245.14189581309984,-5.99,1
23:59,872286364.0,-251.13189581309985,-5.99,1
23:59,872286364.0,-266.12189581309985,-14.99,1
23:59,913127700.0,2836.7471380111165,-18.99,6
23:59,913127700.0,2820.7571380111167,-15.99,1
23:59,913127700.0,2812.767138011117,-7.99,7
23:59,294474095.0,-2628.768786499238,-7.0,1
23:59,294474095.0,-2643.758786499238,-14.99,1
23:59,294474095.0,-2649.7487864992377,-5.99,1
23:59,294474095.0,-2665.7387864992374,-15.99,1
23:59,294474095.0,-2684.7287864992372,-18.99,6
23:59,456246119.0,23854.25539884565,-18.99,6
23:59,456246119.0,23841.265398845648,-12.99,1
23:59,456246119.0,23826.27539884565,-14.99,1
23:59,456246119.0,23820.285398845645,-5.99,1
23:59,456246119.0,23812.295398845643,-7.99,7
23:59,456246119.0,23712.295398845643,-100.0,6
23:59,993039226.0,-4570.369499999994,-15.99,1
23:59,993039226.0,-4578.359499999994,-7.99,1
23:59,993039226.0,-4597.349499999994,-18.99,6
23:59,386277162.0,884.8899999999994,-15.99,1
23:59,386277162.0,871.8999999999994,-12.99,1
23:59,386277162.0,865.9099999999994,-5.99,1
23:59,386277162.0,850.9199999999994,-14.99,1
23:59,386277162.0,831.9299999999994,-18.99,6
23:59,610645022.0,-102.8344626449184,-15.99,1
23:59,610645022.0,-108.82446264491838,-5.99,1
23:59,610645022.0,-114.81446264491838,-5.99,1
23:59,610645022.0,-120.80446264491836,-5.99,1
23:59,610645022.0,-126.79446264491835,-5.99,1
23:59,610645022.0,-145.78446264491836,-18.99,6
23:59,130522384.0,-203.13381562086033,-18.99,6
23:59,130522384.0,-210.13381562086033,-7.0,1
23:59,130522384.0,-217.13381562086033,-7.0,1
23:59,130522384.0,-230.1238156208603,-12.99,1
23:59,130522384.0,-236.11381562086035,-5.99,1
23:59,130522384.0,-252.10381562086036,-15.99,1
23:59,429556122.0,5782.987472972949,-15.99,1
23:59,429556122.0,5682.987472972949,-100.0,6
23:59,429556122.0,5663.997472972949,-18.99,6
23:59,609939116.0,9406.318109076565,-5.99,1
23:59,609939116.0,9398.328109076563,-7.99,1
23:59,609939116.0,9379.338109076563,-18.99,6
23:59,916225911.0,-2495.09925,-5.99,1
23:59,916225911.0,-2501.0892499999995,-5.99,1
23:59,916225911.0,-2508.0892499999995,-7.0,1
23:59,916225911.0,-2524.0792499999993,-15.99,1
23:59,916225911.0,-2543.069249999999,-18.99,6
23:59,793781222.0,2289.910878947406,-18.99,6
23:59,793781222.0,2281.9208789474064,-7.99,1
23:59,793781222.0,2273.9308789474067,-7.99,7
23:59,793781222.0,2173.9308789474067,-100.0,6
23:59,793781222.0,2166.9308789474067,-7.0,1
23:59,793781222.0,2151.940878947407,-14.99,1
23:59,138351025.0,-602.8663500000005,-14.99,1
23:59,138351025.0,-608.8563500000005,-5.99,1
23:59,138351025.0,-615.8563500000005,-7.0,1
23:59,138351025.0,-621.8463500000005,-5.99,1
23:59,138351025.0,-637.8363500000005,-15.99,1
23:59,138351025.0,-656.8263500000005,-18.99,6
23:59,706301742.0,-3233.630649999996,-14.99,1
23:59,706301742.0,-3246.6206499999957,-12.99,1
23:59,706301742.0,-3262.6106499999955,-15.99,1
23:59,706301742.0,-3270.6006499999953,-7.99,1
23:59,706301742.0,-3289.590649999995,-18.99,6
23:59,706301742.0,-3389.590649999995,-100.0,6
23:59,706361191.0,811.0120484940779,-15.99,1
23:59,706361191.0,804.0120484940779,-7.0,1
23:59,706361191.0,785.0220484940779,-18.99,6
23:59,744968736.0,-1469.591826569424,-100.0,6
23:59,744968736.0,-1485.581826569424,-15.99,1
23:59,392790315.0,-4796.521394372064,-18.99,6
23:59,392790315.0,-4804.5113943720635,-7.99,1
23:59,392790315.0,-4820.501394372063,-15.99,1
23:59,392790315.0,-4920.501394372063,-100.0,6
23:59,534908754.0,-1056.3472500000005,-18.99,6
23:59,534908754.0,-1072.3372500000005,-15.99,1
23:59,760704118.0,1724.0123127174895,-7.99,1
23:59,760704118.0,1716.0223127174895,-7.99,7
23:59,736310094.0,-618.9180240274259,-15.99,1
23:59,736310094.0,-631.9080240274259,-12.99,1
23:59,736310094.0,-646.8980240274259,-14.99,1
23:59,736310094.0,-659.8880240274259,-12.99,1
23:59,736310094.0,-672.8780240274259,-12.99,1
23:59,406772240.0,-1401.8122000000003,-18.99,6
23:59,406772240.0,-1409.8022000000003,-7.99,1
23:59,406772240.0,-1425.7922000000003,-15.99,1
23:59,406772240.0,-1438.7822000000006,-12.99,1
23:59,406772240.0,-1453.7722000000006,-14.99,1
23:59,780859359.0,-884.7400000000002,-18.99,6
23:59,780859359.0,-892.7300000000002,-7.99,7
23:59,780859359.0,-992.7300000000002,-100.0,6
23:59,234952520.0,339.59639999999877,-15.99,1
23:59,340321732.0,2798.9692500000037,-15.99,1
23:59,340321732.0,2790.979250000004,-7.99,7
23:59,340321732.0,2690.979250000004,-100.0,6
23:59,340321732.0,2683.979250000004,-7.0,1
23:59,340321732.0,2668.989250000004,-14.99,1
23:59,534097839.0,-5121.686049999997,-15.99,1
23:59,534097839.0,-5129.676049999996,-7.99,7
23:59,534097839.0,-5144.666049999996,-14.99,1
23:59,534097839.0,-5150.656049999996,-5.99,1
23:59,534097839.0,-5163.646049999996,-12.99,1
23:59,534097839.0,-5170.646049999996,-7.0,1
23:59,534097839.0,-5189.6360499999955,-18.99,6
23:59,441142605.0,2680.0903922757298,-7.99,1
23:59,441142605.0,2673.0903922757298,-7.0,1
23:59,441142605.0,2658.10039227573,-14.99,1
23:59,441142605.0,2645.11039227573,-12.99,1
23:59,441142605.0,2626.1203922757304,-18.99,6
23:59,224524792.0,-2374.025682430848,-18.99,6
23:59,224524792.0,-2390.015682430848,-15.99,1
23:59,867679563.0,252.3567537017159,-15.99,1
23:59,867679563.0,244.36675370171588,-7.99,1
23:59,867679563.0,225.37675370171587,-18.99,6
23:59,142791593.0,217.8545999999997,-18.99,6
23:59,142791593.0,201.86459999999963,-15.99,1
23:59,142791593.0,186.87459999999965,-14.99,1
23:59,142791593.0,86.87459999999965,-100.0,6
23:59,857455726.0,-76.53251412431582,-7.99,7
23:59,857455726.0,-84.52251412431582,-7.99,1
23:59,970298834.0,3024.496110827444,-15.99,1
23:59,970298834.0,3005.506110827444,-18.99,6
23:59,421881811.0,3801.820641466341,-15.99,1
23:59,421881811.0,3788.8306414663407,-12.99,1
23:59,421881811.0,3781.8306414663407,-7.0,1
23:59,421881811.0,3762.840641466341,-18.99,6
23:59,987656636.0,6357.24064530641,-15.99,1
23:59,987656636.0,6349.250645306411,-7.99,1
23:59,987656636.0,6330.260645306411,-18.99,6
23:59,987656636.0,6324.270645306411,-5.99,1
23:59,352291960.0,3635.098053303574,-7.99,1
23:59,850290152.0,-3114.415999999996,-18.99,6
23:59,850290152.0,-3130.405999999996,-15.99,1
23:59,850290152.0,-3138.3959999999956,-7.99,7
23:59,850290152.0,-3153.3859999999954,-14.99,1
23:59,850290152.0,-3168.375999999995,-14.99,1
23:59,850290152.0,-3268.375999999995,-100.0,6
23:59,699139822.0,745.004075776947,-15.99,1
23:59,699139822.0,726.014075776947,-18.99,6
23:59,519935524.0,1467.485329737519,-18.99,6
23:59,519935524.0,1461.495329737519,-5.99,1
23:59,601627384.0,4184.341483272718,-7.99,1
23:59,601627384.0,4169.351483272718,-14.99,1
23:59,492850697.0,685.6610866658636,-14.99,1
23:59,492850697.0,670.6710866658636,-14.99,1
23:59,492850697.0,657.6810866658636,-12.99,1
23:59,492850697.0,650.6810866658636,-7.0,1
23:59,492850697.0,642.6910866658636,-7.99,7
23:59,492850697.0,542.6910866658636,-100.0,6
23:59,994214354.0,11509.059528946484,-7.99,7
23:59,994214354.0,11503.069528946484,-5.99,1
23:59,913801979.0,492.0165299144938,-7.99,1
23:59,913801979.0,473.0265299144937,-18.99,6
23:59,913801979.0,460.0365299144937,-12.99,1
23:59,913801979.0,453.0365299144937,-7.0,1
23:59,913801979.0,440.0465299144937,-12.99,1
23:59,913801979.0,425.0565299144937,-14.99,1
23:59,913801979.0,325.0565299144937,-100.0,6
23:59,762700245.0,1691.2217000000026,-15.99,1
23:59,762700245.0,1684.2217000000026,-7.0,1
23:59,762700245.0,1671.2317000000023,-12.99,1
23:59,762700245.0,1658.2417000000023,-12.99,1
23:59,762700245.0,1643.2517000000023,-14.99,1
23:59,762700245.0,1624.2617000000023,-18.99,6
23:59,776108637.0,1563.5402536574954,-18.99,6
23:59,776108637.0,1555.5502536574954,-7.99,1
23:59,776108637.0,1539.5602536574954,-15.99,1
23:59,776108637.0,1532.5602536574954,-7.0,1
23:59,776108637.0,1525.5602536574954,-7.0,1
23:59,776108637.0,1425.5602536574954,-100.0,6
23:59,335698481.0,-2530.700496694939,-15.99,1
23:59,335698481.0,-2549.6904966949387,-18.99,6
23:59,335698481.0,-2649.6904966949387,-100.0,6
23:59,695607232.0,107.19649461055998,-15.99,1
23:59,695607232.0,99.20649461056,-7.99,7
23:59,695607232.0,93.21649461056,-5.99,1
23:59,137913631.0,1797.41645,-15.99,1
23:59,137913631.0,1778.42645,-18.99,6
23:59,469330905.0,1151.8864286233556,-5.99,1
23:59,469330905.0,1136.8964286233556,-14.99,1
23:59,469330905.0,1123.9064286233556,-12.99,1
23:59,469330905.0,1104.9164286233556,-18.99,6
23:59,469330905.0,1096.9264286233556,-7.99,7
23:59,204855464.0,-554.7982386396163,-14.99,1
23:59,204855464.0,-569.7882386396163,-14.99,1
23:59,204855464.0,-576.7882386396163,-7.0,1
23:59,204855464.0,-591.7782386396163,-14.99,1
23:59,204855464.0,-607.7682386396164,-15.99,1
23:59,204855464.0,-626.7582386396164,-18.99,6
23:59,204855464.0,-726.7582386396164,-100.0,6
23:59,409971170.0,3882.672530275451,-18.99,6
23:59,409971170.0,3876.682530275451,-5.99,1
23:59,409971170.0,3861.692530275451,-14.99,1
23:59,409971170.0,3854.692530275451,-7.0,1
23:59,409971170.0,3838.7025302754514,-15.99,1
23:59,409971170.0,3830.712530275451,-7.99,7
23:59,639409800.0,40856.29340954331,-7.99,1
23:59,639409800.0,40840.30340954331,-15.99,1
23:59,639409800.0,40825.31340954331,-14.99,1
23:59,639409800.0,40806.323409543314,-18.99,6
23:59,364357875.0,10001.288485331395,-15.99,1
23:59,364357875.0,9993.298485331396,-7.99,7
23:59,364357875.0,9974.308485331398,-18.99,6
23:59,631111289.0,123.58349999999906,-7.99,1
23:59,631111289.0,104.59349999999908,-18.99,6
23:59,631111289.0,4.593499999999068,-100.0,6
23:59,124102251.0,2619.6972895961853,-15.99,1
23:59,124102251.0,2600.7072895961855,-18.99,6
23:59,124102251.0,2587.7172895961858,-12.99,1
23:59,124102251.0,2580.7172895961858,-7.0,1
23:59,124102251.0,2567.727289596186,-12.99,1
23:59,124102251.0,2560.727289596186,-7.0,1
23:59,361955473.0,688.4037452440841,-18.99,6
23:59,982949451.0,-4141.259167052507,-15.99,1
23:59,982949451.0,-4149.249167052507,-7.99,1
23:59,982949451.0,-4168.239167052507,-18.99,6
23:59,801500539.0,-3654.5086999999985,-5.99,1
23:59,801500539.0,-3667.4986999999983,-12.99,1
23:59,801500539.0,-3674.4986999999983,-7.0,1
23:59,801500539.0,-3687.488699999998,-12.99,1
23:59,801500539.0,-3703.478699999998,-15.99,1
23:59,801500539.0,-3722.4686999999976,-18.99,6
23:59,948069469.0,-560.7863000000011,-5.99,1
23:59,948069469.0,-575.7763000000011,-14.99,1
23:59,948069469.0,-581.7663000000011,-5.99,1
23:59,948069469.0,-596.7563000000011,-14.99,1
23:59,948069469.0,-612.7463000000012,-15.99,1
23:59,948069469.0,-620.7363000000012,-7.99,1
23:59,948069469.0,-639.7263000000012,-18.99,6
23:59,809499628.0,20445.795791588727,-18.99,6
23:59,809499628.0,20429.80579158873,-15.99,1
23:59,952921898.0,-405.8745777080187,-15.99,1
23:59,952921898.0,-411.8645777080188,-5.99,1
23:59,952921898.0,-417.8545777080188,-5.99,1
23:59,952921898.0,-424.8545777080188,-7.0,1
23:59,952921898.0,-439.8445777080188,-14.99,1
23:59,349614277.0,1868.2850999999991,-15.99,1
23:59,349614277.0,1855.2950999999991,-12.99,1
23:59,349614277.0,1849.3050999999991,-5.99,1
23:59,349614277.0,1834.3150999999991,-14.99,1
23:59,349614277.0,1815.325099999999,-18.99,6
23:59,119993184.0,-2196.2519029108616,-18.99,6
23:59,119993184.0,-2204.2419029108614,-7.99,1
23:59,119993184.0,-2219.231902910861,-14.99,1
23:59,555804115.0,-1185.6860475587034,-12.99,1
23:59,555804115.0,-1204.6760475587034,-18.99,6
23:59,311467864.0,-477.870500000001,-14.99,1
23:59,311467864.0,-493.860500000001,-15.99,1
23:59,519933553.0,620.3610041507284,-7.99,7
23:59,519933553.0,604.3710041507284,-15.99,1
23:59,519933553.0,585.3810041507284,-18.99,6
23:59,519933553.0,485.3810041507283,-100.0,6
23:59,519933553.0,479.3910041507283,-5.99,1
23:59,519933553.0,464.40100415072834,-14.99,1
23:59,519933553.0,458.41100415072833,-5.99,1
23:59,414454079.0,4729.758850000002,-18.99,6
23:59,414454079.0,4721.768850000002,-7.99,7
23:59,492058070.0,-1850.7540312595297,-18.99,6
23:59,492058070.0,-1866.7440312595295,-15.99,1
23:59,492058070.0,-1881.7340312595295,-14.99,1
23:59,492058070.0,-1888.7340312595295,-7.0,1
23:59,492058070.0,-1895.7340312595295,-7.0,1
23:59,623156843.0,6184.268454994649,-15.99,1
23:59,623156843.0,6164.278454994649,-7.0,1
23:59,623156843.0,6145.288454994649,-18.99,6
23:59,535273662.0,15.887399999999491,-18.99,6
23:59,535273662.0,-0.1026000000005087,-15.99,1
23:59,535273662.0,-8.092600000000509,-7.99,7
23:59,535273662.0,-14.08260000000051,-5.99,1
23:59,535273662.0,-20.07260000000051,-5.99,1
23:59,535273662.0,-33.06260000000051,-12.99,1
23:59,535273662.0,-39.05260000000051,-5.99,1
23:59,586041848.0,2893.6847,-14.99,1
23:59,586041848.0,2887.6947,-5.99,1
23:59,586041848.0,2880.6947,-7.0,1
23:59,586041848.0,2861.7047,-18.99,6
23:59,586041848.0,2853.7147000000004,-7.99,1
23:59,769311479.0,7822.201442950056,-15.99,1
23:59,769311479.0,7803.211442950056,-18.99,6
23:59,630691258.0,3.376544874841338,-15.99,1
23:59,630691258.0,-15.61345512515866,-18.99,6
23:59,630691258.0,-30.60345512515866,-14.99,1
23:59,630691258.0,-36.59345512515866,-5.99,1
23:59,656317661.0,-71.20465845859734,-15.99,1
23:59,126929801.0,2731.128819212563,-15.99,1
23:59,126929801.0,2723.1388192125632,-7.99,1
23:59,126929801.0,2710.1488192125635,-12.99,1
23:59,126929801.0,2610.1488192125635,-100.0,6
23:59,126929801.0,2591.1588192125637,-18.99,6
23:59,258201793.0,-272.6848000000002,-18.99,6
23:59,433837402.0,624.9741315358117,-15.99,1
23:59,433837402.0,616.9841315358117,-7.99,1
23:59,433837402.0,597.9941315358117,-18.99,6
23:59,578131296.0,1266.1384194440436,-12.99,1
23:59,578131296.0,1250.1484194440436,-15.99,1
23:59,578131296.0,1242.1584194440436,-7.99,1
23:59,578131296.0,1223.1684194440436,-18.99,6
23:59,998405607.0,-159.1814999999981,-15.99,1
23:59,998405607.0,-178.1714999999981,-18.99,6
23:59,998405607.0,-278.1714999999981,-100.0,6
23:59,395284483.0,2079.9603402113084,-12.99,1
23:59,395284483.0,2066.9703402113087,-12.99,1
23:59,395284483.0,2051.980340211309,-14.99,1
23:59,395284483.0,2043.9903402113089,-7.99,1
23:59,366477356.0,1000.9018,-15.99,1
23:59,366477356.0,992.9118,-7.99,1
23:59,366477356.0,973.9217999999998,-18.99,6
23:59,829914501.0,2366.002806570975,-15.99,1
23:59,522188082.0,8818.573772831141,-7.99,1
23:59,522188082.0,8802.583772831142,-15.99,1
23:59,522188082.0,8783.593772831142,-18.99,6
23:59,151916463.0,1223.157555599169,-18.99,6
23:59,151916463.0,1210.167555599169,-12.99,1
23:59,151916463.0,1195.177555599169,-14.99,1
23:59,151916463.0,1188.177555599169,-7.0,1
23:59,215404070.0,769.7875891798496,-18.99,6
23:59,215404070.0,753.7975891798496,-15.99,1
23:59,215404070.0,745.8075891798496,-7.99,7
23:59,215404070.0,739.8175891798496,-5.99,1
23:59,215404070.0,726.8275891798496,-12.99,1
23:59,918772878.0,-1618.4720172453203,-100.0,6
23:59,918772878.0,-1637.4620172453203,-18.99,6
23:59,833499132.0,1692.3619000000024,-15.99,1
23:59,833499132.0,1684.3719000000024,-7.99,7
23:59,833499132.0,1669.3819000000024,-14.99,1
23:59,833499132.0,1663.3919000000024,-5.99,1
23:59,298007503.0,3185.694103625634,-15.99,1
23:59,298007503.0,3166.704103625634,-18.99,6
23:59,208381936.0,-697.6655782217451,-14.99,1
23:59,208381936.0,-716.6555782217451,-18.99,6
23:59,208381936.0,-732.6455782217452,-15.99,1
23:59,208381936.0,-740.6355782217452,-7.99,7
23:59,936917570.0,-3003.692499999996,-12.99,1
23:59,936917570.0,-3018.682499999996,-14.99,1
23:59,936917570.0,-3024.6724999999956,-5.99,1
23:59,936917570.0,-3043.6624999999954,-18.99,6
23:59,936917570.0,-3143.6624999999954,-100.0,6
23:59,936917570.0,-3159.652499999995,-15.99,1
23:59,936917570.0,-3167.642499999995,-7.99,1
23:59,308897841.0,1736.797999999999,-15.99,1
23:59,308897841.0,1730.807999999999,-5.99,1
23:59,308897841.0,1723.807999999999,-7.0,1
23:59,838830098.0,1298.4276920877844,-15.99,1
23:59,838830098.0,1290.4376920877844,-7.99,1
23:59,838830098.0,1275.4476920877844,-14.99,1
23:59,838830098.0,1268.4476920877844,-7.0,1
23:59,838830098.0,1262.4576920877844,-5.99,1
23:59,838830098.0,1249.4676920877844,-12.99,1
23:59,838830098.0,1230.4776920877844,-18.99,6
23:59,838830098.0,1130.4776920877844,-100.0,6
23:59,461990622.0,9242.346995233833,-15.99,1
23:59,461990622.0,9234.356995233831,-7.99,7
23:59,461990622.0,9227.356995233831,-7.0,1
23:59,461990622.0,9214.366995233831,-12.99,1
23:59,461990622.0,9201.376995233832,-12.99,1
23:59,461990622.0,9195.386995233832,-5.99,1
23:59,461990622.0,9176.396995233832,-18.99,6
23:59,252760664.0,8043.943599683385,-15.99,1
23:59,252760664.0,8035.953599683386,-7.99,7
23:59,252760664.0,8016.963599683386,-18.99,6
23:59,252760664.0,8010.973599683386,-5.99,1
23:59,252760664.0,7910.973599683386,-100.0,6
23:59,581655972.0,46168.16883683589,-15.99,1
23:59,581655972.0,46149.17883683589,-18.99,6
23:59,402438092.0,900.3814999999988,-15.99,1
23:59,402438092.0,892.3914999999988,-7.99,1
23:59,402438092.0,873.4014999999988,-18.99,6
23:59,659008214.0,-3602.0376022904225,-15.99,1
23:59,659008214.0,-3610.0276022904222,-7.99,1
23:59,812839908.0,-1704.0948500000002,-12.99,1
23:59,812839908.0,-1720.0848500000002,-15.99,1
23:59,812839908.0,-1728.0748500000002,-7.99,7
23:59,812839908.0,-1747.0648500000002,-18.99,6
23:59,724537117.0,-1450.0442500000004,-15.99,1
23:59,724537117.0,-1469.0342500000004,-18.99,6
23:59,724537117.0,-1482.0242500000004,-12.99,1
23:59,549414742.0,8474.295327397484,-7.99,1
23:59,549414742.0,8458.305327397484,-15.99,1
23:59,549414742.0,8445.315327397484,-12.99,1
23:59,548638376.0,-387.9748132445335,-7.99,1
23:59,548638376.0,-406.9648132445335,-18.99,6
23:59,165098840.0,52.29437363762691,-5.99,1
23:59,165098840.0,37.30437363762691,-14.99,1
23:59,165098840.0,22.314373637626908,-14.99,1
23:59,165098840.0,6.324373637626907,-15.99,1
23:59,165098840.0,-12.665626362373091,-18.99,6
23:59,165098840.0,-112.66562636237308,-100.0,6
23:59,994947671.0,1666.7657000000006,-15.99,1
23:59,994947671.0,1651.7757000000006,-14.99,1
23:59,994947671.0,1638.7857000000006,-12.99,1
23:59,291580432.0,433.40195000000017,-5.99,1
23:59,291580432.0,427.41195000000016,-5.99,1
23:59,291580432.0,412.42195000000015,-14.99,1
23:59,291580432.0,397.43195000000014,-14.99,1
23:59,553734946.0,1017.1730999999982,-15.99,1
23:59,553734946.0,917.1730999999982,-100.0,6
23:59,553734946.0,902.183099999998,-14.99,1
23:59,553734946.0,895.1830999999981,-7.0,1
23:59,553734946.0,876.1930999999981,-18.99,6
23:59,264208990.0,1409.3031999999982,-12.99,1
23:59,264208990.0,1401.3131999999982,-7.99,1
23:59,264208990.0,1385.3231999999982,-15.99,1
23:59,202320275.0,-606.7066500000006,-15.99,1
23:59,202320275.0,-614.6966500000007,-7.99,7
23:59,202320275.0,-633.6866500000007,-18.99,6
23:59,285428103.0,12104.453808161066,-15.99,1
23:59,285428103.0,12096.463808161066,-7.99,1
23:59,285428103.0,11996.463808161066,-100.0,6
23:59,285428103.0,11981.473808161069,-14.99,1
23:59,285428103.0,11962.483808161069,-18.99,6
23:59,494977194.0,2162.804470597578,-7.99,1
23:59,494977194.0,2154.8144705975783,-7.99,7
23:59,494977194.0,2139.8244705975785,-14.99,1
23:59,494977194.0,2107.844470597579,-18.99,6
23:59,285115279.0,-3538.1885107892867,-15.99,1
23:59,285115279.0,-3546.1785107892865,-7.99,7
23:59,285115279.0,-3553.1785107892865,-7.0,1
23:59,285115279.0,-3559.1685107892863,-5.99,1
23:59,285115279.0,-3574.158510789286,-14.99,1
23:59,285115279.0,-3587.148510789286,-12.99,1
23:59,744398361.0,301.7129999999996,-15.99,1
23:59,744398361.0,293.7229999999996,-7.99,1
23:59,744398361.0,274.7329999999996,-18.99,6
23:59,819515373.0,3349.772436063794,-7.99,1
23:59,819515373.0,3343.782436063794,-5.99,1
23:59,819515373.0,3330.7924360637944,-12.99,1
23:59,819515373.0,3317.802436063794,-12.99,1
23:59,819515373.0,3298.812436063795,-18.99,6
23:59,600585971.0,402.8991499999995,-15.99,1
23:59,600585971.0,383.9091499999995,-18.99,6
23:59,600585971.0,376.9091499999995,-7.0,1
23:59,600585971.0,276.9091499999995,-100.0,6
23:59,737645298.0,-2932.2491999999975,-15.99,1
23:59,737645298.0,-2939.2491999999975,-7.0,1
23:59,737645298.0,-3039.2491999999975,-100.0,6
23:59,737645298.0,-3058.2391999999973,-18.99,6
23:59,892354433.0,-302.4499606343386,-15.99,1
23:59,892354433.0,-310.4399606343386,-7.99,7
23:59,892354433.0,-323.4299606343386,-12.99,1
23:59,892354433.0,-338.4199606343386,-14.99,1
23:59,627723633.0,-1610.1513280037618,-7.99,1
23:59,627723633.0,-1710.1513280037618,-100.0,6
23:59,627723633.0,-1723.1413280037618,-12.99,1
23:59,627723633.0,-1736.1313280037618,-12.99,1
23:59,627723633.0,-1751.1213280037618,-14.99,1
23:59,627723633.0,-1766.111328003762,-14.99,1
23:59,450896297.0,15440.68689821693,-15.99,1
23:59,450896297.0,15432.696898216933,-7.99,7
23:59,450896297.0,15419.706898216931,-12.99,1
23:59,450896297.0,15406.716898216931,-12.99,1
23:59,450896297.0,15393.726898216932,-12.99,1
23:59,596171893.0,261.40559482551066,-18.99,6
23:59,336171116.0,48.42839999999956,-14.99,1
23:59,525524239.0,-313.35764978880644,-15.99,1
23:59,525524239.0,-332.34764978880645,-18.99,6
23:59,254853117.0,4520.818552336119,-18.99,6
23:59,254853117.0,4512.828552336119,-7.99,1
23:59,999752672.0,2021.8510935333345,-15.99,1
23:59,679911053.0,3666.3179976196584,-18.99,6
23:59,679911053.0,3650.3279976196586,-15.99,1
23:59,679911053.0,3642.337997619659,-7.99,7
23:59,272538745.0,18980.489900000022,-15.99,1
23:59,272538745.0,18961.49990000002,-18.99,6
23:59,272538745.0,18946.50990000002,-14.99,1
23:59,272538745.0,18933.519900000018,-12.99,1
23:59,272538745.0,18926.519900000018,-7.0,1
23:59,272538745.0,18911.529900000016,-14.99,1
23:59,272538745.0,18811.529900000016,-100.0,6
23:59,753525749.0,-2506.320899999999,-14.99,1
23:59,753525749.0,-2513.320899999999,-7.0,1
23:59,668329719.0,10358.017109515207,-7.0,1
23:59,668329719.0,10352.02710951521,-5.99,1
23:59,668329719.0,10344.03710951521,-7.99,7
23:59,736340277.0,9357.074609588026,-15.99,1
23:59,736340277.0,9351.084609588026,-5.99,1
23:59,736340277.0,9345.094609588026,-5.99,1
23:59,298000165.0,29445.863833530133,-15.99,1
23:59,298000165.0,29437.87383353013,-7.99,7
23:59,298000165.0,29430.87383353013,-7.0,1
23:59,298000165.0,29424.88383353013,-5.99,1
23:59,298000165.0,29405.893833530128,-18.99,6
23:59,298000165.0,29305.893833530128,-100.0,6
23:59,956717493.0,2099.070750435984,-18.99,6
23:59,956717493.0,2086.080750435984,-12.99,1
23:59,956717493.0,2078.0907504359843,-7.99,1
23:59,956717493.0,2070.1007504359845,-7.99,7
23:59,956717493.0,1970.1007504359843,-100.0,6
23:59,486495235.0,2448.835610076206,-7.99,1
23:59,486495235.0,2432.845610076207,-15.99,1
23:59,486495235.0,2417.855610076207,-14.99,1
23:59,486495235.0,2404.8656100762073,-12.99,1
23:59,486495235.0,2389.8756100762075,-14.99,1
23:59,486495235.0,2383.8856100762077,-5.99,1
23:59,486495235.0,2364.895610076208,-18.99,6
23:59,903953091.0,4402.780790134575,-7.99,1
23:59,903953091.0,4386.790790134575,-15.99,1
23:59,903953091.0,4367.800790134575,-18.99,6
23:59,903953091.0,4360.800790134575,-7.0,1
23:59,903953091.0,4347.810790134576,-12.99,1
23:59,903953091.0,4332.820790134576,-14.99,1
23:59,903953091.0,4232.820790134576,-100.0,6
23:59,641764023.0,-904.2538037720044,-7.99,1
23:59,901037631.0,1271.4813230964064,-100.0,6
23:59,901037631.0,1263.4913230964064,-7.99,1
23:59,901037631.0,1247.5013230964064,-15.99,1
23:59,901037631.0,1228.5113230964064,-18.99,6
23:59,918160369.0,-998.2536500000004,-7.99,7
23:59,918160369.0,-1013.2436500000003,-14.99,1
23:59,918160369.0,-1026.2336500000004,-12.99,1
23:59,918160369.0,-1041.2236500000004,-14.99,1
23:59,918160369.0,-1048.2236500000004,-7.0,1
23:59,918160369.0,-1067.2136500000004,-18.99,6
23:59,670102069.0,2042.5976121150468,-7.99,7
23:59,769319491.0,-1140.3230000000008,-14.99,1
23:59,769319491.0,-1146.3130000000008,-5.99,1
23:59,769319491.0,-1165.3030000000008,-18.99,6
23:59,769319491.0,-1173.2930000000008,-7.99,1
23:59,769319491.0,-1181.2830000000008,-7.99,7
23:59,769319491.0,-1281.2830000000008,-100.0,6
23:59,585596026.0,3030.731118569256,-7.99,1
23:59,585596026.0,3014.7411185692563,-15.99,1
23:59,585596026.0,2995.7511185692565,-18.99,6
23:59,585596026.0,2980.7611185692567,-14.99,1
23:59,585596026.0,2965.771118569257,-14.99,1
23:59,585596026.0,2950.781118569257,-14.99,1
23:59,508518911.0,680.7047502790102,-12.99,1
23:59,508518911.0,674.7147502790102,-5.99,1
23:59,508518911.0,667.7147502790102,-7.0,1
23:59,508518911.0,651.7247502790102,-15.99,1
23:59,508518911.0,632.7347502790102,-18.99,6
23:59,508518911.0,532.7347502790102,-100.0,6
23:59,613427466.0,7964.137455264377,-7.99,1
23:59,613427466.0,7948.147455264378,-15.99,1
23:59,613427466.0,7929.157455264378,-18.99,6
23:59,613427466.0,7923.167455264378,-5.99,1
23:59,613427466.0,7908.177455264378,-14.99,1
23:59,613427466.0,7902.187455264379,-5.99,1
23:59,355602925.0,1964.3029924538068,-12.99,1
23:59,355602925.0,1949.3129924538068,-14.99,1
23:59,355602925.0,1933.3229924538068,-15.99,1
23:59,355602925.0,1925.3329924538068,-7.99,1
23:59,355602925.0,1906.3429924538068,-18.99,6
23:59,828532554.0,-148.1096904827103,-18.99,6
23:59,828532554.0,-164.09969048271034,-15.99,1
23:59,213112754.0,6783.434320994548,-7.99,1
23:59,213112754.0,6776.434320994548,-7.0,1
23:59,213112754.0,6769.434320994548,-7.0,1
23:59,213112754.0,6750.444320994548,-18.99,6
23:59,960208650.0,17195.481154964185,-14.99,1
23:59,960208650.0,17182.491154964184,-12.99,1
23:59,960208650.0,17169.501154964182,-12.99,1
23:59,960208650.0,17156.51115496418,-12.99,1
23:59,960208650.0,17140.52115496418,-15.99,1
23:59,960208650.0,17132.531154964177,-7.99,7
23:59,960208650.0,17113.541154964176,-18.99,6
23:59,641376155.0,567.8025121014512,-15.99,1
23:59,641376155.0,548.8125121014511,-18.99,6
23:59,641376155.0,448.81251210145115,-100.0,6
23:59,887156614.0,-285.47862104077376,-18.99,6
23:59,887156614.0,-293.46862104077377,-7.99,7
23:59,887156614.0,-309.4586210407738,-15.99,1
23:59,887156614.0,-322.4486210407738,-12.99,1
23:59,887156614.0,-341.4286210407738,-5.99,1
23:59,490790931.0,746.4889499999986,-15.99,1
23:59,490790931.0,738.4989499999986,-7.99,7
23:59,490790931.0,719.5089499999985,-18.99,6
23:59,490790931.0,619.5089499999985,-100.0,6
23:59,155317149.0,551.187249999999,-14.99,1
23:59,155317149.0,544.187249999999,-7.0,1
23:59,155317149.0,529.197249999999,-14.99,1
23:59,155317149.0,510.207249999999,-18.99,6
23:59,155317149.0,502.217249999999,-7.99,1
23:59,155317149.0,486.227249999999,-15.99,1
23:59,627936697.0,399.7158500000001,-18.99,6
23:59,627936697.0,383.72585,-15.99,1
23:59,737537711.0,103.32553360153568,-5.99,1
23:59,737537711.0,97.33553360153569,-5.99,1
23:59,737537711.0,84.34553360153568,-12.99,1
23:59,737537711.0,71.35553360153568,-12.99,1
23:59,873701090.0,897.1212567144723,-14.99,1
23:59,873701090.0,881.1312567144723,-15.99,1
23:59,873701090.0,873.1412567144723,-7.99,1
23:59,873701090.0,854.1512567144723,-18.99,6
23:59,964702094.0,1387.6717425992497,-15.99,1
23:59,964702094.0,1368.6817425992494,-18.99,6
23:59,280990953.0,1232.489699999998,-7.99,1
23:59,280990953.0,1219.499699999998,-12.99,1
23:59,280990953.0,1213.509699999998,-5.99,1
23:59,280990953.0,1200.519699999998,-12.99,1
23:59,280990953.0,1187.529699999998,-12.99,1
23:59,280990953.0,1168.539699999998,-18.99,6
23:59,554792076.0,32565.577406872155,-12.99,1
23:59,554792076.0,32550.587406872153,-14.99,1
23:59,554792076.0,32537.59740687215,-12.99,1
23:59,554792076.0,32521.60740687215,-15.99,1
23:59,912705941.0,21355.79465760014,-7.99,1
23:59,310375875.0,2929.6023376907665,-15.99,1
23:59,310375875.0,2916.6123376907667,-12.99,1
23:59,310375875.0,2897.622337690767,-18.99,6
23:59,807098817.0,574.7324499999991,-14.99,1
23:59,807098817.0,561.742449999999,-12.99,1
23:59,807098817.0,553.752449999999,-7.99,7
23:59,807098817.0,545.762449999999,-7.99,1
23:59,310740977.0,784.3704359296809,-7.0,1
23:59,310740977.0,777.3704359296809,-7.0,1
23:59,310740977.0,761.3804359296809,-15.99,1
23:59,310740977.0,753.3904359296808,-7.99,7
23:59,310740977.0,653.3904359296808,-100.0,6
23:59,564214408.0,6.362684725726023,-18.99,6
23:59,564214408.0,-1.6273152742739772,-7.99,7
23:59,564214408.0,-7.617315274273977,-5.99,1
23:59,564214408.0,-20.60731527427398,-12.99,1
23:59,291128777.0,-2852.2614405263685,-5.99,1
23:59,291128777.0,-2865.251440526368,-12.99,1
23:59,291128777.0,-2880.241440526368,-14.99,1
23:59,291128777.0,-2899.231440526368,-18.99,6
23:59,709142813.0,1240.4497999999992,-15.99,1
23:59,709142813.0,1232.4597999999992,-7.99,7
23:59,709142813.0,1226.4697999999992,-5.99,1
23:59,546296727.0,376.4577273026184,-7.99,7
23:59,546296727.0,368.4677273026184,-7.99,1
23:59,546296727.0,349.4777273026184,-18.99,6
23:59,546296727.0,336.4877273026184,-12.99,1
23:59,546296727.0,323.4977273026184,-12.99,1
23:59,546296727.0,316.4977273026184,-7.0,1
23:59,546296727.0,303.5077273026184,-12.99,1
23:59,546296727.0,203.5077273026184,-100.0,6
23:59,151968462.0,9132.300237886337,-18.99,6
23:59,151968462.0,9126.310237886337,-5.99,1
23:59,151968462.0,9113.320237886335,-12.99,1
23:59,151968462.0,9107.330237886335,-5.99,1
23:59,151968462.0,9100.330237886335,-7.0,1
23:59,678726554.0,173.87875234838975,-15.99,1
23:59,678726554.0,165.88875234838974,-7.99,1
23:59,678726554.0,146.8987523483897,-18.99,6
23:59,678726554.0,140.90875234838973,-5.99,1
23:59,678726554.0,134.91875234838972,-5.99,1
23:59,678726554.0,127.91875234838972,-7.0,1
23:59,383625050.0,4145.968501081161,-15.99,1
23:59,383625050.0,4137.978501081161,-7.99,1
23:59,383625050.0,4118.988501081161,-18.99,6
23:59,907987693.0,-2724.7069999999976,-18.99,6
23:59,907987693.0,-2740.6969999999974,-15.99,1
23:59,907987693.0,-2748.686999999997,-7.99,7
23:59,854513972.0,2800.9277,-15.99,1
23:59,854513972.0,2781.9377000000004,-18.99,6
23:59,435313070.0,3427.0733330332205,-100.0,6
23:59,435313070.0,3411.0833330332207,-15.99,1
23:59,424927189.0,247.6818827441052,-15.99,1
23:59,424927189.0,239.6918827441052,-7.99,7
23:59,930271460.0,546.2785475357762,-18.99,6
23:59,930271460.0,540.2885475357762,-5.99,1
23:59,930271460.0,533.2885475357762,-7.0,1
23:59,930271460.0,527.2985475357762,-5.99,1
23:59,930271460.0,520.2985475357762,-7.0,1
23:59,656389634.0,-421.4218404219855,-5.99,1
23:59,656389634.0,-428.4218404219855,-7.0,1
23:59,656389634.0,-434.4118404219855,-5.99,1
23:59,656389634.0,-442.4018404219855,-7.99,1
23:59,656389634.0,-461.39184042198553,-18.99,6
23:59,895750759.0,264.0674119243341,-15.99,1
23:59,895750759.0,256.0774119243341,-7.99,7
23:59,895750759.0,250.0874119243341,-5.99,1
23:59,895750759.0,235.0974119243341,-14.99,1
23:59,895750759.0,228.0974119243341,-7.0,1
23:59,895750759.0,209.1074119243341,-18.99,6
23:59,824218857.0,-3981.668660845428,-100.0,6
23:59,824218857.0,-3997.658660845428,-15.99,1
23:59,824218857.0,-4005.648660845427,-7.99,1
23:59,493571342.0,-2708.423380907047,-18.99,6
23:59,493571342.0,-2724.4133809070468,-15.99,1
23:59,493571342.0,-2732.4033809070465,-7.99,7
23:59,583558311.0,-248.15721524866777,-5.99,1
23:59,583558311.0,-261.14721524866775,-12.99,1
23:59,583558311.0,-280.13721524866776,-18.99,6
23:59,703537476.0,1485.5062499999992,-7.99,1
23:59,703537476.0,1479.5162499999992,-5.99,1
23:59,703537476.0,1460.5262499999992,-18.99,6
23:59,574548998.0,271.845049999999,-15.99,1
23:59,574548998.0,263.855049999999,-7.99,1
23:59,574548998.0,244.86504999999897,-18.99,6
23:59,574548998.0,237.86504999999897,-7.0,1
23:59,574548998.0,222.87504999999896,-14.99,1
23:59,741903302.0,3373.407067935261,-15.99,1
23:59,741903302.0,3354.417067935261,-18.99,6
23:59,741903302.0,3341.427067935261,-12.99,1
23:59,741903302.0,3334.427067935261,-7.0,1
23:59,741903302.0,3319.4370679352614,-14.99,1
23:59,741903302.0,3312.4370679352614,-7.0,1
23:59,105375973.0,599.4596528189405,-18.99,6
23:59,105375973.0,583.4696528189405,-15.99,1
23:59,105375973.0,575.4796528189405,-7.99,7
23:59,945054126.0,512.0381,-18.99,6
23:59,945054126.0,504.0481,-7.99,1
23:59,945054126.0,497.0481,-7.0,1
23:59,945054126.0,490.0481,-7.0,1
23:59,945054126.0,483.0481,-7.0,1
23:59,467207141.0,944.8781670482638,-7.99,1
23:59,467207141.0,938.8881670482638,-5.99,1
23:59,467207141.0,919.8981670482638,-18.99,6
23:59,391688371.0,1323.9549551878172,-5.99,1
23:59,391688371.0,1308.9649551878172,-14.99,1
23:59,391688371.0,1302.9749551878172,-5.99,1
23:59,391688371.0,1287.9849551878171,-14.99,1
23:59,391688371.0,1271.9949551878171,-15.99,1
23:59,391688371.0,1264.0049551878171,-7.99,1
23:59,391688371.0,1245.0149551878171,-18.99,6
23:59,494789005.0,3443.904016609372,-18.99,6
23:59,494789005.0,3427.914016609372,-15.99,1
23:59,534325901.0,7624.774160573459,-18.99,6
23:59,534325901.0,7616.784160573459,-7.99,1
23:59,534325901.0,7601.7941605734595,-14.99,1
23:59,534325901.0,7501.7941605734595,-100.0,6
23:59,856957948.0,12644.261154533908,-15.99,1
23:59,856957948.0,12625.271154533908,-18.99,6
23:59,856957948.0,12612.281154533908,-12.99,1
23:59,596328017.0,-2444.6378499999973,-7.99,7
23:59,596328017.0,-2450.627849999997,-5.99,1
23:59,596328017.0,-2469.617849999997,-18.99,6
23:59,596328017.0,-2569.617849999997,-100.0,6
23:59,173335108.0,1364.524000000001,-7.99,1
23:59,173335108.0,1356.534000000001,-7.99,7
23:59,173335108.0,1337.544000000001,-18.99,6
23:59,173335108.0,1330.544000000001,-7.0,1
23:59,173335108.0,1324.554000000001,-5.99,1
23:59,296770890.0,1825.6600103790831,-5.99,1
23:59,296770890.0,1812.6700103790831,-12.99,1
23:59,220183538.0,1052.5335999999995,-15.99,1
23:59,220183538.0,1044.5435999999995,-7.99,1
23:59,806358207.0,13747.344795762372,-14.99,1
23:59,806358207.0,13732.354795762372,-14.99,1
23:59,806358207.0,13716.364795762373,-15.99,1
23:59,806358207.0,13697.374795762373,-18.99,6
23:59,962295212.0,-3123.470149999996,-15.99,1
23:59,962295212.0,-3131.460149999996,-7.99,1
23:59,621652856.0,1175.0459696105402,-18.99,6
23:59,605116158.0,3277.8295000000044,-15.99,1
23:59,605116158.0,3269.8395000000046,-7.99,7
23:59,605116158.0,3256.849500000005,-12.99,1
23:59,605116158.0,3241.859500000005,-14.99,1
23:59,605116158.0,3222.8695000000052,-18.99,6
23:59,889916166.0,551.5134014132266,-7.99,1
23:59,479456865.0,1763.5878118641742,-18.99,6
23:59,479456865.0,1747.5978118641742,-15.99,1
23:59,479456865.0,1739.6078118641742,-7.99,7
23:59,780463728.0,5203.09087094224,-5.99,1
23:59,780463728.0,5188.10087094224,-14.99,1
23:59,780463728.0,5175.110870942241,-12.99,1
23:59,891716230.0,570.4903298101015,-15.99,1
23:59,891716230.0,551.5003298101014,-18.99,6
23:59,223207876.0,-263.6903999999995,-15.99,1
23:59,223207876.0,-282.6803999999995,-18.99,6
23:59,223207876.0,-382.6803999999995,-100.0,6
23:59,223207876.0,-388.6703999999995,-5.99,1
23:59,986267641.0,6085.841099705964,-15.99,1
23:59,986267641.0,6077.851099705964,-7.99,7
23:59,986267641.0,6058.861099705964,-18.99,6
23:59,986267641.0,6043.871099705964,-14.99,1
23:59,986267641.0,6037.8810997059645,-5.99,1
23:59,779620857.0,-381.853196385176,-15.99,1
23:59,779620857.0,-389.843196385176,-7.99,1
23:59,779620857.0,-408.83319638517605,-18.99,6
23:59,914806976.0,1184.2032501854865,-15.99,1
23:59,914806976.0,1165.2132501854865,-18.99,6
23:59,914806976.0,1158.2132501854865,-7.0,1
23:59,914806976.0,1151.2132501854865,-7.0,1
23:59,914806976.0,1145.2232501854864,-5.99,1
23:59,914806976.0,1132.2332501854864,-12.99,1
23:59,914806976.0,1032.2332501854864,-100.0,6
23:59,517190750.0,3107.3585899154123,-100.0,6
23:59,517190750.0,3091.3685899154125,-15.99,1
23:59,647472692.0,29981.077856210857,-7.99,7
23:59,647472692.0,29965.087856210856,-15.99,1
23:59,647472692.0,29950.097856210858,-14.99,1
23:59,647472692.0,29931.107856210852,-18.99,6
23:59,217540156.0,-3648.0448199999937,-15.99,1
23:59,217540156.0,-3748.0448199999937,-100.0,6
23:59,217540156.0,-3767.034819999993,-18.99,6
23:59,183888402.0,22191.93245714014,-5.99,1
23:59,183888402.0,22178.94245714014,-12.99,1
23:59,183888402.0,22172.952457140134,-5.99,1
23:59,183888402.0,22159.962457140136,-12.99,1
23:59,183888402.0,22140.972457140135,-18.99,6
23:59,183888402.0,22132.982457140133,-7.99,1
23:59,136770968.0,-25.900800000000466,-12.99,1
23:59,136770968.0,-38.89080000000047,-12.99,1
23:59,136770968.0,-53.88080000000047,-14.99,1
23:59,136770968.0,-68.87080000000047,-14.99,1
23:59,136770968.0,-84.86080000000047,-15.99,1
23:59,136770968.0,-103.85080000000046,-18.99,6
23:59,293609137.0,52.060492574498134,-14.99,1
23:59,293609137.0,39.07049257449813,-12.99,1
23:59,293609137.0,23.08049257449813,-15.99,1
23:59,293609137.0,15.09049257449813,-7.99,7
23:59,293609137.0,-3.899507425501868,-18.99,6
23:59,194745206.0,840.2333720912432,-15.99,1
23:59,194745206.0,833.2333720912432,-7.0,1
23:59,194745206.0,826.2333720912432,-7.0,1
23:59,194745206.0,807.2433720912431,-18.99,6
23:59,667367404.0,11517.295711836156,-14.99,1
23:59,667367404.0,11504.305711836156,-12.99,1
23:59,667367404.0,11491.315711836156,-12.99,1
23:59,667367404.0,11475.325711836156,-15.99,1
23:59,667367404.0,11375.325711836156,-100.0,6
23:59,403902116.0,842.1531999999993,-7.0,1
23:59,403902116.0,835.1531999999993,-7.0,1
23:59,403902116.0,828.1531999999993,-7.0,1
23:59,403902116.0,821.1531999999993,-7.0,1
23:59,403902116.0,813.1631999999993,-7.99,1
23:59,403902116.0,794.1731999999993,-18.99,6
23:59,532478725.0,5502.298228941877,-7.99,1
23:59,532478725.0,5494.308228941877,-7.99,7
23:59,705848712.0,31121.47063949334,-15.99,1
23:59,705848712.0,31114.47063949334,-7.0,1
23:59,705848712.0,31101.480639493337,-12.99,1
23:59,705848712.0,31095.490639493335,-5.99,1
23:59,705848712.0,31076.500639493333,-18.99,6
23:59,705848712.0,30976.500639493333,-100.0,6
23:59,183186021.0,-1087.9650499999989,-15.99,1
23:59,183186021.0,-1106.955049999999,-18.99,6
23:59,548907062.0,989.1373364260272,-15.99,1
23:59,548907062.0,970.1473364260272,-18.99,6
23:59,548907062.0,870.1473364260272,-100.0,6
23:59,993663752.0,-187.54785758960367,-7.99,1
23:59,993663752.0,-195.53785758960368,-7.99,7
23:59,993663752.0,-202.53785758960368,-7.0,1
23:59,499244466.0,-334.21013128342247,-15.99,1
23:59,499244466.0,-349.2001312834225,-14.99,1
23:59,499244466.0,-362.1901312834225,-12.99,1
23:59,499244466.0,-368.1801312834225,-5.99,1
23:59,499244466.0,-387.1701312834225,-18.99,6
23:59,384497904.0,984.3234999999992,-15.99,1
23:59,384497904.0,971.333499999999,-12.99,1
23:59,384497904.0,871.333499999999,-100.0,6
23:59,392270893.0,15096.588853350557,-15.99,1
23:59,392270893.0,15083.598853350555,-12.99,1
23:59,392270893.0,15076.598853350555,-7.0,1
23:59,392270893.0,15070.608853350555,-5.99,1
23:59,259015404.0,1512.3606423094618,-15.99,1
23:59,259015404.0,1504.3706423094618,-7.99,7
23:59,259015404.0,1498.3806423094618,-5.99,1
23:59,259015404.0,1491.3806423094618,-7.0,1
23:59,259015404.0,1484.3806423094618,-7.0,1
23:59,259015404.0,1465.3906423094618,-18.99,6
23:59,979892433.0,-1219.475000000001,-7.0,1
23:59,979892433.0,-1232.465000000001,-12.99,1
23:59,979892433.0,-1245.455000000001,-12.99,1
23:59,979892433.0,-1251.445000000001,-5.99,1
23:59,979892433.0,-1270.435000000001,-18.99,6
23:59,160166876.0,997.3900405862436,-18.99,6
23:59,160166876.0,984.4000405862434,-12.99,1
23:59,160166876.0,969.4100405862434,-14.99,1
23:59,160166876.0,954.4200405862434,-14.99,1
23:59,160166876.0,948.4300405862434,-5.99,1
23:59,189757473.0,-2382.913649999999,-7.99,1
23:59,189757473.0,-2390.903649999999,-7.99,7
23:59,189757473.0,-2409.8936499999986,-18.99,6
23:59,435984758.0,5092.035707077037,-18.99,6
23:59,435984758.0,5085.035707077037,-7.0,1
23:59,435984758.0,5077.045707077037,-7.99,1
23:59,678330503.0,2962.927368040376,-5.99,1
23:59,678330503.0,2956.937368040376,-5.99,1
23:59,678330503.0,2943.947368040376,-12.99,1
23:59,678330503.0,2924.9573680403764,-18.99,6
23:59,570575024.0,-886.9096500000007,-15.99,1
23:59,570575024.0,-894.8996500000007,-7.99,7
23:59,570575024.0,-913.8896500000008,-18.99,6
23:59,924045955.0,1847.0614426586649,-18.99,6
23:59,924045955.0,1834.0714426586649,-12.99,1
23:59,924045955.0,1827.0714426586649,-7.0,1
23:59,924045955.0,1811.0814426586649,-15.99,1
23:59,924045955.0,1803.0914426586648,-7.99,7
23:59,509627909.0,86.81464999999913,-18.99,6
23:59,509627909.0,70.82464999999914,-15.99,1
23:59,509627909.0,62.83464999999914,-7.99,7
23:59,500051919.0,563.44099665059,-7.99,7
23:59,500051919.0,547.45099665059,-15.99,1
23:59,500051919.0,528.46099665059,-18.99,6
23:59,224112146.0,679.8567499999997,-15.99,1
23:59,224112146.0,660.8667499999997,-18.99,6
23:59,224112146.0,645.8767499999997,-14.99,1
23:59,224112146.0,638.8767499999997,-7.0,1
23:59,365608668.0,954.2539104738324,-15.99,1
23:59,365608668.0,935.2639104738324,-18.99,6
23:59,365608668.0,835.2639104738325,-100.0,6
23:59,365608668.0,822.2739104738325,-12.99,1
23:59,184430449.0,3668.4763323910897,-12.99,1
23:59,184430449.0,3655.4863323910895,-12.99,1
23:59,184430449.0,3640.4963323910897,-14.99,1
23:59,184430449.0,3624.50633239109,-15.99,1
23:59,184430449.0,3605.51633239109,-18.99,6
23:59,796709231.0,546.2223278962974,-7.99,1
23:59,796709231.0,527.2323278962974,-18.99,6
23:59,517934629.0,396.1376787084264,-15.99,1
23:59,517934629.0,388.1476787084264,-7.99,1
23:59,517934629.0,369.1576787084264,-18.99,6
23:59,229205098.0,9090.628670452108,-18.99,6
23:59,627622066.0,4365.44237216963,-18.99,6
23:59,627622066.0,4357.4523721696305,-7.99,1
23:59,627622066.0,4257.4523721696305,-100.0,6
23:59,442079728.0,764.2951192193138,-18.99,6
23:59,642015139.0,-1484.7236625343617,-7.99,1
23:59,642015139.0,-1492.7136625343617,-7.99,7
23:59,990894155.0,93.11720867884152,-15.99,1
23:59,990894155.0,85.12720867884153,-7.99,1
23:59,990894155.0,66.13720867884153,-18.99,6
23:59,252964502.0,-938.5450224913006,-15.99,1
23:59,187111705.0,8363.609736314698,-15.99,1
23:59,899742927.0,15115.203977628284,-7.99,7
23:59,899742927.0,15107.213977628286,-7.99,1
23:59,899742927.0,15088.223977628286,-18.99,6
23:59,899742927.0,14988.223977628286,-100.0,6
23:59,865748375.0,3543.518765646476,-15.99,1
23:59,865748375.0,3535.528765646476,-7.99,1
23:59,865748375.0,3522.5387656464763,-12.99,1
23:59,865748375.0,3515.5387656464763,-7.0,1
23:59,865748375.0,3496.548765646477,-18.99,6
23:59,266777719.0,263.72093378023965,-18.99,6
23:59,851181128.0,6435.689859848635,-12.99,1
23:59,851181128.0,6428.689859848635,-7.0,1
23:59,851181128.0,6415.699859848635,-12.99,1
23:59,851181128.0,6408.699859848635,-7.0,1
23:59,851181128.0,6392.7098598486355,-15.99,1
23:59,851181128.0,6384.719859848636,-7.99,7
23:59,851181128.0,6365.729859848636,-18.99,6
23:59,595800644.0,-792.2977000000003,-18.99,6
23:59,595800644.0,-805.2877000000003,-12.99,1
23:59,595800644.0,-812.2877000000003,-7.0,1
23:59,595800644.0,-825.2777000000003,-12.99,1
23:59,595800644.0,-840.2677000000003,-14.99,1
23:59,595800644.0,-848.2577000000003,-7.99,1
23:59,595800644.0,-864.2477000000003,-15.99,1
23:59,520418719.0,2755.196350000004,-14.99,1
23:59,101531259.0,488.9520999999995,-7.99,1
23:59,101531259.0,388.9520999999995,-100.0,6
23:59,593378953.0,1564.6796500000048,-7.99,1
23:59,593378953.0,1548.6896500000048,-15.99,1
23:59,593378953.0,1535.6996500000048,-12.99,1
23:59,593378953.0,1522.7096500000048,-12.99,1
23:59,593378953.0,1516.7196500000048,-5.99,1
23:59,593378953.0,1510.7296500000048,-5.99,1
23:59,547010927.0,28328.055826228418,-7.0,1
23:59,547010927.0,28313.065826228416,-14.99,1
23:59,547010927.0,28300.075826228414,-12.99,1
23:59,547010927.0,28287.085826228413,-12.99,1
23:59,547010927.0,28271.09582622841,-15.99,1
23:59,547010927.0,28263.10582622841,-7.99,7
23:59,547010927.0,28244.115826228408,-18.99,6
23:59,534583529.0,1781.867588054765,-5.99,1
23:59,534583529.0,1775.877588054765,-5.99,1
23:59,534583529.0,1759.887588054765,-15.99,1
23:59,534583529.0,1751.897588054765,-7.99,7
23:59,366550080.0,27019.41040128616,-7.99,7
23:59,366550080.0,27003.42040128616,-15.99,1
23:59,445240363.0,-1242.8435059632736,-15.99,1
23:59,445240363.0,-1261.8335059632736,-18.99,6
23:59,445240363.0,-1361.8335059632736,-100.0,6
23:59,445240363.0,-1376.8235059632736,-14.99,1
23:59,445240363.0,-1382.8135059632737,-5.99,1
23:59,445240363.0,-1389.8135059632737,-7.0,1
23:59,224215364.0,-1904.3500920882789,-7.99,7
23:59,224215364.0,-1917.3400920882789,-12.99,1
23:59,224215364.0,-1930.330092088279,-12.99,1
23:59,224215364.0,-1936.320092088279,-5.99,1
23:59,224215364.0,-1942.310092088279,-5.99,1
23:59,224215364.0,-1961.300092088279,-18.99,6
23:59,868014990.0,-3653.071099999995,-7.99,1
23:59,868014990.0,-3669.0610999999953,-15.99,1
23:59,868014990.0,-3675.051099999995,-5.99,1
23:59,868014990.0,-3682.051099999995,-7.0,1
23:59,152488934.0,2714.9946573137313,-15.99,1
23:59,152488934.0,2707.0046573137315,-7.99,7
23:59,152488934.0,2701.0146573137317,-5.99,1
23:59,152488934.0,2686.024657313732,-14.99,1
23:59,152488934.0,2586.024657313732,-100.0,6
23:59,308068836.0,721.7415225681923,-14.99,1
23:59,308068836.0,708.7515225681923,-12.99,1
23:59,308068836.0,693.7615225681923,-14.99,1
23:59,308068836.0,678.7715225681923,-14.99,1
23:59,308068836.0,662.7815225681923,-15.99,1
23:59,308068836.0,654.7915225681922,-7.99,1
23:59,639549973.0,6758.863001183843,-14.99,1
23:59,639549973.0,6745.873001183843,-12.99,1
23:59,639549973.0,6730.883001183844,-14.99,1
23:59,639549973.0,6714.893001183844,-15.99,1
23:59,639549973.0,6695.903001183844,-18.99,6
23:59,933745726.0,-146.56394357067674,-7.99,1
23:59,933745726.0,-154.55394357067675,-7.99,7
23:59,933745726.0,-173.54394357067676,-18.99,6
23:59,933745726.0,-180.54394357067676,-7.0,1
23:59,933745726.0,-187.54394357067676,-7.0,1
23:59,933745726.0,-202.53394357067677,-14.99,1
23:59,933745726.0,-208.5239435706768,-5.99,1
23:59,133755851.0,768.119248138252,-7.99,1
23:59,133755851.0,752.129248138252,-15.99,1
23:59,442070890.0,1930.312412444371,-7.99,1
23:59,442070890.0,1911.322412444371,-18.99,6
23:59,336557504.0,2029.2507123661103,-15.99,1
23:59,971129830.0,-1805.0406499999992,-14.99,1
23:59,971129830.0,-1811.0306499999992,-5.99,1
23:59,971129830.0,-1817.0206499999993,-5.99,1
23:59,971129830.0,-1836.0106499999993,-18.99,6
23:59,971129830.0,-1852.0006499999993,-15.99,1
23:59,971129830.0,-1859.9906499999993,-7.99,7
23:59,147474476.0,3919.9000305551344,-7.99,7
23:59,147474476.0,3900.910030555134,-18.99,6
23:59,147474476.0,3885.920030555135,-14.99,1
23:59,147474476.0,3872.930030555135,-12.99,1
23:59,807714284.0,1466.6426607359997,-18.99,6
23:59,520239952.0,-1094.906826654763,-7.99,1
23:59,520239952.0,-1102.8968266547631,-7.99,7
23:59,520239952.0,-1121.8868266547631,-18.99,6
23:59,407323346.0,-2727.4954325553117,-5.99,1
23:59,407323346.0,-2746.4854325553115,-18.99,6
23:59,788740658.0,1946.4714690169988,-7.0,1
23:59,558119802.0,38280.88083098784,-15.99,1
23:59,558119802.0,38272.89083098784,-7.99,7
23:59,558119802.0,38259.90083098784,-12.99,1
23:59,558119802.0,38246.91083098784,-12.99,1
23:59,782058249.0,-1362.5013733101616,-5.99,1
23:59,782058249.0,-1377.4913733101616,-14.99,1
23:59,782058249.0,-1383.4813733101616,-5.99,1
23:59,782058249.0,-1399.4713733101617,-15.99,1
23:59,117308635.0,2475.710251786096,-7.99,1
23:59,117308635.0,2456.720251786096,-18.99,6
23:59,117308635.0,2443.730251786096,-12.99,1
23:59,117308635.0,2437.7402517860965,-5.99,1
23:59,117308635.0,2424.7502517860967,-12.99,1
23:59,117308635.0,2411.760251786097,-12.99,1
23:59,117308635.0,2311.760251786097,-100.0,6
23:59,191161970.0,-4195.371999999994,-18.99,6
23:59,191161970.0,-4203.361999999994,-7.99,7
23:59,191161970.0,-4211.3519999999935,-7.99,1
23:59,191161970.0,-4224.341999999993,-12.99,1
23:59,191161970.0,-4239.331999999993,-14.99,1
23:59,191161970.0,-4252.321999999993,-12.99,1
23:59,191161970.0,-4258.311999999993,-5.99,1
23:59,143061865.0,8236.814826403766,-15.99,1
23:59,143061865.0,8228.824826403767,-7.99,1
23:59,143061865.0,8213.834826403767,-14.99,1
23:59,143061865.0,8194.844826403767,-18.99,6
23:59,779376323.0,5216.475833981341,-15.99,1
23:59,779376323.0,5116.475833981341,-100.0,6
23:59,886921642.0,4246.128789043211,-15.99,1
23:59,886921642.0,4231.138789043212,-14.99,1
23:59,886921642.0,4216.148789043212,-14.99,1
23:59,886921642.0,4197.158789043212,-18.99,6
23:59,886921642.0,4097.158789043212,-100.0,6
23:59,189335192.0,-1003.5939517578606,-18.99,6
23:59,189335192.0,-1019.5839517578606,-15.99,1
23:59,189335192.0,-1119.5839517578606,-100.0,6
23:59,189335192.0,-1125.5739517578606,-5.99,1
23:59,189335192.0,-1131.5639517578609,-5.99,1
23:59,189335192.0,-1137.553951757861,-5.99,1
23:59,189335192.0,-1143.543951757861,-5.99,1
23:59,744211756.0,-4510.1682499999915,-18.99,6
23:59,744211756.0,-4610.1682499999915,-100.0,6
23:59,744211756.0,-4626.158249999991,-15.99,1
23:59,744211756.0,-4634.148249999991,-7.99,7
23:59,668175891.0,1454.892916073262,-18.99,6
23:59,668175891.0,1354.892916073262,-100.0,6
23:59,668175891.0,1341.902916073262,-12.99,1
23:59,668175891.0,1335.912916073262,-5.99,1
23:59,668175891.0,1320.922916073262,-14.99,1
23:59,668175891.0,1304.932916073262,-15.99,1
23:59,898104045.0,-1524.2880500000024,-18.99,6
23:59,898104045.0,-1540.2780500000024,-15.99,1
23:59,898104045.0,-1548.2680500000024,-7.99,7
23:59,898104045.0,-1561.2580500000024,-12.99,1
23:59,898104045.0,-1568.2580500000024,-7.0,1
23:59,691012931.0,-1612.5222500000011,-7.99,1
23:59,691012931.0,-1631.5122500000011,-18.99,6
23:59,691012931.0,-1638.5122500000011,-7.0,1
23:59,709608057.0,3364.3326814685424,-15.99,1
23:59,709608057.0,3356.3426814685427,-7.99,1
23:59,709608057.0,3349.3426814685427,-7.0,1
23:59,709608057.0,3334.352681468543,-14.99,1
23:59,709608057.0,3321.362681468543,-12.99,1
23:59,709608057.0,3302.3726814685433,-18.99,6
23:59,932820758.0,-2781.7465667755537,-14.99,1
23:59,932820758.0,-2797.7365667755535,-15.99,1
23:59,932820758.0,-2805.7265667755532,-7.99,1
23:59,984783496.0,16498.223277976256,-7.0,1
23:59,984783496.0,16491.223277976256,-7.0,1
23:59,984783496.0,16476.233277976255,-14.99,1
23:59,984783496.0,16460.243277976253,-15.99,1
23:59,984783496.0,16441.25327797625,-18.99,6
23:59,984783496.0,16341.253277976251,-100.0,6
23:59,129018172.0,11771.74946802586,-15.99,1
23:59,129018172.0,11765.75946802586,-5.99,1
23:59,129018172.0,11746.76946802586,-18.99,6
23:59,544961962.0,-219.2156769943906,-12.99,1
23:59,544961962.0,-225.2056769943906,-5.99,1
23:59,544961962.0,-232.2056769943906,-7.0,1
23:59,544961962.0,-239.2056769943906,-7.0,1
23:59,544961962.0,-258.1956769943906,-18.99,6
23:59,511179916.0,9282.898183540476,-15.99,1
23:59,511179916.0,9274.908183540478,-7.99,1
23:59,511179916.0,9268.918183540478,-5.99,1
23:59,511179916.0,9262.928183540478,-5.99,1
23:59,480198977.0,14321.322032593253,-15.99,1
23:59,480198977.0,14302.332032593253,-18.99,6
23:59,225210798.0,1187.5899351225796,-15.99,1
23:59,225210798.0,1179.5999351225796,-7.99,7
23:59,225210798.0,1160.6099351225796,-18.99,6
23:59,376271050.0,2346.1156816274706,-7.99,1
23:59,296972867.0,-750.0263000000009,-18.99,6
23:59,358836279.0,676.3656928075857,-7.0,1
23:59,358836279.0,663.3756928075857,-12.99,1
23:59,358836279.0,650.3856928075857,-12.99,1
23:59,358836279.0,637.3956928075856,-12.99,1
23:59,358836279.0,618.4056928075856,-18.99,6
23:59,696333897.0,664.8403999999987,-100.0,6
23:59,696333897.0,656.8503999999987,-7.99,1
23:59,696333897.0,640.8603999999987,-15.99,1
23:59,696333897.0,621.8703999999987,-18.99,6
23:59,219399150.0,-960.0325269529268,-7.99,1
23:59,219399150.0,-967.0325269529268,-7.0,1
23:59,219399150.0,-986.0225269529268,-18.99,6
23:59,475117511.0,8666.758141140192,-100.0,6
23:59,475117511.0,8650.768141140192,-15.99,1
23:59,475117511.0,8643.768141140192,-7.0,1
23:59,475117511.0,8630.778141140192,-12.99,1
23:59,475117511.0,8615.788141140192,-14.99,1
23:59,475117511.0,8600.798141140192,-14.99,1
23:59,475117511.0,8581.808141140193,-18.99,6
23:59,374994043.0,-2447.97805,-15.99,1
23:59,374994043.0,-2453.96805,-5.99,1
23:59,374994043.0,-2459.9580499999997,-5.99,1
23:59,374994043.0,-2472.9480499999995,-12.99,1
23:59,374994043.0,-2478.9380499999993,-5.99,1
23:59,374994043.0,-2497.928049999999,-18.99,6
23:59,462962606.0,-380.7999500000014,-15.99,1
23:59,462962606.0,-386.78995000000134,-5.99,1
23:59,462962606.0,-399.77995000000135,-12.99,1
23:59,462962606.0,-412.76995000000136,-7.0,1
23:59,462962606.0,-431.75995000000137,-18.99,6
23:59,462962606.0,-531.7599500000014,-100.0,6
23:59,154246234.0,-870.2851078978956,-18.99,6
23:59,154246234.0,-886.2751078978956,-15.99,1
23:59,420109571.0,886.3084258932456,-15.99,1
23:59,420109571.0,878.3184258932456,-7.99,7
23:59,420109571.0,865.3284258932456,-12.99,1
23:59,420109571.0,852.3384258932456,-12.99,1
23:59,420109571.0,845.3384258932456,-7.0,1
23:59,420109571.0,839.3484258932456,-5.99,1
23:59,420109571.0,820.3584258932456,-18.99,6
23:59,215426302.0,1211.962404025692,-5.99,1
23:59,215426302.0,1196.972404025692,-14.99,1
23:59,215426302.0,1181.982404025692,-14.99,1
23:59,331048953.0,607.1163679784936,-18.99,6
23:59,331048953.0,594.1263679784936,-12.99,1
23:59,719586818.0,21993.66868747271,-15.99,1
23:59,719586818.0,21986.66868747271,-7.0,1
23:59,719586818.0,21980.678687472708,-5.99,1
23:59,317161035.0,-3864.832599999996,-15.99,1
23:59,317161035.0,-3871.832599999996,-7.0,1
23:59,317161035.0,-3890.822599999996,-18.99,6
23:59,570269025.0,4501.92144214464,-7.0,1
23:59,570269025.0,4488.931442144641,-12.99,1
23:59,570269025.0,4473.941442144641,-14.99,1
23:59,570269025.0,4458.951442144641,-14.99,1
23:59,570269025.0,4439.961442144641,-18.99,6
23:59,570269025.0,4423.9714421446415,-15.99,1
23:59,570269025.0,4323.9714421446415,-100.0,6
23:59,874506295.0,-1199.7417562455723,-18.99,6
23:59,874506295.0,-1215.7317562455723,-15.99,1
23:59,874506295.0,-1228.7217562455724,-12.99,1
23:59,874506295.0,-1328.7217562455724,-100.0,6
23:59,556992209.0,12647.97271021934,-14.99,1
23:59,556992209.0,12634.98271021934,-12.99,1
23:59,556992209.0,12618.99271021934,-15.99,1
23:59,556992209.0,12611.00271021934,-7.99,1
23:59,556992209.0,12592.01271021934,-18.99,6
23:59,444428189.0,2140.3762000000024,-15.99,1
23:59,444428189.0,2127.386200000002,-12.99,1
23:59,444428189.0,2114.396200000003,-12.99,1
23:59,444428189.0,2108.406200000003,-5.99,1
23:59,444428189.0,2095.4162000000033,-12.99,1
23:59,444428189.0,2076.4262000000035,-18.99,6
23:59,752362502.0,8980.807350436322,-15.99,1
23:59,433917275.0,8754.826473170388,-18.99,6
23:59,433917275.0,8748.836473170388,-5.99,1
23:59,433917275.0,8732.846473170388,-15.99,1
23:59,149684419.0,1498.598899999998,-15.99,1
23:59,149684419.0,1491.598899999998,-7.0,1
23:59,149684419.0,1478.608899999998,-12.99,1
23:59,149684419.0,1472.618899999998,-5.99,1
23:59,149684419.0,1466.628899999998,-5.99,1
23:59,165691047.0,1070.3270999999988,-5.99,1
23:59,165691047.0,1057.3370999999988,-12.99,1
23:59,165691047.0,1051.3470999999988,-5.99,1
23:59,165691047.0,1036.3570999999988,-14.99,1
23:59,165691047.0,1028.3670999999988,-7.99,1
23:59,165691047.0,1012.3770999999988,-15.99,1
23:59,337771621.0,-3090.747649999998,-5.99,1
23:59,337771621.0,-3096.7376499999978,-5.99,1
23:59,337771621.0,-3115.7276499999975,-18.99,6
23:59,337771621.0,-3139.707649999997,-7.99,1
23:59,337771621.0,-3239.707649999997,-100.0,6
23:59,700138124.0,5467.839702068643,-18.99,6
23:59,700138124.0,5451.849702068644,-15.99,1
23:59,700138124.0,5443.859702068644,-7.99,7
23:59,169689461.0,1205.613149999999,-15.99,1
23:59,169689461.0,1197.623149999999,-7.99,7
23:59,169689461.0,1097.623149999999,-100.0,6
23:59,169689461.0,1078.633149999999,-18.99,6
23:59,901432314.0,4210.443551743742,-5.99,1
23:59,901432314.0,4204.4535517437425,-5.99,1
23:59,901432314.0,4191.463551743743,-12.99,1
23:59,901432314.0,4172.473551743743,-18.99,6
23:59,901432314.0,4156.483551743743,-15.99,1
23:59,901432314.0,4148.493551743743,-7.99,7
23:59,691843653.0,-3295.415899999992,-15.99,1
23:59,691843653.0,-3303.405899999992,-7.99,7
23:59,691843653.0,-3322.395899999992,-18.99,6
23:59,496395938.0,14063.728381453571,-15.99,1
23:59,496395938.0,14057.738381453571,-5.99,1
23:59,496395938.0,14038.748381453574,-18.99,6
23:59,822718326.0,13230.946001111884,-15.99,1
23:59,822718326.0,13222.956001111885,-7.99,1
23:59,822718326.0,13215.956001111885,-7.0,1
23:59,822718326.0,13208.956001111885,-7.0,1
23:59,822718326.0,13202.966001111885,-5.99,1
23:59,822718326.0,13189.976001111883,-12.99,1
23:59,644751433.0,-1466.8856584655384,-15.99,1
23:59,644751433.0,-1474.8756584655384,-7.99,7
23:59,644751433.0,-1493.8656584655384,-18.99,6
23:59,644751433.0,-1500.8656584655384,-7.0,1
23:59,401293808.0,225.16689999999917,-18.99,6
23:59,401293808.0,219.1768999999991,-5.99,1
23:59,401293808.0,203.18689999999913,-15.99,1
23:59,401293808.0,195.19689999999912,-7.99,7
23:59,401293808.0,95.19689999999912,-100.0,6
23:59,387957305.0,-2880.9236059800783,-15.99,1
23:59,387957305.0,-2888.913605980078,-7.99,7
23:59,387957305.0,-2907.903605980078,-18.99,6
23:59,836655156.0,-3185.6814552191545,-18.99,6
23:59,836655156.0,-3192.6814552191545,-7.0,1
23:59,836655156.0,-3207.6714552191543,-14.99,1
23:59,836655156.0,-3220.661455219154,-12.99,1
23:59,836655156.0,-3228.651455219154,-7.99,7
23:59,836655156.0,-3328.651455219154,-100.0,6
23:59,637649383.0,1205.3227999999983,-15.99,1
23:59,637649383.0,1186.3327999999983,-18.99,6
23:59,637649383.0,1173.3427999999983,-12.99,1
23:59,637649383.0,1160.3527999999983,-12.99,1
23:59,637649383.0,1147.3627999999983,-12.99,1
23:59,637649383.0,1134.3727999999985,-12.99,1
23:59,637649383.0,1034.3727999999985,-100.0,6
23:59,252701364.0,-4081.188672677914,-12.99,1
23:59,252701364.0,-4088.188672677914,-7.0,1
23:59,252701364.0,-4095.188672677914,-7.0,1
23:59,252701364.0,-4102.188672677914,-7.0,1
23:59,252701364.0,-4118.178672677914,-15.99,1
23:59,252701364.0,-4137.1686726779135,-18.99,6
23:59,679943657.0,4393.128889180138,-15.99,1
23:59,679943657.0,4374.138889180138,-18.99,6
23:59,683319988.0,8397.90963499065,-18.99,6
23:59,683319988.0,8389.91963499065,-7.99,7
23:59,683319988.0,8381.92963499065,-7.99,1
23:59,403383649.0,1739.5848031531707,-15.99,1
23:59,998390769.0,216.6167509405243,-7.99,1
23:59,998390769.0,200.6267509405243,-15.99,1
23:59,998390769.0,193.6267509405243,-7.0,1
23:59,998390769.0,178.63675094052428,-14.99,1
23:59,998390769.0,163.64675094052427,-14.99,1
23:59,998390769.0,150.65675094052426,-12.99,1
23:59,848118081.0,-2487.9127980020953,-15.99,1
23:59,848118081.0,-2495.902798002095,-7.99,7
23:59,848118081.0,-2514.892798002095,-18.99,6
23:59,848118081.0,-2614.892798002095,-100.0,6
23:59,711045550.0,2150.9813500000037,-7.99,1
23:59,711045550.0,2131.991350000004,-18.99,6
23:59,797184978.0,142.3100865730194,-15.99,1
23:59,797184978.0,127.3200865730194,-14.99,1
23:59,797184978.0,112.3300865730194,-14.99,1
23:59,797184978.0,99.3400865730194,-12.99,1
23:59,183546640.0,372.30069734773383,-18.99,6
23:59,183546640.0,356.3106973477338,-15.99,1
23:59,183546640.0,348.3206973477338,-7.99,7
23:59,662610817.0,-1046.126831324928,-18.99,6
23:59,662610817.0,-1062.116831324928,-15.99,1
23:59,954263768.0,23.226899999999667,-12.99,1
23:59,954263768.0,10.236899999999666,-12.99,1
23:59,954263768.0,-4.753100000000334,-14.99,1
23:59,954263768.0,-19.743100000000332,-14.99,1
23:59,954263768.0,-27.733100000000334,-7.99,7
23:59,954263768.0,-43.723100000000336,-15.99,1
23:59,479366718.0,2762.251348140042,-7.99,7
23:59,479366718.0,2662.251348140042,-100.0,6
23:59,479366718.0,2643.261348140042,-18.99,6
23:59,280130290.0,86.13024999999949,-15.99,1
23:59,280130290.0,78.1402499999995,-7.99,7
23:59,280130290.0,71.1402499999995,-7.0,1
23:59,280130290.0,58.150249999999495,-12.99,1
23:59,280130290.0,43.16024999999949,-14.99,1
23:59,280130290.0,24.170249999999495,-18.99,6
23:59,454129843.0,1257.86639516656,-12.99,1
23:59,454129843.0,1250.86639516656,-7.0,1
23:59,454129843.0,1244.87639516656,-5.99,1
23:59,454129843.0,1225.88639516656,-18.99,6
23:59,454129843.0,1217.89639516656,-7.99,7
23:59,904154012.0,906.2274581204316,-15.99,1
23:59,904154012.0,899.2274581204315,-7.0,1
23:59,904154012.0,892.2274581204315,-7.0,1
23:59,616924659.0,-177.605420176915,-7.99,1
23:59,616924659.0,-185.595420176915,-7.99,7
23:59,786927378.0,-1683.2302796373165,-7.99,1
23:59,786927378.0,-1699.2202796373165,-15.99,1
23:59,786927378.0,-1818.2102796373165,-100.0,6
23:59,786927378.0,-1833.2002796373165,-14.99,1
23:59,786927378.0,-1840.2002796373165,-7.0,1
23:59,683078800.0,2623.7950811472856,-15.99,1
23:59,683078800.0,2615.805081147286,-7.99,1
23:59,215832575.0,-1119.7594637442198,-12.99,1
23:59,215832575.0,-1132.7494637442198,-12.99,1
23:59,215832575.0,-1151.7394637442198,-18.99,6
23:59,215832575.0,-1159.72946374422,-7.99,7
23:59,215832575.0,-1259.72946374422,-100.0,6
23:59,762859681.0,1365.0515999999989,-15.99,1
23:59,762859681.0,1346.0615999999989,-18.99,6
23:59,653640811.0,20281.834105493457,-15.99,1
23:59,653640811.0,20273.844105493452,-7.99,1
23:59,653640811.0,20254.85410549345,-18.99,6
23:59,576188756.0,-4906.521499999998,-15.99,1
23:59,576188756.0,-4919.511499999998,-12.99,1
23:59,576188756.0,-4925.501499999998,-5.99,1
23:59,576188756.0,-4940.491499999997,-14.99,1
23:59,280200287.0,-361.55295338694896,-7.99,1
23:59,836110591.0,4705.343407774246,-15.99,1
23:59,836110591.0,4605.343407774246,-100.0,6
23:59,836110591.0,4592.353407774246,-12.99,1
23:59,836110591.0,4585.353407774246,-7.0,1
23:59,349107386.0,-3756.930973194561,-12.99,1
23:59,349107386.0,-3771.9209731945607,-14.99,1
23:59,349107386.0,-3777.910973194561,-5.99,1
23:59,349107386.0,-3793.90097319456,-15.99,1
23:59,349107386.0,-3801.89097319456,-7.99,1
23:59,846550094.0,2741.5292671741445,-15.99,1
23:59,846550094.0,2733.5392671741447,-7.99,7
23:59,846550094.0,2720.549267174145,-12.99,1
23:59,846550094.0,2714.559267174145,-5.99,1
23:59,846550094.0,2695.569267174146,-18.99,6
23:59,987390838.0,-3133.7762412103775,-15.99,1
23:59,987390838.0,-3141.7662412103773,-7.99,1
23:59,987390838.0,-3160.756241210377,-18.99,6
23:59,987390838.0,-3167.756241210377,-7.0,1
23:59,987390838.0,-3180.746241210377,-12.99,1
23:59,147341222.0,-1823.4978753207952,-15.99,1
23:59,147341222.0,-1831.4878753207952,-7.99,1
23:59,147341222.0,-1850.4778753207952,-18.99,6
23:59,147341222.0,-1950.4778753207952,-100.0,6
23:59,198946608.0,5082.616124598253,-18.99,6
23:59,975345315.0,41174.06389051303,-18.99,6
23:59,975345315.0,41158.073890513035,-15.99,1
23:59,975345315.0,41152.08389051304,-5.99,1
23:59,975345315.0,41137.09389051304,-14.99,1
23:59,975345315.0,41130.09389051304,-7.0,1
23:59,975345315.0,41115.10389051304,-14.99,1
23:59,347110339.0,-79.50679250314816,-5.99,1
23:59,347110339.0,-92.49679250314816,-12.99,1
23:59,347110339.0,-100.48679250314817,-7.99,1
23:59,347110339.0,-119.47679250314816,-18.99,6
23:59,197779140.0,-414.5677000000004,-100.0,6
23:59,197779140.0,-433.5577000000004,-18.99,6
23:59,197779140.0,-449.5477000000004,-15.99,1
23:59,155867488.0,295.73669999999834,-7.99,1
23:59,155867488.0,287.7466999999983,-7.99,7
23:59,155867488.0,268.7566999999983,-18.99,6
23:59,593191200.0,959.812299999999,-18.99,6
23:59,524425303.0,-417.0196000000012,-18.99,6
23:59,524425303.0,-433.0096000000012,-15.99,1
23:59,524425303.0,-440.9996000000013,-7.99,7
23:59,524425303.0,-455.9896000000013,-14.99,1
23:59,524425303.0,-462.9896000000013,-7.0,1
23:59,524425303.0,-562.9896000000012,-100.0,6
23:59,618514666.0,24498.75347271649,-15.99,1
23:59,618514666.0,24490.763472716488,-7.99,1
23:59,618514666.0,24483.763472716488,-7.0,1
23:59,618514666.0,24464.77347271649,-18.99,6
23:59,737547541.0,472.2005995677744,-18.99,6
23:59,337184232.0,-1650.7190000000005,-7.99,1
23:59,337184232.0,-1750.7190000000005,-100.0,6
23:59,337184232.0,-1769.7090000000003,-18.99,6
23:59,337184232.0,-1782.6990000000003,-12.99,1
23:59,709632525.0,-1444.627350000001,-5.99,1
23:59,709632525.0,-1459.617350000001,-14.99,1
23:59,709632525.0,-1465.607350000001,-5.99,1
23:59,709632525.0,-1481.5973500000007,-15.99,1
23:59,709632525.0,-1500.5873500000007,-18.99,6
23:59,190874125.0,174.37301421356727,-15.99,1
23:59,190874125.0,159.38301421356726,-14.99,1
23:59,190874125.0,152.38301421356726,-7.0,1
23:59,190874125.0,133.39301421356726,-18.99,6
23:59,853907490.0,9607.696784821112,-100.0,6
23:59,853907490.0,9591.706784821114,-15.99,1
23:59,297823329.0,1019.9486499999992,-7.99,1
23:59,297823329.0,1003.9586499999992,-15.99,1
23:59,297823329.0,984.9686499999992,-18.99,6
23:59,426466211.0,-3536.4657499999994,-7.0,1
23:59,426466211.0,-3542.455749999999,-5.99,1
23:59,426466211.0,-3555.445749999999,-12.99,1
23:59,426466211.0,-3568.4357499999987,-12.99,1
23:59,426466211.0,-3587.4257499999985,-18.99,6
23:59,426466211.0,-3603.4157499999983,-15.99,1
23:59,426466211.0,-3703.4157499999983,-100.0,6
23:59,194023154.0,-2779.4246717847327,-15.99,1
23:59,194023154.0,-2787.4146717847325,-7.99,1
23:59,194023154.0,-2802.4046717847323,-14.99,1
23:59,194023154.0,-2808.394671784732,-5.99,1
23:59,194023154.0,-2814.384671784732,-5.99,1
23:59,816685391.0,-604.7944037084264,-18.99,6
23:59,816685391.0,-612.7844037084265,-7.99,1
23:59,816685391.0,-619.7844037084265,-7.0,1
23:59,816685391.0,-634.7744037084265,-14.99,1
23:59,137822385.0,4524.528703161885,-5.99,1
23:59,137822385.0,4516.538703161885,-7.99,7
23:59,137822385.0,4497.548703161885,-18.99,6
23:59,280268430.0,6635.11900606806,-18.99,6
23:59,761272540.0,378.09199999999873,-7.99,1
23:59,761272540.0,362.1019999999987,-15.99,1
23:59,761272540.0,347.1119999999987,-14.99,1
23:59,761272540.0,334.1219999999987,-12.99,1
23:59,761272540.0,328.1319999999987,-5.99,1
23:59,761272540.0,313.1419999999987,-14.99,1
23:59,761272540.0,294.1519999999987,-18.99,6
23:59,775790822.0,-3407.948419216067,-12.99,1
23:59,775790822.0,-3414.948419216067,-7.0,1
23:59,775790822.0,-3421.948419216067,-7.0,1
23:59,775790822.0,-3440.938419216067,-18.99,6
23:59,775790822.0,-3448.9284192160667,-7.99,7
23:59,166019891.0,9856.58658722748,-15.99,1
23:59,166019891.0,9837.59658722748,-18.99,6
23:59,977899503.0,163.26089358085267,-15.99,1
23:59,977899503.0,156.26089358085267,-7.0,1
23:59,977899503.0,141.27089358085266,-14.99,1
23:59,977899503.0,135.28089358085265,-5.99,1
23:59,977899503.0,116.29089358085264,-18.99,6
23:59,304455868.0,1395.7358798978748,-18.99,6
23:59,304455868.0,1387.7458798978748,-7.99,1
23:59,304455868.0,1371.7558798978748,-15.99,1
23:59,304455868.0,1365.7658798978748,-5.99,1
23:59,304455868.0,1352.7758798978748,-12.99,1
23:59,304455868.0,1346.7858798978748,-5.99,1
23:59,304455868.0,1331.7958798978748,-14.99,1
23:59,108931112.0,16947.873206981683,-15.99,1
23:59,108931112.0,16939.88320698168,-7.99,7
23:59,108931112.0,16933.89320698168,-5.99,1
23:59,108931112.0,16926.89320698168,-7.0,1
23:59,518378868.0,-1505.9449000000004,-12.99,1
23:59,518378868.0,-1513.9349000000004,-7.99,7
23:59,518378868.0,-1532.9249000000004,-18.99,6
23:59,537487133.0,313.85834999999946,-14.99,1
23:59,537487133.0,294.86834999999945,-18.99,6
23:59,537487133.0,278.87834999999944,-15.99,1
23:59,537487133.0,270.88834999999943,-7.99,1
23:59,537487133.0,170.88834999999943,-100.0,6
23:59,226703987.0,2493.8321365470747,-15.99,1
23:59,200080192.0,9995.95277175534,-100.0,6
23:59,200080192.0,9980.96277175534,-14.99,1
23:59,200080192.0,9974.97277175534,-5.99,1
23:59,200080192.0,9967.97277175534,-7.0,1
23:59,200080192.0,9961.982771755342,-5.99,1
23:59,200080192.0,9945.992771755342,-15.99,1
23:59,200080192.0,9938.002771755342,-7.99,7
23:59,200080192.0,9919.012771755342,-18.99,6
23:59,180719578.0,-4696.555249999994,-15.99,1
23:59,180719578.0,-4704.545249999994,-7.99,7
23:59,180719578.0,-4723.5352499999935,-18.99,6
23:59,180719578.0,-4738.525249999993,-14.99,1
23:59,651756497.0,18537.173620298407,-7.99,7
23:59,651756497.0,18521.183620298405,-15.99,1
23:59,651756497.0,18502.193620298403,-18.99,6
23:59,262767079.0,-1014.3365000000006,-18.99,6
23:59,262767079.0,-1030.3265000000006,-15.99,1
23:59,262767079.0,-1043.3165000000006,-12.99,1
23:59,262767079.0,-1058.3065000000006,-14.99,1
23:59,262767079.0,-1065.3065000000006,-7.0,1
23:59,262767079.0,-1080.2965000000006,-14.99,1
23:59,262767079.0,-1180.2965000000006,-100.0,6
23:59,176922958.0,2487.58054719765,-18.99,6
23:59,176922958.0,2471.5905471976503,-15.99,1
23:59,176922958.0,2463.6005471976505,-7.99,7
23:59,474301748.0,-2621.3290056839674,-15.99,1
23:59,474301748.0,-2629.319005683967,-7.99,1
23:59,474301748.0,-2642.309005683967,-12.99,1
23:59,474301748.0,-2661.2990056839667,-18.99,6
23:59,757115616.0,2381.4100000000044,-18.99,6
23:59,890830949.0,683.6989499999975,-7.99,1
23:59,890830949.0,675.7089499999975,-7.99,7
23:59,890830949.0,669.7189499999974,-5.99,1
23:59,168414279.0,482.07728427492134,-18.99,6
23:59,168414279.0,474.0872842749214,-7.99,1
23:59,675231808.0,19229.65413259353,-18.99,6
23:59,675231808.0,19214.664132593527,-14.99,1
23:59,675231808.0,19208.674132593525,-5.99,1
23:59,675231808.0,19202.684132593524,-5.99,1
23:59,675231808.0,19187.69413259352,-14.99,1
23:59,675231808.0,19179.70413259352,-7.99,7
23:59,348460748.0,202.01514999999895,-18.99,6
23:59,348460748.0,186.02514999999897,-15.99,1
23:59,348460748.0,178.03514999999896,-7.99,1
23:59,565175333.0,-4219.568522729825,-7.0,1
23:59,565175333.0,-4238.558522729825,-18.99,6
23:59,565175333.0,-4254.548522729825,-15.99,1
23:59,925659248.0,-583.3320892295711,-18.99,6
23:59,925659248.0,-599.3220892295711,-15.99,1
23:59,925659248.0,-607.3120892295711,-7.99,1
23:59,668692488.0,1599.424241057584,-15.99,1
23:59,668692488.0,1580.434241057584,-18.99,6
23:59,923322792.0,-346.74433175363765,-15.99,1
23:59,923322792.0,-354.73433175363766,-7.99,7
23:59,923322792.0,-373.72433175363767,-18.99,6
23:59,923322792.0,-473.72433175363767,-100.0,6
23:59,588565416.0,7525.857151735635,-100.0,6
23:59,588565416.0,7506.867151735635,-18.99,6
23:59,588565416.0,7490.877151735635,-15.99,1
23:59,688712152.0,8051.407900262115,-15.99,1
23:59,688712152.0,8043.417900262115,-7.99,1
23:59,688712152.0,8024.427900262115,-18.99,6
23:59,749371623.0,-2758.084153517342,-7.99,1
23:59,655368335.0,4690.708129096231,-18.99,6
23:59,655368335.0,4682.718129096231,-7.99,1
23:59,655368335.0,4676.728129096231,-5.99,1
23:59,655368335.0,4663.738129096231,-12.99,1
23:59,979122276.0,-230.33303770567136,-18.99,6
23:59,979122276.0,-246.32303770567137,-15.99,1
23:59,979122276.0,-254.31303770567135,-7.99,7
23:59,405945930.0,4501.386219465057,-18.99,6
23:59,405945930.0,4485.396219465058,-15.99,1
23:59,405945930.0,4477.406219465058,-7.99,7
23:59,629078930.0,864.0838132670717,-14.99,1
23:59,629078930.0,845.0938132670717,-18.99,6
23:59,629078930.0,829.1038132670717,-15.99,1
23:59,629078930.0,821.1138132670717,-7.99,7
23:59,795847804.0,27266.80277809937,-15.99,1
23:59,795847804.0,27247.812778099367,-18.99,6
23:59,398429109.0,1957.407050000001,-15.99,1
23:59,398429109.0,1938.417050000001,-18.99,6
23:59,398429109.0,1925.427050000001,-12.99,1
23:59,398429109.0,1919.437050000001,-5.99,1
23:59,398429109.0,1906.447050000001,-12.99,1
23:59,398429109.0,1891.457050000001,-14.99,1
23:59,653667523.0,5594.173594121481,-15.99,1
23:59,653667523.0,5586.183594121481,-7.99,1
23:59,653667523.0,5573.1935941214815,-12.99,1
23:59,653667523.0,5558.203594121482,-14.99,1
23:59,653667523.0,5545.213594121482,-12.99,1
23:59,653667523.0,5538.213594121482,-7.0,1
23:59,612304466.0,-2298.313249999999,-12.99,1
23:59,612304466.0,-2311.3032499999986,-12.99,1
23:59,612304466.0,-2326.2932499999984,-14.99,1
23:59,612304466.0,-2345.283249999998,-18.99,6
23:59,612304466.0,-2353.273249999998,-7.99,1
23:59,612304466.0,-2369.2632499999977,-15.99,1
23:59,345582855.0,1243.644352820549,-15.99,1
23:59,441274121.0,14816.27474001242,-100.0,6
23:59,441274121.0,14797.28474001242,-18.99,6
23:59,441274121.0,14781.29474001242,-15.99,1
23:59,441274121.0,14773.30474001242,-7.99,1
23:59,441274121.0,14766.30474001242,-7.0,1
23:59,441274121.0,14760.31474001242,-5.99,1
23:59,151278285.0,1510.1974499999994,-15.99,1
23:59,151278285.0,1495.2074499999994,-14.99,1
23:59,151278285.0,1476.2174499999994,-18.99,6
23:59,642924505.0,656.305120183526,-14.99,1
23:59,642924505.0,649.305120183526,-7.0,1
23:59,550832673.0,4270.04601639551,-18.99,6
23:59,550832673.0,4254.056016395511,-15.99,1
23:59,550832673.0,4154.056016395511,-100.0,6
23:59,550832673.0,4147.056016395511,-7.0,1
23:59,699997811.0,1766.221850000003,-15.99,1
23:59,699997811.0,1758.2318500000033,-7.99,1
23:59,699997811.0,1739.2418500000033,-18.99,6
23:59,554771381.0,-1782.5611500000002,-18.99,6
23:59,534204159.0,6914.165426726899,-18.99,6
23:59,534204159.0,6906.175426726899,-7.99,7
23:59,283027736.0,853.2242439701728,-7.0,1
23:59,283027736.0,840.2342439701728,-12.99,1
23:59,283027736.0,827.2442439701728,-12.99,1
23:59,283027736.0,811.2542439701728,-15.99,1
23:59,283027736.0,711.2542439701728,-100.0,6
23:59,496865819.0,139.26156815731753,-100.0,6
23:59,496865819.0,131.27156815731752,-7.99,1
23:59,496865819.0,123.28156815731752,-7.99,7
23:59,496865819.0,116.28156815731752,-7.0,1
23:59,496865819.0,110.29156815731751,-5.99,1
23:59,496865819.0,103.29156815731751,-7.0,1
23:59,496865819.0,84.30156815731753,-18.99,6
23:59,868033067.0,-2541.130786451081,-7.0,1
23:59,868033067.0,-2554.1207864510807,-12.99,1
23:59,868033067.0,-2567.1107864510805,-12.99,1
23:59,868033067.0,-2583.10078645108,-15.99,1
23:59,868033067.0,-2591.09078645108,-7.99,7
23:59,879091637.0,82.77152373797709,-12.99,1
23:59,879091637.0,76.7815237379771,-5.99,1
23:59,879091637.0,63.791523737977094,-12.99,1
23:59,879091637.0,44.80152373797709,-18.99,6
23:59,879091637.0,28.81152373797709,-15.99,1
23:59,993238248.0,-148.69148739288391,-15.99,1
23:59,993238248.0,-156.68148739288392,-7.99,1
23:59,993238248.0,-162.67148739288393,-5.99,1
23:59,993238248.0,-262.67148739288393,-100.0,6
23:59,147508204.0,405.98471778188656,-15.99,1
23:59,147508204.0,397.99471778188655,-7.99,1
23:59,106601471.0,12108.625671464826,-12.99,1
23:59,106601471.0,12095.635671464826,-12.99,1
23:59,106601471.0,12088.635671464826,-7.0,1
23:59,106601471.0,12072.645671464828,-15.99,1
23:59,897592348.0,17846.051417711747,-12.99,1
23:59,897592348.0,17831.061417711746,-14.99,1
23:59,897592348.0,17812.071417711744,-18.99,6
23:59,897592348.0,17804.081417711743,-7.99,7
23:59,406862520.0,682.1686265374103,-15.99,1
23:59,406862520.0,674.1786265374103,-7.99,1
23:59,406862520.0,655.1886265374103,-18.99,6
23:59,406862520.0,640.1986265374103,-14.99,1
23:59,145553416.0,-2867.913149999998,-7.0,1
23:59,145553416.0,-2874.913149999998,-7.0,1
23:59,145553416.0,-2890.903149999998,-15.99,1
23:59,145553416.0,-2909.8931499999976,-18.99,6
23:59,527842638.0,1652.3900426329835,-14.99,1
23:59,527842638.0,1636.4000426329835,-15.99,1
23:59,527842638.0,1617.4100426329835,-18.99,6
23:59,527842638.0,1517.4100426329835,-100.0,6
23:59,709935470.0,728.0407376997723,-14.99,1
23:59,709935470.0,713.0507376997723,-14.99,1
23:59,709935470.0,700.0607376997723,-12.99,1
23:59,709935470.0,687.0707376997723,-12.99,1
23:59,709935470.0,668.0807376997723,-18.99,6
23:59,713641917.0,1574.9688459567872,-15.99,1
23:59,713641917.0,1566.9788459567872,-7.99,7
23:59,713641917.0,1547.9888459567871,-18.99,6
23:59,218795010.0,24.848449999999396,-7.99,7
23:59,818552503.0,1346.5380999999988,-100.0,6
23:59,818552503.0,1338.5480999999988,-7.99,1
23:59,818552503.0,1330.5580999999988,-7.99,7
23:59,564744955.0,695.059758588842,-100.0,6
23:59,564744955.0,679.069758588842,-15.99,1
23:59,564744955.0,671.079758588842,-7.99,7
23:59,454356905.0,3333.0140043613455,-7.99,1
23:59,627917561.0,4643.525050000007,-15.99,1
23:59,627917561.0,4635.535050000007,-7.99,7
23:59,627917561.0,4616.545050000007,-18.99,6
23:59,221868392.0,5789.072781209946,-7.0,1
23:59,221868392.0,5783.082781209946,-5.99,1
23:59,221868392.0,5768.092781209946,-14.99,1
23:59,221868392.0,5753.102781209946,-14.99,1
23:59,221868392.0,5737.112781209947,-15.99,1
23:59,221868392.0,5718.122781209947,-18.99,6
23:59,713910252.0,-579.472874271459,-12.99,1
23:59,713910252.0,-595.462874271459,-15.99,1
23:59,713910252.0,-603.452874271459,-7.99,1
23:59,567499591.0,-1657.3899000000004,-100.0,6
23:59,555393405.0,-389.8674000000003,-18.99,6
23:59,555393405.0,-397.8574000000003,-7.99,1
23:59,555393405.0,-413.84740000000033,-15.99,1
23:59,555393405.0,-419.83740000000034,-5.99,1
23:59,555393405.0,-434.8274000000003,-14.99,1
23:59,555393405.0,-534.8274000000004,-100.0,6
23:59,344219145.0,9966.753113232297,-15.99,1
23:59,416060965.0,944.1922547005804,-15.99,1
23:59,416060965.0,936.2022547005804,-7.99,7
23:59,604288474.0,2213.0053096997053,-7.99,1
23:59,604288474.0,2205.0153096997055,-7.99,7
23:59,604288474.0,2186.0253096997058,-18.99,6
23:59,604288474.0,2180.035309699706,-5.99,1
23:59,604288474.0,2173.035309699706,-7.0,1
23:59,620227043.0,-2072.512771013424,-15.99,1
23:59,570410059.0,2687.3221467763115,-18.99,6
23:59,570410059.0,2674.3321467763117,-12.99,1
23:59,570410059.0,2667.3321467763117,-7.0,1
23:59,570410059.0,2660.3321467763117,-7.0,1
23:59,263882093.0,-1011.7538000000006,-15.99,1
23:59,263882093.0,-1024.7438000000006,-12.99,1
23:59,263882093.0,-1037.7338000000009,-12.99,1
23:59,263882093.0,-1044.7338000000009,-7.0,1
23:59,263882093.0,-1059.723800000001,-14.99,1
23:59,263882093.0,-1159.723800000001,-100.0,6
23:59,263882093.0,-1178.713800000001,-18.99,6
23:59,799286313.0,-582.0216128758616,-18.99,6
23:59,799286313.0,-590.0116128758616,-7.99,1
23:59,799286313.0,-690.0116128758616,-100.0,6
23:59,346874167.0,522.504249999999,-18.99,6
23:59,346874167.0,509.51424999999904,-12.99,1
23:59,346874167.0,494.52424999999903,-14.99,1
23:59,346874167.0,487.52424999999903,-7.0,1
23:59,346874167.0,472.534249999999,-14.99,1
23:59,346874167.0,456.544249999999,-15.99,1
23:59,240643705.0,795.130079620568,-5.99,1
23:59,240643705.0,789.140079620568,-5.99,1
23:59,240643705.0,773.150079620568,-15.99,1
23:59,240643705.0,765.160079620568,-7.99,7
23:59,240643705.0,746.170079620568,-18.99,6
23:59,240643705.0,646.170079620568,-100.0,6
23:59,842682241.0,4737.080774877892,-15.99,1
23:59,842682241.0,4729.090774877892,-7.99,7
23:59,842682241.0,4723.100774877892,-5.99,1
23:59,842682241.0,4716.100774877892,-7.0,1
23:59,499410772.0,-2868.789362905162,-7.0,1
23:59,499410772.0,-2874.7793629051616,-5.99,1
23:59,499410772.0,-2880.7693629051614,-5.99,1
23:59,499410772.0,-2893.759362905161,-12.99,1
23:59,499410772.0,-2993.759362905161,-100.0,6
23:59,108481285.0,10862.29894899539,-7.99,1
23:59,108481285.0,10854.30894899539,-7.99,7
23:59,108481285.0,10835.318948995391,-18.99,6
23:59,480557476.0,13632.63968891818,-7.99,1
23:59,480557476.0,13532.63968891818,-100.0,6
23:59,480557476.0,13513.64968891818,-18.99,6
23:59,480557476.0,13498.65968891818,-14.99,1
23:59,480557476.0,13491.65968891818,-7.0,1
23:59,480557476.0,13476.66968891818,-14.99,1
23:59,621181115.0,135.8597504292289,-18.99,6
23:59,621181115.0,119.86975042922892,-15.99,1
23:59,621181115.0,111.87975042922892,-7.99,7
23:59,779236304.0,2667.187595479534,-7.99,1
23:59,779236304.0,2651.1975954795344,-15.99,1
23:59,779236304.0,2636.2075954795346,-14.99,1
23:59,779236304.0,2630.217595479535,-5.99,1
23:59,779236304.0,2623.217595479535,-7.0,1
23:59,779236304.0,2617.227595479535,-5.99,1
23:59,779236304.0,2517.227595479535,-100.0,6
23:59,779236304.0,2498.2375954795352,-18.99,6
23:59,605711527.0,91.23351383258364,-18.99,6
23:59,605711527.0,75.24351383258366,-15.99,1
23:59,605711527.0,67.25351383258366,-7.99,1
23:59,329840194.0,1888.952290143148,-14.99,1
23:59,329840194.0,1873.962290143148,-14.99,1
23:59,329840194.0,1865.972290143148,-7.99,1
23:59,329840194.0,1846.982290143148,-18.99,6
23:59,586315521.0,14375.321788954345,-12.99,1
23:59,586315521.0,14368.321788954345,-7.0,1
23:59,586315521.0,14362.331788954343,-5.99,1
23:59,586315521.0,14354.341788954343,-7.99,1
23:59,586315521.0,14335.351788954344,-18.99,6
23:59,324224854.0,6512.967550053518,-15.99,1
23:59,581618317.0,-5235.711701873204,-7.99,1
23:59,581618317.0,-5243.701701873204,-7.99,7
23:59,581618317.0,-5250.701701873204,-7.0,1
23:59,581618317.0,-5265.691701873204,-14.99,1
23:59,581618317.0,-5284.681701873204,-18.99,6
23:59,581618317.0,-5384.681701873204,-100.0,6
23:59,587225252.0,7444.857698566697,-18.99,6
23:59,104832000.0,-3042.4648589058443,-15.99,1
23:59,104832000.0,-3142.4648589058443,-100.0,6
23:59,104832000.0,-3149.4648589058443,-7.0,1
23:59,792845450.0,1273.7011500000008,-7.99,7
23:59,792845450.0,1258.7111500000008,-14.99,1
23:59,792845450.0,1243.7211500000008,-14.99,1
23:59,792845450.0,1237.7311500000008,-5.99,1
23:59,792845450.0,1222.7411500000007,-14.99,1
23:59,792845450.0,1122.7411500000007,-100.0,6
23:59,792845450.0,1103.7511500000007,-18.99,6
23:59,535804582.0,814.7172999999987,-15.99,1
23:59,535804582.0,799.7272999999986,-14.99,1
23:59,535804582.0,699.7272999999986,-100.0,6
23:59,535804582.0,680.7372999999986,-18.99,6
23:59,250957494.0,1199.2827499999985,-15.99,1
23:59,250957494.0,1191.2927499999985,-7.99,1
23:59,250957494.0,1185.3027499999985,-5.99,1
23:59,250957494.0,1178.3027499999985,-7.0,1
23:59,250957494.0,1171.3027499999985,-7.0,1
23:59,250957494.0,1164.3027499999985,-7.0,1
23:59,250957494.0,1145.3127499999985,-18.99,6
23:59,250957494.0,1045.3127499999985,-100.0,6
23:59,551755686.0,8484.49992665415,-15.99,1
23:59,551755686.0,8477.49992665415,-7.0,1
23:59,551755686.0,8458.509926654151,-18.99,6
23:59,632065391.0,-1098.3086499999995,-18.99,6
23:59,290751280.0,886.7422466748255,-12.99,1
23:59,290751280.0,880.7522466748255,-5.99,1
23:59,290751280.0,873.7522466748255,-7.0,1
23:59,199016328.0,6505.151035099075,-15.99,1
23:59,868377987.0,3907.49564617788,-5.99,1
23:59,868377987.0,3892.50564617788,-14.99,1
23:59,868377987.0,3879.5156461778806,-12.99,1
23:59,868377987.0,3860.525646177881,-18.99,6
23:59,868377987.0,3844.535646177881,-15.99,1
23:59,868377987.0,3836.5456461778817,-7.99,7
23:59,779946617.0,19449.986042219425,-15.99,1
23:59,779946617.0,19441.996042219424,-7.99,7
23:59,779946617.0,19423.006042219426,-18.99,6
23:59,598586358.0,-3693.972449999995,-18.99,6
23:59,598586358.0,-3709.9624499999945,-15.99,1
23:59,598586358.0,-3717.9524499999943,-7.99,1
23:59,611143859.0,3786.437400000013,-14.99,1
23:59,611143859.0,3779.437400000013,-7.0,1
23:59,611143859.0,3760.4474000000127,-18.99,6
23:59,611143859.0,3744.457400000013,-15.99,1
23:59,611143859.0,3736.467400000013,-7.99,1
23:59,131388684.0,25194.38875898358,-15.99,1
23:59,131388684.0,25167.408758983576,-18.99,6
23:59,131388684.0,25152.418758983575,-14.99,1
23:59,131388684.0,25137.428758983573,-14.99,1
23:59,131388684.0,25130.428758983573,-7.0,1
23:59,131388684.0,25123.428758983573,-7.0,1
23:59,131388684.0,25023.428758983573,-100.0,6
23:59,373875019.0,20040.779900423346,-12.99,1
23:59,373875019.0,20025.78990042334,-14.99,1
23:59,373875019.0,20019.79990042334,-5.99,1
23:59,373875019.0,20004.809900423337,-14.99,1
23:59,373875019.0,19985.819900423336,-18.99,6
23:59,373875019.0,19969.829900423338,-15.99,1
23:59,373875019.0,19961.839900423332,-7.99,1
23:59,630468201.0,-362.52568388970167,-18.99,6
23:59,630468201.0,-375.5156838897017,-12.99,1
23:59,630468201.0,-390.5056838897017,-14.99,1
23:59,630468201.0,-405.4956838897017,-14.99,1
23:59,630468201.0,-421.4856838897017,-15.99,1
23:59,655450953.0,-2987.702378455529,-15.99,1
23:59,655450953.0,-3006.692378455529,-18.99,6
23:59,491392945.0,7083.089500000011,-7.0,1
23:59,491392945.0,7070.099500000011,-12.99,1
23:59,491392945.0,7064.109500000011,-5.99,1
23:59,491392945.0,7056.119500000012,-7.99,1
23:59,491392945.0,7048.129500000012,-7.99,7
23:59,491392945.0,7029.139500000012,-18.99,6
23:59,308505160.0,15998.921880601309,-14.99,1
23:59,308505160.0,15992.931880601309,-5.99,1
23:59,308505160.0,15985.931880601309,-7.0,1
23:59,308505160.0,15979.941880601307,-5.99,1
23:59,823208989.0,227.42170386953185,-15.99,1
23:59,823208989.0,219.43170386953184,-7.99,1
23:59,823208989.0,200.4417038695318,-18.99,6
23:59,722358036.0,274.4735906270828,-18.99,6
23:59,722358036.0,258.4835906270828,-15.99,1
23:59,722358036.0,250.49359062708277,-7.99,7
23:59,444371478.0,630.2241499999986,-15.99,1
23:59,444371478.0,611.2341499999986,-18.99,6
23:59,681955876.0,-1233.4781000000005,-7.99,1
23:59,779816907.0,-3163.1360829229097,-7.99,7
23:59,779816907.0,-3171.1260829229095,-7.99,1
23:59,779816907.0,-3178.1260829229095,-7.0,1
23:59,779816907.0,-3191.1160829229093,-12.99,1
23:59,779816907.0,-3198.1160829229093,-7.0,1
23:59,779816907.0,-3217.106082922909,-18.99,6
23:59,704517789.0,20197.43219583166,-12.99,1
23:59,704517789.0,20181.44219583166,-15.99,1
23:59,704517789.0,20162.452195831655,-18.99,6
23:59,727417797.0,6037.145513045319,-7.99,1
23:59,727417797.0,6029.155513045319,-7.99,7
23:59,727417797.0,6010.165513045319,-18.99,6
23:59,246753533.0,757.6076999999982,-15.99,1
23:59,246753533.0,749.6176999999982,-7.99,1
23:59,246753533.0,649.6176999999982,-100.0,6
23:59,722971557.0,-387.3182791569245,-5.99,1
23:59,722971557.0,-393.3082791569245,-5.99,1
23:59,722971557.0,-409.29827915692454,-15.99,1
23:59,722971557.0,-417.28827915692455,-7.99,7
23:59,722971557.0,-436.27827915692455,-18.99,6
23:59,552980092.0,202.98071911933755,-15.99,1
23:59,552980092.0,194.9907191193375,-7.99,7
23:59,552980092.0,176.00071911933753,-18.99,6
23:59,552980092.0,169.00071911933753,-7.0,1
23:59,552980092.0,162.00071911933753,-7.0,1
23:59,552980092.0,149.01071911933752,-12.99,1
23:59,607629901.0,-4693.028319908142,-5.99,1
23:59,607629901.0,-4708.018319908142,-14.99,1
23:59,607629901.0,-4721.008319908142,-12.99,1
23:59,607629901.0,-4736.998319908142,-15.99,1
23:59,607629901.0,-4836.998319908142,-100.0,6
23:59,264550521.0,7320.551154915853,-15.99,1
23:59,264550521.0,7312.561154915853,-7.99,7
23:59,264550521.0,7297.571154915853,-14.99,1
23:59,264550521.0,7290.571154915853,-7.0,1
23:59,264550521.0,7284.581154915853,-5.99,1
23:59,264550521.0,7278.591154915854,-5.99,1
23:59,303843160.0,596.4068000000013,-15.99,1
23:59,303843160.0,577.4168000000013,-18.99,6
23:59,866941383.0,3248.658480303673,-15.99,1
23:59,866941383.0,3229.6684803036733,-18.99,6
23:59,866941383.0,3223.6784803036735,-5.99,1
23:59,866941383.0,3208.6884803036737,-14.99,1
23:59,866941383.0,3195.698480303674,-12.99,1
23:59,426474982.0,-4017.06475,-15.99,1
23:59,158414827.0,-1420.025000000002,-100.0,6
23:59,158414827.0,-1436.015000000002,-15.99,1
23:59,158414827.0,-1455.005000000002,-18.99,6
23:59,158414827.0,-1462.005000000002,-7.0,1
23:59,158414827.0,-1476.995000000002,-14.99,1
23:59,158414827.0,-1482.985000000002,-5.99,1
23:59,158414827.0,-1497.975000000002,-14.99,1
23:59,518466565.0,2098.3127999999992,-100.0,6
23:59,812012103.0,-417.6643000000004,-7.99,7
23:59,812012103.0,-424.6643000000004,-7.0,1
23:59,812012103.0,-437.6543000000004,-12.99,1
23:59,812012103.0,-443.6443000000004,-5.99,1
23:59,834383043.0,6333.523236180321,-18.99,6
23:59,834383043.0,6317.533236180321,-15.99,1
23:59,834383043.0,6304.543236180321,-12.99,1
23:59,834383043.0,6291.553236180322,-12.99,1
23:59,834383043.0,6285.563236180322,-5.99,1
23:59,834383043.0,6185.563236180322,-100.0,6
23:59,556631012.0,644.976373085678,-15.99,1
23:59,556631012.0,636.986373085678,-7.99,7
23:59,556631012.0,617.996373085678,-18.99,6
23:59,556631012.0,517.996373085678,-100.0,6
23:59,390747457.0,995.8723999999976,-15.99,1
23:59,390747457.0,987.8823999999976,-7.99,7
23:59,390747457.0,974.8923999999976,-12.99,1
23:59,390747457.0,959.9023999999976,-14.99,1
23:59,390747457.0,944.9123999999975,-14.99,1
23:59,390747457.0,931.9223999999977,-12.99,1
23:59,390747457.0,912.9323999999976,-18.99,6
23:59,427909748.0,2313.643200000015,-18.99,6
23:59,427909748.0,2305.6532000000157,-7.99,1
23:59,427909748.0,2297.663200000016,-7.99,7
23:59,427909748.0,2284.673200000016,-12.99,1
23:59,407574996.0,2267.429609380937,-7.99,1
23:59,407574996.0,2259.4396093809373,-7.99,7
23:59,407574996.0,2159.4396093809373,-100.0,6
23:59,348525881.0,666.9166245949358,-18.99,6
23:59,348525881.0,651.9266245949358,-14.99,1
23:59,348525881.0,636.9366245949358,-14.99,1
23:59,348525881.0,623.9466245949358,-12.99,1
23:59,348525881.0,615.9566245949358,-7.99,1
23:59,670427480.0,1125.8197000000011,-5.99,1
23:59,670427480.0,1118.8197000000011,-7.0,1
23:59,670427480.0,1105.8297000000011,-12.99,1
23:59,670427480.0,1099.8397000000011,-5.99,1
23:59,670427480.0,1083.8497000000011,-15.99,1
23:59,670427480.0,1075.859700000001,-7.99,1
23:59,821971408.0,1448.0951102355432,-14.99,1
23:59,821971408.0,1435.1051102355432,-12.99,1
23:59,821971408.0,1419.1151102355432,-15.99,1
23:59,821971408.0,1411.1251102355432,-7.99,1
23:59,821971408.0,1392.1351102355432,-18.99,6
23:59,895331556.0,59.57879999999909,-100.0,6
23:59,895331556.0,43.58879999999909,-15.99,1
23:59,895331556.0,36.58879999999909,-7.0,1
23:59,895331556.0,23.598799999999088,-12.99,1
23:59,895331556.0,17.608799999999086,-5.99,1
23:59,895331556.0,-1.3812000000009128,-18.99,6
23:59,679662108.0,18661.239026487347,-15.99,1
23:59,679662108.0,18642.249026487345,-18.99,6
23:59,494156986.0,89.12904567233456,-15.99,1
23:59,494156986.0,81.13904567233456,-7.99,1
23:59,494156986.0,-18.86095432766544,-100.0,6
23:59,494156986.0,-33.85095432766544,-14.99,1
23:59,494156986.0,-46.84095432766544,-12.99,1
23:59,494156986.0,-52.830954327665445,-5.99,1
23:59,494156986.0,-65.82095432766545,-12.99,1
23:59,494156986.0,-84.81095432766544,-18.99,6
23:59,370521542.0,30776.09314615495,-7.99,1
23:59,370521542.0,30760.10314615495,-15.99,1
23:59,370521542.0,30741.11314615495,-18.99,6
23:59,980500334.0,-741.4719338929037,-7.99,1
23:59,128033695.0,3230.3978188047276,-18.99,6
23:59,128033695.0,3214.407818804728,-15.99,1
23:59,128033695.0,3206.417818804728,-7.99,1
23:59,878989510.0,5696.8534678153665,-15.99,1
23:59,878989510.0,5677.863467815367,-18.99,6
23:59,878989510.0,5664.873467815367,-12.99,1
23:59,878989510.0,5657.873467815367,-7.0,1
23:59,585625048.0,3296.069974999358,-15.99,1
23:59,585625048.0,3288.079974999358,-7.99,7
23:59,585625048.0,3269.089974999358,-18.99,6
23:59,585625048.0,3262.089974999358,-7.0,1
23:59,585625048.0,3249.0999749993584,-12.99,1
23:59,585625048.0,3236.1099749993587,-12.99,1
23:59,783650950.0,-500.4306434110117,-12.99,1
23:59,783650950.0,-506.4206434110117,-5.99,1
23:59,783650950.0,-522.4106434110117,-15.99,1
23:59,783650950.0,-530.4006434110117,-7.99,1
23:59,783650950.0,-549.3906434110118,-18.99,6
23:59,835829467.0,-1495.984749999998,-15.99,1
23:59,835829467.0,-1510.974749999998,-14.99,1
23:59,835829467.0,-1516.964749999998,-5.99,1
23:59,835829467.0,-1535.954749999998,-18.99,6
23:59,835829467.0,-1635.954749999998,-100.0,6
23:59,285220959.0,13585.185037241055,-15.99,1
23:59,285220959.0,13577.195037241056,-7.99,1
23:59,285220959.0,13564.205037241056,-12.99,1
23:59,285220959.0,13551.215037241056,-12.99,1
23:59,285220959.0,13536.225037241056,-14.99,1
23:59,285220959.0,13521.235037241056,-14.99,1
23:59,660874296.0,324.5574499608499,-7.99,7
23:59,660874296.0,305.5674499608499,-18.99,6
23:59,660874296.0,292.5774499608499,-12.99,1
23:59,660874296.0,277.5874499608499,-14.99,1
23:59,395654270.0,-2165.9737028122,-18.99,6
23:59,395654270.0,-2181.9637028121997,-15.99,1
23:59,395654270.0,-2188.9637028121997,-7.0,1
23:59,395654270.0,-2195.9637028121997,-7.0,1
23:59,395654270.0,-2208.9537028121995,-12.99,1
23:59,403765849.0,-2604.4354999999964,-15.99,1
23:59,403765849.0,-2612.425499999996,-7.99,1
23:59,403765849.0,-2631.415499999996,-18.99,6
23:59,162162212.0,-128.66425667269095,-15.99,1
23:59,162162212.0,-136.65425667269096,-7.99,7
23:59,162162212.0,-155.64425667269097,-18.99,6
23:59,162162212.0,-162.64425667269097,-7.0,1
23:59,162162212.0,-177.63425667269098,-14.99,1
23:59,162162212.0,-184.63425667269095,-7.0,1
23:59,162162212.0,-197.624256672691,-12.99,1
23:59,455052690.0,390.5677399486276,-7.99,1
23:59,455052690.0,375.5777399486276,-14.99,1
23:59,455052690.0,369.5877399486276,-5.99,1
23:59,455052690.0,363.5977399486276,-5.99,1
23:59,455052690.0,348.60773994862757,-14.99,1
23:59,455052690.0,329.61773994862756,-18.99,6
23:59,316793091.0,1312.5231100549506,-14.99,1
23:59,316793091.0,1299.5331100549506,-12.99,1
23:59,316793091.0,1284.5431100549506,-14.99,1
23:59,316793091.0,1277.5431100549506,-7.0,1
23:59,316793091.0,1258.5531100549506,-18.99,6
23:59,316793091.0,1242.5631100549506,-15.99,1
23:59,316793091.0,1234.5731100549506,-7.99,7
23:59,930277104.0,10753.081339838003,-18.99,6
23:59,348325817.0,11220.620980263167,-100.0,6
23:59,348325817.0,11201.630980263168,-18.99,6
23:59,348325817.0,11185.640980263168,-15.99,1
23:59,690941877.0,-166.98503848250812,-15.99,1
23:59,690941877.0,-174.97503848250813,-7.99,1
23:59,690941877.0,-187.9650384825081,-12.99,1
23:59,690941877.0,-193.95503848250817,-5.99,1
23:59,690941877.0,-206.94503848250815,-12.99,1
23:59,382862215.0,-40.04100000000016,-15.99,1
23:59,382862215.0,-46.03100000000016,-5.99,1
23:59,382862215.0,-53.03100000000016,-7.0,1
23:59,382862215.0,-72.02100000000016,-18.99,6
23:59,382862215.0,-172.02100000000016,-100.0,6
23:59,899983008.0,-3350.931149999996,-15.99,1
23:59,899983008.0,-3358.9211499999956,-7.99,1
23:59,899983008.0,-3377.9111499999954,-18.99,6
23:59,899983008.0,-3383.901149999995,-5.99,1
23:59,899983008.0,-3483.901149999995,-100.0,6
23:59,339791565.0,-3746.016199999997,-15.99,1
23:59,339791565.0,-3765.006199999996,-18.99,6
23:59,339791565.0,-3865.006199999996,-100.0,6
23:59,143383029.0,-1103.3559193476613,-15.99,1
23:59,143383029.0,-1111.3459193476613,-7.99,7
23:59,143383029.0,-1118.3459193476613,-7.0,1
23:59,143383029.0,-1131.3359193476613,-12.99,1
23:59,357651163.0,-731.2100000000007,-15.99,1
23:59,357651163.0,-739.2000000000007,-7.99,1
23:59,357651163.0,-754.1900000000007,-14.99,1
23:59,357651163.0,-760.1800000000007,-5.99,1
23:59,357651163.0,-779.1700000000008,-18.99,6
23:59,812692024.0,4731.561590521822,-100.0,6
23:59,812692024.0,4715.571590521822,-15.99,1
23:59,812692024.0,4707.581590521822,-7.99,1
23:59,812692024.0,4688.591590521823,-18.99,6
23:59,812692024.0,4682.601590521823,-5.99,1
23:59,812692024.0,4676.611590521823,-5.99,1
23:59,812692024.0,4669.611590521823,-7.0,1
23:59,812692024.0,4656.621590521823,-12.99,1
23:59,905860285.0,14657.36680294388,-7.99,1
23:59,179173981.0,5127.225220852742,-15.99,1
23:59,179173981.0,5119.235220852742,-7.99,7
23:59,179173981.0,5100.245220852742,-18.99,6
23:59,179173981.0,5000.245220852742,-100.0,6
23:59,493855007.0,-2838.1766315743916,-7.0,1
23:59,493855007.0,-2854.166631574391,-15.99,1
23:59,687135796.0,32876.780337886106,-7.99,1
23:59,687135796.0,32863.79033788611,-12.99,1
23:59,687135796.0,32850.80033788611,-12.99,1
23:59,687135796.0,32843.80033788611,-7.0,1
23:59,764450279.0,24424.709137873662,-15.99,1
23:59,764450279.0,24405.71913787366,-18.99,6
23:59,603375739.0,2376.8730630232676,-15.99,1
23:59,550644516.0,-171.70635000000152,-15.99,1
23:59,550644516.0,-179.69635000000153,-7.99,7
23:59,550644516.0,-198.6863500000015,-18.99,6
23:59,550644516.0,-204.67635000000155,-5.99,1
23:59,286484726.0,1327.2736391525707,-18.99,6
23:59,965038148.0,510.0374856323278,-7.99,1
23:59,965038148.0,491.0474856323277,-18.99,6
23:59,245198540.0,607.3663988017795,-7.99,7
23:59,245198540.0,507.3663988017795,-100.0,6
23:59,804317849.0,-4127.631633020518,-7.99,1
23:59,804317849.0,-4143.621633020518,-15.99,1
23:59,804317849.0,-4150.621633020518,-7.0,1
23:59,804317849.0,-4163.611633020518,-12.99,1
23:59,804317849.0,-4176.6016330205175,-12.99,1
23:59,804317849.0,-4195.591633020517,-18.99,6
23:59,430910686.0,738.6322000000005,-15.99,1
23:59,430910686.0,730.6422000000005,-7.99,7
23:59,624563756.0,313.7062287835565,-18.99,6
23:59,624563756.0,298.7162287835565,-14.99,1
23:59,624563756.0,283.7262287835565,-14.99,1
23:59,624563756.0,276.7262287835565,-7.0,1
23:59,624563756.0,261.7362287835565,-14.99,1
23:59,624563756.0,253.7462287835565,-7.99,1
23:59,624563756.0,245.75622878355648,-7.99,7
23:59,624563756.0,145.75622878355648,-100.0,6
23:59,893134725.0,1731.467700776119,-18.99,6
23:59,893134725.0,1715.477700776119,-15.99,1
23:59,261793952.0,-172.49573979618503,-15.99,1
23:59,261793952.0,-180.48573979618504,-7.99,1
23:59,261793952.0,-199.47573979618505,-18.99,6
23:59,261793952.0,-212.46573979618503,-12.99,1
23:59,261793952.0,-225.45573979618507,-12.99,1
23:59,261793952.0,-238.44573979618508,-12.99,1
23:59,261793952.0,-251.4357397961851,-12.99,1
23:59,261793952.0,-351.4357397961851,-100.0,6
23:59,134847904.0,3302.7719834790696,-15.99,1
23:59,134847904.0,3294.78198347907,-7.99,7
23:59,134847904.0,3288.79198347907,-5.99,1
23:59,134847904.0,3273.8019834790703,-14.99,1
23:59,134847904.0,3267.8119834790705,-5.99,1
23:59,134847904.0,3248.8219834790707,-18.99,6
23:59,134847904.0,3148.8219834790707,-100.0,6
23:59,767447966.0,6121.647922706574,-12.99,1
23:59,767447966.0,6114.647922706574,-7.0,1
23:59,767447966.0,6098.657922706574,-15.99,1
23:59,767447966.0,6090.667922706574,-7.99,1
23:59,767447966.0,6071.6779227065745,-18.99,6
23:59,767447966.0,5971.6779227065745,-100.0,6
23:59,215311171.0,6278.082865502607,-7.99,1
23:59,215311171.0,6262.092865502607,-15.99,1
23:59,215311171.0,6243.1028655026075,-18.99,6
23:59,215311171.0,6143.1028655026075,-100.0,6
23:59,446720287.0,-1127.9675591815949,-18.99,6
23:59,760753808.0,527.9254999999994,-18.99,6
23:59,138969884.0,741.4620999999995,-15.99,1
23:59,138969884.0,735.4720999999995,-5.99,1
23:59,138969884.0,729.4820999999995,-5.99,1
23:59,138969884.0,710.4920999999995,-18.99,6
23:59,995615876.0,2529.708461877259,-14.99,1
23:59,995615876.0,2516.7184618772594,-12.99,1
23:59,995615876.0,2510.7284618772596,-5.99,1
23:59,647936800.0,2138.640379985134,-15.99,1
23:59,647936800.0,2130.6503799851344,-7.99,7
23:59,647936800.0,2030.6503799851344,-100.0,6
23:59,277562576.0,370.2521699762571,-18.99,6
23:59,277562576.0,362.2621699762571,-7.99,1
23:59,277562576.0,354.27216997625715,-7.99,7
23:59,237684254.0,7227.236631337017,-15.99,1
23:59,237684254.0,7219.246631337017,-7.99,1
23:59,237684254.0,7200.256631337017,-18.99,6
23:59,237684254.0,7185.266631337017,-14.99,1
23:59,237684254.0,7172.2766313370175,-12.99,1
23:59,237684254.0,7157.286631337018,-14.99,1
23:59,175452235.0,-519.5382499999996,-18.99,6
23:59,175452235.0,-534.5282499999996,-14.99,1
23:59,175452235.0,-547.5182499999996,-12.99,1
23:59,986774156.0,2076.5969316257692,-100.0,6
23:59,859603181.0,4203.181645335317,-14.99,1
23:59,859603181.0,4197.191645335317,-5.99,1
23:59,145387690.0,6498.442329695629,-15.99,1
23:59,145387690.0,6485.4523296956295,-12.99,1
23:59,145387690.0,6478.4523296956295,-7.0,1
23:59,145387690.0,6378.4523296956295,-100.0,6
23:59,762785862.0,1172.5248999999992,-100.0,6
23:59,768271776.0,-422.93224676657974,-18.99,6
23:59,768271776.0,-438.92224676657975,-15.99,1
23:59,768271776.0,-446.91224676657976,-7.99,7
23:59,672913754.0,13670.72368710861,-15.99,1
23:59,672913754.0,13664.73368710861,-5.99,1
23:59,672913754.0,13651.74368710861,-12.99,1
23:59,672913754.0,13638.75368710861,-12.99,1
23:59,672913754.0,13631.75368710861,-7.0,1
23:59,340680761.0,-3333.5730999999964,-15.99,1
23:59,340680761.0,-3341.563099999996,-7.99,7
23:59,340680761.0,-3360.553099999996,-18.99,6
23:59,340680761.0,-3367.553099999996,-7.0,1
23:59,713057426.0,-1072.7892500000005,-18.99,6
23:59,713057426.0,-1080.7792500000005,-7.99,1
23:59,713057426.0,-1180.7792500000005,-100.0,6
23:59,713057426.0,-1195.7692500000005,-14.99,1
23:59,713057426.0,-1202.7692500000005,-7.0,1
23:59,422955974.0,440.1419349990499,-7.99,1
23:59,422955974.0,421.1519349990499,-18.99,6
23:59,672994751.0,463.2062907860099,-7.99,1
23:59,672994751.0,455.2162907860099,-7.99,7
23:59,672994751.0,436.22629078600994,-18.99,6
23:59,592961759.0,-1749.3748000000005,-7.99,1
23:59,592961759.0,-1765.3648000000003,-15.99,1
23:59,843174694.0,-5761.613499999998,-18.99,6
23:59,256045540.0,-3956.703899999999,-18.99,6
23:59,680773155.0,1054.4671833310913,-100.0,6
23:59,680773155.0,1038.4771833310913,-15.99,1
23:59,680773155.0,1030.4871833310913,-7.99,7
23:59,680773155.0,1011.4971833310912,-18.99,6
23:59,417850087.0,18195.799129727464,-15.99,1
23:59,417850087.0,18176.809129727462,-18.99,6
23:59,417850087.0,18161.81912972746,-14.99,1
23:59,417850087.0,18155.82912972746,-5.99,1
23:59,417850087.0,18142.839129727457,-12.99,1
23:59,116598243.0,3718.322221777451,-5.99,1
23:59,116598243.0,3712.332221777451,-5.99,1
23:59,116598243.0,3696.3422217774514,-15.99,1
23:59,354894456.0,-76.31000000000039,-14.99,1
23:59,354894456.0,-82.30000000000038,-5.99,1
23:59,354894456.0,-89.30000000000038,-7.0,1
23:59,354894456.0,-96.30000000000038,-7.0,1
23:59,354894456.0,-112.29000000000038,-15.99,1
23:59,354894456.0,-131.28000000000037,-18.99,6
23:59,824916823.0,9988.996125017093,-14.99,1
23:59,824916823.0,9981.006125017091,-7.99,1
23:59,824916823.0,9962.016125017091,-18.99,6
23:59,130154096.0,1360.1711481961063,-15.99,1
23:59,477216513.0,-96.98219999999944,-18.99,6
23:59,876890798.0,2872.2457706999344,-18.99,6
23:59,876890798.0,2856.2557706999346,-15.99,1
23:59,876890798.0,2848.265770699935,-7.99,1
23:59,876890798.0,2748.265770699935,-100.0,6
23:59,673818591.0,1747.6921753758404,-15.99,1
23:59,120634201.0,6340.16869192003,-15.99,1
23:59,197865285.0,459.3633117312204,-15.99,1
23:59,197865285.0,451.3733117312204,-7.99,1
23:59,310620484.0,374.2211950921983,-12.99,1
23:59,310620484.0,361.2311950921983,-12.99,1
23:59,310620484.0,348.24119509219827,-12.99,1
23:59,310620484.0,342.25119509219826,-5.99,1
23:59,310620484.0,326.26119509219825,-15.99,1
23:59,310620484.0,318.27119509219824,-7.99,1
23:59,310620484.0,299.28119509219823,-18.99,6
23:59,639420537.0,-1260.2139499999998,-18.99,6
23:59,639420537.0,-1268.2039499999998,-7.99,7
23:59,639420537.0,-1276.19395,-7.99,1
23:59,639420537.0,-1282.18395,-5.99,1
23:59,969697937.0,-5130.945265670551,-12.99,1
23:59,969697937.0,-5136.9352656705505,-5.99,1
23:59,969697937.0,-5142.92526567055,-5.99,1
23:59,969697937.0,-5158.91526567055,-15.99,1
23:59,969697937.0,-5166.90526567055,-7.99,1
23:59,969697937.0,-5266.90526567055,-100.0,6
23:59,969697937.0,-5285.89526567055,-18.99,6
23:59,293191074.0,1210.568149999999,-15.99,1
23:59,293191074.0,1203.568149999999,-7.0,1
23:59,293191074.0,1196.568149999999,-7.0,1
23:59,536924114.0,-725.2147055930961,-7.99,1
23:59,536924114.0,-733.2047055930962,-7.99,7
23:59,536924114.0,-833.2047055930962,-100.0,6
23:59,536924114.0,-852.1947055930962,-18.99,6
23:59,322720763.0,8349.955803671503,-7.99,1
23:59,659415300.0,2764.254296218074,-5.99,1
23:59,659415300.0,2749.2642962180744,-14.99,1
23:59,659415300.0,2736.2742962180746,-12.99,1
23:59,659415300.0,2717.284296218075,-18.99,6
23:59,659415300.0,2701.294296218075,-15.99,1
23:59,274818272.0,670.2775785671313,-18.99,6
23:59,274818272.0,654.2875785671313,-15.99,1
23:59,274818272.0,647.2875785671313,-7.0,1
23:59,274818272.0,547.2875785671313,-100.0,6
23:59,920830317.0,-47.765779362518735,-5.99,1
23:59,920830317.0,-63.75577936251874,-15.99,1
23:59,920830317.0,-71.74577936251873,-7.99,7
23:59,920830317.0,-90.73577936251873,-18.99,6
23:59,158766229.0,-438.9876358934701,-7.99,1
23:59,158766229.0,-454.9776358934701,-15.99,1
23:59,158766229.0,-460.96763589347006,-5.99,1
23:59,158766229.0,-467.96763589347006,-7.0,1
23:59,158766229.0,-474.96763589347006,-7.0,1
23:59,880546403.0,-1251.539500000002,-7.0,1
23:59,880546403.0,-1264.529500000002,-12.99,1
23:59,880546403.0,-1272.5195000000022,-7.99,7
23:59,880546403.0,-1280.5095000000022,-7.99,1
23:59,880546403.0,-1299.4995000000022,-18.99,6
23:59,880546403.0,-1399.4995000000022,-100.0,6
23:59,711140907.0,1183.9442999999992,-15.99,1
23:59,711140907.0,1164.9542999999992,-18.99,6
23:59,832564361.0,18150.95208229339,-18.99,6
23:59,832564361.0,18134.962082293387,-15.99,1
23:59,832564361.0,18119.972082293385,-14.99,1
23:59,832564361.0,18104.982082293383,-14.99,1
23:59,832564361.0,18098.992082293385,-5.99,1
23:59,832564361.0,17998.992082293382,-100.0,6
23:59,721393911.0,-646.7565425357167,-15.99,1
23:59,721393911.0,-652.7465425357167,-5.99,1
23:59,721393911.0,-671.7365425357167,-18.99,6
23:59,531186970.0,3882.8803852984256,-7.99,7
23:59,531186970.0,3876.890385298426,-5.99,1
23:59,531186970.0,3870.900385298426,-5.99,1
23:59,531186970.0,3857.9103852984263,-12.99,1
23:59,531186970.0,3850.9103852984263,-7.0,1
23:59,531186970.0,3831.9203852984265,-18.99,6
23:59,718058208.0,1881.8439224313229,-7.0,1
23:59,718058208.0,1866.8539224313224,-14.99,1
23:59,718058208.0,1850.8639224313224,-15.99,1
23:59,718058208.0,1842.8739224313224,-7.99,7
23:59,718058208.0,1823.8839224313224,-18.99,6
23:59,345514953.0,240.61219999999935,-15.99,1
23:59,903468956.0,941.2889999999992,-15.99,1
23:59,903468956.0,933.2989999999992,-7.99,7
23:59,781554833.0,1571.3402255639664,-18.99,6
23:59,781554833.0,1565.3502255639664,-5.99,1
23:59,781554833.0,1559.3602255639664,-5.99,1
23:59,781554833.0,1553.3702255639664,-5.99,1
23:59,781554833.0,1537.3802255639664,-15.99,1
23:59,546760202.0,-2024.743027675968,-18.99,6
23:59,546760202.0,-2040.733027675968,-15.99,1
23:59,587202562.0,742.7048994170684,-18.99,6
23:59,587202562.0,734.7148994170684,-7.99,1
23:59,587202562.0,728.7248994170684,-5.99,1
23:59,631744379.0,-2326.791259491066,-7.99,1
23:59,631744379.0,-2345.7812594910656,-18.99,6
23:59,280098744.0,1100.2733778716668,-100.0,6
23:59,985188462.0,320.1663887112247,-15.99,1
23:59,985188462.0,312.1763887112247,-7.99,1
23:59,985188462.0,293.1863887112247,-18.99,6
23:59,985188462.0,287.1963887112247,-5.99,1
23:59,572333122.0,-4020.6175499999954,-15.99,1
23:59,572333122.0,-4026.607549999995,-5.99,1
23:59,572333122.0,-4045.597549999995,-18.99,6
23:59,461029994.0,9472.120239540956,-5.99,1
23:59,461029994.0,9457.130239540957,-14.99,1
23:59,461029994.0,9442.140239540957,-14.99,1
23:59,461029994.0,9423.150239540955,-18.99,6
23:59,461029994.0,9407.160239540955,-15.99,1
23:59,461029994.0,9399.170239540956,-7.99,7
23:59,216285378.0,27521.001113528415,-7.99,7
23:59,216285378.0,27508.011113528413,-12.99,1
23:59,216285378.0,27495.02111352841,-12.99,1
23:59,216285378.0,27480.03111352841,-14.99,1
23:59,216285378.0,27474.04111352841,-5.99,1
23:59,216285378.0,27455.051113528407,-18.99,6
23:59,697140785.0,164.67861673610318,-15.99,1
23:59,697140785.0,156.68861673610317,-7.99,7
23:59,697140785.0,137.69861673610316,-18.99,6
23:59,697140785.0,37.69861673610316,-100.0,6
23:59,697140785.0,24.70861673610316,-12.99,1
23:59,697140785.0,17.70861673610316,-7.0,1
23:59,697140785.0,11.71861673610316,-5.99,1
23:59,697140785.0,-3.2713832638968405,-14.99,1
23:59,843537309.0,-480.8657677916319,-15.99,1
23:59,843537309.0,-499.85576779163193,-18.99,6
23:59,897714622.0,10778.539658692172,-15.99,1
23:59,897714622.0,10765.549658692173,-12.99,1
23:59,897714622.0,10759.559658692173,-5.99,1
23:59,897714622.0,10752.559658692173,-7.0,1
23:59,575652395.0,2199.938097972934,-12.99,1
23:59,575652395.0,2192.938097972934,-7.0,1
23:59,575652395.0,2176.948097972934,-15.99,1
23:59,575652395.0,2168.9580979729344,-7.99,7
23:59,575652395.0,2149.968097972934,-18.99,6
23:59,436430134.0,-564.3739013371817,-5.99,1
23:59,436430134.0,-580.3639013371817,-15.99,1
23:59,436430134.0,-599.3539013371817,-18.99,6
23:59,540159353.0,12746.138785858346,-7.99,7
23:59,540159353.0,12727.148785858346,-18.99,6
23:59,540159353.0,12714.158785858346,-12.99,1
23:59,540159353.0,12707.158785858346,-7.0,1
23:59,532525712.0,-873.8918000000003,-15.99,1
23:59,532525712.0,-881.8818000000003,-7.99,7
23:59,532525712.0,-887.8718000000003,-5.99,1
23:59,532525712.0,-902.8618000000004,-14.99,1
23:59,532525712.0,-909.8618000000004,-7.0,1
23:59,532525712.0,-922.8518000000004,-12.99,1
23:59,358846516.0,1095.6255225272173,-5.99,1
23:59,358846516.0,1088.6255225272173,-7.0,1
23:59,358846516.0,1072.6355225272173,-15.99,1
23:59,358846516.0,1053.6455225272173,-18.99,6
23:59,690523499.0,1137.1286,-18.99,6
23:59,690523499.0,1124.1386,-12.99,1
23:59,690523499.0,1108.1486,-15.99,1
23:59,690523499.0,1100.1586,-7.99,1
23:59,111137699.0,-95.89454999999928,-15.99,1
23:59,111137699.0,-114.88454999999928,-18.99,6
23:59,613729471.0,10367.212456919862,-15.99,1
23:59,613729471.0,10267.212456919862,-100.0,6
23:59,510101371.0,14635.24863577762,-7.99,1
23:59,510101371.0,14619.25863577762,-15.99,1
23:59,762896656.0,-512.6375018481415,-18.99,6
23:59,762896656.0,-528.6275018481415,-15.99,1
23:59,762896656.0,-535.6275018481415,-7.0,1
23:59,971010829.0,689.125056444245,-18.99,6
23:59,121113546.0,337.42315606986966,-7.99,1
23:59,121113546.0,318.43315606986965,-18.99,6
23:59,121113546.0,305.44315606986964,-12.99,1
23:59,121113546.0,298.44315606986964,-7.0,1
23:59,121113546.0,285.45315606986964,-12.99,1
23:59,121113546.0,278.45315606986964,-7.0,1
23:59,782013626.0,2307.8411993116288,-15.99,1
23:59,782013626.0,2299.851199311629,-7.99,7
23:59,782013626.0,2199.851199311629,-100.0,6
23:59,340295966.0,-1396.7919500000005,-15.99,1
23:59,340295966.0,-1496.7919500000005,-100.0,6
23:59,340295966.0,-1515.7819500000005,-18.99,6
23:59,720221651.0,-2653.283866598434,-7.99,1
23:59,720221651.0,-2669.273866598434,-15.99,1
23:59,886837068.0,1011.9955999999992,-18.99,6
23:59,886837068.0,996.0055999999992,-15.99,1
23:59,886837068.0,988.0155999999992,-7.99,7
23:59,886837068.0,888.0155999999993,-100.0,6
23:59,886837068.0,875.0255999999993,-12.99,1
23:59,886837068.0,868.0255999999993,-7.0,1
23:59,909669130.0,663.9398847367668,-15.99,1
23:59,909669130.0,655.9498847367668,-7.99,7
23:59,909669130.0,648.9498847367668,-7.0,1
23:59,331450202.0,9733.47907236453,-7.99,1
23:59,331450202.0,9720.48907236453,-12.99,1
23:59,331450202.0,9713.48907236453,-7.0,1
23:59,331450202.0,9706.48907236453,-7.0,1
23:59,331450202.0,9687.49907236453,-18.99,6
23:59,419550103.0,21501.016936123076,-15.99,1
23:59,419550103.0,21493.026936123075,-7.99,1
23:59,419550103.0,21480.036936123073,-12.99,1
23:59,419550103.0,21465.04693612307,-14.99,1
23:59,726913482.0,-518.5505985264765,-15.99,1
23:59,726913482.0,-537.5405985264765,-18.99,6
23:59,726913482.0,-544.5405985264765,-7.0,1
23:59,726913482.0,-550.5305985264765,-5.99,1
23:59,726913482.0,-556.5205985264765,-5.99,1
23:59,241459011.0,1261.3126132723469,-15.99,1
23:59,241459011.0,1253.3226132723466,-7.99,1
23:59,241459011.0,1247.3326132723466,-5.99,1
23:59,241459011.0,1232.3426132723466,-14.99,1
23:59,241459011.0,1217.3526132723466,-14.99,1
23:59,241459011.0,1117.3526132723466,-100.0,6
23:59,628470485.0,1425.758497567415,-18.99,6
23:59,628470485.0,1417.768497567415,-7.99,1
23:59,628470485.0,1317.768497567415,-100.0,6
23:59,628470485.0,1304.778497567415,-12.99,1
23:59,628470485.0,1297.778497567415,-7.0,1
23:59,628470485.0,1284.7884975674149,-12.99,1
23:59,383345285.0,-957.5579235880762,-18.99,6
23:59,383345285.0,-964.5579235880762,-7.0,1
23:59,383345285.0,-970.5479235880762,-5.99,1
23:59,383345285.0,-983.5379235880762,-12.99,1
23:59,146909202.0,5546.49075930564,-15.99,1
23:59,146909202.0,5540.50075930564,-5.99,1
23:59,146909202.0,5525.51075930564,-14.99,1
23:59,146909202.0,5519.52075930564,-5.99,1
23:59,146909202.0,5500.5307593056405,-18.99,6
23:59,472995101.0,2005.3495840990831,-15.99,1
23:59,472995101.0,1997.3595840990831,-7.99,1
23:59,472995101.0,1984.369584099083,-12.99,1
23:59,127809299.0,2701.2904967244635,-14.99,1
23:59,127809299.0,2686.300496724464,-14.99,1
23:59,127809299.0,2673.310496724464,-12.99,1
23:59,127809299.0,2657.320496724464,-15.99,1
23:59,127809299.0,2638.3304967244644,-18.99,6
23:59,503575533.0,9624.44555803437,-18.99,6
23:59,503575533.0,9608.45555803437,-15.99,1
23:59,503575533.0,9602.46555803437,-5.99,1
23:59,503575533.0,9502.46555803437,-100.0,6
23:59,684284526.0,-3410.936366745756,-15.99,1
23:59,684284526.0,-3418.926366745756,-7.99,1
23:59,684284526.0,-3424.9163667457556,-5.99,1
23:59,684284526.0,-3431.9163667457556,-7.0,1
23:59,684284526.0,-3438.9163667457556,-7.0,1
23:59,684284526.0,-3451.9063667457553,-12.99,1
23:59,684284526.0,-3470.896366745755,-18.99,6
23:59,684284526.0,-3570.896366745755,-100.0,6
23:59,338022396.0,92.79453937573908,-18.99,6
23:59,413557825.0,360.8251999999994,-100.0,6
23:59,730002588.0,16110.214089401868,-15.99,1
23:59,730002588.0,16104.224089401869,-5.99,1
23:59,730002588.0,16091.234089401867,-12.99,1
23:59,730002588.0,16084.234089401867,-7.0,1
23:59,730002588.0,16077.234089401867,-7.0,1
23:59,730002588.0,16058.24408940187,-18.99,6
23:59,305778936.0,11544.423231480136,-15.99,1
23:59,305778936.0,11525.433231480136,-18.99,6
23:59,305778936.0,11510.443231480136,-14.99,1
23:59,305778936.0,11504.453231480136,-5.99,1
23:59,305778936.0,11489.463231480137,-14.99,1
23:59,305778936.0,11482.463231480137,-7.0,1
23:59,305778936.0,11382.463231480137,-100.0,6
23:59,660561861.0,1496.2598316336894,-15.99,1
23:59,660561861.0,1481.2698316336894,-14.99,1
23:59,660561861.0,1475.2798316336894,-5.99,1
23:59,660561861.0,1468.2798316336894,-7.0,1
23:59,660561861.0,1455.2898316336891,-12.99,1
23:59,660561861.0,1436.299831633689,-18.99,6
23:59,657139925.0,15728.77371949208,-14.99,1
23:59,657139925.0,15713.78371949208,-14.99,1
23:59,657139925.0,15706.78371949208,-7.0,1
23:59,657139925.0,15693.79371949208,-12.99,1
23:59,657139925.0,15674.80371949208,-18.99,6
23:59,657139925.0,15666.81371949208,-7.99,1
23:59,657139925.0,15650.82371949208,-15.99,1
23:59,143606916.0,395.8453540291896,-18.99,6
23:59,890196840.0,-3142.0213166751296,-18.99,6
23:59,890196840.0,-3158.01131667513,-15.99,1
23:59,890196840.0,-3171.001316675129,-12.99,1
23:59,890196840.0,-3183.991316675129,-12.99,1
23:59,890196840.0,-3196.9813166751287,-12.99,1
23:59,890196840.0,-3296.9813166751287,-100.0,6
23:59,558875206.0,4694.060539399781,-18.99,6
23:59,558875206.0,4678.070539399781,-15.99,1
23:59,514362267.0,1226.0773191070602,-7.0,1
23:59,514362267.0,1219.0773191070602,-7.0,1
23:59,514362267.0,1211.0873191070602,-7.99,1
23:59,514362267.0,1195.0973191070602,-15.99,1
23:59,660789920.0,-2574.913347382372,-18.99,6
23:59,773633520.0,112.12821093851142,-7.0,1
23:59,773633520.0,93.13821093851142,-18.99,6
23:59,773633520.0,77.14821093851143,-15.99,1
23:59,386729293.0,35779.17407534987,-15.99,1
23:59,386729293.0,35679.17407534987,-100.0,6
23:59,261894284.0,-3264.5937999999965,-15.99,1
23:59,261894284.0,-3283.583799999996,-18.99,6
23:59,261894284.0,-3383.583799999996,-100.0,6
23:59,261894284.0,-3396.573799999996,-12.99,1
23:59,261894284.0,-3411.563799999996,-14.99,1
23:59,261894284.0,-3417.5537999999956,-5.99,1
23:59,261894284.0,-3423.5437999999954,-5.99,1
23:59,799453072.0,169.03454999999872,-18.99,6
23:59,799453072.0,153.0445499999987,-15.99,1
23:59,799453072.0,53.04454999999871,-100.0,6
23:59,799453072.0,47.054549999998706,-5.99,1
23:59,799453072.0,34.064549999998704,-12.99,1
23:59,799453072.0,21.074549999998705,-12.99,1
23:59,799453072.0,8.084549999998702,-12.99,1
23:59,550169791.0,25768.19811294271,-18.99,6
23:59,300095518.0,139.23502834141766,-5.99,1
23:59,254018059.0,36.9695,-18.99,6
23:59,254018059.0,20.97949999999999,-15.99,1
23:59,254018059.0,12.989499999999994,-7.99,7
23:59,254018059.0,-0.0005000000000059,-12.99,1
23:59,456221621.0,984.749367302628,-15.99,1
23:59,456221621.0,976.759367302628,-7.99,1
23:59,456221621.0,957.769367302628,-18.99,6
23:59,860360312.0,374.71020888268026,-15.99,1
23:59,860360312.0,355.72020888268025,-18.99,6
23:59,448004226.0,2092.5423686648796,-18.99,6
23:59,448004226.0,2076.55236866488,-15.99,1
23:59,448004226.0,2068.56236866488,-7.99,1
23:59,489964679.0,23725.30946236988,-15.99,1
23:59,489964679.0,23706.319462369876,-18.99,6
23:59,655730067.0,20.53814999999953,-18.99,6
23:59,655730067.0,12.548149999999527,-7.99,1
23:59,655730067.0,4.558149999999529,-7.99,7
23:59,655730067.0,-8.431850000000471,-12.99,1
23:59,655730067.0,-21.42185000000047,-12.99,1
23:59,655730067.0,-36.41185000000047,-14.99,1
23:59,380228542.0,-440.0420081844343,-15.99,1
23:59,380228542.0,-448.0320081844343,-7.99,1
23:59,380228542.0,-455.0320081844343,-7.0,1
23:59,380228542.0,-462.0320081844343,-7.0,1
23:59,380228542.0,-481.0220081844343,-18.99,6
23:59,820686957.0,-1011.430916311196,-18.99,6
23:59,820686957.0,-1019.4209163111962,-7.99,1
23:59,820686957.0,-1027.4109163111962,-7.99,7
23:59,449387287.0,754.7876938351013,-100.0,6
23:59,449387287.0,738.7976938351013,-15.99,1
23:59,449387287.0,730.8076938351013,-7.99,1
23:59,152616936.0,1442.6650078630646,-7.99,1
23:59,152616936.0,1426.6750078630646,-15.99,1
23:59,152616936.0,1326.6750078630646,-100.0,6
23:59,213096759.0,-1159.2591082144393,-7.99,7
23:59,213096759.0,-1178.2491082144393,-18.99,6
23:59,490868147.0,59.65077912130154,-18.99,6
23:59,490868147.0,44.66077912130154,-14.99,1
23:59,490868147.0,28.670779121301535,-15.99,1
23:59,490868147.0,20.680779121301537,-7.99,1
23:59,749378808.0,2999.4694347502455,-15.99,1
23:59,749378808.0,2991.4794347502457,-7.99,1
23:59,749378808.0,2972.489434750246,-18.99,6
23:59,887853850.0,12055.893691993931,-7.99,1
23:59,235881534.0,14814.871797170324,-15.99,1
23:59,235881534.0,14806.881797170325,-7.99,1
23:59,235881534.0,14791.891797170323,-14.99,1
23:59,235881534.0,14772.901797170323,-18.99,6
23:59,626989363.0,1471.731763317375,-18.99,6
23:59,626989363.0,1455.741763317375,-15.99,1
23:59,626989363.0,1447.751763317375,-7.99,7
23:59,203466392.0,2643.4516960955243,-7.99,1
23:59,203466392.0,2636.4516960955243,-7.0,1
23:59,203466392.0,2629.4516960955243,-7.0,1
23:59,203466392.0,2623.4616960955245,-5.99,1
23:59,203466392.0,2610.4716960955247,-12.99,1
23:59,712474734.0,-1958.659331236004,-7.99,1
23:59,712474734.0,-1977.649331236004,-18.99,6
23:59,786141370.0,343.6916999999992,-15.99,1
23:59,786141370.0,335.70169999999916,-7.99,1
23:59,786141370.0,322.71169999999915,-12.99,1
23:59,786141370.0,303.72169999999915,-18.99,6
23:59,698076160.0,7769.972227948762,-14.99,1
23:59,698076160.0,7756.982227948763,-12.99,1
23:59,698076160.0,7743.992227948763,-12.99,1
23:59,698076160.0,7725.002227948763,-18.99,6
23:59,698955014.0,1279.0516302031967,-7.99,1
23:59,698955014.0,1260.0616302031967,-18.99,6
23:59,698955014.0,1254.0716302031967,-5.99,1
23:59,504055745.0,703.8777613417669,-7.99,7
23:59,504055745.0,687.8877613417669,-15.99,1
23:59,504055745.0,674.8977613417669,-12.99,1
23:59,504055745.0,661.9077613417669,-12.99,1
23:59,504055745.0,561.9077613417669,-100.0,6
23:59,856461967.0,127.14435352949262,-12.99,1
23:59,856461967.0,112.15435352949262,-14.99,1
23:59,856461967.0,93.16435352949264,-18.99,6
23:59,856461967.0,77.17435352949263,-15.99,1
23:59,856461967.0,69.18435352949264,-7.99,7
23:59,603721739.0,1595.7178994831838,-15.99,1
23:59,603721739.0,1588.7178994831838,-7.0,1
23:59,603721739.0,1581.7178994831838,-7.0,1
23:59,603721739.0,1574.7178994831838,-7.0,1
23:59,603721739.0,1567.7178994831838,-7.0,1
23:59,603721739.0,1467.7178994831838,-100.0,6
23:59,603721739.0,1448.7278994831838,-18.99,6
23:59,113747882.0,14003.411829568571,-14.99,1
23:59,113747882.0,13988.421829568571,-14.99,1
23:59,113747882.0,13975.431829568572,-12.99,1
23:59,113747882.0,13967.441829568572,-7.99,1
23:59,113747882.0,13959.451829568572,-7.99,7
23:59,113747882.0,13940.461829568572,-18.99,6
23:59,132400709.0,744.4370351539396,-5.99,1
23:59,132400709.0,738.4470351539396,-5.99,1
23:59,132400709.0,722.4570351539396,-15.99,1
23:59,132400709.0,714.4670351539396,-7.99,1
23:59,961077907.0,208.04154999999997,-15.99,1
23:59,961077907.0,189.05154999999996,-18.99,6
23:59,961077907.0,183.06154999999995,-5.99,1
23:59,961077907.0,83.06154999999995,-100.0,6
23:59,651372390.0,-3788.9657499999985,-15.99,1
23:59,939972497.0,1055.2409086000105,-15.99,1
23:59,939972497.0,1040.2509086000105,-14.99,1
23:59,939972497.0,940.2509086000103,-100.0,6
23:59,939972497.0,921.2609086000105,-18.99,6
23:59,310171581.0,-2306.136204340919,-15.99,1
23:59,310171581.0,-2325.126204340919,-18.99,6
23:59,771125520.0,-10.196950000000925,-15.99,1
23:59,771125520.0,-23.186950000000923,-12.99,1
23:59,771125520.0,-30.186950000000923,-7.0,1
23:59,771125520.0,-49.17695000000092,-18.99,6
23:59,771125520.0,-149.17695000000091,-100.0,6
23:59,255814263.0,2368.9652534884617,-7.99,7
23:59,408057540.0,7401.722574449836,-18.99,6
23:59,408057540.0,7385.732574449837,-15.99,1
23:59,408057540.0,7285.732574449837,-100.0,6
23:59,408057540.0,7279.742574449837,-5.99,1
23:59,408057540.0,7272.742574449837,-7.0,1
23:59,408057540.0,7259.752574449837,-12.99,1
23:59,776431321.0,3880.506382838624,-7.99,7
23:59,776431321.0,3861.516382838624,-18.99,6
23:59,776431321.0,3855.526382838624,-5.99,1
23:59,776431321.0,3849.536382838624,-5.99,1
23:59,844835978.0,11939.849631562927,-7.99,7
23:59,844835978.0,11924.859631562927,-14.99,1
23:59,871200314.0,-270.92487575736163,-15.99,1
23:59,871200314.0,-278.91487575736164,-7.99,7
23:59,871200314.0,-297.90487575736165,-18.99,6
23:59,871200314.0,-310.89487575736166,-12.99,1
23:59,871200314.0,-410.89487575736166,-100.0,6
23:59,322221939.0,4884.856976213188,-15.99,1
23:59,322221939.0,4876.8669762131885,-7.99,7
23:59,322221939.0,4861.876976213189,-14.99,1
23:59,322221939.0,4846.886976213189,-14.99,1
23:59,322221939.0,4827.896976213189,-18.99,6
23:59,519649533.0,-287.27818362933795,-7.0,1
23:59,519649533.0,-306.26818362933795,-18.99,6
23:59,519649533.0,-322.25818362933796,-15.99,1
23:59,519649533.0,-330.248183629338,-7.99,1
23:59,604334058.0,898.0852999999993,-15.99,1
23:59,604334058.0,890.0952999999993,-7.99,7
23:59,364396689.0,-189.50325,-18.99,6
23:59,364396689.0,-195.49325,-5.99,1
23:59,364396689.0,-201.48325,-5.99,1
23:59,364396689.0,-207.47325,-5.99,1
23:59,469561218.0,72.35564999999913,-12.99,1
23:59,469561218.0,56.36564999999913,-15.99,1
23:59,469561218.0,48.375649999999126,-7.99,7
23:59,469561218.0,29.385649999999128,-18.99,6
23:59,585133606.0,6285.584459392841,-15.99,1
23:59,585133606.0,6277.594459392842,-7.99,7
23:59,585133606.0,6258.604459392842,-18.99,6
23:59,585133606.0,6243.614459392842,-14.99,1
23:59,585133606.0,6228.624459392842,-14.99,1
23:59,585133606.0,6221.624459392842,-7.0,1
23:59,585133606.0,6208.6344593928425,-12.99,1
23:59,835736339.0,3261.5860696909385,-18.99,6
23:59,835736339.0,3253.5960696909387,-7.99,1
23:59,916270283.0,3380.9252500000007,-18.99,6
23:59,916270283.0,3372.935250000001,-7.99,7
23:59,916270283.0,3365.935250000001,-7.0,1
23:59,916270283.0,3352.945250000001,-12.99,1
23:59,916270283.0,3345.945250000001,-7.0,1
23:59,141521177.0,8181.695900000015,-18.99,6
23:59,785210466.0,2764.1877969465595,-7.99,1
23:59,785210466.0,2748.1977969465597,-15.99,1
23:59,785210466.0,2729.20779694656,-18.99,6
23:59,785210466.0,2714.21779694656,-14.99,1
23:59,969804197.0,-577.8387500000008,-15.99,1
23:59,969804197.0,-585.8287500000008,-7.99,7
23:59,969804197.0,-604.8187500000008,-18.99,6
23:59,969804197.0,-619.8087500000008,-14.99,1
23:59,969804197.0,-634.7987500000008,-14.99,1
23:59,969804197.0,-641.7987500000008,-7.0,1
23:59,973086490.0,12111.88013905696,-7.99,7
23:59,973086490.0,12095.89013905696,-15.99,1
23:59,973086490.0,12080.90013905696,-14.99,1
23:59,973086490.0,12061.91013905696,-18.99,6
23:59,973086490.0,11961.91013905696,-100.0,6
23:59,140893085.0,8115.381056365462,-18.99,6
23:59,140893085.0,8102.391056365463,-12.99,1
23:59,140893085.0,8095.391056365463,-7.0,1
23:59,140893085.0,8089.401056365463,-5.99,1
23:59,703478110.0,3617.317749908584,-15.99,1
23:59,802697323.0,18990.79817482327,-7.99,7
23:59,802697323.0,18983.79817482327,-7.0,1
23:59,180616589.0,1754.6288282361097,-5.99,1
23:59,180616589.0,1741.6388282361097,-12.99,1
23:59,180616589.0,1735.6488282361097,-5.99,1
23:59,180616589.0,1720.6588282361097,-14.99,1
23:59,180616589.0,1704.6688282361094,-15.99,1
23:59,180616589.0,1685.6788282361094,-18.99,6
23:59,388862238.0,2209.2654778976384,-18.99,6
23:59,388862238.0,2201.2754778976387,-7.99,1
23:59,388862238.0,2193.285477897639,-7.99,7
23:59,388862238.0,2187.295477897639,-5.99,1
23:59,388862238.0,2181.3054778976393,-5.99,1
23:59,940569402.0,5736.3006977283985,-14.99,1
23:59,940569402.0,5729.3006977283985,-7.0,1
23:59,940569402.0,5713.310697728399,-15.99,1
23:59,940569402.0,5705.320697728399,-7.99,7
23:59,990461108.0,735.0078686206109,-7.99,7
23:59,990461108.0,722.0178686206109,-12.99,1
23:59,990461108.0,716.0278686206109,-5.99,1
23:59,990461108.0,710.0378686206109,-5.99,1
23:59,990461108.0,704.0478686206109,-5.99,1
23:59,990461108.0,685.0578686206109,-18.99,6
23:59,520447032.0,9121.446592652728,-15.99,1
23:59,520447032.0,9102.456592652728,-18.99,6
23:59,350921975.0,301.8325710738743,-14.99,1
23:59,350921975.0,294.8325710738743,-7.0,1
23:59,350921975.0,278.8425710738743,-15.99,1
23:59,350921975.0,259.8525710738743,-18.99,6
23:59,350921975.0,159.8525710738743,-100.0,6
23:59,815385232.0,12549.33207722965,-12.99,1
23:59,815385232.0,12534.34207722965,-14.99,1
23:59,815385232.0,12528.35207722965,-5.99,1
23:59,815385232.0,12509.36207722965,-18.99,6
23:59,815385232.0,12493.372077229653,-15.99,1
23:59,912584712.0,904.0606195447332,-15.99,1
23:59,197050303.0,444.269432563495,-14.99,1
23:59,197050303.0,438.279432563495,-5.99,1
23:59,197050303.0,425.289432563495,-12.99,1
23:59,197050303.0,419.299432563495,-5.99,1
23:59,197050303.0,400.30943256349497,-18.99,6
23:59,197050303.0,384.31943256349496,-15.99,1
23:59,951817450.0,10558.880892354871,-7.99,7
23:59,951817450.0,10543.890892354872,-14.99,1
23:59,951817450.0,10530.900892354872,-12.99,1
23:59,951817450.0,10524.910892354872,-5.99,1
23:59,951817450.0,10518.920892354872,-5.99,1
23:59,519644021.0,4279.090813903709,-15.99,1
23:59,519644021.0,4272.090813903709,-7.0,1
23:59,519644021.0,4253.100813903709,-18.99,6
23:59,519644021.0,4153.100813903709,-100.0,6
23:59,518746136.0,-726.6822282369169,-7.99,1
23:59,518746136.0,-734.6722282369169,-7.99,7
23:59,518746136.0,-741.6722282369169,-7.0,1
23:59,518746136.0,-756.6622282369169,-14.99,1
23:59,678851253.0,5235.277509533381,-100.0,6
23:59,678851253.0,5219.287509533381,-15.99,1
23:59,678851253.0,5211.297509533381,-7.99,7
23:59,423208402.0,3767.605500000004,-18.99,6
23:59,423208402.0,3759.615500000004,-7.99,1
23:59,423208402.0,3743.625500000004,-15.99,1
23:59,399144202.0,2654.192606683506,-7.99,1
23:59,399144202.0,2635.202606683506,-18.99,6
23:59,399144202.0,2535.202606683506,-100.0,6
23:59,851649498.0,10130.44968417104,-5.99,1
23:59,851649498.0,10115.45968417104,-14.99,1
23:59,851649498.0,10109.46968417104,-5.99,1
23:59,851649498.0,10096.47968417104,-12.99,1
23:59,851649498.0,10080.48968417104,-15.99,1
23:59,851649498.0,10072.49968417104,-7.99,7
23:59,851649498.0,10053.50968417104,-18.99,6
23:59,518474507.0,16630.557027579514,-7.0,1
23:59,518474507.0,16615.567027579513,-14.99,1
23:59,518474507.0,16600.57702757951,-14.99,1
23:59,518474507.0,16584.58702757951,-15.99,1
23:59,538003940.0,1619.34000000001,-7.99,7
23:59,538003940.0,1603.35000000001,-15.99,1
23:59,538003940.0,1503.35000000001,-100.0,6
23:59,538003940.0,1484.36000000001,-18.99,6
23:59,315078351.0,10435.598246840607,-14.99,1
23:59,315078351.0,10428.598246840607,-7.0,1
23:59,315078351.0,10413.608246840608,-14.99,1
23:59,315078351.0,10406.608246840608,-7.0,1
23:59,315078351.0,10390.618246840608,-15.99,1
23:59,315078351.0,10371.628246840608,-18.99,6
23:59,425964226.0,5103.790764114708,-5.99,1
23:59,425964226.0,5084.800764114708,-18.99,6
23:59,425964226.0,5068.810764114708,-15.99,1
23:59,425964226.0,4968.810764114708,-100.0,6
23:59,661295096.0,3874.610949818632,-7.99,7
23:59,661295096.0,3859.6209498186327,-14.99,1
23:59,661295096.0,3852.6209498186327,-7.0,1
23:59,661295096.0,3833.630949818633,-18.99,6
23:59,478412511.0,12988.839041290454,-100.0,6
23:59,478412511.0,12972.849041290454,-15.99,1
23:59,478412511.0,12965.849041290454,-7.0,1
23:59,478412511.0,12946.859041290454,-18.99,6
23:59,214339619.0,92.24916416988732,-7.99,7
23:59,214339619.0,79.25916416988733,-12.99,1
23:59,214339619.0,66.26916416988733,-12.99,1
23:59,685959099.0,3402.832866099244,-15.99,1
23:59,685959099.0,3394.842866099244,-7.99,1
23:59,685959099.0,3375.852866099244,-18.99,6
23:59,685959099.0,3369.8628660992445,-5.99,1
23:59,279149837.0,1533.3080499999994,-7.99,1
23:59,279149837.0,1433.3080499999994,-100.0,6
23:59,248142083.0,348.0914347025167,-15.99,1
23:59,248142083.0,333.1014347025167,-14.99,1
23:59,248142083.0,320.1114347025167,-12.99,1
23:59,248142083.0,305.1214347025167,-14.99,1
23:59,248142083.0,286.1314347025167,-18.99,6
23:59,143003091.0,13117.900366269252,-18.99,6
23:59,143003091.0,13101.910366269252,-15.99,1
23:59,625658193.0,-571.2356402437831,-7.99,1
23:59,625658193.0,-590.2256402437831,-18.99,6
23:59,625658193.0,-597.2256402437831,-7.0,1
23:59,625658193.0,-603.2156402437831,-5.99,1
23:59,625658193.0,-609.2056402437831,-5.99,1
23:59,625658193.0,-616.2056402437831,-7.0,1
23:59,709151315.0,486.1752183741599,-12.99,1
23:59,709151315.0,479.1752183741599,-7.0,1
23:59,709151315.0,463.1852183741599,-15.99,1
23:59,709151315.0,444.1952183741599,-18.99,6
23:59,191992682.0,-3002.111460292063,-15.99,1
23:59,191992682.0,-3008.1014602920627,-5.99,1
23:59,191992682.0,-3015.1014602920627,-7.0,1
23:59,191992682.0,-3034.0914602920625,-18.99,6
23:59,248625662.0,256.70808428485236,-18.99,6
23:59,248625662.0,240.71808428485235,-15.99,1
23:59,248625662.0,232.72808428485232,-7.99,7
23:59,478986718.0,-596.8697000000016,-7.99,7
23:59,478986718.0,-615.8597000000016,-18.99,6
23:59,478986718.0,-715.8597000000016,-100.0,6
23:59,657528784.0,347.3769000000007,-15.99,1
23:59,657528784.0,339.3869000000007,-7.99,7
23:59,657528784.0,320.3969000000007,-18.99,6
23:59,146686559.0,-451.621411173478,-15.99,1
23:59,146686559.0,-459.611411173478,-7.99,7
23:59,146686559.0,-559.611411173478,-100.0,6
23:59,146686559.0,-578.601411173478,-18.99,6
23:59,815993333.0,6534.236718043218,-15.99,1
23:59,815993333.0,6515.246718043219,-18.99,6
23:59,815993333.0,6509.256718043219,-5.99,1
23:59,815993333.0,6494.266718043219,-14.99,1
23:59,815993333.0,6487.266718043219,-7.0,1
23:59,815993333.0,6474.276718043219,-12.99,1
23:59,455831435.0,-1700.0921048014948,-7.99,1
23:59,455831435.0,-1719.0821048014948,-18.99,6
23:59,455831435.0,-1819.0821048014948,-100.0,6
23:59,418717120.0,-2110.5506465372296,-100.0,6
23:59,418717120.0,-2116.5406465372293,-5.99,1
23:59,418717120.0,-2129.530646537229,-12.99,1
23:59,418717120.0,-2137.520646537229,-7.99,1
23:59,943329213.0,1385.6386193497576,-15.99,1
23:59,943329213.0,1377.6486193497576,-7.99,7
23:59,943329213.0,1358.6586193497576,-18.99,6
23:59,355940285.0,8718.715978189683,-7.99,7
23:59,355940285.0,8710.725978189683,-7.99,1
23:59,355940285.0,8704.735978189683,-5.99,1
23:59,355940285.0,8691.745978189683,-12.99,1
23:59,355940285.0,8685.755978189683,-5.99,1
23:59,817294757.0,-2385.0607999999997,-18.99,6
23:59,257633312.0,43.60369999999899,-15.99,1
23:59,257633312.0,35.613699999998985,-7.99,1
23:59,257633312.0,16.623699999998987,-18.99,6
23:59,257633312.0,3.6336999999989863,-12.99,1
23:59,257633312.0,-11.356300000001012,-14.99,1
23:59,257633312.0,-24.346300000001015,-12.99,1
23:59,663479159.0,5416.9115418277115,-15.99,1
23:59,282837512.0,16343.603666580217,-7.99,1
23:59,282837512.0,16335.613666580217,-7.99,7
23:59,282837512.0,16316.623666580215,-18.99,6
23:59,282837512.0,16310.633666580216,-5.99,1
23:59,282837512.0,16210.633666580216,-100.0,6
23:59,633345190.0,7119.237624869655,-15.99,1
23:59,633345190.0,7111.247624869655,-7.99,7
23:59,633345190.0,7092.257624869655,-18.99,6
23:59,633345190.0,7077.267624869655,-14.99,1
23:59,633345190.0,7062.2776248696555,-14.99,1
23:59,859264768.0,233.5150837819383,-18.99,6
23:59,859264768.0,225.5250837819383,-7.99,7
23:59,859264768.0,217.53508378193828,-7.99,1
23:59,859264768.0,210.53508378193828,-7.0,1
23:59,859264768.0,203.53508378193828,-7.0,1
23:59,987229118.0,1310.507004933438,-15.99,1
23:59,987229118.0,1291.517004933438,-18.99,6
23:59,987229118.0,1276.527004933438,-14.99,1
23:59,989506909.0,-2598.254870759437,-15.99,1
23:59,282046994.0,-43.920649999999625,-7.0,1
23:59,282046994.0,-58.91064999999963,-14.99,1
23:59,282046994.0,-74.90064999999963,-15.99,1
23:59,282046994.0,-93.89064999999962,-18.99,6
23:59,282046994.0,-193.8906499999996,-100.0,6
23:59,290818242.0,8470.986388103865,-100.0,6
23:59,290818242.0,8454.996388103866,-15.99,1
23:59,290818242.0,8447.006388103866,-7.99,1
23:59,333054026.0,1136.49089402319,-15.99,1
23:59,333054026.0,1128.50089402319,-7.99,1
23:59,333054026.0,1122.51089402319,-5.99,1
23:59,333054026.0,1116.52089402319,-5.99,1
23:59,333054026.0,1097.53089402319,-18.99,6
23:59,896821055.0,-414.3594407329176,-7.0,1
23:59,896821055.0,-421.3594407329176,-7.0,1
23:59,896821055.0,-434.3494407329176,-12.99,1
23:59,896821055.0,-442.3394407329176,-7.99,1
23:59,165045150.0,-541.7614385971443,-7.99,7
23:59,165045150.0,-556.7514385971443,-14.99,1
23:59,321372947.0,-180.4449507890995,-18.99,6
23:59,854895960.0,4549.8632912903395,-15.99,1
23:59,854895960.0,4530.87329129034,-18.99,6
23:59,643610517.0,-3140.4336907296565,-15.99,1
23:59,643610517.0,-3153.4236907296563,-12.99,1
23:59,643610517.0,-3160.4236907296563,-7.0,1
23:59,643610517.0,-3175.413690729656,-14.99,1
23:59,643610517.0,-3182.413690729656,-7.0,1
23:59,858989281.0,30831.299331937433,-15.99,1
23:59,873693307.0,12875.080487857684,-18.99,6
23:59,637433131.0,601.100799999999,-15.99,1
23:59,637433131.0,574.120799999999,-18.99,6
23:59,637433131.0,567.120799999999,-7.0,1
23:59,637433131.0,552.130799999999,-14.99,1
23:59,637433131.0,537.140799999999,-14.99,1
23:59,637433131.0,437.140799999999,-100.0,6
23:59,706250160.0,14894.48688046728,-15.99,1
23:59,706250160.0,14886.49688046728,-7.99,7
23:59,766812921.0,171.09929999999895,-15.99,1
23:59,766812921.0,152.10929999999894,-18.99,6
23:59,766812921.0,145.10929999999894,-7.0,1
23:59,758885184.0,1382.677182274345,-15.99,1
23:59,758885184.0,1363.6871822743449,-18.99,6
23:59,799861885.0,1211.9409499999988,-7.99,1
23:59,799861885.0,1192.9509499999988,-18.99,6
23:59,496674181.0,-2767.5154723307223,-15.99,1
23:59,496674181.0,-2786.505472330722,-18.99,6
23:59,845648250.0,368.79404999999934,-18.99,6
23:59,845648250.0,352.80404999999934,-15.99,1
23:59,535744551.0,1350.9930659956258,-7.99,1
23:59,535744551.0,1343.9930659956258,-7.0,1
23:59,535744551.0,1336.9930659956258,-7.0,1
23:59,535744551.0,1329.9930659956258,-7.0,1
23:59,535744551.0,1324.0030659956258,-5.99,1
23:59,535744551.0,1305.0130659956258,-18.99,6
23:59,902798190.0,-121.0036344310265,-15.99,1
23:59,227104649.0,2123.177034316178,-7.99,1
23:59,227104649.0,2117.187034316178,-5.99,1
23:59,227104649.0,2098.1970343161784,-18.99,6
23:59,569687509.0,-2339.4328999999993,-7.0,1
23:59,569687509.0,-2346.4328999999993,-7.0,1
23:59,569687509.0,-2361.422899999999,-14.99,1
23:59,569687509.0,-2374.412899999999,-12.99,1
23:59,569687509.0,-2390.4028999999987,-15.99,1
23:59,569687509.0,-2409.3928999999985,-18.99,6
23:59,399538448.0,9035.059771568456,-7.0,1
23:59,399538448.0,9020.069771568456,-14.99,1
23:59,399538448.0,9014.079771568457,-5.99,1
23:59,399538448.0,8995.089771568457,-18.99,6
23:59,399538448.0,8987.099771568457,-7.99,1
23:59,399538448.0,8979.109771568457,-7.99,7
23:59,910730524.0,9063.733859640794,-15.99,1
23:59,910730524.0,9055.743859640794,-7.99,1
23:59,910730524.0,9036.753859640794,-18.99,6
23:59,910730524.0,9023.763859640794,-12.99,1
23:59,910730524.0,9017.773859640794,-5.99,1
23:59,610450243.0,-205.09959999999975,-7.99,1
23:59,610450243.0,-211.0895999999998,-5.99,1
23:59,610450243.0,-226.0795999999998,-14.99,1
23:59,610450243.0,-241.0695999999998,-14.99,1
23:59,610450243.0,-247.05959999999985,-5.99,1
23:59,610450243.0,-266.0495999999998,-18.99,6
23:59,596463612.0,-1963.502604725138,-7.99,1
23:59,596463612.0,-1979.492604725138,-15.99,1
23:59,596463612.0,-1998.482604725138,-18.99,6
23:59,979135922.0,-140.09969940954875,-15.99,1
23:59,979135922.0,-148.08969940954876,-7.99,1
23:59,235663459.0,1118.568929812015,-15.99,1
23:59,235663459.0,1112.578929812015,-5.99,1
23:59,405416860.0,3208.625406880905,-12.99,1
23:59,405416860.0,3193.635406880905,-14.99,1
23:59,405416860.0,3186.635406880905,-7.0,1
23:59,405416860.0,3167.6454068809053,-18.99,6
23:59,405416860.0,3151.6554068809055,-15.99,1
23:59,742223719.0,1137.5743573048026,-7.0,1
23:59,742223719.0,1121.5843573048026,-15.99,1
23:59,742223719.0,1102.5943573048023,-18.99,6
23:59,548549094.0,-591.0536299265087,-5.99,1
23:59,548549094.0,-598.0536299265087,-7.0,1
23:59,548549094.0,-604.0436299265087,-5.99,1
23:59,548549094.0,-620.0336299265088,-15.99,1
23:59,948558249.0,9794.46346181564,-18.99,6
23:59,948558249.0,9786.473461815642,-7.99,7
23:59,948558249.0,9770.483461815642,-15.99,1
23:59,948558249.0,9764.493461815642,-5.99,1
23:59,948558249.0,9749.503461815642,-14.99,1
23:59,948558249.0,9742.503461815642,-7.0,1
23:59,948558249.0,9736.513461815644,-5.99,1
23:59,982286721.0,-3713.5055240177294,-7.99,1
23:59,982286721.0,-3726.495524017729,-12.99,1
23:59,982286721.0,-3733.495524017729,-7.0,1
23:59,982286721.0,-3740.495524017729,-7.0,1
23:59,982286721.0,-3755.485524017729,-14.99,1
23:59,891513205.0,866.2911796590689,-7.0,1
23:59,891513205.0,851.3011796590689,-14.99,1
23:59,891513205.0,835.3111796590689,-15.99,1
23:59,891513205.0,827.3211796590689,-7.99,1
23:59,891513205.0,808.3311796590689,-18.99,6
23:59,891513205.0,708.3311796590689,-100.0,6
23:59,212560376.0,-103.03287422089784,-18.99,6
23:59,212560376.0,-111.02287422089783,-7.99,1
23:59,212560376.0,-119.01287422089784,-7.99,7
23:59,162370388.0,-2510.840399999998,-15.99,1
23:59,162370388.0,-2518.830399999998,-7.99,7
23:59,162370388.0,-2537.820399999998,-18.99,6
23:59,957821152.0,-1347.6404535715496,-15.99,1
23:59,957821152.0,-1355.6304535715497,-7.99,7
23:59,957821152.0,-1374.6204535715497,-18.99,6
23:59,957821152.0,-1474.6204535715497,-100.0,6
23:59,957821152.0,-1480.6104535715497,-5.99,1
23:59,121858569.0,1945.4311500000024,-100.0,6
23:59,117273481.0,11234.8810387029,-7.99,7
23:59,117273481.0,11226.8910387029,-7.99,1
23:59,750898750.0,-567.2094653199005,-7.99,1
23:59,750898750.0,-575.1994653199005,-7.99,7
23:59,750898750.0,-594.1894653199005,-18.99,6
23:59,750898750.0,-607.1794653199005,-12.99,1
23:59,750898750.0,-613.1694653199005,-5.99,1
23:59,750898750.0,-628.1594653199005,-14.99,1
23:59,992204045.0,9640.178108346256,-15.99,1
23:59,992204045.0,9634.188108346258,-5.99,1
23:59,992204045.0,9619.198108346258,-14.99,1
23:59,992204045.0,9606.208108346258,-12.99,1
23:59,992204045.0,9599.208108346258,-7.0,1
23:59,992204045.0,9580.218108346258,-18.99,6
23:59,992204045.0,9480.218108346258,-100.0,6
23:59,720742759.0,1824.3311308830073,-7.99,1
23:59,720742759.0,1817.3311308830073,-7.0,1
23:59,720742759.0,1802.3411308830073,-14.99,1
23:59,720742759.0,1796.3511308830073,-5.99,1
23:59,720742759.0,1789.3511308830073,-7.0,1
23:59,720742759.0,1770.3611308830073,-18.99,6
23:59,648644594.0,1180.677099999999,-7.0,1
23:59,648644594.0,1174.687099999999,-5.99,1
23:59,648644594.0,1158.697099999999,-15.99,1
23:59,648644594.0,1058.697099999999,-100.0,6
23:59,474951915.0,-2723.846095234011,-18.99,6
23:59,474951915.0,-2729.836095234011,-5.99,1
23:59,474951915.0,-2736.836095234011,-7.0,1
23:59,474951915.0,-2743.836095234011,-7.0,1
23:59,474951915.0,-2749.8260952340106,-5.99,1
23:59,250895529.0,2456.0228324692885,-18.99,6
23:59,250895529.0,2440.0328324692887,-15.99,1
23:59,250895529.0,2432.042832469289,-7.99,1
23:59,250895529.0,2332.042832469289,-100.0,6
23:59,521611005.0,38.29671414895348,-7.99,1
23:59,521611005.0,22.306714148953475,-15.99,1
23:59,521611005.0,-77.69328585104653,-100.0,6
23:59,521611005.0,-96.68328585104652,-18.99,6
23:59,925037906.0,2370.0428000000015,-7.99,7
23:59,925037906.0,2354.0528000000018,-15.99,1
23:59,284161641.0,799.0423110405757,-15.99,1
23:59,284161641.0,780.0523110405757,-18.99,6
23:59,284161641.0,767.0623110405757,-12.99,1
23:59,284161641.0,761.0723110405756,-5.99,1
23:59,380911501.0,78.48219999999914,-15.99,1
23:59,284905540.0,10249.287533307071,-100.0,6
23:59,284905540.0,10230.297533307074,-18.99,6
23:59,284905540.0,10214.307533307074,-15.99,1
23:59,284905540.0,10206.317533307074,-7.99,7
23:59,967989787.0,233.9292326407273,-100.0,6
23:59,512989907.0,-2119.501903975365,-5.99,1
23:59,512989907.0,-2126.501903975365,-7.0,1
23:59,512989907.0,-2142.491903975365,-15.99,1
23:59,615144184.0,1157.763899125519,-100.0,6
23:59,615144184.0,1149.773899125519,-7.99,7
23:59,615144184.0,1143.783899125519,-5.99,1
23:59,837876918.0,-25.86279146542011,-14.99,1
23:59,837876918.0,-40.85279146542011,-14.99,1
23:59,837876918.0,-48.84279146542011,-7.99,1
23:59,837876918.0,-56.832791465420115,-7.99,7
23:59,933491926.0,4552.635897981178,-14.99,1
23:59,933491926.0,4546.645897981178,-5.99,1
23:59,933491926.0,4531.655897981178,-14.99,1
23:59,933491926.0,4524.655897981178,-7.0,1
23:59,933491926.0,4508.665897981178,-15.99,1
23:59,933491926.0,4489.675897981178,-18.99,6
23:59,933491926.0,4389.675897981178,-100.0,6
23:59,466649401.0,1183.0107807973743,-18.99,6
23:59,466649401.0,1167.0207807973743,-15.99,1
23:59,466649401.0,1159.0307807973743,-7.99,7
23:59,466649401.0,1146.0407807973745,-12.99,1
23:59,466649401.0,1131.0507807973745,-14.99,1
23:59,466649401.0,1124.0507807973745,-7.0,1
23:59,466649401.0,1111.0607807973745,-12.99,1
23:59,466649401.0,1011.0607807973744,-100.0,6
23:59,429235692.0,-728.8370000000002,-15.99,1
23:59,429235692.0,-736.8270000000002,-7.99,1
23:59,856147482.0,-377.3467985986247,-15.99,1
23:59,856147482.0,-383.3367985986247,-5.99,1
23:59,856147482.0,-398.3267985986247,-14.99,1
23:59,856147482.0,-417.3167985986247,-18.99,6
23:59,964913066.0,-2453.8946999999976,-7.99,7
23:59,964913066.0,-2469.8846999999973,-15.99,1
23:59,964913066.0,-2475.874699999997,-5.99,1
23:59,964913066.0,-2488.864699999997,-12.99,1
23:59,964913066.0,-2495.864699999997,-7.0,1
23:59,964913066.0,-2501.8546999999967,-5.99,1
23:59,964913066.0,-2520.8446999999965,-18.99,6
23:59,766941757.0,4271.74312150214,-15.99,1
23:59,766941757.0,4252.75312150214,-18.99,6
23:59,766941757.0,4152.75312150214,-100.0,6
23:59,955035930.0,2673.6484791714784,-15.99,1
23:59,955035930.0,2573.6484791714784,-100.0,6
23:59,198051483.0,-716.6319104088573,-12.99,1
23:59,198051483.0,-731.6219104088573,-14.99,1
23:59,198051483.0,-737.6119104088573,-5.99,1
23:59,198051483.0,-744.6119104088573,-7.0,1
23:59,198051483.0,-760.6019104088573,-15.99,1
23:59,724997545.0,-254.7283080022183,-15.99,1
23:59,724997545.0,-262.71830800221835,-7.99,1
23:59,173317688.0,-2512.778734884284,-15.99,1
23:59,173317688.0,-2520.7687348842837,-7.99,7
23:59,173317688.0,-2535.7587348842835,-14.99,1
23:59,173317688.0,-2550.7487348842833,-14.99,1
23:59,828750680.0,1716.78214521368,-5.99,1
23:59,828750680.0,1703.79214521368,-12.99,1
23:59,828750680.0,1696.79214521368,-7.0,1
23:59,828750680.0,1688.80214521368,-7.99,1
23:59,828750680.0,1680.81214521368,-7.99,7
23:59,828750680.0,1661.82214521368,-18.99,6
23:59,828750680.0,1561.82214521368,-100.0,6
23:59,950234174.0,1647.3178192371597,-12.99,1
23:59,950234174.0,1640.3178192371597,-7.0,1
23:59,950234174.0,1627.3278192371597,-12.99,1
23:59,950234174.0,1611.3378192371597,-15.99,1
23:59,950234174.0,1603.3478192371597,-7.99,7
23:59,950234174.0,1584.3578192371594,-18.99,6
23:59,822135975.0,13500.526047161336,-15.99,1
23:59,822135975.0,13492.536047161337,-7.99,1
23:59,822135975.0,13473.546047161337,-18.99,6
23:59,822135975.0,13460.556047161335,-12.99,1
23:59,822135975.0,13447.566047161336,-12.99,1
23:59,826597014.0,-2618.9569406029273,-5.99,1
23:59,826597014.0,-2624.946940602927,-5.99,1
23:59,826597014.0,-2632.936940602927,-7.99,7
23:59,826597014.0,-2648.9269406029266,-15.99,1
23:59,826597014.0,-2667.9169406029264,-18.99,6
23:59,675806859.0,9031.583105282614,-15.99,1
23:59,675806859.0,9023.593105282614,-7.99,7
23:59,391559884.0,200.28714999999931,-18.99,6
23:59,391559884.0,187.2971499999993,-12.99,1
23:59,391559884.0,180.2971499999993,-7.0,1
23:59,391559884.0,167.3071499999993,-12.99,1
23:59,391559884.0,152.3171499999993,-14.99,1
23:59,391559884.0,136.32714999999928,-15.99,1
23:59,421475159.0,-192.41473732558745,-7.99,7
23:59,421475159.0,-211.40473732558743,-18.99,6
23:59,421475159.0,-224.39473732558747,-12.99,1
23:59,421475159.0,-230.38473732558748,-5.99,1
23:59,421475159.0,-236.3747373255875,-5.99,1
23:59,734161378.0,-2866.7826694342116,-7.99,1
23:59,734161378.0,-2873.7826694342116,-7.0,1
23:59,734161378.0,-2879.7726694342114,-5.99,1
23:59,734161378.0,-2885.762669434211,-5.99,1
23:59,734161378.0,-2904.752669434211,-18.99,6
23:59,383833857.0,29632.4699014012,-7.0,1
23:59,383833857.0,29617.4799014012,-14.99,1
23:59,383833857.0,29610.4799014012,-7.0,1
23:59,383833857.0,29603.4799014012,-7.0,1
23:59,124125096.0,392.1825943878018,-18.99,6
23:59,124125096.0,376.1925943878018,-15.99,1
23:59,124125096.0,368.2025943878018,-7.99,1
23:59,124125096.0,355.2125943878018,-12.99,1
23:59,124125096.0,348.2125943878018,-7.0,1
23:59,352899149.0,783.8327411773412,-15.99,1
23:59,256002321.0,7864.759792557941,-12.99,1
23:59,256002321.0,7845.769792557941,-18.99,6
23:59,583579399.0,1503.0661000000007,-15.99,1
23:59,583579399.0,1495.076100000001,-7.99,7
23:59,583579399.0,1482.086100000001,-12.99,1
23:59,583579399.0,1469.096100000001,-12.99,1
23:59,583579399.0,1456.1061000000009,-12.99,1
23:59,583579399.0,1449.1061000000009,-7.0,1
23:59,583579399.0,1430.1161000000006,-18.99,6
23:59,583579399.0,1330.1161000000006,-100.0,6
23:59,497809732.0,2557.997869552596,-15.99,1
23:59,497809732.0,2539.0078695525963,-18.99,6
23:59,899692478.0,-1835.5608435240076,-15.99,1
23:59,899692478.0,-1843.5508435240076,-7.99,1
23:59,899692478.0,-1856.5408435240076,-12.99,1
23:59,899692478.0,-1869.5308435240077,-12.99,1
23:59,899692478.0,-1876.5308435240077,-7.0,1
23:59,899692478.0,-1882.5208435240077,-5.99,1
23:59,899692478.0,-1901.5108435240077,-18.99,6
23:59,899692478.0,-2001.5108435240077,-100.0,6
23:59,715068825.0,-557.5155000000002,-15.99,1
23:59,715068825.0,-657.5155000000002,-100.0,6
23:59,449871732.0,8459.689130852796,-15.99,1
23:59,449871732.0,8451.699130852796,-7.99,7
23:59,449871732.0,8436.709130852796,-14.99,1
23:59,449871732.0,8417.719130852796,-18.99,6
23:59,449871732.0,8317.719130852796,-100.0,6
23:59,559995067.0,3859.3459316088665,-14.99,1
23:59,559995067.0,3844.3559316088663,-14.99,1
23:59,699313649.0,-2439.6658991419044,-18.99,6
23:59,370757362.0,1897.4360236036175,-15.99,1
23:59,370757362.0,1878.4460236036175,-18.99,6
00:52,970298834.0,2990.7948410801546,-14.71,7
00:57,117308635.0,2271.52161564879,-40.24,2
01:14,679662108.0,18615.760289964262,-26.49,7
01:29,660561861.0,1410.7756493325728,-25.52,7
01:48,779946617.0,19413.94407340953,-9.06,5
02:01,647472692.0,29920.67141402665,-10.44,8
02:36,489964679.0,23675.12946236988,-31.19,9
02:37,348325817.0,11153.520980263169,-32.12,9
02:38,187541224.0,3094.608887374237,-45.2,9
02:41,108931112.0,16892.26320698168,-34.63,9
02:44,541639148.0,5132.372771135233,-37.71,8
02:47,851181128.0,6332.329859848636,-33.4,9
02:55,399144202.0,2514.282606683506,-20.92,9
02:57,706250160.0,14870.28955078894,-16.21,7
03:05,441274121.0,14747.36474001242,-12.95,9
03:05,581655972.0,46125.637578870206,-23.54,2
03:10,270374623.0,11657.152337998868,-5.07,5
03:11,113747882.0,13902.881829568572,-37.58,9
03:14,802697323.0,18939.97817482327,-43.82,9
03:18,851181128.0,6321.482445224475,-10.85,2
03:26,256002321.0,7828.021562997802,-17.75,5
03:28,187541224.0,3069.9692762436,-24.64,2
03:29,834383043.0,6148.285510325551,-37.28,4
03:29,532478725.0,5471.328228941878,-22.98,9
03:33,216285378.0,27426.92111352841,-28.13,9
03:33,647936800.0,2002.6803799851343,-27.97,9
03:39,633345190.0,7027.917624869656,-34.36,9
03:40,482513594.0,7132.21905425067,-12.25,9
03:42,113747882.0,13859.55838801534,-43.32,7
03:44,940569402.0,5688.820697728399,-16.5,9
03:44,510101371.0,14576.03863577762,-43.22,9
03:52,994214354.0,11467.769528946485,-35.3,9
03:53,461990622.0,9122.329100918529,-54.07,5
03:56,984783496.0,16327.863277976252,-13.39,9
03:56,286484726.0,1305.3736391525706,-21.9,9
03:56,858989281.0,30827.48158756828,-3.82,2
03:59,324224854.0,6503.465280754527,-9.5,5
04:00,195895574.0,7990.602982446126,-20.69,9
04:01,506618547.0,18089.266573227895,-22.73,2
04:01,252419513.0,-2449.2711858134144,-34.99,9
04:04,651756497.0,18447.92999684482,-54.26,5
04:05,639549973.0,6679.388525219882,-16.51,2
04:09,930277104.0,10722.631339838004,-30.45,9
04:10,534325901.0,7493.55416057346,-8.24,9
04:10,547010927.0,28241.98353712915,-2.13,7
04:11,687135796.0,32819.783421582695,-24.02,7
04:13,822250278.0,7820.76605467593,-23.63,9
04:15,940569402.0,5681.82911421696,-6.99,2
04:21,809499628.0,20407.915791588726,-21.89,9
04:23,308505160.0,15974.194102414747,-5.75,5
04:28,752362502.0,8971.305273543583,-9.5,8
04:29,718058208.0,1796.9899496650348,-26.89,7
04:29,912705941.0,21331.108296913895,-24.69,7
04:31,195895574.0,7948.807040837266,-41.8,5
04:34,252760664.0,7901.389281050767,-9.58,2
04:34,383833857.0,29599.82082459985,-3.66,5
04:36,399144202.0,2502.3629751884996,-11.92,2
04:42,853907490.0,9578.256784821113,-13.45,9
04:42,874431242.0,11456.209047153272,-28.69,9
04:44,822250278.0,7809.457675066755,-11.31,7
04:46,196289502.0,18636.37118908664,-20.25,9
04:49,264550521.0,7257.644670027665,-20.95,7
04:50,951817450.0,10518.435977360714,-0.48,7
04:54,601627384.0,4138.601483272718,-30.75,9
04:55,572384506.0,9402.50532087354,-41.45,9
04:56,910730524.0,8973.407232543914,-44.37,7
04:59,901432314.0,4121.616261987955,-26.88,7
05:01,670102069.0,2008.6476121150467,-33.95,9
05:02,586315521.0,14295.490769052616,-39.86,4
05:05,259015404.0,1433.8906423094618,-31.5,9
05:05,815993333.0,6419.06518658263,-55.21,4
05:06,678851253.0,5192.608137861535,-18.69,4
05:07,815385232.0,12486.382077229651,-6.99,9
05:07,690523499.0,1066.7086,-33.45,9
05:08,992204045.0,9434.731074965872,-45.49,2
05:10,809499628.0,20398.770558595257,-9.15,8
05:12,124102251.0,2525.9403545921964,-34.79,5
05:14,930277104.0,10711.66577324388,-10.97,8
05:15,613729471.0,10260.581216949678,-6.63,2
05:15,518474507.0,16552.16702757951,-32.42,9
05:16,874431242.0,11444.22731634641,-11.98,2
05:20,554792076.0,32495.071416939852,-26.54,5
05:20,549414742.0,8439.187374495528,-0.14,2
05:21,522188082.0,8720.783604655519,-62.81,2
05:21,287480331.0,9309.10593216534,-21.49,9
05:28,933491926.0,4328.540113662489,-61.14,2
05:28,108563213.0,26593.86184696304,-8.62,2
05:30,873693307.0,12857.830487857684,-17.25,9
05:31,370521542.0,30737.937280446105,-3.18,7
05:37,145387690.0,6362.47232969563,-15.98,9
05:37,987229118.0,1272.3002897383349,-4.23,4
05:43,450896297.0,15369.296898216931,-24.43,9
05:43,383625050.0,4100.425920327189,-18.56,5
05:44,364357875.0,9972.268617475504,-2.04,7
05:50,237684254.0,7145.340892717897,-11.95,7
05:51,169006407.0,13342.391667785136,-33.61,2
05:52,709608057.0,3270.2926814685434,-32.08,9
05:52,623156843.0,6111.097345239462,-34.19,7
05:54,441274121.0,14669.814871196611,-77.55,5
05:57,550169791.0,25757.044703844957,-11.15,5
06:01,534204159.0,6905.137435654455,-1.04,8
06:01,200080192.0,9876.217479114031,-42.8,5
06:02,670102069.0,1940.8975141138776,-67.75,8
06:05,639409800.0,40773.42689047069,-32.9,7
06:05,887853850.0,12055.125138713393,-0.77,2
06:08,675806859.0,8984.205666130483,-39.39,5
06:10,683319988.0,8363.67963499065,-18.25,9
06:10,183888402.0,22094.90245714013,-38.08,9
06:11,668329719.0,10322.77729750625,-21.26,2
06:11,179173981.0,4945.701488562895,-54.54,2
06:13,795847804.0,27246.19767288256,-1.62,2
06:13,145387690.0,6332.892652354508,-29.58,2
06:16,237493332.0,17239.844653752796,-18.0,5
06:20,698076160.0,7722.885462803154,-2.12,2
06:21,556992209.0,12540.219610254611,-51.79,2
06:22,237493332.0,17229.404653752797,-10.44,9
06:26,853907490.0,9562.03659532662,-16.22,2
06:28,496395938.0,14034.517502392577,-4.23,7
06:28,282837512.0,16205.010243995475,-5.62,5
06:28,482513594.0,7093.735504982324,-38.48,2
06:31,305778936.0,11381.79265777028,-0.67,7
06:32,120634201.0,6326.78869192003,-13.38,9
06:33,905860285.0,14649.374479122713,-7.99,7
06:34,806358207.0,13687.24985048317,-10.12,7
06:37,996042490.0,7395.935854635792,-19.22,8
06:38,667367404.0,11346.15468436667,-29.17,5
06:39,534325901.0,7492.657467764521,-0.9,7
06:48,433917275.0,8702.156473170387,-30.69,9
06:48,196289502.0,18574.571370371752,-61.8,7
06:48,683319988.0,8349.533166317084,-14.15,8
06:53,657139925.0,15628.22371949208,-22.6,9
06:56,769311479.0,7799.287197906318,-3.92,4
06:56,705848712.0,30958.600639493332,-17.9,9
07:00,815385232.0,12454.69602859711,-31.69,7
07:00,130154096.0,1357.2226328480244,-2.95,5
07:01,494789005.0,3412.914016609372,-15.0,9
07:02,519644021.0,4119.863695711647,-33.24,2
07:03,836110591.0,4558.923407774246,-26.43,9
07:04,949032480.0,4447.885690020492,-30.98,9
07:11,290818242.0,8420.037218811529,-26.97,7
07:12,146909202.0,5444.862056119024,-55.67,7
07:12,873693307.0,12823.03527237254,-34.8,7
07:12,647936800.0,1992.2542916568,-10.43,7
07:13,435984758.0,5070.477270767234,-6.57,2
07:15,245690309.0,11695.60380047841,-18.48,2
07:18,987163717.0,4827.036078176685,-38.78,9
07:18,221868392.0,5690.422781209947,-27.7,9
07:19,704517789.0,20107.26296776085,-55.19,7
07:19,749378808.0,2949.849434750246,-22.64,9
07:31,899742927.0,14986.963459673869,-1.26,4
07:31,700138124.0,5418.773738193075,-25.09,5
07:34,450896297.0,15366.33586496894,-2.96,8
07:37,897714622.0,10700.12956594118,-52.43,2
07:40,609939116.0,9366.762400934122,-12.58,2
07:40,500043411.0,15528.309604056829,-13.87,7
07:41,480557476.0,13472.283381694113,-4.39,2
07:41,511179916.0,9256.69809267326,-6.23,7
07:43,719586818.0,21954.91880032966,-25.76,8
07:48,673025413.0,2890.8692713863265,-66.04,5
07:50,973086490.0,11948.97013905696,-12.94,9
07:50,749378808.0,2891.1098123710212,-58.74,2
07:51,758160963.0,8857.753838993789,-71.32,2
07:55,213112754.0,6743.432770762738,-7.01,5
07:58,690958123.0,23901.325258578472,-15.28,5
08:02,738958551.0,10371.973867790308,-76.08,5
08:03,930271460.0,514.9985475357762,-5.3,9
08:04,564744955.0,663.279758588842,-7.8,9
08:04,587225252.0,7403.607698566697,-41.25,9
08:05,399538448.0,8973.709771568458,-5.4,9
08:06,473820682.0,13198.323109903722,-10.36,5
08:07,885259672.0,3708.810114099697,-6.5,9
08:08,824916823.0,9925.886125017094,-36.13,9
08:09,520447032.0,9070.802353103736,-31.65,7
08:11,519935524.0,1455.7953297375188,-5.7,9
08:14,730002588.0,16057.27665744224,-0.97,5
08:15,960208650.0,17075.066171388036,-38.47,7
08:15,280200287.0,-366.95295338694893,-5.4,9
08:17,532525712.0,-937.0193000000004,-14.17,5
08:19,572384506.0,9393.60268750895,-8.9,7
08:19,478651121.0,-464.4355704015304,-65.54,5
08:20,395284483.0,2036.8403402113088,-7.15,9
08:20,527842638.0,1511.2600426329834,-6.15,9
08:21,417850087.0,18088.93761316335,-53.9,7
08:22,675806859.0,8942.037666130484,-42.17,5
08:22,241459011.0,1112.2026132723463,-5.15,9
08:24,762700245.0,1616.4617000000026,-7.8,9
08:24,143003091.0,13059.095994863394,-42.81,5
08:25,668329719.0,10279.58729750625,-43.19,5
08:26,890567652.0,445.2861996796006,-71.7,5
08:29,596463612.0,-2022.310104725138,-23.83,5
08:29,310375875.0,2855.0723376907667,-42.55,9
08:29,284905540.0,10143.121533307074,-63.2,5
08:29,229205098.0,9081.557101848231,-9.07,5
08:33,266777719.0,198.9149337802397,-64.81,5
08:36,331450202.0,9647.361072364529,-40.14,5
08:36,235881534.0,14762.167695737977,-10.73,5
08:37,146686559.0,-654.876911173478,-76.28,5
08:37,838415080.0,-3622.488999999998,-48.32,5
08:38,909676212.0,719.5305317876131,-83.24,5
08:39,909676212.0,718.0858136673079,-1.44,7
08:40,559995067.0,3836.8904356377343,-7.47,7
08:40,821971408.0,1356.7571102355432,-35.38,5
08:41,588565416.0,7476.505535826391,-14.37,7
08:43,851649498.0,10019.777297054252,-33.73,2
08:43,194023154.0,-2836.3371717847317,-21.95,5
08:44,322221939.0,4758.890976213189,-69.01,5
08:44,924045955.0,1782.106442658665,-20.98,5
08:44,151968462.0,9096.126762668016,-4.2,7
08:45,832564361.0,17998.497260099248,-0.49,7
08:46,987656636.0,6293.863004672784,-30.41,7
08:47,142791593.0,3.0446999999996365,-83.83,5
08:47,215832575.0,-1307.54196374422,-47.81,5
08:48,949032480.0,4444.459589916322,-3.43,8
08:50,680773155.0,969.5090833310912,-41.99,5
08:51,518466565.0,1943.2214999999992,-155.09,5
08:52,698955014.0,1156.1769802031968,-97.89,5
08:52,229205098.0,9057.393101848233,-24.16,5
08:53,322221939.0,4756.680268609067,-2.21,2
08:55,623156843.0,6012.754345239462,-98.34,5
08:56,667367404.0,11340.454684366669,-5.7,9
09:03,581655972.0,46119.487578870205,-6.15,9
09:03,383833857.0,29594.42082459985,-5.4,9
09:03,287480331.0,9285.9407880553,-23.17,5
09:04,506618547.0,18083.666573227896,-5.6,9
09:09,558875206.0,4673.120539399782,-4.95,9
09:10,162162212.0,-347.368956672691,-149.74,5
09:10,785749304.0,10046.067057902475,-56.52,5
09:10,586315521.0,14287.690769052617,-7.8,9
09:13,138609932.0,2039.884003294586,-5.4,9
09:14,993238248.0,-287.67148739288393,-25.0,2
09:15,999752672.0,2017.1510935333345,-4.7,9
09:15,943329213.0,1305.3816193497576,-53.28,5
09:16,187111705.0,8360.45128188352,-3.16,7
09:16,762859681.0,1339.0615999999989,-7.0,7
09:16,690958123.0,23895.42525857847,-5.9,9
09:16,578131296.0,1192.2184194440435,-30.95,1
09:17,299871610.0,826.3506530587667,-28.0,2
09:17,889916166.0,491.53340141322656,-59.98,4
09:18,546296727.0,196.51772730261837,-6.99,7
09:18,442079728.0,744.3051192193138,-19.99,2
09:18,781554833.0,1377.4002255639664,-159.98,2
09:18,117273481.0,11221.5910387029,-5.3,9
09:19,511179916.0,9110.559092673262,-146.14,5
09:19,618138606.0,1959.863303264288,-5.7,9
09:19,290818242.0,8413.437218811529,-6.6,9
09:20,283027736.0,672.2842439701727,-38.97,2
09:20,540159353.0,12701.708785858344,-5.45,9
09:21,503575533.0,9432.39555803437,-70.07,2
09:21,767447966.0,5911.827922706574,-59.85,5
09:21,679662108.0,18459.268289964264,-156.49,5
09:21,818552503.0,1092.4747999999988,-238.08,5
09:21,965038148.0,449.4043656323277,-41.64,4
09:21,279149837.0,1417.3280499999994,-15.98,2
09:22,142791593.0,-14.895300000000365,-17.94,7
09:22,993238248.0,-309.67148739288393,-22.0,2
09:22,147508204.0,387.01471778188653,-10.98,7
09:23,639409800.0,40640.97989047069,-132.45,5
09:23,857997794.0,1406.9856651508865,-27.97,4
09:23,384497904.0,841.343499999999,-29.99,1
09:24,807098817.0,473.792449999999,-71.97,2
09:25,358836279.0,605.4156928075856,-12.99,2
09:25,722358036.0,227.5135906270828,-22.98,2
09:25,890567652.0,306.2861996796006,-139.0,2
09:26,709151315.0,412.2352183741599,-31.96,1
09:27,130522384.0,-274.10381562086036,-22.0,2
09:27,250957494.0,987.3327499999984,-57.98,2
09:27,492850697.0,436.6010866658636,-106.09,2
09:27,703588001.0,478.27129999999966,-12.99,2
09:28,903663593.0,722.139380043554,-14.98,7
09:28,603375739.0,2363.883063023268,-12.99,2
09:28,547010927.0,28205.373537129148,-36.61,2
09:28,760704118.0,1663.0523127174897,-52.97,2
09:29,621652856.0,1145.0259696105402,-30.02,2
09:29,283027736.0,631.2942439701727,-40.99,2
09:29,165098840.0,-167.6456263623731,-54.98,6
09:29,553734946.0,776.2130999999981,-99.98,4
09:30,943829984.0,397.4158091134568,-3.0,4
09:30,469330905.0,1076.9364286233556,-19.99,2
09:31,737547541.0,427.22059956777434,-44.98,2
09:31,460463595.0,98.98205458142108,-33.21,7
09:31,637433131.0,374.210799999999,-62.93,4
09:32,422955974.0,311.1719349990499,-109.98,2
09:32,277562576.0,348.28216997625714,-5.99,4
09:33,585133606.0,6203.464711631686,-5.17,5
09:33,711140907.0,1129.9542999999992,-35.0,2
09:33,358836279.0,550.4256928075856,-54.99,2
09:33,475277431.0,1904.294136943619,-6.0,4
09:34,519933553.0,401.4210041507283,-56.99,2
09:34,280098744.0,1068.7933778716667,-31.48,4
09:35,680773155.0,949.5190833310912,-19.99,2
09:35,660561861.0,1360.7856493325728,-49.99,2
09:35,709142813.0,1222.9797999999992,-3.49,4
09:36,909669130.0,618.9298847367668,-30.02,2
09:37,977899503.0,73.75089358085265,-42.54,4
09:37,786141370.0,288.73169999999914,-14.99,4
09:37,442079728.0,708.3551192193138,-35.95,1
09:38,147508204.0,315.01471778188653,-72.0,2
09:39,648644594.0,1045.707099999999,-12.99,2
09:40,266777719.0,168.77493378023968,-30.14,2
09:41,358836279.0,405.4456928075856,-144.98,2
09:41,647472692.0,29669.37141402665,-251.3,2
09:41,668175891.0,1254.942916073262,-49.99,2
09:41,283027736.0,474.3142439701727,-156.98,2
09:42,284161641.0,745.0723110405756,-16.0,7
09:42,678851253.0,5107.201137861535,-85.41,5
09:42,492850697.0,411.6210866658636,-24.98,1
09:42,923322792.0,-523.6943317536377,-49.97,2
09:43,903663593.0,644.149380043554,-77.99,2
09:44,867679563.0,150.39675370171585,-74.98,2
09:44,240643705.0,574.200079620568,-71.97,4
09:44,548907062.0,810.1673364260272,-59.98,2
09:45,519933553.0,376.4210041507283,-25.0,2
09:46,503575533.0,9394.40555803437,-37.99,7
09:46,585625048.0,3103.8099749993585,-132.3,2
09:47,621652856.0,1139.0259696105402,-6.0,1
09:47,680773155.0,924.5190833310912,-25.0,2
09:48,890567652.0,203.7861996796006,-102.5,2
09:48,250895529.0,2276.042832469289,-56.0,2
09:49,737547541.0,392.22059956777434,-35.0,2
09:50,165098840.0,-221.6356263623731,-53.99,2
09:50,364357875.0,9907.231617475503,-65.04,5
09:51,737537711.0,49.28553360153568,-22.07,2
09:52,412823730.0,688.1203158504898,-13.0,2
09:52,455052690.0,294.61773994862756,-35.0,2
09:52,865748375.0,3461.5187656464764,-35.03,2
09:52,283027736.0,463.8342439701727,-10.48,4
09:53,978951113.0,-355.5031425904192,-11.98,7
09:55,657139925.0,15583.695279996144,-44.53,7
09:55,986774156.0,2048.6469316257694,-27.95,7
09:55,596171893.0,209.41559482551065,-51.99,2
09:56,348325817.0,11071.490980263166,-82.03,2
09:57,490790931.0,594.5089499999985,-25.0,2
09:57,519933553.0,356.4310041507283,-19.99,2
09:59,943829984.0,329.4358091134568,-67.98,6
09:59,737547541.0,386.23059956777433,-5.99,2
10:00,909676212.0,658.0958136673079,-59.99,2
10:00,250895529.0,2236.062832469289,-39.98,2
10:00,285220959.0,13447.735037241056,-73.5,5
10:00,183546640.0,288.3406973477338,-59.98,2
10:01,346874167.0,309.554249999999,-146.99,2
10:01,412823730.0,666.1003158504898,-22.02,2
10:01,407574996.0,2105.2396093809375,-54.2,2
10:03,709142813.0,1192.9897999999991,-29.99,2
10:03,873701090.0,796.8298067144723,-57.32,4
10:04,277562576.0,319.32216997625716,-28.96,1
10:04,535744551.0,1268.0630659956255,-36.95,7
10:04,480557476.0,13453.793381694111,-18.49,7
10:05,924045955.0,1775.0994426586649,-7.01,4
10:07,812012103.0,-457.6243000000004,-13.98,1
10:07,519933553.0,303.4410041507283,-52.99,2
10:07,504055745.0,531.9477613417669,-29.96,7
10:08,678726554.0,82.92875234838971,-44.99,2
10:09,407574996.0,2074.1296093809374,-31.11,2
10:09,424927189.0,212.7218827441052,-26.97,7
10:09,695607232.0,87.22649461056,-5.99,2
10:09,455052690.0,240.69773994862751,-53.92,1
10:09,647472692.0,29565.07141402665,-104.3,2
10:10,615144184.0,1074.803899125519,-49.99,2
10:11,347110339.0,-126.46679250314814,-6.99,4
10:12,823208989.0,98.8517038695318,-101.59,2
10:14,657528784.0,265.4169000000007,-54.98,2
10:14,603375739.0,2333.923063023268,-29.96,7
10:15,283027736.0,436.8742439701727,-26.96,7
10:16,479456865.0,1733.6178118641742,-5.99,2
10:17,556631012.0,486.006373085678,-31.99,2
10:17,266777719.0,157.74493378023968,-11.03,1
10:19,578131296.0,1092.2284194440435,-99.99,2
10:19,737537711.0,11.19553360153568,-38.09,2
10:19,248142083.0,148.64143470251668,-137.49,2
10:19,596171893.0,170.46559482551066,-38.95,7
10:19,298000165.0,29292.377664103824,-13.52,5
10:21,867679563.0,90.41675370171586,-59.98,2
10:21,264550521.0,7227.434670027665,-30.21,7
10:21,331048953.0,521.1363679784936,-72.99,2
10:21,442079728.0,658.3651192193138,-49.99,2
10:22,168414279.0,361.1072842749213,-112.98,2
10:23,572136270.0,-314.44328841197654,-31.1,5
10:23,422955974.0,244.26193499904988,-66.91,7
10:23,816685391.0,-731.9309037084265,-97.16,5
10:25,556631012.0,386.016373085678,-99.99,2
10:25,192202372.0,622.9757349805994,-67.98,2
10:25,504055745.0,490.9039613417668,-41.04,5
10:25,973086490.0,11942.907761277673,-6.06,8
10:28,641376155.0,348.62251210145115,-100.19,2
10:28,781554833.0,1339.4102255639664,-37.99,2
10:29,541639148.0,5103.382771135233,-28.99,1
10:29,155317149.0,441.247249999999,-44.98,2
10:29,133755851.0,724.649248138252,-27.48,4
10:31,250895529.0,2192.062832469289,-44.0,2
10:31,143003091.0,12967.409994863394,-91.69,2
10:31,578131296.0,1062.2384194440435,-29.99,4
10:38,492850697.0,355.52504666586356,-56.1,4
10:38,711140907.0,1037.9842999999992,-91.97,2
10:38,978951113.0,-408.5031425904192,-53.0,2
10:39,909669130.0,605.9298847367668,-13.0,2
10:40,412823730.0,629.0432958504898,-37.06,4
10:41,641376155.0,328.55245210145114,-20.07,4
10:42,427909748.0,2264.6832000000163,-19.99,4
10:42,647472692.0,29356.47141402665,-208.6,2
10:43,993238248.0,-386.66148739288394,-76.99,2
10:45,192202372.0,606.4857349805994,-16.49,4
10:46,575652395.0,2140.620701060258,-9.35,5
10:47,519933553.0,257.4710041507283,-45.97,2
10:47,585625048.0,2968.0099749993583,-135.8,2
10:48,280268430.0,6603.639006068061,-31.48,4
10:49,283027736.0,366.8942439701727,-69.98,2
10:54,270374623.0,11610.952337998866,-46.2,2
10:54,655368335.0,4606.044054440489,-57.69,5
10:54,978951113.0,-495.4731425904192,-86.97,4
10:55,427909748.0,2184.7032000000163,-79.98,2
10:57,248142083.0,109.14143470251668,-39.5,2
10:58,192202372.0,586.4957349805994,-19.99,2
11:01,737537711.0,-71.02446639846431,-82.22,2
11:01,280268430.0,6455.659006068061,-147.98,2
11:03,548907062.0,796.1873364260272,-13.98,4
11:05,890567652.0,163.7861996796006,-40.0,2
11:08,409370545.0,919.3012755455208,-74.68,5
11:09,143003091.0,12855.423994863391,-111.99,2
11:09,668175891.0,1238.962916073262,-15.98,1
11:10,821971408.0,1332.7971102355432,-23.96,7
11:11,965038148.0,439.3943656323277,-10.01,2
11:11,270374623.0,11600.702337998866,-10.25,4
11:11,680773155.0,918.5290833310912,-5.99,2
11:13,130522384.0,-293.0838156208604,-18.98,2
11:16,266777719.0,109.52493378023968,-48.22,2
11:17,695607232.0,46.236494610559994,-40.99,2
11:18,688328251.0,-1300.1363753548274,-122.48,2
11:21,706361191.0,755.0320484940779,-29.99,2
11:22,641376155.0,198.31245210145113,-130.24,2
11:23,424927189.0,164.7318827441052,-47.99,2
11:27,678726554.0,55.96875234838971,-26.96,1
11:27,407574996.0,2019.9896093809373,-54.14,7
11:29,250895529.0,2152.122832469289,-39.94,1
11:32,194745206.0,727.0333720912431,-80.21,2
11:32,909669130.0,599.9498847367668,-5.98,4
11:32,709142813.0,1164.029799999999,-28.96,7
11:34,248142083.0,48.651434702516674,-60.49,2
11:38,598793068.0,996.336399999998,-21.97,4
11:39,890567652.0,9.7861996796006,-154.0,2
11:42,585625048.0,2898.709974999358,-69.3,2
11:45,660561861.0,1244.8156493325728,-115.97,2
11:46,688328251.0,-1412.1163753548274,-111.98,2
11:50,504055745.0,463.9339613417668,-26.97,4
11:50,152616936.0,1193.6820078630649,-132.99,5
11:50,283027736.0,344.8942439701727,-22.0,2
11:51,993238248.0,-427.641487392884,-40.98,2
11:51,786141370.0,282.7516999999991,-5.98,4
11:52,637433131.0,310.23079999999896,-63.98,2
11:52,598793068.0,969.3763999999978,-26.96,7
11:53,331048953.0,482.1863679784936,-38.95,7
11:53,766941757.0,4115.37312150214,-37.38,9
11:54,956717493.0,1912.1307504359845,-57.97,2
11:55,688328251.0,-1530.6063753548274,-118.49,2
11:58,143003091.0,12793.123994863394,-62.3,2
11:58,248142083.0,23.65143470251667,-25.0,2
11:58,402438092.0,838.5339999999989,-34.87,2
11:59,454356905.0,3323.8924146339677,-9.12,4
12:03,412823730.0,547.9832958504899,-81.06,2
12:04,168414279.0,304.1172842749213,-56.99,2
12:06,455052690.0,198.72773994862752,-41.97,4
12:07,331048953.0,352.20636797849363,-129.98,2
12:11,709151315.0,382.2452183741599,-29.99,2
12:17,679943657.0,4366.338889180138,-7.8,9
12:19,449387287.0,708.4176938351013,-22.39,9
12:20,938992364.0,682.9401237313995,-15.01,4
12:24,799453072.0,-344.01545000000124,-352.1,2
12:28,248142083.0,-21.838565297483328,-45.49,2
12:28,779236304.0,2463.997595479535,-34.24,9
12:33,711140907.0,1019.0142999999993,-18.97,7
12:34,322221939.0,4724.530268609067,-32.15,1
12:34,143003091.0,12623.065994863397,-170.06,2
12:34,490790931.0,521.5289499999985,-72.98,2
12:35,668175891.0,1207.472916073262,-31.49,4
12:36,520447032.0,9039.672353103737,-31.13,9
12:36,469561218.0,-3.80435000000087,-33.19,9
12:36,776431321.0,3837.556382838624,-11.98,1
12:36,786141370.0,204.7616999999991,-77.99,2
12:37,688328251.0,-1545.5863753548274,-14.98,2
12:41,284161641.0,721.1723110405757,-23.9,4
12:43,384497904.0,828.353499999999,-12.99,2
12:46,615144184.0,1044.823899125519,-29.98,2
12:47,202320275.0,-701.0378500000006,-67.35,5
12:47,412823730.0,467.92329585048986,-80.06,2
12:47,402438092.0,775.1664999999989,-63.37,2
12:47,799453072.0,-503.61545000000126,-159.6,2
12:50,175452235.0,-574.1207499999996,-26.6,5
12:50,254853117.0,4511.670777336199,-1.16,4
12:53,978951113.0,-517.4731425904192,-22.0,2
12:55,678726554.0,-16.021247651610288,-71.99,2
12:55,943829984.0,297.4458091134568,-31.99,2
12:56,615144184.0,969.8338991255188,-74.99,2
12:58,224215364.0,-1972.550092088279,-11.25,5
12:59,910730524.0,8967.507232543914,-5.9,9
12:59,248142083.0,-120.31856529748332,-98.48,2
13:01,340680761.0,-3382.245599999996,-14.69,5
13:04,585625048.0,2737.709974999358,-161.0,2
13:04,402438092.0,627.8064999999989,-147.36,2
13:07,630468201.0,-512.1185338897017,-90.63,5
13:09,956717493.0,1902.1407504359845,-9.99,2
13:10,407574996.0,2012.689609380937,-7.3,9
13:12,585625048.0,2732.209974999358,-5.5,9
13:13,552980092.0,132.51071911933752,-16.5,4
13:15,134461671.0,6392.318033850895,-30.29,5
13:17,340321732.0,2661.489250000004,-7.5,9
13:17,904154012.0,882.2374581204315,-9.99,7
13:21,688712152.0,8019.627900262115,-4.8,9
13:21,849096144.0,2451.7290207513443,-6.5,9
13:22,277562576.0,312.1721699762572,-7.15,9
13:24,993238248.0,-483.631487392884,-55.99,2
13:25,248142083.0,-247.8085652974833,-127.49,2
13:25,709151315.0,312.2452183741599,-70.0,2
13:28,680773155.0,885.5290833310912,-33.0,4
13:32,711140907.0,996.0342999999992,-22.98,2
13:32,895750759.0,110.6374119243341,-98.47,2
13:40,695607232.0,14.246494610559996,-31.99,2
13:41,442079728.0,606.3851192193138,-51.98,2
13:45,455052690.0,89.44373994862755,-109.28,5
13:45,248142083.0,-336.8085652974833,-89.0,2
13:46,384497904.0,819.353499999999,-9.0,4
13:46,709142813.0,1114.039799999999,-49.99,2
13:47,194745206.0,651.8233720912431,-75.21,2
13:47,660561861.0,1199.8656493325727,-44.95,4
13:52,578131296.0,1057.2384194440435,-5.0,4
13:53,421881811.0,3753.9046430358,-8.94,2
13:56,895750759.0,-7.852588075665892,-118.49,2
13:58,641376155.0,148.22245210145113,-50.09,2
13:59,660561861.0,1178.8856493325727,-20.98,4
13:59,637433131.0,260.24079999999896,-49.99,2
14:00,786141370.0,169.8016999999991,-34.96,1
14:07,578131296.0,947.2584194440436,-109.98,2
14:08,615144184.0,913.8538991255188,-55.98,2
14:12,414454079.0,4719.228850000002,-2.54,4
14:17,287480331.0,9239.5207880553,-46.42,2
14:18,168414279.0,282.1172842749213,-22.0,2
14:21,895750759.0,-158.83258807566588,-150.98,2
14:22,890567652.0,-304.7138003203994,-135.0,2
14:23,688328251.0,-1639.5863753548274,-94.0,2
14:26,270374623.0,11542.172337998863,-58.53,2
14:37,993238248.0,-511.631487392884,-28.0,2
14:48,615144184.0,840.8838991255188,-72.97,2
14:53,384497904.0,744.373499999999,-74.98,2
14:54,938992364.0,647.9101237313995,-35.03,2
14:58,985188462.0,250.9763887112247,-36.22,9
15:03,680773155.0,873.5890833310912,-11.94,9
15:05,938992364.0,553.8501237313994,-94.06,2
15:05,890567652.0,-552.2138003203994,-247.5,2
15:09,786141370.0,105.82169999999913,-63.98,2
15:17,688328251.0,-1739.5663753548274,-99.98,2
15:19,641376155.0,86.12245210145113,-62.1,2
15:21,938992364.0,547.8501237313994,-6.0,2
15:26,329840194.0,1806.681730143148,-40.3,4
15:31,890567652.0,-638.7138003203994,-86.5,2
15:35,555393405.0,-635.6274000000003,-100.8,2
15:41,688328251.0,-1879.5463753548272,-139.98,2
15:45,448279144.0,1322.648899999999,-41.98,2
15:47,192202372.0,556.4957349805994,-30.0,4
15:48,615144184.0,833.8938991255188,-6.99,1
15:52,742223719.0,1067.6043573048023,-34.99,2
16:00,938992364.0,365.70012373139946,-182.15,2
16:04,890567652.0,-683.2138003203994,-44.5,2
16:05,709142813.0,1014.0497999999992,-99.99,2
16:06,165098840.0,-243.6356263623731,-22.0,6
16:07,742223719.0,1009.6343573048024,-57.97,4
16:07,448279144.0,1293.688899999999,-28.96,1
16:10,838830098.0,1110.4876920877844,-19.99,6
16:19,867987292.0,2809.140549240447,-58.45,7
16:20,885259672.0,3702.2310002268177,-6.58,7
16:24,684988568.0,-118.06247342720154,-49.92,7
16:25,720742759.0,1720.3711308830073,-49.99,2
16:26,198946608.0,5050.556124598253,-32.06,1
16:28,641376155.0,56.072452101451134,-30.05,2
16:28,890567652.0,-758.2138003203994,-75.0,2
16:29,660561861.0,1133.9056493325727,-44.98,2
16:31,331048953.0,316.2263679784936,-35.98,4
16:31,637433131.0,242.27079999999896,-17.97,1
16:34,779620857.0,-536.453346385176,-127.62,5
16:34,128033695.0,3176.487818804728,-29.93,9
16:35,738958551.0,10341.813867790308,-30.16,9
16:36,286484726.0,1277.3736391525706,-28.0,2
16:38,456221621.0,917.789367302628,-39.98,2
16:40,720742759.0,1714.3811308830072,-5.99,1
16:42,241459011.0,1090.2326132723465,-21.97,1
16:42,899742927.0,14856.463459673869,-130.5,2
16:44,776108637.0,1284.5802536574954,-140.98,2
16:47,641376155.0,36.05245210145114,-20.02,1
16:49,274818272.0,487.30757856713126,-59.98,2
16:50,170233640.0,-716.9016100501027,-72.36,5
16:51,521611005.0,-109.67328585104651,-12.99,2
16:51,151278285.0,1470.2274499999994,-5.99,2
16:52,720742759.0,1670.3811308830072,-44.0,4
16:55,627723633.0,-1802.208828003762,-36.1,5
16:58,890567652.0,-934.7138003203994,-176.5,2
16:59,116598243.0,3640.524221777451,-55.82,5
17:00,492215823.0,4963.342223815445,-38.5,9
17:01,519935524.0,1410.715329737519,-45.08,2
17:01,799286313.0,-848.0355628758616,-158.02,5
17:02,912584712.0,899.0706195447331,-4.99,7
17:02,456221621.0,862.8193673026278,-54.97,2
17:04,146909202.0,5313.292056119024,-131.57,2
17:05,128033695.0,3164.273435682079,-12.21,7
17:05,129018172.0,11646.78946802586,-99.98,2
17:06,641376155.0,-27.077547898548865,-63.13,2
17:06,679911053.0,3633.829497619659,-8.51,4
17:09,108481285.0,10809.570899965316,-25.75,2
17:09,165098840.0,-353.6156263623731,-109.98,2
17:11,166019891.0,9823.11658722748,-14.48,9
17:12,762700245.0,1516.4717000000026,-99.99,2
17:12,890567652.0,-1088.7138003203995,-154.0,2
17:13,736340277.0,9269.104176335628,-75.99,8
17:14,345582855.0,1231.6743528205493,-11.97,4
17:14,696333897.0,579.8703999999987,-42.0,4
17:15,854513972.0,2757.7377000000006,-24.2,9
17:17,532478725.0,5469.654286050555,-1.67,4
17:17,296972867.0,-813.4141000000009,-63.39,5
17:18,291580432.0,353.47195000000016,-43.96,4
17:19,414805878.0,14814.113239226288,-35.35,9
17:19,347110339.0,-151.46679250314816,-25.0,2
17:19,742223719.0,983.6543573048024,-25.98,2
17:20,860360312.0,333.72020888268025,-22.0,2
17:20,492850697.0,317.5050466658636,-38.02,2
17:21,964702094.0,1338.6917425992494,-29.99,2
17:23,197865285.0,432.3933117312203,-18.98,2
17:23,366477356.0,911.9417999999998,-61.98,2
17:23,683078800.0,2541.830481147286,-73.97,5
17:24,308068836.0,634.7815225681923,-20.01,2
17:25,613729471.0,9953.981216949678,-306.6,2
17:25,521611005.0,-259.6532858510465,-149.98,2
17:25,828750680.0,1511.83214521368,-49.99,4
17:25,535804582.0,650.7472999999986,-29.99,4
17:25,975345315.0,41109.11389051304,-5.99,4
17:26,380228542.0,-538.0220081844343,-57.0,2
17:26,709608057.0,3268.8110241817135,-1.48,4
17:27,405945930.0,4465.426219465058,-11.98,7
17:27,667367404.0,11260.604684366668,-79.85,2
17:28,688328251.0,-1953.5063753548277,-73.96,2
17:29,815385232.0,12406.94602859711,-47.75,7
17:29,519935524.0,1393.6713097375189,-17.04,4
17:31,347110339.0,-281.4467925031481,-129.98,2
17:32,388862238.0,2159.3254778976393,-21.98,4
17:33,844835978.0,11906.547631562928,-18.31,5
17:33,314980178.0,5565.286850000007,-19.98,2
17:33,500843551.0,1299.7122999999997,-42.98,2
17:34,492850697.0,217.4250466658636,-100.08,2
17:34,605116158.0,3219.8695000000052,-3.0,4
17:34,558875206.0,4651.120539399782,-22.0,2
17:35,373163757.0,12208.157782079334,-21.99,7
17:35,631111289.0,-1.3765000000009318,-5.97,7
17:36,890567652.0,-1183.2138003203995,-94.5,2
17:36,698076160.0,7699.915462803154,-22.97,4
17:37,454129843.0,1202.91639516656,-14.98,7
17:37,361955473.0,682.4137452440841,-5.99,2
17:37,180616589.0,1659.7188282361094,-25.96,7
17:37,383625050.0,4010.041920327189,-90.38,5
17:38,282102606.0,1087.7713624228263,-9.99,7
17:39,196289502.0,18532.681370371753,-41.89,7
17:40,930271460.0,391.62774753577617,-123.37,5
17:41,633345190.0,7006.537624869656,-21.38,7
17:41,555393405.0,-681.8134000000003,-46.19,2
17:41,603721739.0,1320.7378994831838,-127.99,2
17:43,851181128.0,6207.212445224474,-114.27,2
17:43,647936800.0,1917.0442916567995,-75.21,2
17:43,758885184.0,1287.6971822743446,-75.99,2
17:44,824916823.0,9922.90495602982,-2.98,2
17:44,698955014.0,1142.0403404481908,-14.14,5
17:44,613729471.0,9919.68121694968,-34.3,2
17:44,637433131.0,156.30079999999896,-85.97,2
17:45,405945930.0,4410.4362194650585,-54.99,2
17:45,168414279.0,262.1472842749213,-19.97,7
17:45,390747457.0,902.9423999999976,-9.99,2
17:46,832564361.0,17986.191260099247,-12.31,5
17:48,519935524.0,1326.561309737519,-67.11,2
17:48,951817450.0,10460.465977360716,-57.97,7
17:49,605116158.0,3197.8695000000052,-22.0,2
17:49,347110339.0,-311.4067925031481,-29.96,1
17:51,886921642.0,4087.5694233211734,-9.59,8
17:52,241459011.0,1068.2326132723465,-22.0,2
17:52,842682241.0,4707.256704504095,-8.84,5
17:53,897592348.0,17778.11141771174,-25.97,7
17:53,322720763.0,8238.466803671503,-111.49,5
17:54,158414827.0,-1501.865000000002,-3.89,5
17:55,613729471.0,9818.18121694968,-101.5,2
17:56,500843551.0,1249.7122999999997,-50.0,2
17:56,762859681.0,1329.0615999999989,-10.0,7
17:56,414805878.0,14805.361575531178,-8.75,5
17:57,574548998.0,192.88504999999896,-29.99,2
17:57,518474507.0,16531.891073113846,-20.28,5
17:57,786141370.0,75.84169999999911,-29.98,2
17:59,679911053.0,3624.378977014804,-9.45,2
18:00,678851253.0,5087.111137861535,-20.09,2
18:01,130154096.0,1203.2226328480244,-154.0,2
18:02,486495235.0,2269.833860076208,-95.06,5
18:04,585133606.0,6173.484711631687,-29.98,9
18:04,890567652.0,-1385.7138003203995,-202.5,2
18:05,999752672.0,1988.1610935333345,-28.99,9
18:06,256002321.0,7815.581562997802,-12.44,9
18:07,305778936.0,11346.06265777028,-35.73,9
18:07,833499132.0,1556.9786000000024,-106.41,5
18:09,688328251.0,-2031.4863753548275,-77.98,2
18:09,796709231.0,461.2423278962974,-65.99,2
18:11,886921642.0,4079.1834233211734,-8.39,5
18:16,719742742.0,3.0899922220368765,-35.93,9
18:26,224112146.0,572.1439999999997,-66.73,5
18:27,227104649.0,2076.5823843161784,-21.61,7
18:31,587202562.0,713.7348994170684,-14.99,7
18:31,891716230.0,501.5303298101014,-49.97,7
18:32,106601471.0,12036.145671464828,-36.5,9
18:36,984783496.0,16323.56209471927,-4.3,7
18:39,726913482.0,-637.6372985264766,-81.12,5
18:46,887853850.0,12026.225138713393,-28.9,9
18:47,688328251.0,-2160.4763753548277,-128.99,2
18:47,213112754.0,6734.382770762738,-9.05,9
18:47,905860285.0,14614.556479122712,-34.82,5
18:53,510101371.0,14491.553829927714,-84.48,5
18:53,308505160.0,15936.014102414749,-38.18,9
18:55,143061865.0,8129.296826403767,-65.55,5
18:58,570323670.0,4251.009038476782,-3.48,8
18:58,421475159.0,-356.1377373255875,-119.76,5
18:59,471897866.0,8412.891134195606,-35.07,5
19:07,899692478.0,-2121.6908435240075,-120.18,5
19:08,282837512.0,16176.130243995478,-28.88,9
19:09,653667523.0,5425.611594121482,-112.6,5
19:10,822135975.0,13351.414047161335,-96.15,5
19:11,467207141.0,793.7742670482637,-126.12,5
19:14,858989281.0,30814.53158756828,-12.95,9
19:16,651372390.0,-3837.0407499999983,-48.07,5
19:16,131388684.0,24970.130758983574,-53.3,5
19:20,865748375.0,3442.6421610555662,-18.88,2
19:22,785749304.0,10030.127057902477,-15.94,9
19:23,482513594.0,7070.677504982324,-23.06,5
19:23,370521542.0,30725.997280446107,-11.94,9
19:24,170637730.0,1945.4501684677464,-6.85,5
19:24,531186970.0,3719.7173852984265,-112.2,5
19:28,352291960.0,3603.758053303574,-31.34,9
19:28,842682241.0,4681.666704504095,-25.59,9
19:29,651756497.0,18424.93999684482,-22.99,9
19:30,558119802.0,38212.53865468165,-34.37,7
19:33,992204045.0,9375.574074965873,-59.16,5
19:35,398429109.0,1827.6370000000009,-63.82,5
19:36,117273481.0,11041.1870387029,-180.4,5
19:43,345582855.0,1221.0476528205493,-10.63,5
19:52,762859681.0,1280.173599999999,-48.89,5
20:03,736340277.0,9244.184176335628,-24.92,5
20:04,285428103.0,11932.691808161067,-29.79,5
20:05,873701090.0,768.8398067144723,-27.99,9
20:05,815993333.0,6382.147186582631,-36.92,5
20:10,282102606.0,989.2981624228264,-98.47,5
20:10,933491926.0,4290.782113662489,-37.76,5
20:11,255814263.0,2283.040603488462,-85.92,5
20:13,166019891.0,9791.644587227482,-31.47,5
20:18,290818242.0,8344.75321881153,-68.68,5
20:22,897714622.0,10676.22956594118,-23.9,9
20:23,758885184.0,1204.745082274345,-82.95,5
20:29,994214354.0,11459.6128978241,-8.16,5
20:40,758160963.0,8844.303838993788,-13.45,9
20:46,310375875.0,2819.213113752716,-35.86,5
20:48,690958123.0,23830.808258578472,-64.62,5
21:11,549414742.0,8421.957374495529,-17.23,9
23:58,873701090.0,767.7347184835162,-1.11,2
00:44,873701090.0,745.0128820811549,-22.72,2
01:03,678851253.0,5044.2631845839105,-42.85,4
01:53,270374623.0,11538.895477973432,-3.28,7
01:55,548907062.0,740.9631711746526,-55.22,7
02:21,518474507.0,16491.021073113847,-40.87,9
02:40,187541224.0,3029.3692762436,-40.6,9
02:41,282837512.0,16142.700243995478,-33.43,9
02:44,128033695.0,3161.2618120666593,-3.01,5
02:45,601627384.0,4105.091483272718,-33.51,9
02:56,408057540.0,7227.962574449837,-31.79,9
03:00,738958551.0,10315.873867790307,-25.94,9
03:01,287480331.0,9218.4407880553,-21.08,9
03:12,282837512.0,16113.256211239235,-29.44,5
03:14,651756497.0,18420.02989966431,-4.91,7
03:20,586315521.0,14229.812171631698,-57.88,2
03:25,442079728.0,577.6451192193138,-28.74,9
03:26,678330503.0,2858.7216425501533,-66.24,7
03:28,540159353.0,12681.394164377818,-20.31,5
03:29,905860285.0,14599.738563165887,-14.82,8
03:35,216285378.0,27391.191113528406,-35.73,9
03:35,719586818.0,21945.093539701986,-9.83,4
03:40,489964679.0,23634.699462369877,-40.43,9
03:46,802697323.0,18895.398174823273,-44.58,9
03:48,987163717.0,4794.146078176685,-32.89,9
03:53,305778936.0,11313.67265777028,-32.39,9
03:55,108481285.0,10803.108983901346,-6.46,8
03:55,986267641.0,5993.191430840904,-21.75,9
03:58,912705941.0,21309.799351867143,-21.31,5
04:03,324224854.0,6480.26578196589,-23.2,2
04:03,522188082.0,8665.491565524566,-55.29,8
04:04,550169791.0,25752.99061418696,-4.05,5
04:07,365608668.0,816.7854719666742,-5.49,7
04:08,229205098.0,9032.74090953428,-24.65,2
04:10,399144202.0,2485.5245147199125,-16.84,2
04:11,940569402.0,5662.12911421696,-19.7,9
04:17,511179916.0,9105.755992984496,-4.8,4
04:18,480557476.0,13423.285589675756,-30.51,5
04:20,256002321.0,7791.731562997802,-23.85,9
04:23,492215823.0,4927.952223815445,-35.39,9
04:24,305778936.0,11301.021883817286,-12.65,5
04:26,587225252.0,7377.267698566697,-26.34,9
04:28,859603181.0,4123.545121246931,-73.65,2
04:34,221868392.0,5670.432781209947,-19.99,9
04:39,609939116.0,9325.97076748945,-40.79,7
04:40,198946608.0,5028.902373798625,-21.65,7
04:40,532478725.0,5439.684286050555,-29.97,9
04:41,994214354.0,11430.122897824102,-29.49,9
04:41,687135796.0,32812.7934215827,-6.99,9
04:43,348325817.0,11039.110980263167,-32.38,9
04:44,575652395.0,2133.734517920477,-6.89,5
04:45,170637730.0,1931.522318353816,-13.93,5
04:49,824916823.0,9900.104956029822,-22.8,9
04:49,264550521.0,7210.603073595996,-16.83,8
04:53,572384506.0,9368.11268750895,-25.49,9
04:54,809499628.0,20379.280558595256,-19.49,9
05:04,310375875.0,2788.113113752716,-31.1,9
05:04,633345190.0,6977.747624869656,-28.79,9
05:04,409971170.0,3776.7438909754687,-53.97,7
05:05,221868392.0,5665.661356637594,-4.77,7
05:06,766941757.0,4074.47312150214,-40.9,9
05:06,992204045.0,9340.440324081264,-35.13,2
05:06,120634201.0,6307.29869192003,-19.49,9
05:12,290818242.0,8284.921004429223,-59.83,7
05:12,687135796.0,32793.73785787817,-19.06,8
05:13,151968462.0,9079.2132401415,-16.91,2
05:14,183888402.0,22046.97245714013,-47.93,9
05:15,519644021.0,4103.272001636762,-16.59,2
05:17,951817450.0,10405.151468509135,-55.31,7
05:20,960208650.0,17050.35023688258,-24.72,5
05:20,195895574.0,7932.402459600402,-16.4,7
05:21,471897866.0,8384.03994859486,-28.85,5
05:22,435984758.0,5067.530773789633,-2.95,8
05:23,613729471.0,9810.303587992514,-7.88,5
05:25,315546581.0,32984.064109378196,-70.28,5
05:25,237493332.0,17208.87932497077,-20.53,7
05:26,364357875.0,9901.058455547023,-6.17,7
05:26,196289502.0,18520.231370371752,-12.45,9
05:29,285220959.0,13400.382488127392,-4.4,2
05:30,441274121.0,14635.21647104934,-34.6,4
05:30,897714622.0,10674.234413471777,-2.0,2
05:31,984783496.0,16296.372094719269,-27.19,9
05:32,706250160.0,14842.099550788938,-28.19,9
05:40,873693307.0,12802.145272372542,-20.89,9
05:40,147474476.0,3839.5008591201313,-33.43,8
05:41,461990622.0,9111.612681195547,-10.72,5
05:44,785749304.0,10010.937057902474,-19.19,9
05:44,213112754.0,6685.831715807026,-48.55,5
05:45,310620484.0,269.26119509219825,-30.02,9
05:46,670102069.0,1901.057514113878,-39.84,9
05:46,624500124.0,3800.623682682268,-10.76,7
05:47,510101371.0,14446.353829927712,-45.2,9
05:48,450896297.0,15342.14586496894,-24.19,9
05:48,187111705.0,8308.691826722466,-44.91,8
05:50,518474507.0,16480.178987580694,-10.84,4
05:51,865748375.0,3416.9863240244263,-25.66,7
05:55,887853850.0,12006.8578092337,-19.37,8
05:57,842682241.0,4662.679954099576,-18.99,7
05:57,259015404.0,1406.7606423094617,-27.13,9
05:58,899742927.0,14856.338374243787,-0.13,2
06:01,256002321.0,7759.264111912755,-32.47,2
06:01,653640811.0,20240.641415088896,-14.21,7
06:03,532478725.0,5424.44991731514,-15.23,5
06:03,706250160.0,14813.982515898762,-28.12,5
06:04,383833857.0,29582.622038375277,-11.8,2
06:07,547010927.0,28175.053537129148,-30.32,9
06:08,994214354.0,11415.681605976391,-14.44,2
06:10,408057540.0,7184.921037500423,-43.04,2
06:11,873693307.0,12787.850322166894,-14.29,5
06:13,124102251.0,2511.720065265774,-14.22,5
06:14,769311479.0,7730.668810774459,-68.62,2
06:18,473820682.0,13190.703308120324,-7.62,7
06:20,450896297.0,15300.354911474682,-41.79,7
06:22,558119802.0,38201.3449940752,-11.19,2
06:23,108563213.0,26548.618194166545,-45.24,2
06:28,815385232.0,12391.167829677452,-15.78,2
06:29,867987292.0,2808.68595951718,-0.45,2
06:30,973086490.0,11921.517761277672,-21.39,9
06:32,348325817.0,11034.857205167227,-4.25,2
06:36,940569402.0,5645.217891425691,-16.91,7
06:36,718058208.0,1752.8883447974822,-44.1,2
06:45,996042490.0,7376.357699763785,-19.58,8
06:45,985188462.0,214.8863887112247,-36.09,9
06:46,949032480.0,4410.379589916322,-34.08,9
06:46,758160963.0,8835.313838993789,-8.99,9
06:46,736340277.0,9226.994176335627,-17.19,9
06:47,858989281.0,30795.24158756828,-19.29,9
06:49,822135975.0,13309.983351574396,-41.43,5
06:51,179173981.0,4908.571488562895,-37.13,9
06:53,851181128.0,6178.072445224474,-29.14,9
06:54,657139925.0,15568.195279996144,-15.5,9
06:54,853907490.0,9557.86426203134,-4.17,5
07:01,832564361.0,17957.593185490554,-28.6,4
07:02,108931112.0,16859.74320698168,-32.52,9
07:07,675806859.0,8939.271914081108,-2.77,5
07:09,322221939.0,4708.1976106583425,-16.33,2
07:09,392270893.0,15041.975171604305,-28.63,7
07:13,623156843.0,5992.057249829612,-20.7,5
07:13,308505160.0,15914.157486642454,-21.86,8
07:19,704517789.0,20093.26689463572,-14.0,7
07:21,668329719.0,10228.483170737863,-51.1,2
07:22,482513594.0,7043.6808751635745,-27.0,7
07:22,179173981.0,4854.826800937221,-53.74,7
07:27,429556122.0,5633.195544980972,-30.8,2
07:27,534325901.0,7489.2597360016525,-3.4,5
07:28,581655972.0,46100.00529200948,-19.48,2
07:28,709608057.0,3233.3110241817135,-35.5,9
07:29,910730524.0,8941.678425566231,-25.83,8
07:31,858989281.0,30782.45849516344,-12.78,2
07:33,901432314.0,4114.1731401526595,-7.44,5
07:33,355733816.0,5718.073720118672,-6.03,8
07:34,730002588.0,16040.66751067895,-16.61,4
07:37,930277104.0,10707.208146432018,-4.46,2
07:38,286484726.0,1222.3138129418446,-55.06,5
07:38,851649498.0,10019.112767002433,-0.66,5
07:39,749378808.0,2863.209812371021,-27.9,9
07:40,984783496.0,16294.032847666043,-2.34,2
07:43,520447032.0,9006.26272143219,-33.41,7
07:48,298000165.0,29263.26648883291,-29.11,5
07:54,419550103.0,21438.142584583376,-26.9,2
07:55,117273481.0,11023.685243085156,-17.5,8
07:55,235881534.0,14744.73379398647,-17.43,7
07:56,145387690.0,6328.986833795143,-3.91,5
07:57,245690309.0,11675.128246600065,-20.48,5
07:58,496395938.0,13953.925290629662,-80.59,7
08:06,399538448.0,8968.659771568458,-5.05,9
08:06,527842638.0,1505.6600426329835,-5.6,9
08:06,417850087.0,18066.42492314957,-22.51,2
08:07,280200287.0,-373.45295338694893,-6.5,9
08:10,779946617.0,19413.426404741935,-0.52,5
08:13,785749304.0,10003.990659349976,-6.95,5
08:13,388862238.0,2088.4565355055183,-70.87,2
08:16,657528784.0,216.5499000000007,-48.87,5
08:18,836110591.0,4540.425854893008,-18.5,2
08:18,541639148.0,5084.146998255038,-19.24,5
08:19,679911053.0,3615.175545226769,-9.2,2
08:21,321372947.0,-217.7514507890995,-37.31,5
08:23,948558249.0,9728.913461815642,-7.6,9
08:23,762700245.0,1509.3217000000025,-7.15,9
08:24,644751433.0,-1518.8581584655385,-17.99,5
08:24,414805878.0,14766.98157553118,-38.38,9
08:24,766941757.0,4067.434664992592,-7.04,7
08:26,494789005.0,3403.0221209248175,-9.89,8
08:31,822718326.0,13169.284001111884,-20.69,5
08:31,588565416.0,7474.207440626085,-2.3,5
08:33,762896656.0,-568.5225018481415,-32.89,5
08:34,383625050.0,3940.654876600135,-69.39,2
08:34,752362502.0,8970.291812530992,-1.01,8
08:35,496395938.0,13857.633290629665,-96.29,5
08:36,146909202.0,5277.520842558387,-35.77,5
08:36,844835978.0,11897.041631562928,-9.51,5
08:38,766692943.0,-2139.04425,-39.79,5
08:40,572384506.0,9360.333105920474,-7.78,7
08:41,951817450.0,10350.649468509137,-54.5,5
08:41,930277104.0,10630.81014643202,-76.4,5
08:42,407574996.0,1894.8796093809376,-117.81,5
08:42,522188082.0,8550.033565524565,-115.46,5
08:43,673025413.0,2854.966523060288,-35.9,2
08:44,554792076.0,32437.699416939853,-57.37,5
08:45,215426302.0,1162.004404025692,-19.98,5
08:45,913801979.0,204.23932991449368,-120.82,5
08:46,518378868.0,-1568.4449000000004,-35.52,5
08:47,173317688.0,-2568.201234884283,-17.45,5
08:47,554792076.0,32431.359211007824,-6.34,7
08:48,744968736.0,-1493.376826569424,-7.79,5
08:48,625658193.0,-724.9016402437832,-108.7,5
08:48,374994043.0,-2544.7505499999993,-46.82,5
08:50,426466211.0,-3727.993249999998,-24.58,5
08:54,949032480.0,4343.109027725614,-67.27,7
08:54,700138124.0,5411.998652839649,-6.78,2
08:55,832564361.0,17915.943185490552,-41.65,5
08:55,547010927.0,28164.03198541631,-11.02,5
08:56,128030172.0,-623.3421274498501,-120.04,5
08:56,287480331.0,9150.8945519088,-67.55,7
08:58,285873880.0,13304.641088241024,-69.83,2
08:58,479456865.0,1578.5863618641745,-155.03,5
09:00,426474982.0,-4031.36725,-14.3,5
09:05,216285378.0,27341.06411352841,-50.13,5
09:05,973086490.0,11915.76421366712,-5.75,5
09:06,705848712.0,30956.155962795972,-2.44,5
09:09,613729471.0,9804.703587992512,-5.6,9
09:11,916270283.0,3259.9502500000012,-86.0,5
09:12,624500124.0,3792.276002682269,-8.35,4
09:13,133755851.0,674.659248138252,-49.99,2
09:13,806358207.0,13646.223210187256,-41.03,2
09:14,741903302.0,3306.0870679352615,-6.35,9
09:15,639549973.0,6670.374963942971,-9.01,2
09:15,904154012.0,850.2874581204314,-31.95,7
09:16,117273481.0,11001.725243085157,-21.96,1
09:17,675231808.0,19173.71413259352,-5.99,4
09:17,633345190.0,6970.334195266846,-7.41,5
09:18,575652395.0,2118.659427920478,-15.08,4
09:18,703478110.0,3595.3477499085843,-21.97,7
09:18,390747457.0,802.9523999999976,-99.99,2
09:19,241459011.0,982.2626132723464,-85.97,4
09:19,667367404.0,11211.862284366667,-48.74,4
09:19,333054026.0,902.23089402319,-195.3,2
09:20,282102606.0,964.2981624228264,-25.0,2
09:20,547010927.0,28141.05198541631,-22.98,1
09:20,216285378.0,27306.804113528407,-34.26,2
09:20,737547541.0,360.4425995677743,-25.79,5
09:21,570410059.0,2605.3521467763117,-54.98,2
09:21,987656636.0,6269.972624091263,-23.89,8
09:23,604288474.0,2165.3776291457934,-7.66,7
09:23,386729293.0,35579.18407534987,-99.99,2
09:24,517934629.0,363.1676787084264,-5.99,2
09:24,454129843.0,1147.92639516656,-54.99,2
09:25,414454079.0,4716.688850000002,-2.54,4
09:25,187111705.0,8263.359826722466,-45.33,5
09:25,672913754.0,13544.68768710861,-87.07,5
09:25,648644594.0,867.707099999999,-178.0,2
09:26,663479159.0,5388.961541827712,-27.95,7
09:27,510101371.0,14413.953829927714,-32.4,4
09:27,833899961.0,938.0921957180096,-26.96,1
09:28,555804115.0,-1228.911047558703,-24.23,5
09:28,786879739.0,-2608.030794120556,-51.51,5
09:28,585596026.0,2925.8311185692573,-24.95,4
09:29,435984758.0,5061.480673789632,-6.05,4
09:30,873693307.0,12754.840322166894,-33.01,2
09:30,259015404.0,1389.8745493429474,-16.89,7
09:30,366477356.0,861.0117999999999,-50.93,7
09:31,450896297.0,15265.454911474682,-34.9,7
09:31,603721739.0,1238.7478994831838,-81.99,2
09:31,504055745.0,412.9539613417668,-50.98,6
09:32,473820682.0,13072.431308120322,-118.27,2
09:32,454129843.0,1006.94639516656,-140.98,2
09:32,574548998.0,166.92504999999895,-25.96,1
09:32,757115616.0,2344.4600000000046,-36.95,7
09:33,500043411.0,15393.399604056827,-134.91,2
09:33,303843160.0,456.5198000000013,-120.9,5
09:33,886837068.0,839.0755999999992,-28.95,7
09:33,456246119.0,23695.80539884564,-16.49,4
09:33,856957948.0,12582.291154533908,-29.99,2
09:33,719586818.0,21885.096539701983,-60.0,5
09:35,322221939.0,4607.607610658342,-100.59,2
09:36,449387287.0,659.4316938351013,-48.99,2
09:37,390747457.0,782.9623999999976,-19.99,4
09:37,709142813.0,994.0597999999992,-19.99,2
09:37,834581602.0,379.6473999999991,-165.97,7
09:38,138609932.0,2024.914003294586,-14.97,4
09:38,500051919.0,499.51099665059,-28.95,7
09:39,668175891.0,1154.472916073262,-53.0,2
09:40,333054026.0,689.4308940231901,-212.8,2
09:40,648644594.0,830.207099999999,-37.5,2
09:41,610645022.0,-173.39526264491838,-27.61,5
09:41,349614277.0,1725.345099999999,-89.98,2
09:41,427909748.0,2145.763200000016,-38.94,7
09:43,131388684.0,24893.930758983573,-76.2,2
09:44,736340277.0,9204.324176335627,-22.67,7
09:44,284161641.0,658.1723110405757,-63.0,2
09:44,631111289.0,-14.41650000000093,-13.04,5
09:45,237684254.0,7140.339777871784,-5.0,2
09:46,130522384.0,-413.0638156208604,-119.98,2
09:47,667367404.0,11191.40228436667,-20.46,7
09:48,656317661.0,-78.19465845859733,-6.99,7
09:49,499244466.0,-453.1447812834225,-65.97,5
09:49,624563756.0,124.78622878355648,-20.97,1
09:49,792845450.0,1031.7811500000007,-71.97,2
09:49,168414279.0,235.17728427492128,-26.97,4
09:49,860360312.0,133.74020888268026,-199.98,2
09:50,812012103.0,-459.5843000000005,-131.98,2
09:52,225210798.0,1110.6199351225796,-49.99,4
09:52,303843160.0,423.54980000000126,-32.97,4
09:52,785210466.0,2702.23779694656,-11.98,1
09:53,941285623.0,1345.9293990667702,-35.0,2
09:53,405945930.0,4396.786219465059,-13.65,5
09:53,500043411.0,15391.250944056828,-2.15,4
09:55,648644594.0,676.2270999999989,-153.98,6
09:56,187111705.0,8149.259826722466,-114.1,2
09:56,851181128.0,6134.358088980829,-43.71,7
09:57,408057540.0,7063.121037500423,-121.8,7
09:58,403383649.0,1708.604803153171,-30.98,1
09:58,165098840.0,-485.5956263623731,-131.98,2
09:58,699997811.0,1587.7418500000033,-151.5,2
09:58,623156843.0,5899.997249829612,-92.06,2
10:00,587202562.0,637.7648994170684,-75.97,2
10:00,924045955.0,1675.009442658665,-100.09,2
10:00,388862238.0,2082.4865355055185,-5.97,4
10:00,479366718.0,2543.761348140042,-99.5,2
10:01,683319988.0,8326.19280990545,-23.34,2
10:02,490790931.0,358.5489499999985,-42.98,2
10:02,680773155.0,782.1090833310911,-91.48,7
10:03,793781222.0,2136.950878947407,-14.99,4
10:03,914806976.0,280.23325018548644,-22.0,2
10:03,500043411.0,15357.030944056827,-34.22,4
10:04,424397946.0,702.1297836054002,-77.99,2
10:04,762859681.0,1243.183599999999,-36.99,7
10:06,471897866.0,8353.55994859486,-30.48,4
10:06,121113546.0,366.9531560698696,-31.5,2
10:06,333054026.0,410.1308940231902,-279.3,2
10:07,941285623.0,1296.9293990667702,-49.0,2
10:07,834581602.0,310.64739999999915,-69.0,7
10:08,815993333.0,6356.469889549911,-25.68,7
10:08,550169791.0,25665.11061418696,-87.88,2
10:09,473820682.0,13017.131308120324,-55.3,2
10:09,806358207.0,13611.846660187255,-34.38,4
10:09,449387287.0,483.7876938351014,-175.64,2
10:09,667367404.0,11080.80228436667,-110.6,2
10:09,283027736.0,294.8942439701727,-50.0,2
10:11,284161641.0,602.8723110405757,-55.3,2
10:11,489964679.0,23624.628372369876,-10.07,4
10:14,977899503.0,61.760893580852645,-11.99,2
10:16,143003091.0,12619.054708677711,-4.01,5
10:17,627622066.0,4233.4923721696305,-23.96,7
10:17,546296727.0,166.52772730261836,-29.99,4
10:17,699997811.0,1410.7418500000033,-177.0,2
10:20,479366718.0,2451.261348140042,-92.5,2
10:20,331048953.0,229.6013679784936,-86.62,5
10:21,187111705.0,8065.259826722466,-84.0,2
10:21,675231808.0,19033.74913259352,-139.97,5
10:21,441274121.0,14584.87683104934,-50.34,4
10:22,449387287.0,473.79769383510137,-9.99,2
10:23,985188462.0,-19.58561128877531,-234.47,2
10:23,121113546.0,237.45315606986964,-129.5,2
10:23,254853117.0,4295.370777336198,-216.3,2
10:25,520447032.0,8983.672721432189,-22.59,1
10:25,520239952.0,-1231.871176654763,-109.98,5
10:26,166019891.0,9738.380670145782,-53.26,8
10:28,414454079.0,4538.230850000003,-178.46,2
10:28,408057540.0,6951.821037500423,-111.3,4
10:28,603721739.0,1200.7578994831838,-37.99,2
10:29,282102606.0,858.3081624228265,-105.99,2
10:29,108931112.0,16813.61735272232,-46.13,2
10:31,284161641.0,432.07231104057576,-170.8,2
10:31,822135975.0,13294.683351574397,-15.3,4
10:32,184430449.0,3545.53633239109,-59.98,2
10:32,196289502.0,18518.637818889176,-1.59,5
10:33,667367404.0,10948.50228436667,-132.3,2
10:33,833899961.0,908.1021957180096,-29.99,2
10:37,914806976.0,188.2532501854864,-91.98,2
10:38,939972497.0,856.2809086000104,-64.98,4
10:38,720742759.0,1598.3811308830072,-72.0,2
10:39,605116158.0,3184.1838000000052,-13.69,5
10:39,480557476.0,13194.385589675756,-228.9,2
10:40,611143859.0,3658.3274000000138,-78.14,2
10:41,595800644.0,-1012.1570000000004,-147.91,5
10:42,834581602.0,196.16739999999916,-114.48,4
10:43,200080192.0,9864.077479114034,-12.14,1
10:43,366550080.0,26976.439661099852,-26.98,4
10:44,166019891.0,9725.580670145782,-12.8,4
10:44,866941383.0,3148.728480303674,-46.97,4
10:44,473820682.0,12940.131308120324,-77.0,2
10:45,683078800.0,2508.880481147286,-32.95,7
10:46,699997811.0,1378.7918500000033,-31.95,7
10:47,143061865.0,8090.180471331608,-39.12,2
10:47,188263947.0,839.4227500000007,-52.91,7
10:49,822135975.0,13269.173351574396,-25.51,7
10:51,200080192.0,9859.20184419246,-4.88,2
10:51,284161641.0,397.07231104057576,-35.0,2
10:52,141521177.0,8064.715900000016,-116.98,2
10:53,121113546.0,84.85315606986964,-152.6,2
10:55,642924505.0,631.305120183526,-18.0,4
10:55,285428103.0,11847.691808161067,-85.0,2
10:56,914806976.0,129.77325018548643,-58.48,4
10:56,500843551.0,1197.7222999999997,-51.99,2
10:57,585133606.0,6121.504711631687,-51.98,4
11:00,603721739.0,1094.7778994831838,-105.98,2
11:02,703588001.0,451.3112999999997,-26.96,1
11:02,699997811.0,1365.8018500000032,-12.99,2
11:09,169006407.0,13327.995666381756,-14.4,7
11:09,255814263.0,2260.0606034884618,-22.98,2
11:09,667367404.0,10805.00228436667,-143.5,2
11:11,419550103.0,21331.056584583377,-107.09,2
11:11,624563756.0,61.79622878355648,-62.99,2
11:12,235881534.0,14666.02579398647,-78.71,5
11:13,329840194.0,1784.6217301431482,-22.06,7
11:13,284161641.0,230.47231104057576,-166.6,2
11:15,473820682.0,12857.531308120322,-82.6,2
11:17,280098744.0,1027.8033778716667,-40.99,2
11:18,895331556.0,-76.38120000000092,-75.0,2
11:20,703588001.0,384.33129999999966,-66.98,2
11:21,130522384.0,-448.0138156208604,-34.95,1
11:21,506618547.0,18076.596573227896,-7.07,1
11:22,370757362.0,1778.4560236036175,-99.99,2
11:22,585596026.0,2903.8611185692575,-21.97,7
11:23,874431242.0,11441.30310447872,-2.92,2
11:24,492850697.0,117.3350466658636,-100.09,2
11:24,494789005.0,3380.7821209248177,-22.24,2
11:24,699139822.0,675.874075776947,-50.14,2
11:25,603721739.0,1084.7978994831838,-9.98,1
11:25,121113546.0,-12.446843930130356,-97.3,2
11:28,552980092.0,62.433719119337525,-70.08,5
11:29,506618547.0,18033.999687850817,-42.6,7
11:30,699997811.0,1236.8018500000032,-129.0,2
11:31,254853117.0,4058.7707773361985,-236.6,2
11:32,508518911.0,500.7447502790102,-31.99,2
11:33,441142605.0,2616.1403922757304,-9.98,4
11:34,419550103.0,21212.112584583378,-118.94,2
11:34,121113546.0,-43.94684393013035,-31.5,2
11:35,758160963.0,8786.313838993789,-49.0,7
11:35,441274121.0,14468.51683104934,-116.36,2
11:35,331450202.0,9643.28944092215,-4.07,5
11:36,270374623.0,11510.069477973431,-28.83,5
11:36,303843160.0,402.5798000000012,-20.97,1
11:37,473820682.0,12795.245308120322,-62.29,2
11:37,165098840.0,-580.5756263623731,-94.98,2
11:37,221868392.0,5630.351356637593,-35.31,1
11:39,518474507.0,16420.228987580693,-59.95,2
11:40,667367404.0,10697.202284366673,-107.8,2
11:41,433917275.0,8685.889474370399,-16.27,5
11:41,130154096.0,1186.2426328480244,-16.98,7
11:42,534204159.0,6904.02692023668,-1.11,7
11:42,779376323.0,5084.555833981341,-31.92,4
11:42,628470485.0,1274.7984975674146,-9.99,4
11:42,985188462.0,-110.5716112887753,-90.99,2
11:43,699997811.0,1162.3018500000032,-74.5,2
11:44,489964679.0,23571.678372369875,-52.95,2
11:45,749378808.0,2862.47696055885,-0.73,5
11:46,885259672.0,3697.279874191072,-4.95,2
11:49,187111705.0,8033.809826722466,-31.45,7
11:49,895331556.0,-123.88120000000092,-47.5,2
11:50,448279144.0,1213.718899999999,-79.97,4
11:51,758160963.0,8682.01383899379,-104.3,4
11:54,623156843.0,5795.917249829612,-104.08,2
11:54,795847804.0,27215.86872504431,-30.33,8
11:55,975345315.0,41108.24284900512,-0.87,2
11:57,414454079.0,4489.244850000003,-48.99,2
11:58,758160963.0,8626.71383899379,-55.3,4
11:59,473820682.0,12664.359308120322,-130.89,2
12:01,897714622.0,10646.634413471776,-27.6,9
12:02,423208402.0,3738.635500000005,-4.99,4
12:02,285428103.0,11794.618336586644,-53.07,8
12:03,121113546.0,-176.24684393013035,-132.3,2
12:03,344219145.0,9919.892953309323,-46.86,2
12:04,254853117.0,3964.2707773361985,-94.5,2
12:05,264550521.0,7197.213073595995,-13.39,9
12:05,196289502.0,18450.117818889175,-68.52,2
12:06,970298834.0,2948.5728358846695,-42.22,5
12:06,248142083.0,-426.4365652974833,-89.63,5
12:10,758160963.0,8514.71383899379,-112.0,7
12:11,985188462.0,-243.54361128877528,-132.97,2
12:12,358846516.0,965.6755225272173,-87.97,2
12:12,779236304.0,2435.6375954795353,-28.36,2
12:13,779236304.0,2414.297595479535,-21.34,9
12:13,480557476.0,13086.641589675755,-107.74,2
12:14,647936800.0,1914.658509444158,-2.39,8
12:15,414805878.0,14746.717856324232,-20.26,2
12:15,449871732.0,8283.769130852796,-33.95,1
12:16,621181115.0,-6.420249570771077,-118.3,2
12:16,832564361.0,17826.193185490552,-89.75,2
12:16,473820682.0,12629.359308120322,-35.0,2
12:16,797184978.0,77.19008657301941,-22.15,9
12:16,537487133.0,127.71834999999945,-43.17,9
12:17,975345315.0,41078.74484900512,-29.5,5
12:18,192202372.0,524.5057349805994,-31.99,2
12:19,184430449.0,3533.55633239109,-11.98,7
12:20,349614277.0,1698.3750999999993,-26.97,7
12:21,165098840.0,-650.6781263623731,-70.1,2
12:21,414454079.0,4336.686850000003,-152.56,2
12:22,113747882.0,13836.41838801534,-23.14,9
12:22,683078800.0,2463.900481147286,-44.98,2
12:27,824916823.0,9879.254393454745,-20.85,5
12:29,196289502.0,18437.575838889177,-12.54,4
12:29,520447032.0,8959.69272143219,-23.98,9
12:29,450896297.0,15235.899911474682,-29.55,4
12:32,215404070.0,656.8375891798496,-69.99,2
12:32,540159353.0,12635.810164377815,-45.58,5
12:34,758160963.0,8389.41383899379,-125.3,2
12:34,779376323.0,5057.605833981341,-26.95,1
12:34,433837402.0,317.2941315358117,-280.7,2
12:35,121113546.0,-322.5468439301303,-146.3,2
12:38,834581602.0,120.17739999999915,-75.99,7
12:41,196289502.0,18409.985838889173,-27.59,4
12:42,667367404.0,10534.10228436667,-163.1,2
12:42,519644021.0,4047.902001636762,-55.37,2
12:42,480557476.0,12926.383589675756,-160.26,2
12:43,699139822.0,640.6840757769471,-35.19,9
12:43,786141370.0,-7.648300000000901,-83.49,2
12:47,473820682.0,12616.773308120322,-12.59,2
12:49,986267641.0,5953.343822798504,-39.85,2
12:49,121113546.0,-377.8468439301303,-55.3,2
12:50,621181115.0,-72.92024957077108,-66.5,2
12:50,449387287.0,343.6116938351014,-130.19,2
12:50,303843160.0,367.5898000000012,-34.99,2
12:51,165098840.0,-754.9131263623731,-104.23,2
12:53,475277431.0,1893.304136943619,-10.99,4
12:53,386729293.0,35541.08627063043,-38.1,7
12:54,982949451.0,-4222.936667052507,-54.7,5
12:56,390747457.0,732.9723999999976,-49.99,2
12:58,310375875.0,2786.933126219952,-1.18,8
13:00,758160963.0,8222.81383899379,-166.6,2
13:01,887853850.0,11972.0678092337,-34.79,9
13:05,625281433.0,-642.7696573707569,-71.96,5
13:05,503575533.0,9264.35255803437,-130.05,5
13:05,621181115.0,-257.02024957077106,-184.1,2
13:05,187111705.0,7894.509826722466,-139.3,2
13:06,605711527.0,5.408513832583665,-61.84,5
13:07,121113546.0,-534.6468439301303,-156.8,2
13:07,936917570.0,-3232.704999999995,-65.06,5
13:08,943829984.0,246.2807091134568,-51.17,5
13:08,407574996.0,1888.3796093809376,-6.5,9
13:09,158414827.0,-1508.365000000002,-6.5,5
13:10,585625048.0,2725.409974999358,-6.8,9
13:10,480557476.0,12801.097589675755,-125.29,2
13:11,786141370.0,-138.1183000000009,-130.47,2
13:12,683319988.0,8294.29280990545,-31.9,9
13:12,583579399.0,1328.1261000000006,-1.99,4
13:14,187111705.0,7888.059826722466,-6.45,9
13:14,277562576.0,305.7221699762572,-6.45,9
13:14,760704118.0,1587.0883127174895,-75.96,5
13:15,449387287.0,253.3396938351014,-90.27,2
13:15,893134725.0,1709.487700776119,-5.99,2
13:15,408057540.0,6916.821037500423,-35.0,7
13:15,667367404.0,10398.302284366671,-135.8,2
13:16,639409800.0,40606.98635136643,-33.99,5
13:16,349107386.0,-3878.86347319456,-76.97,5
13:16,454129843.0,976.95639516656,-29.99,2
13:18,806358207.0,13585.926660187257,-25.92,2
13:19,680773155.0,677.1290833310911,-104.98,2
13:20,213096759.0,-1211.9691082144393,-33.72,5
13:20,836110591.0,4499.425854893008,-41.0,9
13:21,473820682.0,12503.401308120325,-113.37,2
13:21,758160963.0,8054.81383899379,-168.0,2
13:22,303843160.0,290.5998000000012,-76.99,2
13:22,348460748.0,70.80389999999898,-107.23,5
13:23,656812046.0,2144.2627537325193,-60.18,2
13:23,500843551.0,1161.7422999999997,-35.98,4
13:24,834581602.0,-24.782600000000855,-144.96,7
13:25,117273481.0,10975.745243085155,-25.98,4
13:25,885259672.0,3674.279874191072,-23.0,2
13:27,659008214.0,-3639.270102290422,-29.24,5
13:28,414454079.0,4142.086850000002,-194.6,2
13:31,124125096.0,254.1084443878018,-94.1,5
13:32,213112754.0,6673.581715807026,-12.25,9
13:34,823208989.0,65.8517038695318,-33.0,9
13:35,857754342.0,1114.0650380227198,-32.97,4
13:36,806358207.0,13566.256660187257,-19.67,1
13:37,834581602.0,-155.75260000000085,-130.97,4
13:37,408057540.0,6794.321037500423,-122.5,4
13:39,534583529.0,1735.0475880547651,-16.85,9
13:39,690523499.0,965.22295,-101.49,5
13:40,188263947.0,697.4427500000007,-141.98,2
13:41,758160963.0,7937.21383899379,-117.6,2
13:41,246753533.0,600.5672999999982,-49.05,5
13:42,994214354.0,11392.593115976391,-23.09,4
13:42,189335192.0,-1200.5610517578607,-57.02,5
13:45,492850697.0,85.31504666586358,-32.02,2
13:48,158766229.0,-556.26388589347,-81.3,5
13:49,615144184.0,645.3938991255188,-188.5,4
13:50,639409800.0,40603.95635136643,-3.03,7
13:51,667367404.0,10366.802284366671,-31.5,2
13:55,668692488.0,1558.454241057584,-21.98,4
13:55,414454079.0,3990.9148500000024,-151.17,2
13:55,699997811.0,1057.3018500000032,-105.0,2
13:56,408057540.0,6626.321037500423,-168.0,4
14:00,690523499.0,752.43695,-212.79,2
14:02,427909748.0,2139.7732000000165,-5.99,2
14:03,113747882.0,13823.93838801534,-12.48,4
14:04,758160963.0,7846.91383899379,-90.3,2
14:07,690523499.0,706.95095,-45.49,2
14:09,620227043.0,-2132.017771013424,-59.51,5
14:09,108481285.0,10770.128983901346,-32.98,1
14:10,680773155.0,530.6490833310911,-146.48,7
14:11,475277431.0,1858.3541369436189,-34.95,7
14:14,667367404.0,10193.902284366672,-172.9,2
14:14,699997811.0,808.3018500000032,-249.0,2
14:18,419550103.0,21130.94058458338,-81.17,2
14:19,121113546.0,-657.1468439301303,-122.5,2
14:24,408057540.0,6459.721037500422,-166.6,7
14:24,456221621.0,791.5845673026279,-71.23,5
14:24,758160963.0,7713.91383899379,-133.0,2
14:26,718058208.0,1682.6183447974822,-70.27,2
14:27,254853117.0,3730.4707773361984,-233.8,2
14:36,121113546.0,-841.9468439301303,-184.8,2
14:38,667367404.0,10099.402284366672,-94.5,2
14:39,586041848.0,2699.7427000000007,-153.97,5
14:41,680773155.0,442.1590833310911,-88.49,4
14:43,699997811.0,718.3018500000032,-90.0,2
14:44,621181115.0,-362.02024957077106,-105.0,2
14:48,121113546.0,-896.5468439301303,-54.6,2
14:49,254853117.0,3591.170777336198,-139.3,2
14:50,833499132.0,1535.0086000000024,-21.97,7
14:54,621181115.0,-565.020249570771,-203.0,2
15:00,574548998.0,128.93504999999894,-37.99,2
15:01,408057540.0,6424.721037500422,-35.0,2
15:04,254853117.0,3423.870777336198,-167.3,2
15:07,672913754.0,13533.40091586932,-11.29,2
15:17,558119802.0,37931.8449940752,-269.5,2
15:21,254853117.0,3160.670777336198,-263.2,2
15:30,408057540.0,6250.421037500422,-174.3,2
15:36,762859681.0,1228.203599999999,-14.98,4
15:36,621181115.0,-739.320249570771,-174.3,2
15:37,284161641.0,160.47231104057576,-70.0,2
15:47,408057540.0,6027.821037500422,-222.6,2
15:49,760753808.0,516.9354999999994,-10.99,7
15:51,621181115.0,-829.620249570771,-90.3,2
15:52,284161641.0,90.47231104057576,-70.0,2
15:53,941285623.0,1231.85739906677,-65.07,2
16:06,941285623.0,1120.55739906677,-111.3,2
16:14,442070890.0,1885.3524124443709,-25.97,1
16:15,409370545.0,895.1612755455209,-24.14,7
16:20,653640811.0,20235.651415088894,-4.99,1
16:22,995615876.0,2473.8608618772596,-36.87,5
16:22,985188462.0,-393.3156112887752,-149.77,2
16:25,284161641.0,-42.52768895942424,-133.0,2
16:25,941285623.0,1065.2573990667702,-55.3,2
16:25,333054026.0,229.5308940231902,-180.6,2
16:28,769311479.0,7707.308810774459,-23.36,1
16:29,621181115.0,-1023.5202495707708,-193.9,2
16:33,254853117.0,2987.0707773361983,-173.6,2
16:33,121113546.0,-1040.0468439301303,-143.5,2
16:35,799861885.0,1142.9609499999988,-49.99,2
16:37,985188462.0,-572.4736112887751,-179.16,2
16:38,527842638.0,1480.6900426329837,-24.97,7
16:40,284161641.0,-160.82768895942422,-118.3,2
16:41,581655972.0,46073.04529200948,-26.96,7
16:48,886921642.0,4011.8154233211735,-67.37,5
16:49,941285623.0,996.6713990667702,-68.59,2
16:49,550644516.0,-306.5211000000015,-101.84,5
16:49,333054026.0,181.23089402319025,-48.3,2
16:53,376271050.0,2296.145681627471,-49.97,4
16:54,738958551.0,10311.96252167489,-3.91,2
17:00,621181115.0,-1110.320249570771,-86.8,2
17:04,121113546.0,-1144.3468439301305,-104.3,2
17:14,941285623.0,986.1853990667702,-10.49,2
17:15,613729471.0,9784.953587992512,-19.75,9
17:17,656317661.0,-91.17465845859734,-12.98,7
17:19,520418719.0,2719.246350000004,-35.95,1
17:19,903663593.0,627.1793800435539,-16.97,7
17:22,333054026.0,-21.769105976809783,-203.0,2
17:23,291580432.0,61.47195000000016,-42.0,4
17:27,698076160.0,7652.935462803154,-46.98,2
17:28,668692488.0,1291.603041057584,-266.85,5
17:29,690523499.0,592.17895,-114.77,2
17:30,467207141.0,763.7842670482637,-29.99,2
17:32,829914501.0,2350.022806570975,-15.98,7
17:32,252760664.0,7893.740837028637,-7.65,2
17:36,718058208.0,1581.8468647974823,-100.77,4
17:36,556992209.0,12503.469610254611,-36.75,5
17:38,809499628.0,20354.1966662159,-25.08,2
17:38,690523499.0,396.19295,-195.99,2
17:41,613427466.0,7792.903455264379,-109.28,5
17:43,941285623.0,949.7993990667702,-36.39,2
17:49,956717493.0,1840.4021504359848,-61.74,5
17:54,296770890.0,1619.5120103790832,-193.16,2
17:54,525524239.0,27.66235021119355,-19.99,2
17:58,941285623.0,908.4993990667704,-41.3,2
18:07,690523499.0,298.89295,-97.3,2
18:07,399144202.0,2459.3345147199125,-26.19,9
18:08,954263768.0,-94.58230000000034,-50.86,5
18:20,383833857.0,29566.18203837528,-16.44,9
18:21,941285623.0,895.9133990667702,-12.59,2
18:23,551755686.0,8449.519926654151,-8.99,7
18:27,296770890.0,1417.9120103790833,-201.6,2
18:31,856957948.0,12549.291154533908,-33.0,7
18:44,666952234.0,-14.01685187551324,-39.06,5
18:44,310375875.0,2729.3137462199525,-57.62,7
18:56,352291960.0,3555.9200533035737,-47.84,5
18:57,479456865.0,1560.6063618641742,-17.98,7
18:58,655450953.0,-3072.9548784555286,-66.26,5
19:02,809499628.0,20314.0726662159,-40.12,5
19:05,245690309.0,11659.336246600064,-15.79,5
19:09,188263947.0,600.3660500000008,-97.08,5
19:16,215311171.0,6132.953193862323,-10.15,5
19:21,902798190.0,-194.18863443102651,-73.19,5
19:23,124102251.0,2398.138065265774,-113.58,5
19:39,550832673.0,4078.9460163955105,-68.11,5
19:41,176922958.0,2436.3005471976503,-27.3,5
19:46,180616589.0,1602.8928282361094,-56.83,5
19:46,373875019.0,19956.54366488721,-5.3,7
19:56,345582855.0,1169.7229528205494,-51.32,5
19:59,583558311.0,-381.31521524866776,-101.18,5
19:59,618514666.0,24447.581472716487,-17.19,5
20:19,370521542.0,30702.08873635136,-23.91,5
20:21,252760664.0,7795.446837028638,-98.29,5
20:38,519935524.0,1312.491309737519,-14.07,5
20:48,331450202.0,9626.38944092215,-16.9,9
20:52,553734946.0,698.2085999999981,-78.0,5
21:09,679662108.0,18453.801149596235,-5.47,2
21:14,549414742.0,8397.777374495528,-24.18,9
21:15,930277104.0,10595.020146432018,-35.79,9
00:12,858989281.0,30764.39187197745,-18.07,2
00:12,910730524.0,8895.471447367192,-46.21,7
00:13,601627384.0,4073.5714832727176,-31.52,9
00:15,417850087.0,18026.563692825217,-39.86,7
00:15,651756497.0,18416.31392921429,-3.72,4
00:17,822135975.0,13251.713295818734,-17.46,8
00:23,887853850.0,11941.7278092337,-30.34,9
00:25,718058208.0,1553.5931948754271,-28.25,2
00:38,853907490.0,9501.706061916268,-56.16,7
00:39,572384506.0,9326.943105920474,-33.39,9
00:40,905860285.0,14523.116191355584,-76.62,2
00:42,719586818.0,21876.97936065171,-8.12,2
00:43,986267641.0,5949.381032609326,-3.96,2
00:44,874431242.0,11439.998741593812,-1.3,7
00:45,324224854.0,6428.299194614615,-51.97,5
00:46,873693307.0,12739.900322166894,-14.94,9
00:47,806358207.0,13565.337665462252,-0.92,7
00:48,409971170.0,3759.977964093,-16.77,7
00:49,450896297.0,15164.811234089271,-71.09,5
00:51,169006407.0,13327.411286368586,-0.58,2
00:54,679911053.0,3606.715673139491,-8.46,5
00:55,815993333.0,6311.288054354532,-45.18,5
01:03,815385232.0,12343.827492588593,-47.34,5
01:08,975345315.0,41035.204564972104,-43.54,5
01:14,885259672.0,3625.300877770387,-48.98,2
01:20,824916823.0,9855.814393454742,-23.44,9
01:29,623156843.0,5778.44442910211,-17.47,8
01:33,237493332.0,17198.439324970772,-10.44,9
01:36,647936800.0,1903.817449040946,-10.84,8
01:36,586315521.0,14195.008032867174,-34.8,8
01:39,558875206.0,4251.430539399782,-19.69,9
01:39,940569402.0,5624.277891425691,-20.94,9
01:44,851181128.0,6106.663239317231,-27.69,2
01:50,441274121.0,14389.179243163182,-79.34,2
01:51,987656636.0,6246.664389639515,-23.31,8
01:54,433917275.0,8614.121198545256,-71.77,4
02:01,419550103.0,21108.772153265076,-22.17,2
02:04,703588001.0,351.40129999999965,-32.93,9
02:04,473820682.0,12464.500919085844,-38.9,5
02:20,482513594.0,7003.620882996528,-40.06,7
02:23,290818242.0,8261.728724764615,-23.19,2
02:24,873693307.0,12674.422022838246,-65.48,4
02:24,145387690.0,6319.78211197923,-9.2,5
02:26,264550521.0,7154.916925129778,-42.3,5
02:26,749378808.0,2833.53696055885,-28.94,9
02:28,256002321.0,7739.284111912755,-19.98,9
02:30,179173981.0,4819.226800937221,-35.6,9
02:37,270374623.0,11453.93323503042,-56.14,5
02:37,406772240.0,-1488.2022000000006,-34.43,9
02:41,633345190.0,6950.1441952668465,-20.19,9
02:44,237684254.0,7122.902462440869,-17.44,7
02:45,709608057.0,3204.1810241817134,-29.13,9
02:49,441274121.0,14379.779243163182,-9.4,9
02:52,270374623.0,11437.99323503042,-15.94,9
02:52,992204045.0,9314.556139563132,-25.88,7
02:59,506618547.0,18011.503420352856,-22.5,2
03:01,450896297.0,15137.921234089274,-26.89,9
03:10,832564361.0,17806.533691207354,-19.66,8
03:12,970298834.0,2943.005267096296,-5.57,7
03:12,683319988.0,8268.54280990545,-25.75,9
03:12,480557476.0,12756.871368630904,-44.23,7
03:15,500843551.0,1124.5622999999996,-37.18,9
03:25,534204159.0,6899.946597831311,-4.08,7
03:26,795847804.0,27207.379300328605,-8.49,2
03:30,518474507.0,16389.088987580693,-31.14,9
03:32,113747882.0,13820.662943544436,-3.28,2
03:40,120634201.0,6284.99869192003,-22.3,9
03:43,519644021.0,4022.8753451275807,-25.03,7
03:45,809499628.0,20304.0926662159,-9.98,9
03:46,802697323.0,18861.31817482327,-34.08,9
03:50,196289502.0,18387.085838889172,-22.9,9
03:51,639549973.0,6667.750781051046,-2.62,5
03:52,259015404.0,1352.4945493429473,-37.38,9
03:53,108931112.0,16779.39735272232,-34.22,9
03:55,843537309.0,-514.795767791632,-14.94,9
03:56,601627384.0,4064.110789542348,-9.46,2
03:57,195895574.0,7893.416245694646,-38.99,2
03:58,987163717.0,4753.906078176685,-40.24,9
04:02,510101371.0,14373.383829927714,-40.57,9
04:02,785749304.0,9990.879710580211,-13.11,5
04:03,256002321.0,7724.281997124805,-15.0,5
04:05,383833857.0,29552.192038375277,-13.99,9
04:05,705848712.0,30934.77596279597,-21.38,9
04:06,779946617.0,19394.0699352682,-19.36,4
04:07,824916823.0,9855.24408682512,-0.57,2
04:11,899742927.0,14843.090677800546,-13.25,7
04:11,520447032.0,8937.95272143219,-21.74,9
04:12,245690309.0,11636.45297469208,-22.88,5
04:12,540159353.0,12619.072556398536,-16.74,4
04:14,752362502.0,8949.566879701148,-20.72,2
04:14,842682241.0,4644.756472018022,-17.92,7
04:15,433917275.0,8576.231198545256,-37.89,9
04:23,259015404.0,1339.7094137402205,-12.79,5
04:24,370521542.0,30687.09873635136,-14.99,9
04:27,541639148.0,5066.7283630190495,-17.42,2
04:27,310375875.0,2700.1737462199526,-29.14,9
04:33,639409800.0,40553.57409838944,-50.38,7
04:36,383833857.0,29514.464245487565,-37.73,2
04:39,706250160.0,14805.323783152877,-8.66,7
04:41,179173981.0,4735.701192705245,-83.53,7
04:42,588565416.0,7427.536785278187,-46.67,7
04:43,166019891.0,9723.83894603534,-1.74,2
04:47,647472692.0,29321.18141402665,-35.29,9
04:48,642015139.0,-1528.3536625343618,-35.64,9
04:48,730002588.0,16035.612406897735,-5.06,7
04:51,749378808.0,2815.78580541444,-17.75,7
04:54,700138124.0,5393.00865283965,-18.99,9
04:57,496395938.0,13824.146059625513,-33.49,2
04:59,435984758.0,5053.667174241571,-7.81,2
04:59,887853850.0,11906.116551529283,-35.61,7
05:03,414805878.0,14718.287856324232,-28.43,9
05:04,587225252.0,7307.170654672866,-35.18,9
05:04,500043411.0,15317.65030288726,-39.38,4
05:08,776431321.0,3808.547651438482,-29.01,2
05:11,738958551.0,10272.88252167489,-39.08,9
05:12,429556122.0,5631.5439983437345,-1.65,2
05:13,322221939.0,4545.953261223446,-61.65,2
05:13,613729471.0,9773.309606666422,-11.64,7
05:16,554792076.0,32384.599687136422,-46.76,5
05:18,489964679.0,23532.52837236987,-39.15,9
05:19,549414742.0,8355.64737449553,-42.13,9
05:21,678330503.0,2809.2830955774557,-49.44,5
05:24,361201224.0,4531.23456841002,-3.37,5
05:27,836110591.0,4463.785854893008,-35.64,9
05:29,348325817.0,11028.486049872565,-6.37,2
05:31,687135796.0,32781.787857878175,-11.95,9
05:33,822250278.0,7806.607715652269,-2.85,2
05:33,704517789.0,20050.63336732809,-42.63,7
05:36,285220959.0,13365.09302081832,-35.29,4
05:36,471897866.0,8331.738538265192,-21.82,5
05:39,187111705.0,7826.053691219994,-62.01,2
05:40,985188462.0,-609.3036112887752,-36.83,9
05:40,700138124.0,5386.1452771683735,-6.86,7
05:40,940569402.0,5575.801903035758,-48.48,2
05:45,587225252.0,7271.948478217324,-35.22,4
05:53,370521542.0,30669.094813372027,-18.0,8
05:55,124102251.0,2326.123048647608,-72.02,8
06:04,198946608.0,4992.370279073173,-36.53,2
06:09,252760664.0,7785.67371128512,-9.77,2
06:16,851181128.0,6078.413239317231,-28.25,9
06:19,673025413.0,2854.502322234607,-0.46,7
06:21,511179916.0,9057.500424308731,-48.26,2
06:30,550169791.0,25584.741840987124,-80.37,7
06:32,364357875.0,9884.267750964527,-16.79,2
06:32,532478725.0,5383.02991731514,-41.42,9
06:34,461990622.0,9108.870844193263,-2.74,5
06:36,550169791.0,25577.751840987123,-6.99,9
06:37,522188082.0,8549.083630825262,-0.95,7
06:38,310375875.0,2680.120141719671,-20.05,2
06:44,779236304.0,2379.8075954795354,-34.49,9
06:45,151968462.0,9049.935431124786,-29.28,2
06:51,679662108.0,18435.62364131593,-18.18,8
06:52,235881534.0,14659.377457680885,-6.65,5
06:57,575652395.0,2068.2939183491885,-50.37,5
06:57,308505160.0,15900.16295946595,-13.99,7
06:58,930277104.0,10570.120146432018,-24.9,9
07:07,516051449.0,1840.530149110848,-4.19,5
07:12,949032480.0,4337.470126234882,-5.64,8
07:13,657139925.0,15552.715279996146,-15.48,9
07:14,973086490.0,11892.27421366712,-23.49,9
07:20,494789005.0,3348.22386216766,-32.56,2
07:23,604288474.0,2122.604146907142,-42.77,7
07:27,237493332.0,17193.509824540022,-4.93,7
07:28,183888402.0,22007.41245714013,-39.56,9
07:34,609939116.0,9317.814162708442,-8.16,2
07:36,836110591.0,4454.781804805773,-9.0,5
07:37,930277104.0,10554.778106870466,-15.34,7
07:39,667367404.0,10080.252290583823,-19.15,2
07:39,865748375.0,3396.319261626129,-20.67,7
07:39,678851253.0,5040.1508695571865,-4.11,8
07:40,298000165.0,29202.14770541533,-61.12,7
07:43,912705941.0,21302.45738668962,-7.34,7
07:48,960208650.0,17048.710003767206,-1.64,7
07:49,120634201.0,6235.4987850174475,-49.5,2
07:58,216285378.0,27269.104113528407,-37.7,9
07:58,187541224.0,2999.2092762436,-30.16,9
08:02,170637730.0,1916.856425983354,-14.67,7
08:02,670102069.0,1863.767514113878,-37.29,9
08:03,769311479.0,7630.121231159092,-77.19,5
08:06,581655972.0,46068.498228201366,-4.55,2
08:08,213112754.0,6651.782127937354,-21.8,2
08:11,868377987.0,3805.4556567228888,-31.09,7
08:14,675231808.0,19020.448371069513,-13.3,5
08:16,558119802.0,37865.633356243285,-66.21,7
08:21,897714622.0,10640.35727761808,-6.28,5
08:24,675806859.0,8921.113028154687,-18.16,7
08:25,624500124.0,3760.878621206129,-31.4,7
08:33,683319988.0,8248.172220883187,-20.37,5
08:36,200080192.0,9794.010106655123,-65.19,2
08:41,383625050.0,3937.224771996545,-3.43,8
08:43,108563213.0,26512.968442466474,-35.65,2
08:48,809499628.0,20287.38572202212,-16.71,5
08:49,315546581.0,32954.440887140736,-29.62,5
08:54,331450202.0,9591.104575144118,-35.28,8
09:11,229205098.0,9024.731671819633,-8.01,2
09:13,851649498.0,9991.84760528232,-27.27,5
09:15,254853117.0,2964.0907773361982,-22.98,7
09:20,548907062.0,680.9831711746526,-59.98,4
09:20,143003091.0,12615.024215401025,-4.03,2
09:21,933491926.0,4281.774577103418,-9.01,5
09:21,844835978.0,11870.061631562929,-26.98,4
09:22,427909748.0,1911.2732000000165,-228.5,2
09:23,771125520.0,-155.16695000000092,-5.99,7
09:26,101531259.0,380.9720999999995,-7.98,4
09:27,618138606.0,1875.363303264288,-84.5,2
09:27,601627384.0,4038.300789542348,-25.81,1
09:30,398429109.0,1792.6870000000008,-34.95,7
09:30,853907490.0,9413.326061916268,-88.38,6
09:31,280098744.0,1021.8133778716668,-5.99,4
09:33,511179916.0,8945.500424308733,-112.0,2
09:35,672994751.0,431.23629078600993,-4.99,7
09:36,705848712.0,30933.234385002233,-1.54,4
09:37,165691047.0,938.3870999999988,-73.99,2
09:37,999752672.0,1943.1610935333345,-45.0,2
09:39,802697323.0,18812.0382742167,-49.28,7
09:39,973086490.0,11869.61169575029,-22.66,7
09:39,541639148.0,5055.434923019049,-11.29,4
09:39,143061865.0,8083.520398866594,-6.66,7
09:40,348325817.0,10924.186049872564,-104.3,2
09:40,517190750.0,3069.3485899154125,-22.02,6
09:41,280990953.0,1038.539699999998,-130.0,2
09:42,618138606.0,1737.383303264288,-137.98,2
09:42,758160963.0,7700.643636716753,-13.27,2
09:44,604334058.0,888.1052999999993,-1.99,4
09:45,730002588.0,16002.982406897738,-32.63,7
09:49,258201793.0,-351.4348000000002,-78.75,7
09:51,690523499.0,292.90295,-5.99,4
09:52,290818242.0,7990.828724764615,-270.9,2
09:52,427909748.0,1761.3032000000164,-149.97,2
09:57,511179916.0,8785.900424308733,-159.6,2
09:58,215311171.0,6120.973193862324,-11.98,7
09:58,668692488.0,1270.633041057584,-20.97,1
10:02,752362502.0,8879.566879701148,-70.0,2
10:05,420109571.0,761.3684258932456,-58.99,2
10:07,943329213.0,1288.3416193497576,-17.04,7
10:07,511179916.0,8508.000424308733,-277.9,2
10:10,348325817.0,10822.686049872564,-101.5,2
10:12,165691047.0,861.9170999999988,-76.47,2
10:15,290818242.0,7795.528724764615,-195.3,2
10:17,282837512.0,16076.896211239236,-36.36,6
10:18,245690309.0,11613.54173469208,-22.91,4
10:18,711045550.0,2065.001350000004,-66.99,2
10:18,138609932.0,2009.9640032945856,-14.95,4
10:19,672994751.0,386.2562907860099,-44.98,2
10:19,258201793.0,-403.9348000000002,-52.5,4
10:19,324224854.0,6293.1991946146145,-135.1,2
10:21,213112754.0,6604.452127937354,-47.33,2
10:23,713910252.0,-640.300524271459,-36.85,5
10:23,216285378.0,27164.804113528407,-104.3,2
10:24,822718326.0,13151.238001111884,-18.05,5
10:24,147474476.0,3817.5008591201313,-22.0,2
10:24,361201224.0,4513.19456841002,-18.04,7
10:25,246753533.0,533.5972999999982,-66.97,4
10:25,345582855.0,1161.7429528205494,-7.98,4
10:25,631111289.0,-149.4015000000009,-134.98,2
10:25,121858569.0,1900.791150000002,-44.64,5
10:26,969697937.0,-5300.18276567055,-14.29,5
10:27,414454079.0,3978.7448500000023,-12.17,4
10:27,524425303.0,-597.9553000000012,-34.97,5
10:28,108931112.0,16754.31565394212,-25.08,8
10:30,752362502.0,8852.266879701148,-27.3,2
10:30,420109571.0,627.8684258932456,-133.5,2
10:30,213930646.0,-1550.4445634725632,-17.91,5
10:31,975200042.0,-3293.742699999996,-26.08,5
10:31,500843551.0,1077.5600999999997,-47.0,5
10:32,225210798.0,1050.5809351225796,-60.04,5
10:33,229205098.0,8939.933671819632,-84.8,5
10:33,402438092.0,586.8164999999989,-40.99,2
10:34,477216513.0,-164.51294999999948,-67.53,5
10:35,838830098.0,1072.4976920877843,-37.99,2
10:35,358846516.0,863.8507225272173,-101.82,5
10:36,511179916.0,8228.700424308734,-279.3,2
10:37,779946617.0,19242.1399352682,-151.93,2
10:37,570269025.0,4258.981442144642,-64.99,2
10:38,690958123.0,23782.25999787065,-48.55,5
10:38,891716230.0,377.0303298101014,-124.5,2
10:38,478412511.0,12863.619041290454,-83.24,2
10:39,420109571.0,536.3684258932456,-91.5,2
10:40,298007503.0,3126.0841036256343,-40.62,2
10:40,124102251.0,2113.3230486476077,-212.8,2
10:40,631111289.0,-233.01900000000091,-83.62,2
10:41,950234174.0,1474.1708192371595,-110.19,5
10:41,417850087.0,18016.503692825216,-10.06,2
10:42,211493028.0,1425.731449999999,-57.0,6
10:43,216285378.0,26981.41811352841,-183.39,2
10:43,108931112.0,16610.475693942124,-143.84,4
10:45,280990953.0,932.039699999998,-106.5,2
10:46,127809299.0,2621.3929467244643,-16.94,5
10:46,290818242.0,7687.7287247646145,-107.8,2
10:48,990461108.0,627.0678686206109,-57.99,2
10:49,570269025.0,4192.0114421446415,-66.97,4
10:50,570269025.0,4136.769145837062,-55.24,7
10:50,248658670.0,-162.80834999999996,-52.61,5
10:52,355733816.0,5706.0937201186725,-11.98,7
10:52,420109571.0,408.3684258932456,-128.0,2
10:53,104832000.0,-3185.524858905844,-36.06,5
10:54,124102251.0,1855.723048647608,-257.6,2
10:55,448279144.0,1087.218899999999,-126.5,2
10:57,795847804.0,27164.519300328604,-42.86,1
10:59,494156986.0,-198.43595432766543,-113.62,2
10:59,867987292.0,2728.62595951718,-80.06,2
11:01,303843160.0,280.6098000000012,-9.99,2
11:01,604288474.0,2091.900066907142,-30.7,4
11:01,744211756.0,-4683.550749999991,-49.4,5
11:02,427909748.0,1727.3332000000164,-33.97,2
11:04,570323670.0,4220.848828476782,-30.16,4
11:06,310171581.0,-2367.696204340919,-42.57,5
11:06,752362502.0,8727.666879701148,-124.6,2
11:09,448279144.0,928.7188999999988,-158.5,2
11:11,241459011.0,917.2389132723464,-65.02,5
11:11,909669130.0,584.9398847367668,-15.01,4
11:12,581655972.0,46058.50822820137,-9.99,2
11:12,624500124.0,3724.098621206129,-36.78,1
11:12,421881811.0,3670.7656430358,-83.14,5
11:13,280990953.0,700.039699999998,-232.0,2
11:13,421881811.0,3656.11986503427,-14.65,2
11:13,913127700.0,2637.963138011117,-174.8,5
11:13,699997811.0,671.6787000000032,-46.62,5
11:13,131388684.0,24831.120758983572,-62.81,2
11:14,705848712.0,30861.384385002235,-71.85,2
11:14,494156986.0,-339.80345432766546,-141.37,2
11:15,254853117.0,2934.0707773361983,-30.02,2
11:15,338022396.0,43.33848937573909,-49.46,5
11:15,849096144.0,2401.7390207513445,-49.99,2
11:16,221868392.0,5629.751001559866,-0.6,2
11:17,217540156.0,-3811.2323199999937,-44.2,5
11:18,653640811.0,20196.661415088893,-38.99,1
11:19,497809732.0,2520.5278695525963,-18.48,4
11:23,448279144.0,801.7188999999989,-127.0,2
11:24,799453072.0,-589.9590500000013,-86.34,5
11:26,108563213.0,26479.658442466472,-33.31,2
11:27,532478725.0,5372.78232220567,-10.25,2
11:29,653640811.0,20183.723448804805,-12.94,7
11:29,633345190.0,6657.544195266846,-292.6,2
11:30,752362502.0,8554.766879701148,-172.9,2
11:30,194745206.0,629.753372091243,-22.07,2
11:33,948069469.0,-698.3261000000011,-58.6,5
11:35,618138606.0,1651.413303264288,-85.97,2
11:35,867987292.0,2719.80553807024,-8.82,7
11:35,868014990.0,-3731.416099999995,-49.36,5
11:36,552980092.0,37.48371911933752,-24.95,4
11:36,654329190.0,-333.8449490514807,-44.03,5
11:39,348325817.0,10696.686049872564,-126.0,2
11:39,472995101.0,1946.5044840990831,-37.87,5
11:39,494156986.0,-414.7884543276655,-74.98,2
11:39,427909748.0,1661.8332000000164,-65.5,2
11:43,165691047.0,718.9670999999987,-74.98,2
11:43,448279144.0,614.7188999999989,-187.0,2
11:44,258201793.0,-534.4348000000002,-89.62,2
11:45,633345190.0,6560.944195266846,-96.6,2
11:47,752362502.0,8499.466879701149,-55.3,2
11:48,216286013.0,-25.12632345486658,-59.33,5
11:56,433917275.0,8563.701198545255,-12.53,4
11:57,284905540.0,10092.18880574533,-50.93,2
12:00,242218612.0,-444.3011999999994,-141.98,2
12:01,806358207.0,13545.657665462251,-19.68,2
12:01,815385232.0,12328.607492588591,-15.22,7
12:02,280990953.0,650.039699999998,-50.0,2
12:02,583579399.0,1300.1361000000006,-27.99,2
12:03,570323670.0,4175.03569386357,-45.81,7
12:06,856147482.0,-450.4567985986247,-33.14,9
12:06,165691047.0,670.4770999999987,-48.49,2
12:06,891716230.0,332.5303298101014,-44.5,2
12:07,216285378.0,26826.06011352841,-155.36,2
12:08,218795010.0,-8.351550000000607,-33.2,9
12:08,786141370.0,-182.48710000000088,-44.37,5
12:09,653640811.0,20140.35144880481,-43.37,2
12:11,143061865.0,8060.540398866595,-22.98,2
12:12,633345190.0,6484.835095266846,-76.11,4
12:14,414454079.0,3942.1448500000024,-36.6,9
12:14,631111289.0,-257.3865000000009,-24.37,2
12:15,611143859.0,3652.6274000000135,-5.7,9
12:16,146909202.0,5276.060289987379,-1.46,2
12:16,290818242.0,7549.128724764614,-138.6,2
12:17,824916823.0,9843.784086825122,-11.46,4
12:20,846550094.0,2625.5792671741456,-69.99,2
12:20,494156986.0,-510.0234543276655,-95.23,2
12:22,624563756.0,13.424128783556483,-48.37,5
12:23,280990953.0,511.539699999998,-138.5,2
12:24,999752672.0,1740.1610935333345,-203.0,2
12:26,258201793.0,-580.9348000000002,-46.5,2
12:27,796709231.0,-49.61022210370258,-50.85,5
12:28,651756497.0,18403.11392921429,-13.2,2
12:30,741269136.0,2064.265950000003,-21.97,7
12:32,417850087.0,17888.151692825217,-128.35,5
12:32,105375973.0,509.3096528189405,-66.17,2
12:33,165691047.0,656.9870999999987,-13.49,2
12:33,494156986.0,-578.2584543276655,-68.23,2
12:34,137822385.0,4465.859703161885,-31.69,5
12:34,329840194.0,1710.344730143148,-74.28,5
12:35,516051449.0,1801.580149110848,-38.95,1
12:36,229205098.0,8896.813671819631,-43.12,2
12:37,846550094.0,2360.9932671741453,-264.59,2
12:38,285428103.0,11757.826336586644,-36.79,5
12:38,344522228.0,-3073.736988208392,-17.06,5
12:39,197050303.0,254.33943256349497,-129.98,2
12:40,514362267.0,1189.1073191070602,-5.99,4
12:43,604870380.0,-1979.5890529005533,-39.32,5
12:44,216285378.0,26763.76011352841,-62.3,2
12:46,916270283.0,3245.970250000001,-13.98,1
12:46,668329719.0,10201.704803305782,-26.78,7
12:48,844835978.0,11849.36963156293,-20.69,5
12:48,282837512.0,16055.156211239237,-21.74,9
12:49,776431321.0,3802.5576514384816,-5.99,2
12:50,857997794.0,1312.5906651508865,-94.39,5
12:50,511179916.0,7971.100424308734,-257.6,2
12:52,344219145.0,9873.342953309326,-46.55,5
12:55,199016328.0,6467.201035099075,-37.95,7
12:56,165691047.0,593.9970999999987,-62.99,2
12:56,994214354.0,11385.416482179253,-7.18,7
12:56,340680761.0,-3410.955599999996,-28.71,5
12:58,736310094.0,-723.8835240274259,-51.01,5
12:59,494156986.0,-619.1334543276655,-40.88,2
13:00,910730524.0,8847.381447367192,-48.09,2
13:02,511179916.0,7805.900424308734,-165.2,2
13:03,585625048.0,2719.6099749993577,-5.8,9
13:03,122884111.0,-1958.9585830729688,-29.15,5
13:04,258201793.0,-695.6848000000002,-114.75,2
13:04,758160963.0,7624.903636716753,-75.74,2
13:05,259015404.0,1334.6094137402204,-5.1,9
13:05,603375739.0,2167.183063023268,-166.74,5
13:06,846550094.0,2171.307267174145,-189.69,2
13:07,480557476.0,12751.071368630905,-5.8,9
13:07,448004226.0,1926.58236866488,-141.98,2
13:08,277562576.0,300.3221699762572,-5.4,9
13:09,407574996.0,1881.2296093809373,-7.15,9
13:13,322221939.0,4538.853261223446,-7.1,9
13:14,895331556.0,-149.85120000000092,-25.97,2
13:14,801500539.0,-3816.7361999999976,-94.27,5
13:14,653640811.0,20022.765448804807,-117.59,2
13:15,586315521.0,14173.168032867174,-21.84,9
13:15,454356905.0,3305.637534633968,-18.25,4
13:17,743630833.0,-472.3613867152987,-118.6,5
13:17,853907490.0,9348.04406191627,-65.28,5
13:18,187111705.0,7820.253691219994,-5.8,9
13:18,216285378.0,26685.37411352841,-78.39,2
13:19,165691047.0,483.9970999999987,-110.0,2
13:23,291128777.0,-2926.4114405263676,-27.18,5
13:23,704517789.0,20020.23336732809,-30.4,2
13:24,866941383.0,3130.7584803036743,-17.97,7
13:24,482513594.0,6987.720882996528,-15.9,9
13:26,291580432.0,-19.22579999999985,-80.7,5
13:26,812692024.0,4651.671590521823,-4.95,9
13:27,486495235.0,2159.853860076208,-109.98,2
13:28,873701090.0,733.6385372874504,-11.37,4
13:28,895331556.0,-166.8212000000009,-16.97,1
13:28,846550094.0,2011.0212671741451,-160.29,2
13:31,124102251.0,1771.7230486476078,-84.0,2
13:31,737547541.0,282.4525995677743,-77.99,2
13:32,999752672.0,1606.1610935333345,-134.0,2
13:35,419084831.0,-393.6101255261033,-95.8,5
13:35,683078800.0,2462.55929844157,-1.34,7
13:35,496674181.0,-2951.013172330722,-164.51,5
13:37,871866387.0,904.7931999999988,-76.54,5
13:39,258201793.0,-766.9348000000002,-71.25,2
13:44,846550094.0,1850.7212671741452,-160.3,2
13:44,280990953.0,389.039699999998,-122.5,4
13:44,290818242.0,7458.128724764614,-91.0,2
13:47,478412511.0,12854.429774725051,-9.19,7
13:47,859603181.0,4096.27849115667,-27.27,7
13:48,216285378.0,26560.07411352841,-125.3,2
13:52,124102251.0,1571.5230486476078,-200.2,2
13:52,578131296.0,789.7531694440436,-157.51,5
13:59,807714284.0,1410.4501607359996,-56.19,5
14:03,776108637.0,1232.6002536574954,-51.98,2
14:03,849096144.0,2271.7590207513445,-129.98,2
14:05,633345190.0,6316.855095266847,-167.98,2
14:06,258201793.0,-857.6848000000002,-90.75,2
14:10,672913754.0,13490.45091586932,-42.95,7
14:12,280990953.0,205.539699999998,-183.5,7
14:12,846550094.0,1652.6632671741452,-198.06,2
14:12,631111289.0,-364.99650000000094,-107.61,2
14:12,506618547.0,17973.053420352855,-38.45,2
14:15,604288474.0,2073.728066907142,-18.17,5
14:18,806358207.0,13543.067665462251,-2.59,4
14:27,216285378.0,26395.60211352841,-164.47,2
14:30,258201793.0,-962.3098000000002,-104.62,2
14:30,641764023.0,-952.8163037720044,-48.56,5
14:32,448279144.0,564.7188999999989,-50.0,2
14:34,409971170.0,3728.346364093,-31.63,4
14:37,655368335.0,4599.804533288692,-6.24,7
14:37,631111289.0,-438.48900000000094,-73.49,2
14:38,572136270.0,-338.09068841197654,-23.65,5
14:39,874506295.0,-1359.5917562455722,-30.87,5
14:39,736340277.0,9186.474176335629,-17.85,9
14:41,999752672.0,1566.1610935333345,-40.0,2
14:41,618138606.0,1590.413303264288,-61.0,2
14:43,290818242.0,7291.528724764614,-166.6,2
14:43,141521177.0,7967.919900000015,-96.8,5
14:48,448279144.0,445.71889999999894,-119.0,2
14:49,653640811.0,19830.293448804805,-192.47,2
14:53,999752672.0,1496.6610935333345,-69.5,2
14:58,633345190.0,6309.152693194736,-7.7,7
15:00,290818242.0,7103.228724764614,-188.3,2
15:01,601627384.0,4018.670789542348,-19.63,2
15:02,492850697.0,75.31504666586358,-10.0,2
15:02,250895529.0,1999.824532469289,-152.3,5
15:05,494156986.0,-674.6184543276655,-55.48,2
15:09,618138606.0,1463.423303264288,-126.99,2
15:13,572384506.0,9280.729331564831,-46.21,8
15:13,176922958.0,2360.5325471976503,-75.77,5
15:15,391688371.0,1189.6169551878172,-55.4,5
15:15,951817450.0,10325.754898213178,-24.89,7
15:15,835736339.0,3173.466019690939,-80.13,4
15:17,999752672.0,1401.6610935333345,-95.0,2
15:17,994214354.0,11349.026482179252,-36.39,9
15:17,815385232.0,12285.917492588593,-42.69,2
15:22,331450202.0,9584.944575144118,-6.16,7
15:22,287480331.0,9113.737276759692,-37.16,8
15:25,124102251.0,1349.623048647608,-221.9,2
15:25,286484726.0,1112.3338129418446,-109.98,2
15:25,653640811.0,19733.035448804803,-97.26,2
15:29,720742759.0,1588.3911308830072,-9.99,1
15:31,494156986.0,-809.9859543276655,-135.37,2
15:32,914806976.0,58.79325018548643,-70.98,2
15:36,427909748.0,1541.3532000000164,-120.48,2
15:37,999752672.0,1268.1610935333345,-133.5,2
15:39,435984758.0,4950.263174241571,-103.4,5
15:45,709151315.0,216.35921837415992,-95.89,7
15:50,433917275.0,8518.831198545255,-44.87,2
15:55,802697323.0,18760.0058342167,-52.03,4
15:58,471897866.0,8270.598538265192,-61.14,2
16:00,420109571.0,317.37842589324555,-90.99,2
16:01,678330503.0,2799.1530955774556,-10.13,2
16:02,999752672.0,1184.1610935333345,-84.0,2
16:03,510101371.0,14361.295517599829,-12.09,7
16:10,857754342.0,1069.0850380227198,-44.98,2
16:10,511179916.0,7725.400424308734,-80.5,2
16:11,290818242.0,6865.928724764613,-237.3,2
16:11,448279144.0,222.71889999999897,-223.0,2
16:12,832564361.0,17800.533691207354,-6.0,9
16:17,420109571.0,86.87842589324555,-230.5,2
16:18,709151315.0,34.35921837415992,-182.0,4
16:23,173335108.0,1282.904000000001,-41.65,9
16:24,399144202.0,2435.1345147199127,-24.2,9
16:24,290818242.0,6580.328724764613,-285.6,2
16:26,511179916.0,7607.800424308733,-117.6,2
16:33,454356905.0,3285.8941729977596,-19.74,2
16:34,420109571.0,-34.11157410675446,-120.99,2
16:34,999752672.0,1035.6610935333345,-148.5,2
16:38,258201793.0,-997.9348000000002,-35.62,2
16:44,494156986.0,-851.9784543276654,-41.99,2
16:44,475117511.0,8559.985388645127,-21.82,7
16:46,170637730.0,1899.673945983354,-17.18,4
16:48,290818242.0,6399.728724764613,-180.6,2
16:49,891716230.0,220.53032981010145,-112.0,2
16:51,414805878.0,14673.472331599369,-44.82,7
16:53,258201793.0,-1119.0598000000002,-121.12,2
16:57,995615876.0,2365.4028618772595,-108.46,2
17:06,891716230.0,51.03032981010142,-169.5,2
17:08,258201793.0,-1230.8098000000002,-111.75,2
17:09,511179916.0,7378.900424308734,-228.9,2
17:10,399538448.0,8933.426037371237,-35.23,4
17:14,245198540.0,476.4063988017795,-30.96,7
17:20,290818242.0,6235.228724764613,-164.5,2
17:29,556992209.0,12466.422600254611,-37.05,4
17:33,613729471.0,9751.959606666422,-21.35,7
17:34,996042490.0,7332.514296926533,-43.84,7
17:34,258201793.0,-1366.9348000000002,-136.12,2
17:35,245690309.0,11580.92173469208,-32.62,7
17:36,678851253.0,5005.1508695571865,-35.0,2
17:40,964702094.0,1301.7417425992494,-36.95,7
17:45,511179916.0,7219.300424308733,-159.6,2
17:47,919185264.0,5409.955859740337,-36.95,7
17:47,373875019.0,19920.593664887205,-35.95,1
17:49,128033695.0,3109.9634920666595,-51.3,4
17:52,678851253.0,4922.550869557186,-82.6,2
17:54,494156986.0,-992.2209543276654,-140.24,2
17:55,345514953.0,175.36219999999935,-65.25,2
18:03,886921642.0,3764.0434233211736,-247.77,4
18:05,128033695.0,3073.375912742186,-36.59,7
18:07,653640811.0,19630.863448804805,-102.17,2
18:13,846550094.0,1507.0772671741452,-145.59,2
18:13,324224854.0,6267.9091946146145,-25.29,9
18:21,494156986.0,-1097.2059543276655,-104.99,2
18:24,678851253.0,4810.564869557186,-111.99,2
18:24,305778936.0,11275.781883817286,-25.24,9
18:33,679662108.0,18415.29364131593,-20.33,9
18:34,398429109.0,1754.4070000000008,-38.28,9
18:38,119943495.0,-1330.082562112858,-28.1,9
18:48,899692478.0,-2138.4708435240077,-16.78,9
18:54,678851253.0,4730.078869557186,-80.49,2
18:58,511179916.0,7193.710424308733,-25.59,9
19:17,305778936.0,11253.306983903054,-22.47,7
19:32,678851253.0,4639.106869557187,-90.97,2
19:49,738958551.0,10267.403470932368,-5.48,8
19:51,901432314.0,4072.109396231524,-42.06,5
19:55,245690309.0,11570.43173469208,-10.49,9
20:01,280268430.0,6430.606437495366,-25.05,8
20:17,503575533.0,9245.21172413544,-19.14,5
20:33,212560376.0,-134.41287422089783,-15.4,9
20:34,547010927.0,28126.371904675467,-14.68,2
22:03,549414742.0,8345.133271891416,-10.51,4
22:07,187541224.0,2950.4208179393545,-48.79,2
22:33,399538448.0,8910.486037371236,-22.94,9
00:19,822135975.0,13182.754136775164,-68.96,2
00:24,718058208.0,1550.9701538694046,-2.62,5
00:26,667367404.0,10059.653386896727,-20.6,5
00:29,657139925.0,15536.565279996146,-16.15,9
00:39,264550521.0,7147.5430532815,-7.37,7
00:39,851649498.0,9989.085384036396,-2.76,2
00:45,785749304.0,9978.514828309098,-12.36,5
00:45,824916823.0,9794.016390420442,-49.77,2
00:51,824916823.0,9773.116390420442,-20.9,9
00:53,987163717.0,4722.236078176685,-31.67,9
01:00,815385232.0,12278.527492588591,-7.39,9
01:00,213112754.0,6585.152127937354,-19.3,9
01:02,704517789.0,20010.577770423228,-9.66,7
01:04,113747882.0,13780.482943544435,-40.18,9
01:07,897714622.0,10629.386964266443,-10.97,5
01:14,851181128.0,6073.07768473769,-5.34,2
01:17,795847804.0,27113.11390172453,-51.41,7
01:17,910730524.0,8842.802614801136,-4.58,2
01:17,414454079.0,3907.9148500000024,-34.23,9
01:17,108481285.0,10751.951721253865,-15.37,7
01:29,541639148.0,5052.340248306755,-3.09,7
01:37,874431242.0,11432.366429378397,-7.63,2
01:42,815385232.0,12247.781581410987,-30.75,4
01:44,836110591.0,4427.651804805773,-27.13,9
01:48,518474507.0,16357.558987580693,-31.53,9
01:51,769311479.0,7618.724629747891,-11.4,2
01:54,887853850.0,11879.876551529283,-26.24,9
02:06,421881811.0,3650.4834926197927,-5.64,2
02:06,633345190.0,6279.402693194736,-29.75,9
02:10,229502829.0,-4106.445424186246,-25.44,9
02:13,639409800.0,40535.87052908917,-17.7,4
02:18,581655972.0,46010.39342898296,-48.11,2
02:27,131388684.0,24811.83075898357,-19.29,9
02:27,179173981.0,4701.695250236597,-34.01,7
02:29,749378808.0,2781.06580541444,-34.72,9
02:31,518474507.0,16339.63183096009,-17.93,7
02:33,145387690.0,6292.59211197923,-27.19,9
02:34,215311171.0,6088.249923382263,-32.72,5
02:36,572384506.0,9260.509331564832,-20.22,9
02:36,547010927.0,28098.431904675468,-27.94,9
02:44,853907490.0,9322.129906903265,-25.91,5
02:44,433917275.0,8518.358188399756,-0.47,5
02:47,492215823.0,4897.732223815445,-30.22,9
02:49,383625050.0,3895.60551853142,-41.62,2
02:51,806358207.0,13477.45911737363,-65.61,7
02:54,124102251.0,1299.3474507256176,-50.28,7
02:56,822250278.0,7793.627715652269,-12.98,9
02:57,166019891.0,9650.217808791598,-73.62,2
02:58,673025413.0,2851.84841297088,-2.65,5
03:04,145387690.0,6241.735881859585,-50.86,2
03:07,383833857.0,29496.264245487564,-18.2,9
03:12,399144202.0,2432.122325771701,-3.01,7
03:18,221868392.0,5616.893829807865,-12.86,7
03:18,639549973.0,6660.4560081435675,-7.29,7
03:19,880546403.0,-1435.2295000000022,-35.73,9
03:23,802697323.0,18719.4858342167,-40.52,9
03:24,471897866.0,8227.51034450029,-43.09,8
03:24,668329719.0,10195.65849329302,-6.05,5
03:27,604288474.0,2073.682346840727,-0.05,2
03:28,198946608.0,4986.534199620675,-5.84,2
03:31,601627384.0,3973.630789542348,-45.04,9
03:31,322720763.0,8181.644883432073,-56.82,2
03:35,237684254.0,7109.905362030223,-13.0,7
03:37,940569402.0,5568.301903035758,-7.5,9
03:38,237493332.0,17161.33058012053,-32.18,5
03:39,216285378.0,26355.81211352841,-39.79,9
03:39,270374623.0,11426.04323503042,-11.95,9
03:41,235881534.0,14630.392074981492,-28.99,8
03:41,383833857.0,29493.081868980946,-3.18,8
03:42,675806859.0,8904.847588490933,-16.27,5
03:45,970298834.0,2935.711106174519,-7.29,2
03:47,687135796.0,32775.79785787818,-5.99,9
03:47,482513594.0,6963.804747963853,-23.92,8
03:48,461990622.0,9099.366437142702,-9.5,5
03:49,809499628.0,20275.74572202212,-11.64,9
03:50,572384506.0,9241.246484160418,-19.26,2
03:52,556992209.0,12407.5759755884,-58.85,7
03:54,719586818.0,21847.816791760742,-29.16,4
03:56,679662108.0,18366.13440802384,-49.16,2
04:01,822250278.0,7776.931430857228,-16.7,7
04:03,128033695.0,3059.207277870898,-14.17,2
04:05,873693307.0,12655.532022838246,-18.89,9
04:07,108931112.0,16573.285693942125,-37.19,9
04:08,308505160.0,15860.04668416832,-40.12,5
04:09,779236304.0,2346.7175954795352,-33.09,9
04:10,270374623.0,11423.909540429748,-2.13,7
04:11,221868392.0,5587.603829807865,-29.29,9
04:12,170637730.0,1871.198399086269,-28.48,2
04:12,752362502.0,8448.550832500616,-50.92,2
04:17,912705941.0,21256.66203568797,-45.8,7
04:19,187111705.0,7801.684251292104,-18.57,2
04:25,887853850.0,11853.76459819049,-26.11,5
04:28,949032480.0,4300.080126234881,-37.39,9
04:30,992204045.0,9277.443543101608,-37.11,7
04:31,414805878.0,14630.382331599369,-43.09,9
04:35,985188462.0,-644.8936112887752,-35.59,9
04:36,960208650.0,17018.496341700815,-30.21,5
04:38,183888402.0,21976.98245714013,-30.43,9
04:46,994214354.0,11318.046482179252,-30.98,9
04:48,373163757.0,12159.97380189042,-48.18,4
04:49,419550103.0,21096.42356163113,-12.35,2
04:51,395284483.0,2013.8903402113087,-22.95,9
04:53,836110591.0,4417.108623559947,-10.54,8
04:53,678851253.0,4601.939008970083,-37.17,8
04:55,651756497.0,18358.830588023837,-44.28,5
04:56,305778936.0,11221.551085442492,-31.76,2
04:58,766941757.0,4038.954664992592,-28.48,9
05:05,956717493.0,1822.3396622581224,-18.06,8
05:06,984783496.0,16277.142847666044,-16.89,9
05:11,297823329.0,947.3386499999992,-37.63,9
05:13,874431242.0,11412.026429378397,-20.34,9
05:14,245690309.0,11539.983039955234,-30.45,7
05:16,547010927.0,28057.709832490043,-40.72,2
05:21,994214354.0,11253.845942038624,-64.2,2
05:23,386729293.0,35535.72244797837,-5.36,5
05:24,706250160.0,14798.30634717023,-7.02,2
05:25,519644021.0,4012.208764921877,-10.67,2
05:30,256002321.0,7708.381997124805,-15.9,9
05:32,534325901.0,7483.2597360016525,-6.0,9
05:32,534204159.0,6872.424305185661,-27.52,8
05:38,450896297.0,15097.331234089272,-40.59,9
05:40,885259672.0,3592.049870059762,-33.25,4
05:44,738958551.0,10233.573470932368,-33.83,9
05:46,679911053.0,3595.964370722318,-10.75,4
05:48,473820682.0,12446.47158641198,-18.03,7
05:50,532478725.0,5332.65232220567,-40.13,9
05:50,661295096.0,3833.3282147844234,-0.3,4
05:52,169006407.0,13282.861915153697,-44.55,2
05:53,370521542.0,30656.844813372027,-12.25,9
05:57,146909202.0,5275.967900152972,-0.09,5
05:59,867987292.0,2683.914983929644,-35.89,2
06:00,683319988.0,8234.356416654467,-13.82,2
06:01,489964679.0,23504.79837236987,-27.73,9
06:02,613729471.0,9745.270345921172,-6.69,7
06:03,510101371.0,14330.675517599826,-30.62,9
06:08,709608057.0,3157.0010241817135,-47.18,9
06:09,450896297.0,15093.389606158991,-3.94,2
06:15,858989281.0,30748.76718728476,-15.62,2
06:15,738958551.0,10158.88109235757,-74.69,4
06:18,586315521.0,14158.87249855633,-14.3,2
06:24,370521542.0,30629.686899389217,-27.16,5
06:26,815993333.0,6282.019829799528,-29.27,7
06:28,348325817.0,10662.116049872566,-34.57,9
06:30,192202372.0,523.2860875172223,-1.22,5
06:31,905860285.0,14516.229300973924,-6.89,2
06:31,554792076.0,32369.772933010034,-14.83,5
06:33,575652395.0,2064.540857999725,-3.75,2
06:35,647936800.0,1882.651908872067,-21.17,7
06:38,511179916.0,7176.137456558823,-17.57,8
06:38,940569402.0,5568.079821692767,-0.22,2
06:40,873701090.0,731.9456096994852,-1.69,7
06:42,633345190.0,6278.242070770057,-1.16,2
06:42,417850087.0,17877.78899102393,-10.36,2
06:46,973086490.0,11817.100356342393,-52.51,2
06:53,859603181.0,4091.516125197535,-4.76,7
06:54,534325901.0,7477.404459047701,-5.86,5
06:55,120634201.0,6219.848785017448,-15.65,9
06:56,973086490.0,11811.100356342393,-6.0,9
06:57,196289502.0,18360.44900806777,-26.64,5
06:58,628470485.0,1237.8386353461492,-36.96,8
06:58,510101371.0,14298.43576627904,-32.24,2
06:59,290818242.0,6228.433950928461,-6.79,5
07:01,287480331.0,9081.347276759694,-32.39,9
07:02,873693307.0,12644.578106103032,-10.95,7
07:03,670102069.0,1843.437514113878,-20.33,9
07:13,623156843.0,5723.698102971445,-54.75,2
07:15,364357875.0,9856.632372005564,-27.64,5
07:19,549414742.0,8312.793271891416,-32.34,9
07:21,587225252.0,7228.528478217324,-43.42,9
07:32,930277104.0,10505.989594652234,-48.79,2
07:33,822718326.0,13137.345295024492,-13.89,2
07:33,435984758.0,4948.881884676441,-1.38,7
07:33,949032480.0,4284.995618572876,-15.08,5
07:34,776431321.0,3751.6283953035854,-50.93,7
07:37,842682241.0,4639.380502002305,-5.38,5
07:41,996042490.0,7302.447755230955,-30.07,2
07:42,151968462.0,9045.804023177194,-4.13,5
07:45,195895574.0,7871.154131850322,-22.26,5
07:46,624500124.0,3683.3063506052977,-40.79,8
07:48,986267641.0,5907.841578567127,-41.54,5
07:52,984783496.0,16269.279533644938,-7.86,5
07:54,285220959.0,13307.358398914175,-57.73,7
07:54,698076160.0,7645.028316048644,-7.91,7
07:56,601627384.0,3968.7243156550626,-4.91,7
07:56,899742927.0,14839.647350069636,-3.44,2
07:57,345582855.0,1155.1429528205497,-6.6,9
08:01,885259672.0,3586.049870059762,-6.0,9
08:02,187541224.0,2912.7308179393544,-37.69,9
08:06,259015404.0,1292.0194137402204,-42.59,9
08:09,241459011.0,910.7389132723464,-6.5,9
08:11,454356905.0,3258.5011190301416,-27.39,2
08:15,549414742.0,8307.808076315458,-4.99,5
08:16,282837512.0,16041.649765215538,-13.51,2
08:19,395284483.0,2008.4903402113089,-5.4,9
08:21,196289502.0,18344.54900806777,-15.9,9
08:23,252760664.0,7724.354699721144,-61.32,2
08:24,712474734.0,-1984.391831236004,-6.74,5
08:25,691843653.0,-3342.713399999992,-20.32,5
08:27,851649498.0,9937.761384036396,-51.32,5
08:28,252419513.0,-2463.1311858134145,-13.86,5
08:32,252701364.0,-4179.813672677914,-42.64,5
08:32,843174694.0,-5790.983499999998,-29.37,5
08:33,844206657.0,1122.1557551465696,-61.75,5
08:34,106601471.0,11984.485671464829,-51.66,5
08:34,506618547.0,17960.04218435895,-13.01,2
08:34,610450243.0,-277.3295999999998,-11.28,5
08:35,168414279.0,209.4747842749213,-25.7,5
08:35,151278285.0,1321.1211499999995,-149.11,5
08:36,657528784.0,75.9969000000007,-140.55,5
08:36,204855464.0,-882.5477886396163,-155.79,5
08:37,423208402.0,3705.139450000004,-33.5,5
08:41,832564361.0,17800.427850485536,-0.11,7
08:41,128033695.0,3043.478277870898,-15.73,5
08:41,108563213.0,26421.733315416805,-57.93,2
08:41,424927189.0,75.0566327441052,-89.68,5
08:42,903953091.0,4083.888790134576,-148.93,5
08:43,550169791.0,25492.02984098712,-85.72,5
08:44,734161378.0,-2943.625169434211,-38.87,5
08:44,237493332.0,17111.42058012053,-49.91,5
08:44,696758548.0,-3734.6303963201367,-37.37,5
08:45,480557476.0,12705.82103346121,-45.25,5
08:45,570575024.0,-1071.0757000000008,-157.19,5
08:45,892354433.0,-369.4999606343386,-31.08,5
08:46,113747882.0,13748.050294953346,-32.43,2
08:48,629078930.0,754.5007632670716,-66.61,5
08:50,308897841.0,1703.059999999999,-20.75,5
08:52,316793091.0,1189.9050600549506,-44.67,5
08:52,130154096.0,1038.5328328480243,-147.71,5
08:53,558119802.0,37854.84368957762,-10.79,5
08:53,668329719.0,10086.26249329302,-109.4,5
08:55,834581602.0,-214.56520000000089,-58.81,5
08:56,833899961.0,855.1149957180096,-52.99,5
08:56,358846516.0,858.5007225272172,-5.35,9
08:57,506618547.0,17918.48318435895,-41.56,5
08:59,262767079.0,-1254.3215000000007,-74.03,5
08:59,493571342.0,-2750.8233809070466,-18.42,5
09:00,310620484.0,181.83819509219825,-87.42,5
09:01,365608668.0,675.5660719666741,-141.22,5
09:02,290818242.0,6222.933950928461,-5.5,9
09:03,490868147.0,-54.43622087869847,-75.12,5
09:04,506618547.0,17912.78318435895,-5.7,9
09:04,799861885.0,1045.6647999999986,-97.3,5
09:05,683319988.0,8226.856416654467,-7.5,9
09:08,999752672.0,1030.9610935333344,-4.7,9
09:08,581655972.0,46003.89342898296,-6.5,9
09:11,690958123.0,23775.909997870647,-6.35,9
09:12,683078800.0,2457.55929844157,-5.0,9
09:12,426474982.0,-4078.71475,-47.35,5
09:13,380911501.0,2.19339999999913,-76.29,5
09:16,129018172.0,11496.42946802586,-150.36,5
09:17,535744551.0,1250.0630659956255,-18.0,4
09:17,980500334.0,-756.6219338929037,-15.15,5
09:18,865748375.0,3225.736261626129,-170.58,5
09:18,586315521.0,14153.47249855633,-5.4,9
09:18,670102069.0,1831.2188178311612,-12.22,5
09:19,441274121.0,14374.329243163182,-5.45,9
09:19,558875206.0,4245.730539399782,-5.7,9
09:19,233981231.0,2994.7607227241697,-1.99,4
09:20,422955974.0,150.97573499904988,-93.29,5
09:21,117273481.0,10969.745243085155,-6.0,9
09:22,298007503.0,2952.4841036256344,-173.6,2
09:22,540159353.0,12612.272556398537,-6.8,9
09:22,525524239.0,5.6623502111935515,-22.0,2
09:23,352291960.0,3492.8100533035736,-63.11,2
09:24,406862520.0,388.92837653741026,-251.27,5
09:24,547010927.0,27949.909832490044,-107.8,2
09:27,667367404.0,10054.153386896727,-5.5,9
09:27,370521542.0,30552.316899389218,-77.37,2
09:28,757115616.0,2311.5000000000045,-32.96,7
09:28,749378808.0,2769.3151603403426,-11.75,7
09:28,886921642.0,3615.7334233211736,-148.31,2
09:29,612304466.0,-2382.5982499999977,-13.34,5
09:30,162162212.0,-447.358956672691,-99.99,2
09:31,776431321.0,3721.6683953035854,-29.96,7
09:31,402438092.0,513.9590999999989,-72.86,5
09:33,514362267.0,1107.7473191070603,-81.36,7
09:34,895331556.0,-213.8212000000009,-47.0,2
09:38,298007503.0,2844.7121036256344,-107.77,2
09:38,444428189.0,2021.1262000000036,-55.3,2
09:39,547010927.0,27772.80983249005,-177.1,2
09:40,783650950.0,-642.3786434110118,-92.99,5
09:42,405416860.0,3117.3694068809054,-34.29,2
09:42,285220959.0,13238.058398914178,-69.3,2
09:42,520447032.0,8913.116019540916,-24.84,2
09:43,886921642.0,3604.842941961027,-10.89,2
09:43,305778936.0,11145.381085442492,-76.17,2
09:45,776431321.0,3701.6783953035856,-19.99,2
09:45,621652856.0,1116.0359696105402,-22.99,7
09:46,741903302.0,3299.0970679352617,-6.99,4
09:46,653667523.0,5400.661594121482,-24.95,7
09:47,965038148.0,386.18816563232775,-53.21,4
09:48,535744551.0,1185.0830659956257,-64.98,2
09:50,548907062.0,635.5769711746526,-45.41,5
09:50,673025413.0,2603.34841297088,-248.5,7
09:50,722971557.0,-509.9042791569246,-73.63,5
09:51,834383043.0,6138.295510325551,-9.99,7
09:52,444371478.0,558.8055499999987,-52.43,5
09:52,444428189.0,1980.5402000000036,-40.59,2
09:53,347110339.0,-504.4067925031481,-193.0,2
09:53,461029994.0,9372.200239540956,-26.97,4
09:54,613729471.0,9698.461345921172,-46.81,5
09:54,448004226.0,1868.59236866488,-57.99,2
09:55,821971408.0,1297.7971102355432,-35.0,2
09:55,285220959.0,12989.558398914178,-248.5,2
09:57,525524239.0,-11.317649788806447,-16.98,1
09:58,924045955.0,1579.929442658665,-95.08,2
10:00,514362267.0,1021.1298191070604,-86.62,4
10:02,469561218.0,-181.1399000000009,-177.34,5
10:03,547010927.0,27598.509832490046,-174.3,2
10:03,792845450.0,1028.2911500000007,-3.49,4
10:04,588565416.0,7419.654986037862,-7.88,7
10:05,347110339.0,-671.4067925031482,-167.0,2
10:05,933491926.0,4249.179966429635,-32.59,2
10:07,711045550.0,1744.4013500000042,-320.6,7
10:09,246753533.0,527.4972999999982,-6.1,9
10:09,442079728.0,409.64511921931376,-168.0,2
10:12,675806859.0,8879.627588490934,-25.22,2
10:12,856957948.0,12512.321154533907,-36.97,4
10:13,366550080.0,26907.36503397812,-25.21,2
10:13,228136274.0,1433.6968299999996,-30.03,7
10:14,444428189.0,1822.3542000000036,-158.19,2
10:15,865748375.0,3062.650261626129,-163.09,2
10:15,762859681.0,1100.670599999999,-127.53,5
10:16,578131296.0,734.7631694440436,-54.99,2
10:19,903953091.0,4078.888790134576,-5.0,9
10:19,233981231.0,2936.7807227241697,-57.98,2
10:19,965038148.0,337.16816563232777,-49.02,5
10:22,427909748.0,1534.3632000000164,-6.99,4
10:24,924045955.0,1507.209442658665,-72.72,2
10:24,703537476.0,1397.4862499999992,-63.04,2
10:25,522188082.0,8518.853630825262,-30.23,1
10:26,518746136.0,-809.6572282369169,-52.99,5
10:26,673025413.0,2423.44841297088,-179.9,4
10:27,414454079.0,3859.1248500000024,-48.79,2
10:27,696333897.0,557.8703999999987,-22.0,2
10:28,264550521.0,7130.4230532815,-17.12,7
10:31,522188082.0,8504.916370739786,-13.94,2
10:32,155317149.0,287.757249999999,-113.49,2
10:32,290751280.0,774.2522466748255,-99.5,2
10:32,272538745.0,18700.229900000017,-111.3,2
10:36,475277431.0,1834.3841369436188,-23.97,4
10:36,711045550.0,1509.201350000004,-235.2,4
10:38,298007503.0,2559.1541036256344,-60.19,2
10:39,441142605.0,2560.3801422757306,-55.76,5
10:39,290751280.0,722.2522466748255,-52.0,2
10:39,285873880.0,13215.651088241024,-88.99,2
10:43,280098744.0,956.5453778716668,-65.27,5
10:43,924045955.0,1389.466942658665,-117.74,2
10:44,259015404.0,1275.344368169414,-16.68,2
10:46,272538745.0,18555.329900000015,-144.9,2
10:47,596171893.0,163.47559482551063,-6.99,1
10:52,551755686.0,8420.549926654152,-28.97,4
10:53,865748375.0,2992.590261626129,-70.06,2
10:53,405416860.0,3015.8834068809056,-101.49,2
10:53,965038148.0,212.29316563232777,-124.88,2
10:57,192202372.0,219.83608751722232,-303.45,5
10:57,572384506.0,9211.966484160415,-29.28,2
10:58,821971408.0,1260.8791102355433,-36.92,5
11:00,347110339.0,-728.9067925031482,-57.5,2
11:00,895331556.0,-238.9316000000009,-25.11,5
11:00,155317149.0,232.26724999999897,-55.49,2
11:02,290751280.0,597.2522466748255,-125.0,2
11:06,272538745.0,18384.529900000016,-170.8,2
11:10,215426302.0,1020.814404025692,-97.99,2
11:10,904154012.0,722.8074581204314,-127.48,2
11:10,924045955.0,1245.0994426586649,-144.37,2
11:11,819515373.0,3264.862436063795,-33.95,1
11:11,722358036.0,78.00829062708277,-149.51,5
11:11,572384506.0,9198.386484160415,-13.58,1
11:12,383833857.0,29462.081868980946,-31.0,1
11:13,912584712.0,889.080619544733,-9.99,1
11:14,283027736.0,194.76924397017268,-100.12,2
11:20,986774156.0,2042.6569316257696,-5.99,2
11:20,405416860.0,2932.5974068809055,-83.29,2
11:20,290751280.0,452.7522466748255,-144.5,2
11:22,711045550.0,1395.1013500000042,-114.1,7
11:22,347110339.0,-786.4067925031482,-57.5,2
11:25,272538745.0,18335.529900000016,-49.0,2
11:26,924045955.0,1209.864442658665,-35.23,2
11:27,647472692.0,29280.11966402665,-41.06,4
11:28,290751280.0,340.7522466748255,-112.0,2
11:29,155317149.0,217.28724999999895,-14.98,2
11:29,120634201.0,6204.718785017448,-15.13,4
11:30,449387287.0,83.3866938351014,-169.95,5
11:30,469330905.0,943.2784286233556,-133.66,2
11:35,987656636.0,6163.944389639515,-82.72,2
11:39,522188082.0,8489.155790739786,-15.76,4
11:41,412823730.0,397.86329585048986,-70.06,2
11:41,290751280.0,251.25224667482553,-89.5,2
11:41,819515373.0,3191.8724360637952,-72.99,2
11:41,155317149.0,139.797249999999,-77.49,2
11:42,215426302.0,833.928404025692,-186.89,2
11:42,283027736.0,138.51924397017268,-56.25,2
11:43,849096144.0,2224.9920207513446,-46.77,5
11:44,904154012.0,600.8174581204314,-121.99,2
11:48,469330905.0,774.6204286233556,-168.66,2
11:52,272538745.0,18300.529900000016,-35.0,2
11:53,514362267.0,988.1373191070604,-32.99,7
11:56,298000165.0,29159.177705415328,-42.97,4
11:58,688712152.0,8004.468690701315,-15.16,5
12:01,987229118.0,1261.3202897383348,-10.98,1
12:03,155317149.0,96.807249999999,-42.99,2
12:10,637649383.0,924.5280999999984,-109.84,5
12:10,215426302.0,780.042404025692,-53.89,2
12:14,668175891.0,1133.944366073262,-20.53,5
12:16,492850697.0,50.29504666586358,-25.02,2
12:16,221356538.0,990.6313999999996,-24.97,7
12:20,272538745.0,18164.729900000017,-135.8,2
12:21,444428189.0,1674.6682000000037,-147.69,2
12:21,215426302.0,655.442404025692,-124.6,2
12:21,355733816.0,5689.123720118672,-16.97,7
12:22,469330905.0,729.8344286233555,-44.79,2
12:22,920830317.0,-351.2029793625187,-260.47,5
12:22,889916166.0,459.55340141322654,-31.98,4
12:28,514362267.0,927.0348191070603,-61.1,4
12:31,711140907.0,965.6942999999992,-30.34,9
12:35,405416860.0,2779.3114068809055,-153.29,2
12:37,442079728.0,144.34511921931374,-265.3,2
12:40,644751433.0,-1538.7781584655386,-19.92,5
12:41,979122276.0,-319.5600377056714,-65.25,5
12:44,924045955.0,1161.489442658665,-48.38,2
12:44,272538745.0,18004.429900000017,-160.3,2
12:49,673025413.0,2207.84841297088,-215.6,7
12:57,444428189.0,1621.4962000000037,-53.17,2
12:57,215426302.0,573.556404025692,-81.89,2
13:01,849096144.0,2219.6420207513447,-5.35,9
13:01,442079728.0,-124.4548807806862,-268.8,2
13:01,405416860.0,2538.5394068809055,-240.77,2
13:03,570410059.0,2540.8521467763117,-64.5,2
13:07,688712152.0,7998.468690701315,-6.0,9
13:08,290751280.0,50.75224667482553,-200.5,2
13:10,215426302.0,309.670404025692,-263.89,2
13:10,924045955.0,1074.886942658665,-86.6,2
13:11,272538745.0,17977.129900000018,-27.3,2
13:11,673025413.0,2079.74841297088,-128.1,7
13:12,514362267.0,883.1823191070605,-43.85,2
13:12,155317149.0,4.827249999998983,-91.98,2
13:13,179173981.0,4592.305250236596,-109.39,2
13:14,909676212.0,627.1458136673078,-30.95,7
13:16,653667523.0,5300.681594121483,-99.98,2
13:18,290751280.0,45.75224667482553,-5.0,9
13:18,444428189.0,1544.5102000000036,-76.99,2
13:18,347110339.0,-960.9067925031482,-174.5,2
13:19,910730524.0,8837.302614801136,-5.5,9
13:19,218795010.0,-127.1737500000006,-118.82,5
13:20,711045550.0,1200.5013500000043,-194.6,7
13:21,285873880.0,13171.803088241024,-43.85,5
13:25,469330905.0,496.0484286233555,-233.79,2
13:26,272538745.0,17817.52990000002,-159.6,2
13:26,364396689.0,-286.11825,-78.64,5
13:27,924045955.0,970.644442658665,-104.24,2
13:27,987656636.0,6145.784800257587,-18.16,5
13:29,284905540.0,9984.388805745331,-107.8,2
13:29,930277104.0,10462.859594652236,-43.13,9
13:30,480557476.0,12629.681033461213,-76.14,2
13:32,653667523.0,5263.031594121483,-37.65,9
13:32,170637730.0,1829.998399086269,-41.2,7
13:33,570410059.0,2475.3521467763117,-65.5,2
13:34,444428189.0,1476.6382000000035,-67.87,2
13:36,673025413.0,2025.14841297088,-54.6,4
13:36,741903302.0,3243.715867935262,-55.38,5
13:36,347110339.0,-1061.9067925031482,-101.0,2
13:42,155317149.0,-131.66275000000104,-136.49,2
13:45,106601471.0,11957.649438273984,-26.84,2
13:46,711045550.0,1012.9013500000044,-187.6,4
13:47,272538745.0,17566.92990000002,-250.6,2
13:50,348325817.0,10658.229260641292,-3.89,2
13:51,924045955.0,936.894442658665,-33.75,2
13:51,194023154.0,-2860.8321717847316,-24.49,5
13:53,673025413.0,1690.5484129708802,-334.6,4
13:53,775790822.0,-3493.433419216067,-44.51,5
13:59,442079728.0,-162.9548807806862,-38.5,2
13:59,570410059.0,2435.8521467763117,-39.5,2
14:00,865748375.0,2730.1042616261293,-262.49,2
14:00,272538745.0,17483.62990000002,-83.3,2
14:03,155317149.0,-166.66275000000104,-35.0,2
14:08,673025413.0,1529.5484129708802,-161.0,7
14:11,444428189.0,1422.7382000000034,-53.9,2
14:11,285873880.0,13098.249883709035,-73.55,2
14:20,901432314.0,4060.792741749081,-11.32,5
14:21,347110339.0,-1125.9067925031482,-64.0,2
14:28,444428189.0,1312.838200000003,-109.9,2
14:29,904154012.0,486.8174581204314,-114.0,2
14:34,587225252.0,7207.041241878882,-21.49,7
14:36,155317149.0,-272.65275000000105,-105.99,2
14:43,696333897.0,496.89039999999864,-60.98,2
14:49,444428189.0,1104.2382000000034,-208.6,2
14:51,965038148.0,134.29316563232777,-78.0,2
14:51,405416860.0,2434.9534068809057,-103.59,2
14:53,469330905.0,293.07642862335547,-202.97,2
14:53,538003940.0,1479.37000000001,-4.99,7
14:53,551755686.0,8282.978926654152,-137.57,5
14:55,585625048.0,2712.2718830134913,-7.34,7
14:56,444428189.0,1058.7522000000033,-45.49,2
15:13,556992209.0,12383.5859755884,-23.99,4
15:17,924045955.0,837.519442658665,-99.38,2
15:17,108812033.0,788.0466999999982,-32.06,5
15:18,117308635.0,2204.2616156487898,-67.26,2
15:19,673025413.0,1368.5484129708802,-161.0,7
15:24,352899149.0,760.8727411773411,-22.96,7
15:29,405416860.0,2346.9734068809057,-87.98,2
15:29,469330905.0,113.90442862335549,-179.17,2
15:31,444428189.0,1016.7522000000032,-42.0,2
15:32,250895529.0,1895.824532469289,-104.0,2
15:32,520447032.0,8857.739019540915,-55.38,5
15:33,673025413.0,1124.9484129708803,-243.6,4
15:34,259015404.0,1248.2643681694142,-27.08,7
15:44,158414827.0,-1527.540000000002,-19.18,5
15:45,129018172.0,11480.44946802586,-15.98,1
15:49,285220959.0,12863.558398914178,-126.0,2
15:50,155317149.0,-381.15275000000105,-108.5,2
15:58,679911053.0,3555.904350722318,-40.06,4
16:01,414454079.0,3855.0648500000025,-4.06,4
16:01,386277162.0,809.9599999999994,-21.97,7
16:03,180616589.0,1600.9028282361094,-1.99,4
16:04,565175333.0,-4307.536022729825,-52.99,5
16:04,441142605.0,2554.410142275731,-5.97,4
16:07,392270893.0,14994.351402089738,-47.62,7
16:07,613427466.0,7786.913455264379,-5.99,7
16:07,865748375.0,2603.4462616261294,-126.66,2
16:10,155317149.0,-445.13275000000107,-63.98,2
16:18,283027736.0,110.78424397017268,-27.73,2
16:23,678330503.0,2587.3680955774557,-211.78,5
16:24,548907062.0,535.5869711746526,-99.99,2
16:24,514362267.0,868.5573191070605,-14.62,7
16:26,871200314.0,504.1551242426383,-34.95,7
16:31,744968736.0,-1505.271826569424,-11.89,5
16:31,194745206.0,602.3133720912431,-27.44,9
16:32,856461967.0,1.4173535294926296,-67.77,5
16:32,865748375.0,2552.3602616261296,-51.09,2
16:33,256002321.0,7697.197659144663,-11.18,7
16:37,322221939.0,4390.9502612234455,-147.9,5
16:37,673025413.0,993.3484129708804,-131.6,7
16:38,924045955.0,761.0269426586649,-76.49,2
16:39,155317149.0,-552.622750000001,-107.49,2
16:45,303843160.0,165.6398000000012,-114.97,4
16:45,137822385.0,4439.879703161885,-25.98,2
16:46,933491926.0,4207.939966429635,-41.24,1
16:46,653667523.0,5253.9197238903325,-9.11,8
16:47,241459011.0,841.7389132723465,-69.0,7
16:48,532478725.0,5292.97232220567,-39.68,1
16:49,514362267.0,804.8223191070605,-63.73,4
16:52,279149837.0,1383.3780499999991,-33.95,1
16:55,283027736.0,23.04174397017269,-87.74,2
16:55,965038148.0,75.41816563232777,-58.88,2
16:57,444428189.0,920.1522000000032,-96.6,2
17:02,860360312.0,34.240208882680264,-99.5,2
17:03,556992209.0,12307.4819755884,-76.1,5
17:06,386729293.0,35508.78244797837,-26.94,9
17:06,310375875.0,2660.640141719671,-19.48,9
17:11,639420537.0,-1312.2139499999998,-30.03,5
17:11,449871732.0,8261.684369968103,-22.08,2
17:11,183888402.0,21890.57245714013,-86.41,2
17:13,347110339.0,-1364.9067925031482,-239.0,2
17:14,678330503.0,2533.663739035043,-53.7,5
17:14,766812921.0,135.11929999999893,-9.99,4
17:15,284905540.0,9880.788805745333,-103.6,2
17:15,444428189.0,820.0522000000033,-100.1,2
17:17,198946608.0,4956.454199620675,-30.08,2
17:18,858560423.0,14057.877253018789,-89.97,4
17:19,399144202.0,2399.032325771701,-33.09,9
17:20,987163717.0,4660.2660781766845,-61.97,2
17:20,628470485.0,957.4046353461492,-280.43,5
17:21,965038148.0,-97.08183436767224,-172.5,2
17:21,482513594.0,6919.364747963853,-44.44,2
17:21,510101371.0,14279.02576627904,-19.41,4
17:21,155317149.0,-584.612750000001,-31.99,2
17:22,776108637.0,1092.6002536574954,-140.0,2
17:22,255814263.0,2201.150603488462,-58.91,1
17:23,433917275.0,8492.258188399755,-26.1,2
17:25,442070890.0,1765.3824124443709,-119.97,2
17:25,629078930.0,721.5507632670716,-32.95,7
17:26,500043411.0,15269.96030288726,-47.69,7
17:27,331450202.0,9567.454575144118,-17.49,7
17:27,514362267.0,693.0873191070605,-111.74,2
17:27,166019891.0,9637.967808791598,-12.25,9
17:27,500043411.0,15217.115933365922,-52.84,4
17:28,891716230.0,-43.94967018989858,-94.98,2
17:30,373163757.0,12135.98380189042,-23.99,4
17:30,720742759.0,1526.4111308830072,-61.98,2
17:30,639409800.0,40525.78052908917,-10.09,4
17:31,324224854.0,6241.826221317996,-26.08,8
17:31,283027736.0,-68.8107560298273,-91.85,2
17:31,441274121.0,14351.684317052235,-22.64,2
17:32,229205098.0,8826.576971287188,-70.24,7
17:33,506618547.0,17890.53318435895,-22.25,7
17:34,859264768.0,167.4854337819383,-36.05,5
17:34,887853850.0,11713.76459819049,-140.0,2
17:35,137913631.0,1741.7982499999998,-36.63,5
17:36,546296727.0,123.55772730261836,-42.97,2
17:36,534325901.0,7417.512459047702,-59.89,5
17:37,310375875.0,2625.3671404375264,-35.27,7
17:38,605116158.0,3172.506400000005,-11.68,5
17:38,668692488.0,1202.023041057584,-68.61,2
17:40,912705941.0,21189.552035687968,-67.11,2
17:40,628470485.0,897.4246353461492,-59.98,4
17:41,865748375.0,2356.4022616261295,-195.96,2
17:41,423208402.0,3695.159450000004,-9.98,4
17:43,965038148.0,-208.45683436767223,-111.38,2
17:43,355602925.0,1885.3729924538068,-20.97,7
17:44,183186021.0,-321.2200499999989,-44.27,5
17:45,155317149.0,-663.612750000001,-79.0,2
17:45,140893085.0,7895.613056365462,-193.79,5
17:47,442079728.0,-274.9548807806862,-112.0,2
17:47,454129843.0,961.97639516656,-14.98,1
17:48,532478725.0,5249.090143866419,-43.88,5
17:50,514362267.0,678.0948191070605,-14.99,2
17:50,284905540.0,9623.18880574533,-257.6,2
17:50,347110339.0,-1565.9067925031482,-201.0,2
17:53,893134725.0,1690.881000776119,-18.61,5
17:53,444428189.0,742.3662000000032,-77.69,2
17:53,345582855.0,1147.6429528205497,-7.5,4
17:53,642924505.0,539.335120183526,-91.97,2
17:54,709151315.0,-0.59078162584008,-34.95,1
17:54,442079728.0,-414.2548807806862,-139.3,2
17:55,405416860.0,2181.815406880906,-165.16,2
17:55,965038148.0,-294.70683436767223,-86.25,2
17:57,904154012.0,402.3374581204314,-84.48,2
17:57,720742759.0,1487.9211308830072,-38.49,2
17:57,610645022.0,-254.2592626449184,-80.86,5
17:57,229205098.0,8694.276971287189,-132.3,2
17:59,297823329.0,897.3486499999991,-49.99,2
17:59,347110339.0,-1692.4067925031482,-126.5,2
18:01,627622066.0,4140.03237216963,-93.46,2
18:02,380228542.0,-706.6992581844343,-168.68,5
18:02,137913631.0,1716.8982499999995,-24.9,9
18:03,285220959.0,12699.75839891418,-163.8,2
18:05,865748375.0,2259.1022616261293,-97.3,2
18:06,668692488.0,1148.0380410575842,-53.98,2
18:06,904154012.0,300.8474581204314,-101.49,2
18:06,229205098.0,8382.776971287189,-311.5,2
18:06,469330905.0,-79.2675713766445,-193.17,2
18:07,876890798.0,2686.899570699935,-61.37,5
18:09,183888402.0,21835.35374194889,-55.22,2
18:09,304455868.0,1305.5058798978748,-26.29,9
18:11,155317149.0,-688.612750000001,-25.0,2
18:11,284905540.0,9360.68880574533,-262.5,2
18:13,627622066.0,4049.54237216963,-90.49,2
18:16,234952520.0,303.54639999999875,-36.05,9
18:16,116169597.0,1814.8069499999997,-39.18,9
18:19,405416860.0,2015.2574068809056,-166.56,2
18:19,859603181.0,4046.828125197535,-44.69,5
18:22,887156614.0,-400.81977104077384,-59.39,5
18:25,166019891.0,9583.9825287916,-53.99,7
18:25,687135796.0,32738.694122797853,-37.1,8
18:26,668692488.0,1076.7955410575842,-71.24,2
18:27,444428189.0,728.3802000000032,-13.99,2
18:29,705848712.0,30845.18438500223,-16.2,9
18:30,642924505.0,531.345120183526,-7.99,7
18:30,469330905.0,-143.6535713766445,-64.39,2
18:31,155317149.0,-766.602750000001,-77.99,2
18:32,322221939.0,4383.572087153324,-7.38,7
18:32,220183538.0,1029.5735999999995,-14.97,7
18:35,486495235.0,2120.933860076208,-38.92,9
18:38,690958123.0,23709.29344787065,-66.62,7
18:40,951817450.0,10314.98861839392,-10.77,2
18:41,699139822.0,612.6440757769471,-28.04,9
18:41,822718326.0,13077.887295024491,-59.46,5
18:45,155867488.0,227.78669999999832,-40.97,7
18:47,471897866.0,8128.47434450029,-99.04,5
18:48,175452235.0,-606.3257499999996,-32.2,5
18:50,549414742.0,8274.617476315458,-33.19,7
18:50,541639148.0,4932.745248306755,-119.59,5
18:51,444428189.0,687.0942000000032,-41.29,2
18:57,668692488.0,1051.303041057584,-25.49,2
18:59,730002588.0,15983.78121478008,-19.2,2
19:00,639409800.0,40495.49052908917,-30.29,9
19:02,409971170.0,3714.2130454715784,-14.13,5
19:04,163470640.0,914.9322999999996,-76.62,5
19:06,986267641.0,5828.314578567127,-79.53,5
19:06,473820682.0,12435.77158641198,-10.7,9
19:08,806358207.0,13371.24111737363,-106.22,5
19:08,858989281.0,30735.76718728476,-13.0,9
19:11,785749304.0,9964.824828309098,-13.69,9
19:12,421881811.0,3617.3534926197926,-33.13,9
19:12,975345315.0,40996.7325649721,-38.47,5
19:13,408057540.0,5979.871037500422,-47.95,9
19:14,550169791.0,25482.7236263938,-9.31,4
19:14,213096759.0,-1299.4191082144391,-87.45,5
19:14,598586358.0,-3764.1074499999945,-46.16,5
19:14,797184978.0,68.19008657301941,-9.0,5
19:15,837876918.0,-108.19279146542011,-51.36,5
19:17,558875206.0,4072.837539399782,-172.89,5
19:20,558119802.0,37820.71368957762,-34.13,9
19:20,366477356.0,649.2026499999998,-211.81,5
19:23,941285623.0,823.9253990667703,-71.99,5
19:25,713910252.0,-712.5793742714591,-72.28,5
19:25,919185264.0,5398.249728102833,-11.71,5
19:26,982286721.0,-3797.200524017729,-41.71,5
19:26,441274121.0,14270.596317052235,-81.09,5
19:27,662610817.0,-1279.001831324928,-216.88,5
19:29,609939116.0,9302.864762765288,-14.95,8
19:43,237493332.0,17104.030580120532,-7.39,9
19:46,705848712.0,30840.6671482825,-4.52,5
19:46,855129444.0,-36.58769543737221,-27.9,9
19:51,119993184.0,-2234.6744029108613,-15.44,5
19:53,596463612.0,-2065.547604725138,-43.24,5
20:04,496395938.0,13789.662403114817,-34.48,5
20:05,245690309.0,11529.511039955234,-10.47,5
20:09,478651121.0,-510.1011204015304,-45.67,5
20:11,315078351.0,10332.498246840609,-39.13,9
20:14,736340277.0,9169.974176335629,-16.5,9
20:14,348525881.0,581.4866245949357,-34.47,5
20:15,282837512.0,16005.069765215538,-36.58,9
20:17,979892433.0,-1345.565000000001,-75.13,5
20:17,366550080.0,26856.32103397812,-51.04,5
20:20,331450202.0,9514.84257514412,-52.61,5
20:23,510101371.0,14188.43176627904,-90.59,5
20:26,993039226.0,-4638.861999999994,-41.51,5
20:29,399538448.0,8882.011997995913,-28.47,2
20:33,809499628.0,20272.218054187408,-3.53,5
20:34,964702094.0,1263.4646121713563,-38.28,2
20:43,609939116.0,9278.964762765288,-23.9,9
20:45,331450202.0,9493.944262870316,-20.9,5
20:47,414805878.0,14614.521621427131,-15.86,7
20:50,559995067.0,3818.3872347100505,-18.5,7
20:53,700138124.0,5384.568411230337,-1.58,5
20:59,352899149.0,730.3668882280012,-30.51,7
00:37,973086490.0,11798.860356342391,-12.24,9
00:55,252760664.0,7706.971174910657,-17.38,8
00:56,779236304.0,2319.877595479535,-26.84,9
01:08,973086490.0,11763.337873668272,-35.52,7
01:25,766941757.0,4007.2146649925926,-31.74,9
01:49,305778936.0,11139.332944862248,-6.05,2
01:57,613729471.0,9691.549774767043,-6.91,4
02:05,588565416.0,7394.426988659335,-25.23,5
02:05,272538745.0,17482.388374448128,-1.24,8
02:10,480557476.0,12605.58014973217,-24.1,2
02:14,479366718.0,2442.3724130004225,-8.89,2
02:26,899742927.0,14833.16345077304,-6.48,5
02:29,113747882.0,13720.050294953346,-28.0,9
02:35,679662108.0,18365.94070773663,-0.19,4
02:36,520447032.0,8825.859019540916,-31.88,9
02:47,769311479.0,7616.245113978694,-2.48,7
02:48,450896297.0,15057.899606158991,-35.49,9
03:01,559995067.0,3780.0226999425417,-38.36,7
03:03,752362502.0,8409.189348509424,-39.36,2
03:03,779946617.0,19225.449935268203,-16.69,9
03:09,657139925.0,15522.875279996146,-13.69,9
03:10,858989281.0,30718.52718728476,-17.24,9
03:17,399144202.0,2396.2592275791535,-2.77,7
03:18,795847804.0,27110.15317586239,-2.96,2
03:24,518474507.0,16300.30183096009,-39.33,9
03:25,687135796.0,32713.71996572331,-24.97,2
03:37,135937041.0,-547.390348268412,-26.48,9
03:37,496395938.0,13782.380580702724,-7.28,5
03:38,706250160.0,14782.495813719406,-15.81,2
03:38,987163717.0,4627.6860781766845,-32.58,9
03:39,633345190.0,6246.6520707700565,-31.59,9
03:40,698076160.0,7638.598837201856,-6.43,2
03:40,532478725.0,5205.950143866418,-43.14,9
03:41,489964679.0,23470.608372369876,-34.19,9
03:41,621652856.0,1084.9859696105402,-31.05,9
03:47,822250278.0,7761.553885730861,-15.38,5
03:49,572384506.0,9168.786484160417,-29.6,9
03:50,259015404.0,1210.0243681694142,-38.24,9
03:52,885259672.0,3579.117337452143,-6.93,2
03:53,195895574.0,7852.814131850322,-18.34,9
03:54,183888402.0,21790.26374194889,-45.09,9
03:55,518474507.0,16294.101112350378,-6.2,8
03:57,601627384.0,3937.1743156550624,-31.55,9
03:57,873693307.0,12629.078106103032,-15.5,9
03:58,145387690.0,6219.081085479836,-22.65,7
03:58,421881811.0,3598.3046994878987,-19.05,5
03:59,779946617.0,19210.27460579416,-15.18,2
04:07,858989281.0,30688.018875064725,-30.51,7
04:07,933491926.0,4188.839653369495,-19.1,5
04:07,670102069.0,1794.5488178311612,-36.67,9
04:07,985188462.0,-669.9836112887753,-25.09,9
04:08,196289502.0,18330.35900806777,-14.19,9
04:10,179173981.0,4562.435250236596,-29.87,9
04:11,280268430.0,6412.472723953795,-18.13,7
04:11,450896297.0,15056.576491703188,-1.32,5
04:11,187541224.0,2872.3508179393543,-40.38,9
04:12,987229118.0,1215.0072037797918,-46.31,7
04:13,867987292.0,2673.3025057016753,-10.61,2
04:18,200080192.0,9792.484708105472,-1.53,2
04:19,383833857.0,29398.635733121497,-63.45,8
04:24,930271460.0,356.9277475357762,-34.7,9
04:26,647472692.0,29252.56538842876,-27.55,7
04:27,903468956.0,924.348999999999,-8.95,9
04:28,873693307.0,12620.557492784852,-8.52,2
04:29,399144202.0,2370.1092275791534,-26.15,9
04:29,108563213.0,26358.83485298606,-62.9,7
04:31,461990622.0,9087.27614720736,-12.09,2
04:33,667367404.0,10015.173900824651,-38.98,2
04:36,441274121.0,14251.396317052237,-19.2,9
04:38,930277104.0,10462.800857266013,-0.06,8
04:41,633345190.0,6235.271233244409,-11.38,5
04:41,179173981.0,4516.304630008081,-46.13,5
04:42,554792076.0,32366.888128999188,-2.88,7
04:42,108481285.0,10713.081192394911,-38.87,7
04:44,108931112.0,16533.195693942125,-40.09,9
04:45,802697323.0,18679.9158342167,-39.57,9
04:46,675806859.0,8871.692721943215,-7.93,5
04:46,245690309.0,11527.818130396998,-1.69,2
04:50,809499628.0,20253.818054187406,-18.4,9
04:50,623156843.0,5662.060876498848,-61.64,7
04:54,651756497.0,18312.73671909955,-46.09,2
04:54,824916823.0,9753.736390420445,-19.38,9
04:55,611143859.0,3613.1274000000135,-39.5,9
04:59,414805878.0,14577.301621427132,-37.22,9
05:01,270374623.0,11403.125966948948,-20.78,7
05:04,668329719.0,10064.57821026855,-21.68,5
05:04,490790931.0,325.96894999999853,-32.58,9
05:07,324224854.0,6204.56381020638,-37.26,7
05:14,609939116.0,9250.983889891846,-27.98,2
05:15,683319988.0,8189.206416654468,-37.65,9
05:21,653640811.0,19630.540661670704,-0.32,7
05:24,145387690.0,6198.181085479836,-20.9,9
05:25,370521542.0,30547.298681540004,-5.02,7
05:25,120634201.0,6189.728785017448,-14.99,9
05:27,949032480.0,4283.261909474946,-1.73,2
05:30,298000165.0,29147.404216517487,-11.77,7
05:30,718058208.0,1541.7301618102017,-9.24,8
05:32,216285378.0,26318.92211352841,-36.89,9
05:34,912705941.0,21162.723522235672,-26.83,5
05:34,187111705.0,7779.529179312496,-22.16,7
05:34,639409800.0,40464.192483072104,-31.3,5
05:37,170637730.0,1784.1535446714302,-45.84,7
05:39,221868392.0,5562.0538298078645,-25.55,9
05:40,660874296.0,232.17744996084983,-30.42,9
05:43,414454079.0,3817.4348500000024,-37.63,9
05:45,322221939.0,4379.494121046896,-4.08,7
05:45,719586818.0,21846.379446309373,-1.44,7
05:46,556992209.0,12277.315238008125,-30.17,5
05:50,113747882.0,13717.90592618471,-2.14,2
05:52,506618547.0,17880.428419658932,-10.1,5
05:54,587225252.0,7170.261241878882,-36.78,9
05:55,547010927.0,27592.18318336208,-6.33,7
05:56,704517789.0,19979.608461863532,-30.97,4
05:57,366550080.0,26853.4130780201,-2.91,2
05:58,842682241.0,4601.200502002304,-38.18,9
05:59,822135975.0,13173.25448463934,-9.5,2
06:00,409971170.0,3662.396047950587,-51.82,5
06:02,128033695.0,3000.9220203252676,-42.56,2
06:05,429556122.0,5578.510459904381,-53.03,7
06:06,960208650.0,16998.247515050374,-20.25,5
06:07,581655972.0,45982.164323293895,-21.73,7
06:08,142791593.0,-41.08530000000036,-26.19,9
06:08,383625050.0,3884.4116317907415,-11.19,5
06:13,809499628.0,20218.305045413425,-35.51,7
06:14,905860285.0,14513.199385097956,-3.03,8
06:16,510101371.0,14144.94176627904,-43.49,9
06:16,259015404.0,1194.9312102483052,-15.09,7
06:22,520447032.0,8796.829172869204,-29.03,5
06:22,492215823.0,4866.902223815445,-30.83,9
06:26,834383043.0,6087.751415159748,-50.54,5
06:28,897714622.0,10578.94399004103,-50.44,4
06:30,970298834.0,2907.815442509811,-27.9,5
06:36,235881534.0,14584.13131688957,-46.26,2
06:37,824916823.0,9742.112158853495,-11.62,5
06:37,812692024.0,4603.383712951308,-48.29,5
06:39,853907490.0,9303.929906903262,-18.2,9
06:40,749378808.0,2738.1751603403427,-31.14,9
06:41,151968462.0,9015.060573754852,-30.74,8
06:48,522188082.0,8488.188733212875,-0.97,2
06:50,940569402.0,5514.1096663072085,-53.97,2
06:52,558119802.0,37789.80073882448,-30.91,7
06:55,705848712.0,30819.7271482825,-20.94,9
06:56,225210798.0,1035.275317359389,-15.31,8
06:57,146909202.0,5232.942376844087,-43.03,7
06:58,586315521.0,14117.39249855633,-36.08,9
06:58,709608057.0,3122.4110241817134,-34.59,9
07:01,550169791.0,25412.636273446435,-70.09,2
07:01,482513594.0,6899.164747963853,-20.2,9
07:07,456246119.0,23694.84029306781,-0.97,7
07:15,519644021.0,4001.335019869408,-10.87,2
07:16,187541224.0,2812.764627433773,-59.59,7
07:19,414805878.0,14546.650494591064,-30.65,7
07:21,842682241.0,4596.493352366729,-4.71,2
07:22,221868392.0,5551.525711621034,-10.53,5
07:27,435984758.0,4943.643768529374,-5.24,2
07:34,290818242.0,6199.296006001577,-23.64,4
07:34,417850087.0,17841.090511277427,-36.7,8
07:37,647936800.0,1876.5088088647583,-6.14,7
07:39,776108637.0,1086.2502536574957,-6.35,9
07:40,348325817.0,10646.608419024627,-11.62,7
07:41,534325901.0,7411.316085315584,-6.2,2
07:45,127809299.0,2604.975771126573,-16.42,8
07:45,738958551.0,10156.580609226836,-2.3,2
07:46,672913754.0,13489.085723842123,-1.37,2
07:48,256002321.0,7679.957659144663,-17.24,9
07:49,678851253.0,4522.476617530483,-79.46,2
07:50,683078800.0,2418.0453899424633,-39.51,5
07:54,741903302.0,3243.5596174915186,-0.16,7
07:57,364357875.0,9855.301383868236,-1.33,2
07:58,345582855.0,1141.9929528205494,-5.65,9
07:59,473820682.0,12424.27950513254,-11.49,2
08:04,549414742.0,8257.717280528164,-16.9,5
08:04,910730524.0,8825.204885777735,-12.1,5
08:05,673025413.0,944.8025652807094,-48.55,4
08:05,229205098.0,8326.33737602714,-56.44,7
08:05,169006407.0,13273.100763916858,-9.76,5
08:06,395284483.0,2002.3903402113087,-6.1,9
08:07,336557504.0,2024.2507123661103,-5.0,9
08:08,264550521.0,7119.153227761795,-11.27,5
08:08,117308635.0,2175.931176555349,-28.33,7
08:10,987656636.0,6122.671532957857,-23.11,7
08:12,131388684.0,24809.806084551114,-2.02,4
08:14,604288474.0,2070.5484050141495,-3.13,2
08:18,984783496.0,16204.879057772465,-64.4,5
08:19,500043411.0,15212.65047946702,-4.47,2
08:20,853907490.0,9303.109090558908,-0.82,5
08:21,456221621.0,786.8845673026278,-4.7,9
08:25,358846516.0,853.1007225272173,-5.4,9
08:25,885259672.0,3574.0173374521432,-5.1,9
08:26,554771381.0,-1791.3961500000005,-8.83,5
08:27,730002588.0,15964.79932114482,-18.98,4
08:27,494404688.0,-2898.2032653362076,-25.32,5
08:30,491392945.0,6985.347500000012,-43.79,5
08:31,838830098.0,1066.4476920877844,-6.05,9
08:31,290751280.0,-31.17495332517447,-76.93,5
08:32,433917275.0,8461.338188399755,-30.92,9
08:34,758160963.0,7590.645636716753,-34.26,5
08:38,202320275.0,-844.3985500000006,-143.36,5
08:39,766812921.0,20.346949999998913,-114.77,5
08:39,462962606.0,-652.3209500000014,-120.56,5
08:40,511179916.0,7159.012197532521,-17.13,5
08:40,494789005.0,3288.80786216766,-59.42,5
08:50,248625662.0,133.65308428485235,-99.07,5
08:50,666952234.0,-113.42770187551324,-99.41,5
08:53,138609932.0,2004.164003294586,-5.8,9
08:53,978410962.0,-3021.230839548971,-46.96,5
08:54,180719578.0,-4765.577749999993,-27.05,5
08:55,933745726.0,-286.0589435706768,-77.53,5
08:57,452974357.0,-3608.9039499999935,-13.35,5
08:58,285220959.0,12660.976518931788,-38.78,7
08:59,149684419.0,1411.606799999998,-55.02,5
09:00,494156986.0,-1120.2016543276654,-23.0,5
09:00,618514666.0,24366.633472716487,-80.95,5
09:01,482513594.0,6847.462747963853,-51.7,5
09:02,647472692.0,29176.23038842876,-76.34,5
09:02,344843570.0,-360.59181750933385,-45.87,5
09:03,581655972.0,45976.26432329389,-5.9,9
09:05,610450243.0,-309.6545999999998,-32.33,5
09:05,993238248.0,-644.6874873928839,-133.06,5
09:08,903663593.0,621.7051992000772,-5.47,7
09:08,198946608.0,4793.242199620676,-163.21,5
09:08,683319988.0,8182.1064166544675,-7.1,9
09:09,586315521.0,14112.39249855633,-5.0,9
09:10,138969884.0,625.5848999999995,-84.91,5
09:11,441274121.0,14246.346317052235,-5.05,9
09:11,690958123.0,23703.79344787065,-5.5,9
09:12,169006407.0,13264.80076391686,-8.3,9
09:12,999752672.0,1024.6110935333345,-6.35,9
09:13,624563756.0,7.324128783556484,-6.1,9
09:13,535744551.0,1025.1838159956258,-159.9,5
09:15,352291960.0,3357.4650533035738,-135.34,5
09:15,119943495.0,-1347.917562112858,-17.84,5
09:17,541639148.0,4929.66636346834,-3.08,4
09:18,195895574.0,7839.319365980238,-13.49,7
09:18,851649498.0,9932.111384036396,-5.65,9
09:19,987229118.0,1093.0172037797918,-121.99,2
09:20,558875206.0,4067.437539399782,-5.4,9
09:20,683078800.0,2412.245389942463,-5.8,9
09:22,930277104.0,10411.060857266011,-51.74,2
09:22,417850087.0,17834.590511277427,-6.5,9
09:22,540159353.0,12606.472556398538,-5.8,9
09:23,675806859.0,8776.457721943214,-95.23,5
09:23,336171116.0,423.4283999999995,-5.0,9
09:24,492850697.0,-21.774953334136413,-72.07,6
09:24,667367404.0,10009.373900824652,-5.8,9
09:25,285873880.0,13084.061034812446,-14.19,2
09:28,134461671.0,6387.3577034654245,-4.96,2
09:28,228136274.0,1316.3509299999996,-117.35,5
09:31,819515373.0,3124.902436063795,-66.97,4
09:34,519644021.0,3948.995019869408,-52.34,2
09:34,187111705.0,7710.467179312496,-69.06,5
09:36,461029994.0,9366.210239540957,-5.99,4
09:42,129018172.0,11223.549468025862,-256.9,7
09:43,310740977.0,623.4004359296808,-29.99,2
09:43,760753808.0,509.93549999999937,-7.0,7
09:43,395654270.0,-2231.3037028121994,-22.35,5
09:44,494977194.0,1992.344470597579,-115.5,2
09:44,909676212.0,605.1458136673078,-22.0,6
09:45,776431321.0,3669.6983953035856,-31.98,4
09:46,688712152.0,7787.068690701315,-211.4,2
09:46,310620484.0,67.05219509219825,-114.79,2
09:47,933491926.0,4163.669653369495,-25.17,2
09:47,762859681.0,1079.650599999999,-21.02,4
09:48,812692024.0,4518.413712951307,-84.97,4
09:52,494977194.0,1958.969470597579,-33.38,2
09:53,941285623.0,761.9553990667703,-61.97,2
09:55,194745206.0,586.9413720912431,-15.37,2
09:57,237684254.0,7096.011262166835,-13.89,4
09:59,688712152.0,7679.268690701315,-107.8,2
10:00,285115279.0,-3638.5796107892857,-51.43,5
10:01,598793068.0,942.4063999999978,-26.97,4
10:01,700138124.0,5335.998411230337,-48.57,2
10:01,727417797.0,5963.403626772112,-6.99,4
10:02,700138124.0,5333.847158248867,-2.15,7
10:03,310620484.0,-23.24780490780175,-90.3,2
10:03,933491926.0,4162.149083369495,-1.52,4
10:03,588565416.0,7299.002988659335,-95.42,5
10:05,749378808.0,2731.2448913460325,-6.93,7
10:06,165691047.0,439.62829999999866,-44.37,5
10:07,519644021.0,3943.975019869408,-5.02,7
10:07,143003091.0,12589.331013557226,-25.69,8
10:08,494977194.0,1826.969470597579,-132.0,2
10:09,945054126.0,455.9681,-27.08,5
10:11,155317149.0,-891.9885000000011,-125.39,5
10:13,659415300.0,2690.494296218075,-5.4,9
10:14,129018172.0,11136.749468025862,-86.8,7
10:18,137822385.0,4434.129703161885,-5.75,9
10:18,984783496.0,16182.087057772464,-22.79,5
10:19,194745206.0,409.18337209124314,-177.76,2
10:20,246753533.0,519.9972999999982,-7.5,9
10:29,779376323.0,5007.615833981341,-49.99,6
10:30,494977194.0,1702.844470597579,-124.12,2
10:32,497772347.0,949.3217499999978,-58.8,2
10:39,414454079.0,3811.364850000002,-6.07,4
10:40,364357875.0,9730.141383868237,-125.16,2
10:40,815993333.0,6267.092633827528,-14.93,7
10:42,596171893.0,156.48559482551065,-6.99,1
10:44,895750759.0,-192.7825880756659,-33.95,1
10:44,407574996.0,1578.8296093809372,-302.4,2
10:44,684988568.0,-237.4432734272016,-119.38,5
10:45,479366718.0,2380.8924130004225,-61.48,4
10:46,519935524.0,1279.333809737519,-33.16,5
10:48,194745206.0,326.59737209124313,-82.59,2
10:49,572384506.0,9138.155703743796,-30.63,8
10:50,310620484.0,-194.00580490780175,-170.76,2
10:52,169689461.0,978.643149999999,-99.99,2
10:57,916270283.0,3195.970250000001,-50.0,2
11:07,194745206.0,230.71137209124316,-95.89,2
11:12,901432314.0,4042.886741749081,-17.91,5
11:16,886921642.0,3600.362502380696,-4.48,5
11:17,706361191.0,639.0320484940779,-116.0,2
11:22,305778936.0,11099.102944862248,-40.23,2
11:27,497772347.0,767.3217499999978,-182.0,2
11:29,552980092.0,20.98371911933752,-16.5,7
11:33,706361191.0,455.0320484940779,-184.0,2
11:34,183888402.0,21434.66374194889,-355.6,7
11:36,194745206.0,76.72537209124317,-153.99,2
11:41,497772347.0,697.3417499999978,-69.98,4
11:47,183888402.0,21352.09174194889,-82.57,4
11:49,475117511.0,8531.985388645127,-28.0,2
12:11,472995101.0,1833.024484099083,-113.48,2
12:11,101531259.0,316.4720999999995,-64.5,2
12:14,497772347.0,599.3417499999978,-98.0,2
12:15,194745206.0,13.739372091243183,-62.99,2
12:18,407574996.0,1450.0296093809372,-128.8,2
12:22,348325817.0,10614.488419024628,-32.12,9
12:23,549414742.0,8231.077280528165,-26.64,9
12:25,661295096.0,3797.3482147844234,-35.98,4
12:26,460463595.0,-34.55994541857893,-40.57,2
12:28,534204159.0,6841.784305185661,-30.64,9
12:29,183888402.0,21170.79174194889,-181.3,7
12:30,497772347.0,419.4417499999978,-179.9,2
12:31,427909748.0,1501.8732000000164,-32.49,9
12:36,564214408.0,-65.61451527427398,-45.01,5
12:37,183888402.0,21023.80574194889,-146.99,7
12:39,407574996.0,1256.1296093809374,-193.9,2
12:41,460463595.0,-107.35994541857892,-72.8,2
12:41,136770968.0,-135.34080000000046,-31.49,4
12:44,120634201.0,6149.770521925363,-39.96,2
12:44,101531259.0,227.9720999999995,-88.5,2
12:46,338022396.0,0.3063393757390855,-43.03,5
12:48,129018172.0,11004.449468025863,-132.3,2
12:51,673025413.0,891.0635652807093,-53.74,5
12:55,892354433.0,-393.09996063433863,-23.6,5
12:56,753525749.0,-2570.268399999999,-56.95,5
12:59,446720287.0,-1182.0875591815943,-54.12,5
13:00,129018172.0,10716.049468025863,-288.4,2
13:01,256002321.0,7623.130537128445,-56.83,4
13:02,984783496.0,16152.915057772463,-29.17,4
13:05,737547541.0,193.89559956777433,-88.56,5
13:06,407574996.0,1001.3296093809374,-254.8,2
13:06,792845450.0,1002.3111500000008,-25.98,2
13:07,643610517.0,-3204.741190729656,-22.33,5
13:07,472995101.0,1773.034484099083,-59.99,2
13:10,688712152.0,7372.668690701315,-306.6,2
13:11,430910686.0,557.7156000000004,-172.93,5
13:14,133755851.0,660.689248138252,-13.97,4
13:20,849096144.0,2213.1420207513447,-6.5,9
13:23,524425303.0,-653.7488000000012,-55.79,5
13:24,910730524.0,8819.554885777736,-5.65,9
13:26,129018172.0,10401.049468025863,-315.0,2
13:38,460463595.0,-238.9179454185789,-131.56,2
13:39,472995101.0,1687.5744840990833,-85.46,2
13:43,688712152.0,7302.668690701315,-70.0,2
13:43,773633520.0,1.5975609385114211,-75.55,5
13:51,688712152.0,7295.368690701314,-7.3,9
13:53,183888402.0,20843.90574194889,-179.9,2
13:55,995615876.0,2331.7628618772596,-33.64,9
13:57,593378953.0,1475.7296500000048,-35.0,2
14:14,441142605.0,2494.4103733518577,-60.0,2
14:15,460463595.0,-469.2039454185789,-230.29,2
14:21,480198977.0,14242.352032593251,-59.98,4
14:33,180616589.0,1588.6108282361097,-12.29,5
14:37,895750759.0,-225.7625880756659,-32.98,2
14:38,660561861.0,1106.4056493325727,-27.5,4
14:46,706361191.0,316.0320484940779,-139.0,2
14:52,407574996.0,896.3296093809374,-105.0,2
14:57,933491926.0,4115.585083369495,-46.56,5
14:59,984783496.0,16139.215057772462,-13.7,9
15:03,706361191.0,271.5320484940779,-44.5,2
15:05,407574996.0,827.7296093809374,-68.6,2
15:25,409971170.0,3630.396047950587,-32.0,9
15:29,310620484.0,-444.5918049078017,-250.59,2
15:29,912584712.0,876.100619544733,-12.98,1
15:31,955035930.0,2564.6684791714783,-8.98,4
15:54,321372947.0,-233.04645078909948,-15.3,5
15:55,322221939.0,4351.024121046896,-28.47,9
15:58,460463595.0,-636.4899454185788,-167.29,2
15:59,282046994.0,-315.1446499999996,-121.25,5
16:04,720742759.0,1226.1970808830072,-261.72,5
16:04,310620484.0,-576.8638049078018,-132.27,2
16:12,448279144.0,-70.04735000000107,-292.77,5
16:14,460463595.0,-735.8619454185788,-99.37,2
16:18,706361191.0,227.0320484940779,-44.5,2
16:19,785210466.0,2683.7477969465604,-18.49,9
16:22,596171893.0,130.51559482551065,-25.97,7
16:25,492215823.0,4811.756023815445,-55.15,4
16:30,575652395.0,2045.562048650919,-18.98,5
16:30,901432314.0,3865.800741749081,-177.09,2
16:32,678330503.0,2508.672070991702,-24.99,7
16:33,128033695.0,2981.2720203252675,-19.65,9
16:38,310375875.0,2593.547384477424,-31.82,5
16:50,901432314.0,3760.814741749082,-104.99,2
16:57,788740658.0,1940.4714690169988,-6.0,7
16:58,909669130.0,569.9798847367667,-14.96,4
16:58,796709231.0,-103.5902221037026,-53.98,2
17:05,662610817.0,-1359.001831324928,-80.0,8
17:06,194745206.0,-136.0326279087568,-149.77,2
17:10,331450202.0,9479.744262870316,-14.2,9
17:13,679911053.0,3546.609725903845,-9.29,7
17:15,874431242.0,11384.150305836769,-27.88,2
17:17,213112754.0,6572.202127937354,-12.95,9
17:19,479456865.0,1527.6363618641742,-32.97,4
17:20,407574996.0,649.2296093809374,-178.5,2
17:20,480557476.0,12572.66014973217,-32.92,2
17:22,960208650.0,16868.007515050373,-130.24,2
17:23,482513594.0,6839.536920486713,-7.93,5
17:23,497772347.0,114.2417499999978,-305.2,2
17:23,836110591.0,4389.078623559947,-28.03,9
17:24,516051449.0,1719.3441491108483,-82.24,5
17:24,832564361.0,17796.386408994687,-4.04,2
17:26,586315521.0,14106.08249855633,-6.31,4
17:28,315078351.0,10292.569636643486,-39.93,2
17:30,416060965.0,859.2122547005804,-76.99,2
17:30,194745206.0,-262.7046279087568,-126.67,2
17:32,138609932.0,1988.2040032945856,-15.96,4
17:33,414805878.0,14535.509694591065,-11.14,4
17:34,626989363.0,1410.771763317375,-36.98,2
17:34,629078930.0,574.5647632670716,-146.99,2
17:36,785749304.0,9953.13655985382,-11.69,8
17:37,806358207.0,13339.411952857774,-31.83,7
17:38,508518911.0,472.7447502790102,-28.0,2
17:40,137913631.0,1696.9082499999995,-19.99,2
17:41,916270283.0,3182.9802500000014,-12.99,2
17:42,642924505.0,513.345120183526,-18.0,4
17:42,639409800.0,40450.9281630721,-13.26,4
17:42,865748375.0,2227.7583261340956,-31.34,5
17:42,310375875.0,2500.832384477424,-92.71,5
17:44,627622066.0,3988.56237216963,-60.98,2
17:45,656317661.0,-113.14465845859732,-21.97,1
17:47,858989281.0,30568.346875064726,-119.67,2
17:48,738958551.0,10125.350609226836,-31.23,9
17:48,992204045.0,9275.66045730176,-1.78,2
17:49,390747457.0,683.6692999999976,-49.3,5
17:49,336171116.0,274.9683999999996,-148.46,2
17:50,999752672.0,1012.6310935333344,-11.98,7
17:50,795847804.0,27087.67317586239,-22.48,2
17:52,587202562.0,461.2648994170683,-176.5,2
17:53,500043411.0,15205.15047946702,-7.5,9
17:54,370757362.0,1755.4860236036177,-22.97,7
17:55,466649401.0,969.0607807973744,-42.0,4
17:55,629078930.0,367.4067632670716,-207.16,2
17:58,940569402.0,5491.959666307209,-22.15,9
17:58,358846516.0,789.1907225272173,-63.91,7
17:59,742223719.0,883.6743573048025,-99.98,4
17:59,698955014.0,1132.0503404481908,-9.99,4
18:00,194745206.0,-498.5906279087568,-235.89,2
18:01,310620484.0,-777.7638049078017,-200.9,2
18:04,887853850.0,11693.13459819049,-20.63,9
18:04,532478725.0,5200.079997218351,-5.87,5
18:05,405945930.0,4373.886219465059,-22.9,9
18:08,893134725.0,1631.124100776119,-59.76,5
18:08,858989281.0,30418.56087506473,-149.79,2
18:10,226703987.0,2458.8321365470747,-35.0,2
18:14,768271776.0,-485.84224676657976,-38.93,9
18:15,270374623.0,11387.225966948949,-15.9,9
18:21,627936697.0,354.59585000000004,-29.13,9
18:25,996042490.0,7238.230153576683,-64.22,7
18:25,605116158.0,3136.0777000000053,-36.43,5
18:30,310620484.0,-960.4078049078016,-182.64,2
18:31,858989281.0,30363.27487506473,-55.29,2
18:32,624500124.0,3576.2903506052976,-107.02,5
18:34,226703987.0,2451.846136547075,-6.99,2
18:34,736340277.0,9151.344176335628,-18.63,9
18:38,897714622.0,10543.953990041033,-34.99,9
18:40,124102251.0,1298.1997989312445,-1.15,5
18:48,704517789.0,19676.788461863533,-302.82,5
18:48,586315521.0,14101.37161065345,-4.71,5
18:50,690523499.0,290.40295,-2.5,7
18:51,287480331.0,9073.906556759694,-7.44,7
18:53,792845450.0,928.7061500000008,-73.6,5
18:54,992204045.0,9221.58643730176,-54.07,7
18:56,570323670.0,4163.012849540705,-12.02,2
18:57,237493332.0,17075.431964897376,-28.6,5
18:57,887853850.0,11616.547212764452,-76.59,8
19:03,296770890.0,1379.2820103790832,-38.63,9
19:06,631744379.0,-2384.2712594910654,-38.49,5
19:08,687135796.0,32698.479965723312,-15.24,9
19:08,226703987.0,2382.546136547074,-69.3,2
19:13,345582855.0,1095.6291528205493,-46.36,5
19:16,166019891.0,9570.2765287916,-13.71,5
19:16,930277104.0,10366.320857266011,-44.74,9
19:17,282837512.0,15973.569765215538,-31.5,9
19:21,137822385.0,4305.735703161885,-128.39,5
19:22,967989787.0,174.53808264072725,-59.39,5
19:22,493640090.0,-2982.8234499999976,-42.34,5
19:23,631111289.0,-476.34900000000096,-37.86,5
19:28,812839908.0,-1764.7498500000002,-17.68,5
19:28,961077907.0,-65.86520000000007,-148.93,5
19:28,489964679.0,23469.802069968184,-0.81,5
19:28,277562576.0,239.60766997625723,-60.71,5
19:32,191161970.0,-4325.280999999993,-66.97,5
19:39,345514953.0,141.71719999999937,-33.64,5
19:39,706301742.0,-3425.763149999995,-36.17,5
19:41,769311479.0,7466.599113978694,-149.65,5
19:41,994214354.0,11214.194316772906,-39.65,7
19:42,287230540.0,974.4409977638752,-22.68,9
19:43,331450202.0,9451.365412298996,-28.38,7
19:45,226703987.0,2327.2601365470746,-55.29,2
19:47,535804582.0,609.7300999999986,-41.02,5
19:47,994214354.0,11178.464316772906,-35.73,9
19:51,534325901.0,7389.836085315585,-21.48,9
19:54,547010927.0,27559.08318336208,-33.1,9
19:55,720221651.0,-2696.468866598434,-27.2,5
19:59,690958123.0,23663.93544787065,-39.86,5
20:04,541639148.0,4910.16636346834,-19.5,9
20:06,564744955.0,612.260958588842,-51.02,5
20:09,687135796.0,32616.77596572331,-81.7,5
20:10,370521542.0,30534.298681540004,-13.0,9
20:11,683319988.0,8090.4414166544675,-91.66,5
20:18,196289502.0,18247.133041109904,-33.29,5
20:22,143061865.0,8037.876786288926,-22.66,8
20:25,198946608.0,4738.672320785162,-54.57,7
20:28,893134725.0,1619.4841007761188,-11.64,9
20:31,625281433.0,-778.3299073707569,-135.56,5
20:34,844835978.0,11805.57763156293,-43.79,5
20:39,455831435.0,-1867.1571048014948,-48.07,5
20:41,433917275.0,8405.825478449684,-55.51,5
20:43,752362502.0,8338.062348509424,-71.13,5
20:43,605711527.0,-75.14748616741632,-80.56,5
20:43,152488934.0,2545.127157313732,-40.9,5
20:47,355602925.0,1823.767392453807,-61.61,5
20:53,851181128.0,6067.213279224717,-5.86,2
20:56,951817450.0,10303.040518685442,-11.95,5
20:57,540159353.0,12556.114556398536,-50.36,5
20:59,851181128.0,6043.013279224717,-24.2,9
21:00,587225252.0,7140.000048551972,-30.26,2
21:08,338022396.0,-18.093660624260913,-18.4,9
21:35,683319988.0,8075.641369550389,-14.8,7
21:39,310375875.0,2477.992384477424,-22.84,9
01:32,183888402.0,20811.415741948887,-32.49,9
02:16,348325817.0,10586.238419024628,-28.25,9
02:41,679662108.0,18338.686875455052,-27.25,5
02:44,687135796.0,32606.22596572331,-10.55,9
02:49,572384506.0,9094.065703743796,-44.09,9
02:57,510101371.0,14109.73176627904,-35.21,9
02:58,984783496.0,16120.475057772464,-18.74,9
03:03,853907490.0,9292.409090558907,-10.7,9
03:03,146909202.0,5213.262376844087,-19.68,9
03:03,383625050.0,3869.922966993742,-14.49,5
03:04,670102069.0,1767.158817831161,-27.39,9
03:09,414805878.0,14506.029694591063,-29.48,9
03:11,482513594.0,6812.4258659164625,-27.11,7
03:14,601627384.0,3902.2943156550623,-34.88,9
03:16,473820682.0,12405.063549888171,-19.22,2
03:18,639549973.0,6631.644613704224,-28.81,2
03:20,779236304.0,2281.037595479535,-38.84,9
03:22,113747882.0,13686.22592618471,-31.68,9
03:27,520447032.0,8772.699172869205,-24.13,9
03:30,518474507.0,16260.721112350378,-33.38,9
03:34,853907490.0,9282.560729468987,-9.85,4
03:36,108481285.0,10704.071829999568,-9.01,7
03:38,489964679.0,23432.202069968185,-37.6,9
03:38,604288474.0,2061.2172287000253,-9.33,8
03:39,892354433.0,-408.1299606343386,-15.03,9
03:42,987163717.0,4586.546078176684,-41.14,9
03:46,179173981.0,4485.374630008081,-30.93,9
03:52,706250160.0,14762.79313078748,-19.7,8
03:53,264550521.0,7112.292628948262,-6.86,2
04:10,461990622.0,9071.230221046071,-16.05,5
04:11,419550103.0,21056.46685486507,-39.96,7
04:16,450896297.0,15011.976491703188,-44.6,9
04:17,113747882.0,13639.40388862525,-46.82,8
04:17,885259672.0,3571.09191292673,-2.93,5
04:17,179173981.0,4459.4804211475775,-25.89,5
04:18,572384506.0,9019.63918019796,-74.43,2
04:19,749378808.0,2698.2548913460328,-32.99,9
04:23,683319988.0,8045.7513695503885,-29.89,9
04:23,120634201.0,6126.390521925363,-23.38,9
04:24,985188462.0,-691.2536112887752,-21.27,9
04:24,679911053.0,3529.6543862333683,-16.96,8
04:28,408057540.0,5941.451037500422,-38.42,9
04:29,237684254.0,7080.611596857049,-15.4,7
04:35,216285378.0,26274.17211352841,-44.75,9
04:37,322221939.0,4333.540229187524,-17.48,7
04:37,145387690.0,6198.162708345381,-0.02,7
04:43,657139925.0,15507.375279996146,-15.5,9
04:53,749378808.0,2666.8862391934676,-31.37,2
04:54,760704118.0,1565.5983127174895,-21.49,9
04:58,925037906.0,2332.352800000002,-21.7,9
05:00,200080192.0,9773.744708105472,-18.74,9
05:04,478412511.0,12829.869447002146,-24.56,8
05:05,819515373.0,3049.3261876645106,-75.58,5
05:10,198946608.0,4654.112882807986,-84.56,8
05:12,196289502.0,18234.753041109903,-12.38,9
05:13,933491926.0,4080.180218368096,-35.4,2
05:17,832564361.0,17784.25014103694,-12.14,7
05:17,518474507.0,16214.572595331329,-46.15,2
05:19,873693307.0,12611.607492784851,-8.95,9
05:20,414805878.0,14466.55647436352,-39.47,7
05:25,809499628.0,20201.405045413423,-16.9,9
05:25,290818242.0,6196.649246938613,-2.65,5
05:26,450896297.0,14971.655092987705,-40.32,7
05:27,975345315.0,40981.6205777799,-15.11,7
05:28,331450202.0,9424.417058100662,-26.95,2
05:28,984783496.0,16101.688958476458,-18.79,2
05:29,554792076.0,32326.268329777264,-40.62,7
05:34,151968462.0,8996.188461960946,-18.87,5
05:34,899742927.0,14792.76173267226,-40.4,2
05:40,738958551.0,10086.700609226837,-38.65,9
05:41,687135796.0,32601.96939152369,-4.26,5
05:41,940569402.0,5476.6096663072085,-15.35,9
05:44,511179916.0,7158.755910645969,-0.26,2
05:44,128033695.0,2936.6604201137548,-44.61,5
05:45,912705941.0,21125.5936208431,-37.13,2
05:46,736340277.0,9131.894176335629,-19.45,9
05:48,550169791.0,25391.33419106515,-21.3,8
05:48,480557476.0,12571.4242298861,-1.24,7
05:51,587225252.0,7105.550048551972,-34.45,9
05:53,873693307.0,12602.561396647649,-9.05,2
05:55,766941757.0,3980.624664992592,-26.59,9
05:56,305778936.0,11083.122944862247,-15.98,9
06:01,370521542.0,30521.348681540003,-12.95,9
06:04,994214354.0,11145.584316772907,-32.88,9
06:09,668329719.0,10057.802670998077,-6.78,7
06:10,285220959.0,12650.647598201354,-10.33,7
06:11,802697323.0,18646.675834216698,-33.24,9
06:12,364357875.0,9672.496678125137,-57.64,5
06:14,471897866.0,8083.115346481349,-45.36,8
06:15,541639148.0,4887.402347029749,-22.76,2
06:16,146909202.0,5188.162575783505,-25.1,2
06:17,134461671.0,6341.531001320822,-45.83,5
06:18,960208650.0,16860.132696642097,-7.87,5
06:19,259015404.0,1182.9898366218165,-11.94,8
06:19,718058208.0,1520.49857041276,-21.23,5
06:20,704517789.0,19662.529603784704,-14.26,7
06:22,256002321.0,7607.190537128446,-15.94,9
06:22,348325817.0,10557.76298789874,-28.48,5
06:25,842682241.0,4551.820732562672,-44.67,7
06:25,520447032.0,8751.732904471393,-20.97,7
06:27,433917275.0,8376.325478449684,-29.5,9
06:27,657139925.0,15503.97029988269,-3.4,7
06:28,858989281.0,30346.924875064728,-16.35,9
06:28,678851253.0,4465.386209778264,-57.09,8
06:29,910730524.0,8786.185130228474,-33.37,7
06:30,322720763.0,8179.668327825511,-1.98,5
06:30,506618547.0,17879.54514021811,-0.88,5
06:31,930277104.0,10337.830857266012,-28.49,9
06:34,229205098.0,8320.990344041444,-5.35,5
06:38,399144202.0,2338.88132556208,-31.23,2
06:38,766941757.0,3973.701397234488,-6.92,5
06:41,213112754.0,6535.148770299568,-37.05,5
06:41,532478725.0,5164.739997218351,-35.34,9
06:44,655368335.0,4542.236533799308,-57.57,8
06:47,534325901.0,7382.846085315585,-6.99,9
06:48,237493332.0,17008.013702600063,-67.42,2
06:49,324224854.0,6155.15932728805,-49.4,2
06:51,169006407.0,13234.901783182886,-29.9,7
06:53,108563213.0,26334.35497222293,-24.48,5
06:53,414454079.0,3777.5148500000023,-33.85,9
06:55,370521542.0,30506.787382272556,-14.56,5
06:55,408057540.0,5938.9767982999165,-2.47,4
06:55,987656636.0,6121.258897035102,-1.41,5
06:58,108931112.0,16507.775693942127,-25.42,9
07:00,549414742.0,8203.137280528164,-27.94,9
07:00,587225252.0,7100.622105903525,-4.93,7
07:02,930277104.0,10290.79165254055,-47.04,5
07:03,836110591.0,4340.1786235599475,-48.9,9
07:04,769311479.0,7455.482490566695,-11.12,5
07:05,310375875.0,2451.936007188775,-26.06,7
07:06,709608057.0,3086.1210241817134,-36.29,9
07:07,195895574.0,7817.029365980238,-22.29,9
07:10,221868392.0,5509.985711621034,-41.54,9
07:10,441274121.0,14227.932981681912,-18.41,7
07:12,496395938.0,13740.081955590596,-42.3,2
07:16,887853850.0,11590.792167847534,-25.76,2
07:17,116598243.0,3634.474221777451,-6.05,9
07:18,776108637.0,1078.6502536574956,-7.6,9
07:19,609939116.0,9241.717366495272,-9.27,7
07:22,558119802.0,37767.28015560242,-22.52,8
07:23,719586818.0,21807.740705406693,-38.64,7
07:24,315546581.0,32905.236482810986,-49.2,2
07:25,383833857.0,29385.095733121496,-13.54,9
07:29,187541224.0,2773.934627433773,-38.83,9
07:37,992204045.0,9203.49969809077,-18.09,7
07:38,822135975.0,13165.481359123029,-7.77,7
07:39,461029994.0,9335.613297163543,-30.6,8
07:41,909676212.0,577.7969019002102,-27.35,5
07:44,519644021.0,3943.7010716011023,-0.27,5
07:45,187111705.0,7684.156332690096,-26.31,7
07:50,586315521.0,14070.44229353735,-30.93,4
07:51,673025413.0,861.4753565414796,-29.59,7
07:53,435984758.0,4906.494937013028,-37.15,5
08:01,280268430.0,6396.739433262342,-15.73,7
08:02,752362502.0,8315.877873675552,-22.18,2
08:04,270374623.0,11356.607721142083,-30.62,5
08:05,117273481.0,10927.647052867636,-35.95,5
08:05,395284483.0,1996.6903402113087,-5.7,9
08:06,454129843.0,957.02639516656,-4.95,9
08:07,345582855.0,1090.4791528205492,-5.15,9
08:08,785749304.0,9947.97147489076,-5.17,2
08:13,776431321.0,3652.536972173123,-17.16,7
08:16,897714622.0,10540.89143803414,-3.06,2
08:18,973086490.0,11718.754580501383,-44.58,2
08:18,336557504.0,2016.7507123661103,-7.5,9
08:20,874431242.0,11359.810305836769,-24.34,9
08:20,822250278.0,7757.276848955016,-4.28,4
08:20,195895574.0,7788.028124553097,-29.0,2
08:21,478986718.0,-753.8578000000016,-38.0,5
08:24,519935524.0,1273.933809737519,-5.4,9
08:28,426466211.0,-3741.703249999998,-13.71,5
08:28,659415300.0,2629.507146218075,-60.99,5
08:28,960208650.0,16810.1946966421,-49.94,5
08:28,936813994.0,640.293360832788,-43.03,5
08:30,189335192.0,-1220.6507017578606,-20.09,5
08:31,224524792.0,-2426.833182430848,-36.82,5
08:32,851181128.0,6002.123241098415,-40.89,2
08:33,699313649.0,-2489.9458991419046,-50.28,5
08:33,951817450.0,10238.836518685444,-64.2,5
08:35,425730826.0,2866.7469093887203,-18.43,5
08:36,308897841.0,1641.254899999999,-61.81,5
08:36,613729471.0,9687.858016449063,-3.69,7
08:39,639409800.0,40441.72586687837,-9.2,5
08:39,762785862.0,1120.0962999999992,-52.43,5
08:41,264208990.0,1297.4234999999985,-87.9,5
08:45,764450279.0,24366.77211635454,-38.95,2
08:45,240643705.0,557.0217988343001,-17.18,7
08:46,287480331.0,9028.361264385274,-45.55,5
08:46,970298834.0,2888.816150913943,-19.0,5
08:46,761272540.0,197.0752999999987,-97.08,5
08:47,820686957.0,-1132.487566311196,-105.08,5
08:52,245690309.0,11518.312130396998,-9.51,5
08:52,675806859.0,8748.429391554819,-28.03,7
08:52,768271776.0,-606.7990967665797,-120.96,5
08:53,373163757.0,11875.28980189042,-260.69,5
08:55,647472692.0,29143.147104846143,-33.08,4
08:57,874431242.0,11343.4486703541,-16.36,5
09:00,540159353.0,12549.514556398535,-6.6,9
09:01,282837512.0,15962.260664139694,-11.31,2
09:03,613729471.0,9681.358016449063,-6.5,9
09:05,472995101.0,1598.6573340990833,-88.92,5
09:06,624563756.0,1.974128783556484,-5.35,9
09:06,987229118.0,956.8742037797916,-136.14,5
09:09,618138606.0,1457.323303264288,-6.1,9
09:10,403765849.0,-2688.047999999996,-56.63,5
09:11,815993333.0,6252.604066515882,-14.49,7
09:12,586315521.0,14065.09229353735,-5.35,9
09:13,383833857.0,29379.695733121494,-5.4,9
09:13,116169597.0,1797.8269499999994,-16.98,4
09:15,690958123.0,23656.13544787065,-7.8,9
09:15,760753808.0,479.94549999999936,-29.99,7
09:16,558875206.0,4061.7375393997822,-5.7,9
09:17,809499628.0,20187.311468179058,-14.09,5
09:18,987656636.0,6111.178897035102,-10.08,7
09:19,506618547.0,17874.14514021811,-5.4,9
09:19,604288474.0,2034.6452287000257,-26.57,5
09:19,417850087.0,17828.890511277426,-5.7,9
09:20,409370545.0,856.9412755455209,-38.22,7
09:21,618514666.0,24167.875472716485,-198.76,7
09:21,117273481.0,10921.647052867636,-6.0,9
09:22,504055745.0,363.6907613417668,-49.26,5
09:22,834383043.0,6081.761415159748,-5.99,4
09:22,683078800.0,2404.945389942463,-7.3,9
09:24,441274121.0,14222.282981681912,-5.65,9
09:26,475277431.0,1692.5291369436188,-141.85,5
09:27,896821055.0,-481.2894407329176,-38.95,1
09:27,472995101.0,1568.6673340990833,-29.99,4
09:28,391688371.0,1147.0289551878172,-42.59,5
09:29,553734946.0,505.2085999999981,-193.0,2
09:30,945054126.0,442.9781,-12.99,2
09:34,879091637.0,-29.21847626202291,-58.03,2
09:34,504055745.0,361.7007613417668,-1.99,4
09:36,779946617.0,19192.27711718675,-18.0,8
09:37,473820682.0,12371.674809888173,-33.39,4
09:38,575652395.0,1997.402048650919,-48.16,2
09:42,137822385.0,4277.775703161885,-27.96,1
09:42,978951113.0,-726.4094925904193,-208.94,5
09:44,588565416.0,7278.932079939112,-20.07,7
09:47,867679563.0,61.848353701715865,-28.57,5
09:47,399538448.0,8876.661997995912,-5.35,9
09:49,618514666.0,24012.50347271649,-155.37,4
09:49,977899503.0,-5.761106419147346,-67.52,5
09:52,873701090.0,692.1776680163313,-39.77,2
09:53,865748375.0,2185.3155600401788,-42.44,8
09:54,425730826.0,2856.7569093887205,-9.99,2
09:56,245198540.0,330.1638988017795,-146.24,7
09:58,277562576.0,220.495894778178,-19.11,7
10:00,549414742.0,8199.66452616559,-3.47,2
10:01,903953091.0,4073.388790134576,-5.5,9
10:04,403902116.0,545.6560499999993,-248.52,5
10:04,943829984.0,106.81070911345682,-139.47,2
10:05,659415300.0,2623.007146218075,-6.5,9
10:08,909676212.0,507.81690190021015,-69.98,4
10:13,245198540.0,267.1638988017795,-63.0,4
10:14,310740977.0,497.4004359296808,-126.0,2
10:15,456246119.0,23692.850293067804,-1.99,4
10:15,950234174.0,1212.3708192371596,-261.8,2
10:15,461029994.0,9309.013297163545,-26.6,5
10:16,137822385.0,4272.025703161885,-5.75,9
10:18,687135796.0,32596.70939152369,-5.26,4
10:20,553734946.0,401.2085999999981,-104.0,2
10:20,127809299.0,2576.975771126573,-28.0,2
10:28,570269025.0,4094.779145837062,-41.99,2
10:29,322221939.0,4313.188699187524,-20.35,4
10:31,973086490.0,11624.646580501383,-94.11,5
10:32,943829984.0,42.85070911345682,-63.96,2
10:34,916270283.0,3147.0302500000016,-35.95,1
10:39,552980092.0,11.033719119337524,-9.95,4
10:39,441142605.0,2472.4303733518577,-21.98,4
10:41,570269025.0,4065.818696413823,-28.96,5
10:42,456246119.0,23691.350293067804,-1.5,4
10:43,575652395.0,1981.601572079696,-15.8,2
10:44,554792076.0,32282.350329777262,-43.92,5
10:44,547010927.0,27529.79318336208,-29.29,2
10:45,547010927.0,27503.90454110418,-25.89,2
10:46,950234174.0,1010.0708192371596,-202.3,2
10:50,348325817.0,10542.18698789874,-15.58,4
10:50,943829984.0,-46.62929088654317,-89.48,2
10:52,679662108.0,18290.516875455058,-48.17,2
11:06,245198540.0,142.3188988017795,-124.84,7
11:08,280098744.0,932.5753778716668,-23.97,4
11:16,845648250.0,258.28094999999934,-94.52,5
11:16,793781222.0,2064.9808789474073,-71.97,4
11:20,364357875.0,9665.326678125137,-7.17,7
11:21,767447966.0,5750.274922706574,-161.55,5
11:34,308505160.0,15844.276129160617,-15.77,5
11:41,857997794.0,1277.6106651508865,-34.98,4
11:43,108931112.0,16502.503088505637,-5.27,7
11:44,679662108.0,18258.796875455053,-31.72,1
11:45,943829984.0,-51.61929088654317,-4.99,4
11:45,245198540.0,-17.753601198220494,-48.71,4
11:51,494789005.0,3257.1066688728656,-31.7,4
11:51,950234174.0,947.7708192371596,-62.3,2
11:55,737547541.0,153.91559956777434,-39.98,2
11:58,799861885.0,1035.6747999999986,-9.99,7
12:03,433837402.0,283.4041315358117,-33.89,9
12:05,386277162.0,783.5299999999994,-26.43,9
12:08,895331556.0,-298.9316000000009,-60.0,2
12:12,679943657.0,4360.938889180138,-5.4,9
12:20,245198540.0,-129.10610119822047,-111.35,7
12:23,854895960.0,4521.580161043493,-9.29,5
12:25,308505160.0,15809.446129160617,-34.83,9
12:27,618514666.0,24010.513472716484,-1.99,4
12:28,950234174.0,893.1708192371597,-54.6,2
12:31,996042490.0,7222.008082430419,-16.22,8
12:37,355940285.0,8486.955978189684,-198.8,2
12:47,762896656.0,-597.5775018481414,-29.05,5
12:50,108812033.0,717.0645999999981,-70.98,5
12:51,767447966.0,5739.274922706574,-11.0,7
12:51,950234174.0,730.0708192371596,-163.1,2
12:53,660561861.0,1056.415649332573,-49.99,4
12:55,821971408.0,1238.9091102355433,-21.97,7
12:58,550169791.0,25378.844191065153,-12.49,9
13:00,277562576.0,214.795894778178,-5.7,9
13:02,189757473.0,-2432.963649999999,-23.07,5
13:03,245198540.0,-201.4586011982205,-72.35,7
13:03,910730524.0,8781.085130228474,-5.1,9
13:03,310620484.0,-983.3378049078016,-22.93,9
13:03,340321732.0,2656.489250000004,-5.0,9
13:03,187111705.0,7678.106332690096,-6.05,9
13:04,355940285.0,8444.955978189684,-42.0,2
13:08,116169597.0,1790.0269499999995,-7.8,9
13:12,585625048.0,2706.471883013491,-5.8,9
13:15,245198540.0,-336.45860119822044,-135.0,4
13:17,688712152.0,7288.218690701315,-7.15,9
13:18,849096144.0,2206.6420207513447,-6.5,9
13:18,749378808.0,2661.3862391934676,-5.5,9
13:19,593378953.0,1469.7296500000048,-6.0,9
13:29,310740977.0,353.92843592968086,-143.47,2
13:31,570323670.0,4162.487256450264,-0.53,2
13:33,726913482.0,-692.9985485264766,-55.36,5
13:47,261793952.0,-412.4407397961851,-61.01,5
13:57,310740977.0,263.62843592968085,-90.3,2
14:02,572333122.0,-4082.377549999995,-36.78,5
14:14,760753808.0,284.6454999999994,-195.3,2
14:28,618514666.0,23905.555472716485,-104.96,2
14:37,572136270.0,-450.64858841197656,-112.56,5
14:38,152616936.0,1131.7120078630646,-61.97,2
14:40,333054026.0,-182.70910597680975,-160.94,2
14:48,760753808.0,152.34549999999942,-132.3,2
14:55,310740977.0,185.24243592968085,-78.39,2
14:57,950234174.0,514.4708192371596,-215.6,2
15:11,310740977.0,40.38443592968088,-144.86,2
15:14,760753808.0,-99.65450000000055,-252.0,2
15:16,546296727.0,117.56772730261837,-5.99,7
15:25,950234174.0,293.9708192371596,-220.5,2
15:28,388862238.0,1904.5065355055185,-177.98,2
15:39,321372947.0,-246.45285078909947,-13.41,5
15:39,939972497.0,838.3109086000104,-17.97,1
15:42,517934629.0,323.18767870842635,-39.98,2
15:46,950234174.0,172.1708192371596,-121.8,2
15:46,720742759.0,1193.2470808830071,-32.95,1
15:53,939972497.0,748.3309086000104,-89.98,2
16:06,272538745.0,17447.508374448127,-34.88,9
16:11,456221621.0,766.5945673026279,-20.29,9
16:11,414454079.0,3773.464850000002,-4.05,4
16:13,538003940.0,1441.42000000001,-37.95,7
16:14,647472692.0,29116.327104846143,-26.82,7
16:16,280200287.0,-490.07045338694894,-116.62,2
16:17,744968736.0,-1514.146826569424,-8.88,5
16:20,532478725.0,5101.726092940425,-63.01,2
16:20,950234174.0,105.6708192371596,-66.5,2
16:21,829914501.0,2267.828806570975,-82.19,5
16:22,698076160.0,7592.678837201856,-45.92,1
16:29,670102069.0,1720.0368685848796,-47.12,7
16:32,817294757.0,-2419.8383,-34.78,5
16:33,286484726.0,1027.5988129418447,-84.73,2
16:33,760753808.0,-270.4545000000005,-170.8,2
16:33,964702094.0,1140.4946121713565,-122.97,2
16:35,642924505.0,362.8651201835259,-150.48,2
16:35,886921642.0,3579.9125023806964,-20.45,9
16:39,280200287.0,-517.062953386949,-26.99,2
16:46,297823329.0,881.3686499999991,-15.98,7
16:52,587225252.0,7057.672105903525,-42.95,2
16:53,286484726.0,956.3638129418448,-71.23,2
16:54,605116158.0,3108.0777000000053,-28.0,2
16:56,695607232.0,-13.753505389440004,-28.0,2
16:58,395284483.0,1915.0633402113087,-81.63,5
17:03,296972867.0,-909.9189000000008,-96.5,5
17:06,551755686.0,8215.998926654152,-66.98,2
17:07,642924505.0,248.87512018352595,-113.99,2
17:08,656812046.0,2118.092753732519,-26.17,9
17:08,760753808.0,-510.5545000000006,-240.1,2
17:09,736310094.0,-808.1789240274259,-84.3,5
17:09,647936800.0,1872.439854554387,-4.07,7
17:09,310740977.0,-128.2735640703191,-168.66,2
17:13,534325901.0,7360.282727889288,-22.56,2
17:15,280200287.0,-563.562953386949,-46.5,2
17:15,994214354.0,11111.0372439458,-34.55,4
17:17,887853850.0,11564.052167847534,-26.74,9
17:17,670102069.0,1712.8968685848797,-7.14,7
17:18,494977194.0,1571.9724705975789,-130.87,5
17:21,350921975.0,81.18972107387428,-78.66,5
17:21,286484726.0,867.1138129418447,-89.25,2
17:21,534097839.0,-5211.228549999995,-21.59,5
17:21,570323670.0,4127.437256450264,-35.05,1
17:24,414805878.0,14460.22647436352,-6.33,2
17:25,886837068.0,835.0955999999992,-3.98,4
17:26,950234174.0,21.67081923715961,-84.0,2
17:26,859603181.0,4024.788125197535,-22.04,7
17:28,147474476.0,3795.530859120131,-21.97,7
17:29,146909202.0,5043.262575783506,-144.9,2
17:29,806358207.0,13337.32805840264,-2.08,5
17:31,166019891.0,9564.1365287916,-6.14,2
17:31,760753808.0,-634.4545000000005,-123.9,2
17:33,336557504.0,1994.7807123661105,-21.97,1
17:33,758885184.0,1115.245082274345,-89.5,2
17:34,613427466.0,7765.943455264379,-20.97,7
17:34,224112146.0,478.05979999999965,-94.08,5
17:38,237493332.0,16955.563702600062,-52.45,2
17:38,282102606.0,825.3481624228265,-32.96,7
17:38,901432314.0,3716.9431607333145,-43.87,5
17:39,885259672.0,3565.08591292673,-6.01,4
17:40,235881534.0,14522.01579551679,-62.12,5
17:40,286484726.0,748.2388129418447,-118.88,2
17:42,871200314.0,441.17512424263833,-62.98,6
17:42,496395938.0,13711.931955590597,-28.15,7
17:43,466649401.0,932.0335807973744,-37.03,5
17:46,221868392.0,5502.831091927804,-7.15,7
17:47,758160963.0,7589.681724777471,-0.96,5
17:47,858989281.0,30316.37487506473,-30.55,7
17:48,950234174.0,-104.32918076284038,-126.0,2
17:48,386729293.0,35458.80244797836,-49.98,2
17:48,667367404.0,9973.533900824652,-35.84,2
17:49,146909202.0,4967.6765757835055,-75.59,2
17:50,520418719.0,2675.775300000004,-43.47,5
17:50,687135796.0,32589.339391523692,-7.37,1
17:52,668692488.0,985.333041057584,-65.97,4
17:52,547010927.0,27482.554541104186,-21.35,9
17:54,370757362.0,1523.5160236036174,-231.97,2
17:57,147474476.0,3659.772859120132,-135.76,2
17:58,366477356.0,590.2026499999998,-59.0,2
18:00,873693307.0,12492.703396647648,-109.86,2
18:01,653640811.0,19565.867180827685,-64.67,2
18:01,287480331.0,8985.361264385274,-43.0,9
18:01,146909202.0,4912.376575783505,-55.3,2
18:02,993663752.0,-218.97785758960367,-16.44,9
18:03,151968462.0,8946.481461960946,-49.71,5
18:03,128033695.0,2842.1884201137545,-94.47,2
18:04,124102251.0,1274.3196680143317,-23.88,4
18:06,540159353.0,12508.503598157957,-41.01,5
18:06,198051483.0,-787.1019104088573,-26.5,9
18:07,633345190.0,6206.291233244409,-28.98,9
18:08,758885184.0,912.2550822743448,-202.99,2
18:10,806358207.0,13254.02805840264,-83.3,7
18:11,166019891.0,9544.9365287916,-19.2,9
18:12,286484726.0,706.2388129418447,-42.0,2
18:13,248142083.0,-456.8265652974833,-30.39,9
18:15,146909202.0,4812.304575783505,-100.07,2
18:15,482513594.0,6793.475865916463,-18.95,9
18:17,147474476.0,3622.014859120132,-37.76,2
18:17,587202562.0,352.89649941706836,-108.37,5
18:19,514362267.0,646.9948191070605,-31.1,9
18:21,436430134.0,-624.2439013371817,-24.89,9
18:24,618514666.0,23818.069472716485,-87.49,2
18:25,873693307.0,12345.07339664765,-147.63,2
18:31,701070224.0,-1713.4191,-280.26,5
18:31,738958551.0,10045.023576870202,-41.68,7
18:34,170637730.0,1772.473201280178,-11.68,8
18:35,366477356.0,467.70264999999984,-122.5,2
18:35,270374623.0,11322.717721142086,-33.89,7
18:35,604334058.0,736.8443999999993,-151.26,5
18:36,838830098.0,991.5154920877844,-74.93,5
18:37,128033695.0,2625.9024201137545,-216.29,2
18:38,785749304.0,9911.90747489076,-36.06,5
18:41,264208990.0,1295.4334999999985,-1.99,7
18:43,478651121.0,-574.6792704015304,-64.58,5
18:49,310375875.0,2422.436007188775,-29.5,9
18:51,724997545.0,-301.56095800221834,-38.84,5
18:52,146909202.0,4757.004575783505,-55.3,2
18:52,583558311.0,-428.48121524866775,-47.17,5
18:53,245690309.0,11475.072780396998,-43.24,4
18:54,785749304.0,9896.60747489076,-15.3,9
18:55,489964679.0,23424.732174033554,-7.47,4
18:56,224215364.0,-1984.925092088279,-12.38,5
18:56,574548998.0,-0.0417000000010716,-128.98,5
18:57,920031185.0,-339.80637051629225,-111.64,5
18:57,633345190.0,6100.361233244409,-105.93,4
18:58,503575533.0,9228.598110679244,-16.61,2
18:58,180616589.0,1574.6108282361097,-14.0,5
19:00,954263768.0,-144.96270000000035,-50.38,5
19:02,795847804.0,27082.220777909923,-5.45,5
19:02,987390838.0,-3222.333741210377,-41.59,5
19:07,279149837.0,1237.2810499999994,-146.1,5
19:12,534908754.0,-1095.8583000000003,-23.52,5
19:17,929044080.0,787.1638915056282,-20.82,5
19:18,762700245.0,1482.8717000000024,-26.45,9
19:20,282837512.0,15930.020664139694,-32.24,9
19:24,949032480.0,4252.421909474946,-30.84,9
19:27,160166876.0,916.3300405862434,-32.1,9
19:28,146909202.0,4562.404575783505,-194.6,2
19:34,344219145.0,9858.600996107834,-14.74,2
19:35,285428103.0,11736.868336586644,-20.96,5
19:35,867987292.0,2672.828312441252,-0.47,2
19:36,478412511.0,12674.385447002143,-155.48,5
19:38,859603181.0,3977.600802131094,-47.19,2
19:40,890830949.0,578.0885999999974,-91.63,5
19:47,964702094.0,1062.1310121713564,-78.36,5
20:00,951817450.0,10220.933335485312,-17.9,2
20:00,531186970.0,3693.1588078659806,-26.56,5
20:01,858989281.0,30313.88511912171,-2.49,2
20:12,742223719.0,736.2438573048025,-147.43,5
20:13,771125520.0,-214.51820000000097,-59.35,5
20:15,872286364.0,-310.96949581309985,-44.85,5
20:15,835736339.0,3147.3795783833075,-26.09,7
20:15,245690309.0,11431.182780397,-43.89,5
20:22,214339619.0,-31.96463583011267,-98.23,5
20:23,252760664.0,7647.841241461462,-59.13,7
20:23,143061865.0,8033.846634939098,-4.03,7
20:39,166019891.0,9482.47105076686,-62.47,7
20:40,975345315.0,40907.9105777799,-73.71,5
20:43,106601471.0,11920.401862653182,-37.25,5
20:48,522188082.0,8471.141436684238,-17.05,7
20:50,256002321.0,7582.389936681895,-24.8,5
20:54,581655972.0,45935.20686133913,-41.06,5
20:55,786141370.0,-244.8375000000009,-62.35,5
21:05,824916823.0,9709.172158853497,-32.94,9
21:13,366550080.0,26834.1657944632,-19.25,7
21:32,259015404.0,1145.3498366218162,-37.64,9
